Date,Country,Migration State,Arrivals,Arrivals: Gender Male,Arrivals: Gender Female
1/01/2020,Aruba,Kedah,0,0,0
1/01/2020,Aruba,Pulau Pinang,0,0,0
1/01/2020,Afghanistan,Johor,2,0,2
1/01/2020,Afghanistan,Kedah,1,1,0
1/01/2020,Afghanistan,Perlis,0,0,0
1/01/2020,Afghanistan,Pulau Pinang,0,0,0
1/01/2020,Afghanistan,Sarawak,0,0,0
1/01/2020,Afghanistan,Selangor,180,161,19
1/01/2020,Angola,Johor,0,0,0
1/01/2020,Angola,Kedah,0,0,0
1/01/2020,Angola,Sabah,0,0,0
1/01/2020,Angola,Selangor,9,6,3
1/01/2020,Anguilla,Selangor,0,0,0
1/01/2020,Albania,Johor,35,17,18
1/01/2020,Albania,Kedah,6,4,2
1/01/2020,Albania,Perak,1,1,0
1/01/2020,Albania,Perlis,1,1,0
1/01/2020,Albania,Pulau Pinang,2,0,2
1/01/2020,Albania,Sabah,1,1,0
1/01/2020,Albania,Sarawak,1,1,0
1/01/2020,Albania,Selangor,62,31,31
1/01/2020,Andorra,Johor,0,0,0
1/01/2020,Andorra,Kedah,0,0,0
1/01/2020,Andorra,Perlis,0,0,0
1/01/2020,Andorra,Pulau Pinang,0,0,0
1/01/2020,Andorra,Selangor,5,3,2
1/01/2020,Antigua and Barbuda,Selangor,0,0,0
1/01/2020,United Arab Emirates,Johor,22,14,8
1/01/2020,United Arab Emirates,Kedah,4,3,1
1/01/2020,United Arab Emirates,Kelantan,0,0,0
1/01/2020,United Arab Emirates,Perak,0,0,0
1/01/2020,United Arab Emirates,Perlis,0,0,0
1/01/2020,United Arab Emirates,Pulau Pinang,4,3,1
1/01/2020,United Arab Emirates,Sabah,0,0,0
1/01/2020,United Arab Emirates,Sarawak,0,0,0
1/01/2020,United Arab Emirates,Selangor,371,252,119
1/01/2020,Argentina,Johor,221,133,88
1/01/2020,Argentina,Kedah,304,148,156
1/01/2020,Argentina,Kelantan,5,2,3
1/01/2020,Argentina,Melaka,0,0,0
1/01/2020,Argentina,Perak,0,0,0
1/01/2020,Argentina,Perlis,20,11,9
1/01/2020,Argentina,Pulau Pinang,5,2,3
1/01/2020,Argentina,Sabah,3,1,2
1/01/2020,Argentina,Sarawak,1,1,0
1/01/2020,Argentina,Selangor,908,464,444
1/01/2020,Argentina,W.P. Labuan,0,0,0
1/01/2020,Armenia,Johor,5,2,3
1/01/2020,Armenia,Kedah,3,1,2
1/01/2020,Armenia,Kelantan,1,1,0
1/01/2020,Armenia,Perak,2,0,2
1/01/2020,Armenia,Perlis,0,0,0
1/01/2020,Armenia,Pulau Pinang,1,1,0
1/01/2020,Armenia,Sabah,0,0,0
1/01/2020,Armenia,Sarawak,0,0,0
1/01/2020,Armenia,Selangor,79,22,57
1/01/2020,Antarctica,Selangor,0,0,0
1/01/2020,Antigua and Barbuda,Johor,6,3,3
1/01/2020,Antigua and Barbuda,Kedah,0,0,0
1/01/2020,Antigua and Barbuda,Pulau Pinang,0,0,0
1/01/2020,Antigua and Barbuda,Sarawak,0,0,0
1/01/2020,Antigua and Barbuda,Selangor,22,12,10
1/01/2020,Australia,Johor,8923,4980,3943
1/01/2020,Australia,Kedah,1138,636,502
1/01/2020,Australia,Kelantan,21,15,6
1/01/2020,Australia,Melaka,10,7,3
1/01/2020,Australia,Negeri Sembilan,0,0,0
1/01/2020,Australia,Pahang,52,23,29
1/01/2020,Australia,Perak,282,156,126
1/01/2020,Australia,Perlis,115,64,51
1/01/2020,Australia,Pulau Pinang,2617,1339,1278
1/01/2020,Australia,Sabah,908,464,444
1/01/2020,Australia,Sarawak,956,535,421
1/01/2020,Australia,Selangor,36952,20700,16252
1/01/2020,Australia,Terengganu,0,0,0
1/01/2020,Australia,W.P. Labuan,24,17,7
1/01/2020,Austria,Johor,242,159,83
1/01/2020,Austria,Kedah,170,97,73
1/01/2020,Austria,Kelantan,8,7,1
1/01/2020,Austria,Melaka,0,0,0
1/01/2020,Austria,Negeri Sembilan,0,0,0
1/01/2020,Austria,Pahang,0,0,0
1/01/2020,Austria,Perak,8,7,1
1/01/2020,Austria,Perlis,28,19,9
1/01/2020,Austria,Pulau Pinang,75,57,18
1/01/2020,Austria,Sabah,26,15,11
1/01/2020,Austria,Sarawak,18,13,5
1/01/2020,Austria,Selangor,904,585,319
1/01/2020,Austria,Terengganu,0,0,0
1/01/2020,Austria,W.P. Labuan,1,1,0
1/01/2020,Azerbaijan,Johor,6,5,1
1/01/2020,Azerbaijan,Kedah,9,8,1
1/01/2020,Azerbaijan,Kelantan,0,0,0
1/01/2020,Azerbaijan,Melaka,2,1,1
1/01/2020,Azerbaijan,Perlis,0,0,0
1/01/2020,Azerbaijan,Pulau Pinang,0,0,0
1/01/2020,Azerbaijan,Sabah,3,2,1
1/01/2020,Azerbaijan,Sarawak,3,1,2
1/01/2020,Azerbaijan,Selangor,159,89,70
1/01/2020,Azerbaijan,W.P. Labuan,1,1,0
1/01/2020,Burundi,Pulau Pinang,0,0,0
1/01/2020,Burundi,Sarawak,0,0,0
1/01/2020,Burundi,Selangor,2,2,0
1/01/2020,Belgium,Johor,265,171,94
1/01/2020,Belgium,Kedah,140,80,60
1/01/2020,Belgium,Kelantan,5,3,2
1/01/2020,Belgium,Melaka,0,0,0
1/01/2020,Belgium,Negeri Sembilan,0,0,0
1/01/2020,Belgium,Pahang,0,0,0
1/01/2020,Belgium,Perak,2,0,2
1/01/2020,Belgium,Perlis,14,8,6
1/01/2020,Belgium,Pulau Pinang,76,53,23
1/01/2020,Belgium,Sabah,17,12,5
1/01/2020,Belgium,Sarawak,15,12,3
1/01/2020,Belgium,Selangor,1243,812,431
1/01/2020,Belgium,W.P. Labuan,2,2,0
1/01/2020,Benin,Johor,0,0,0
1/01/2020,Benin,Kedah,0,0,0
1/01/2020,Benin,Perak,0,0,0
1/01/2020,Benin,Pulau Pinang,0,0,0
1/01/2020,Benin,Sabah,1,1,0
1/01/2020,Benin,Sarawak,0,0,0
1/01/2020,Benin,Selangor,6,5,1
1/01/2020,Burkina Faso,Perak,0,0,0
1/01/2020,Burkina Faso,Pulau Pinang,0,0,0
1/01/2020,Burkina Faso,Selangor,5,5,0
1/01/2020,Bangladesh,Johor,5428,4954,474
1/01/2020,Bangladesh,Kedah,72,35,37
1/01/2020,Bangladesh,Kelantan,1,1,0
1/01/2020,Bangladesh,Melaka,17,17,0
1/01/2020,Bangladesh,Negeri Sembilan,0,0,0
1/01/2020,Bangladesh,Pahang,1,1,0
1/01/2020,Bangladesh,Perak,0,0,0
1/01/2020,Bangladesh,Perlis,0,0,0
1/01/2020,Bangladesh,Pulau Pinang,81,74,7
1/01/2020,Bangladesh,Sabah,14,7,7
1/01/2020,Bangladesh,Sarawak,167,151,16
1/01/2020,Bangladesh,Selangor,21150,17904,3246
1/01/2020,Bangladesh,W.P. Labuan,24,24,0
1/01/2020,Bulgaria,Johor,73,49,24
1/01/2020,Bulgaria,Kedah,68,32,36
1/01/2020,Bulgaria,Kelantan,0,0,0
1/01/2020,Bulgaria,Pahang,0,0,0
1/01/2020,Bulgaria,Perak,0,0,0
1/01/2020,Bulgaria,Perlis,1,1,0
1/01/2020,Bulgaria,Pulau Pinang,2,1,1
1/01/2020,Bulgaria,Sabah,3,2,1
1/01/2020,Bulgaria,Sarawak,1,1,0
1/01/2020,Bulgaria,Selangor,495,252,243
1/01/2020,Bulgaria,W.P. Labuan,2,1,1
1/01/2020,Bahrain,Johor,7,4,3
1/01/2020,Bahrain,Kedah,5,3,2
1/01/2020,Bahrain,Kelantan,1,1,0
1/01/2020,Bahrain,Perlis,0,0,0
1/01/2020,Bahrain,Pulau Pinang,0,0,0
1/01/2020,Bahrain,Sabah,0,0,0
1/01/2020,Bahrain,Sarawak,4,4,0
1/01/2020,Bahrain,Selangor,454,260,194
1/01/2020,Bahamas,Johor,1,0,1
1/01/2020,Bahamas,Kedah,0,0,0
1/01/2020,Bahamas,Perak,0,0,0
1/01/2020,Bahamas,Sabah,1,1,0
1/01/2020,Bahamas,Sarawak,0,0,0
1/01/2020,Bahamas,Selangor,5,2,3
1/01/2020,Bosnia and Herzegovina,Johor,9,4,5
1/01/2020,Bosnia and Herzegovina,Kedah,10,6,4
1/01/2020,Bosnia and Herzegovina,Perlis,0,0,0
1/01/2020,Bosnia and Herzegovina,Pulau Pinang,3,3,0
1/01/2020,Bosnia and Herzegovina,Sabah,0,0,0
1/01/2020,Bosnia and Herzegovina,Sarawak,2,2,0
1/01/2020,Bosnia and Herzegovina,Selangor,85,44,41
1/01/2020,Belarus,Johor,19,10,9
1/01/2020,Belarus,Kedah,42,19,23
1/01/2020,Belarus,Kelantan,2,1,1
1/01/2020,Belarus,Pahang,0,0,0
1/01/2020,Belarus,Perak,0,0,0
1/01/2020,Belarus,Perlis,0,0,0
1/01/2020,Belarus,Pulau Pinang,16,8,8
1/01/2020,Belarus,Sabah,10,7,3
1/01/2020,Belarus,Sarawak,3,1,2
1/01/2020,Belarus,Selangor,423,189,234
1/01/2020,Belarus,W.P. Labuan,0,0,0
1/01/2020,Belize,Johor,3,1,2
1/01/2020,Belize,Pulau Pinang,0,0,0
1/01/2020,Belize,Sarawak,0,0,0
1/01/2020,Belize,Selangor,7,4,3
1/01/2020,Bermuda,Selangor,0,0,0
1/01/2020,Bolivia,Johor,6,2,4
1/01/2020,Bolivia,Kedah,0,0,0
1/01/2020,Bolivia,Melaka,0,0,0
1/01/2020,Bolivia,Perak,2,0,2
1/01/2020,Bolivia,Perlis,0,0,0
1/01/2020,Bolivia,Pulau Pinang,0,0,0
1/01/2020,Bolivia,Sabah,0,0,0
1/01/2020,Bolivia,Sarawak,0,0,0
1/01/2020,Bolivia,Selangor,30,15,15
1/01/2020,Brazil,Johor,293,173,120
1/01/2020,Brazil,Kedah,163,72,91
1/01/2020,Brazil,Kelantan,1,0,1
1/01/2020,Brazil,Melaka,0,0,0
1/01/2020,Brazil,Pahang,0,0,0
1/01/2020,Brazil,Perak,6,4,2
1/01/2020,Brazil,Perlis,10,4,6
1/01/2020,Brazil,Pulau Pinang,18,12,6
1/01/2020,Brazil,Sabah,17,8,9
1/01/2020,Brazil,Sarawak,17,9,8
1/01/2020,Brazil,Selangor,1480,828,652
1/01/2020,Brazil,W.P. Labuan,0,0,0
1/01/2020,Barbados,Johor,1,1,0
1/01/2020,Barbados,Kedah,0,0,0
1/01/2020,Barbados,Perlis,0,0,0
1/01/2020,Barbados,Pulau Pinang,0,0,0
1/01/2020,Barbados,Selangor,10,3,7
1/01/2020,Brunei Darussalam,Johor,496,231,265
1/01/2020,Brunei Darussalam,Kedah,13,9,4
1/01/2020,Brunei Darussalam,Kelantan,10,6,4
1/01/2020,Brunei Darussalam,Melaka,0,0,0
1/01/2020,Brunei Darussalam,Pahang,0,0,0
1/01/2020,Brunei Darussalam,Perak,3,2,1
1/01/2020,Brunei Darussalam,Perlis,13,9,4
1/01/2020,Brunei Darussalam,Pulau Pinang,10,4,6
1/01/2020,Brunei Darussalam,Sabah,1023,499,524
1/01/2020,Brunei Darussalam,Sarawak,77835,43927,33908
1/01/2020,Brunei Darussalam,Selangor,6217,3079,3138
1/01/2020,Brunei Darussalam,W.P. Labuan,2881,1815,1066
1/01/2020,Bhutan,Johor,8,6,2
1/01/2020,Bhutan,Kedah,1,1,0
1/01/2020,Bhutan,Perak,0,0,0
1/01/2020,Bhutan,Perlis,0,0,0
1/01/2020,Bhutan,Pulau Pinang,2,0,2
1/01/2020,Bhutan,Sabah,0,0,0
1/01/2020,Bhutan,Sarawak,0,0,0
1/01/2020,Bhutan,Selangor,66,48,18
1/01/2020,Botswana,Johor,2,2,0
1/01/2020,Botswana,Kedah,0,0,0
1/01/2020,Botswana,Perlis,0,0,0
1/01/2020,Botswana,Pulau Pinang,0,0,0
1/01/2020,Botswana,Sabah,0,0,0
1/01/2020,Botswana,Sarawak,2,2,0
1/01/2020,Botswana,Selangor,25,10,15
1/01/2020,Central African Republic,Kedah,0,0,0
1/01/2020,Central African Republic,Selangor,0,0,0
1/01/2020,Canada,Johor,2001,1124,877
1/01/2020,Canada,Kedah,320,178,142
1/01/2020,Canada,Kelantan,15,9,6
1/01/2020,Canada,Melaka,2,1,1
1/01/2020,Canada,Negeri Sembilan,0,0,0
1/01/2020,Canada,Pahang,0,0,0
1/01/2020,Canada,Perak,22,15,7
1/01/2020,Canada,Perlis,59,38,21
1/01/2020,Canada,Pulau Pinang,489,262,227
1/01/2020,Canada,Sabah,273,143,130
1/01/2020,Canada,Sarawak,544,303,241
1/01/2020,Canada,Selangor,5740,3274,2466
1/01/2020,Canada,Terengganu,0,0,0
1/01/2020,Canada,W.P. Labuan,13,11,2
1/01/2020,Cocos (Keeling) Islands,Selangor,0,0,0
1/01/2020,Switzerland,Johor,426,264,162
1/01/2020,Switzerland,Kedah,288,159,129
1/01/2020,Switzerland,Kelantan,11,4,7
1/01/2020,Switzerland,Melaka,2,1,1
1/01/2020,Switzerland,Negeri Sembilan,0,0,0
1/01/2020,Switzerland,Pahang,1,1,0
1/01/2020,Switzerland,Perak,17,10,7
1/01/2020,Switzerland,Perlis,62,44,18
1/01/2020,Switzerland,Pulau Pinang,151,84,67
1/01/2020,Switzerland,Sabah,35,22,13
1/01/2020,Switzerland,Sarawak,33,17,16
1/01/2020,Switzerland,Selangor,1413,893,520
1/01/2020,Switzerland,W.P. Labuan,7,6,1
1/01/2020,Chile,Johor,57,26,31
1/01/2020,Chile,Kedah,54,30,24
1/01/2020,Chile,Kelantan,1,1,0
1/01/2020,Chile,Melaka,0,0,0
1/01/2020,Chile,Pahang,0,0,0
1/01/2020,Chile,Perak,0,0,0
1/01/2020,Chile,Perlis,7,3,4
1/01/2020,Chile,Pulau Pinang,19,6,13
1/01/2020,Chile,Sabah,1,0,1
1/01/2020,Chile,Sarawak,1,0,1
1/01/2020,Chile,Selangor,366,190,176
1/01/2020,China,Johor,92472,38137,54335
1/01/2020,China,Kedah,5069,2188,2881
1/01/2020,China,Kelantan,26,11,15
1/01/2020,China,Melaka,2,0,2
1/01/2020,China,Pahang,43,21,22
1/01/2020,China,Perak,236,89,147
1/01/2020,China,Perlis,136,72,64
1/01/2020,China,Pulau Pinang,10906,5180,5726
1/01/2020,China,Sabah,12574,5703,6871
1/01/2020,China,Sarawak,1192,446,746
1/01/2020,China,Selangor,163242,75519,87723
1/01/2020,China,Terengganu,0,0,0
1/01/2020,China,W.P. Labuan,60,30,30
1/01/2020,Côte d'Ivoire,Johor,0,0,0
1/01/2020,Côte d'Ivoire,Kedah,1,1,0
1/01/2020,Côte d'Ivoire,Pulau Pinang,1,1,0
1/01/2020,Côte d'Ivoire,Sabah,0,0,0
1/01/2020,Côte d'Ivoire,Sarawak,0,0,0
1/01/2020,Côte d'Ivoire,Selangor,36,27,9
1/01/2020,Cameroon,Johor,3,3,0
1/01/2020,Cameroon,Kedah,0,0,0
1/01/2020,Cameroon,Pulau Pinang,0,0,0
1/01/2020,Cameroon,Sabah,0,0,0
1/01/2020,Cameroon,Sarawak,1,1,0
1/01/2020,Cameroon,Selangor,33,23,10
1/01/2020,Congo,Johor,0,0,0
1/01/2020,Congo,Pulau Pinang,0,0,0
1/01/2020,Congo,Sarawak,0,0,0
1/01/2020,Congo,Selangor,9,4,5
1/01/2020,Congo,Johor,1,1,0
1/01/2020,Congo,Kedah,0,0,0
1/01/2020,Congo,Selangor,2,2,0
1/01/2020,Cook Islands,Selangor,0,0,0
1/01/2020,Colombia,Johor,28,17,11
1/01/2020,Colombia,Kedah,0,0,0
1/01/2020,Colombia,Perak,0,0,0
1/01/2020,Colombia,Pulau Pinang,2,0,2
1/01/2020,Colombia,Sabah,0,0,0
1/01/2020,Colombia,Sarawak,0,0,0
1/01/2020,Colombia,Selangor,217,114,103
1/01/2020,Colombia,W.P. Labuan,0,0,0
1/01/2020,Comoros,Johor,0,0,0
1/01/2020,Comoros,Kedah,1,0,1
1/01/2020,Comoros,Selangor,19,13,6
1/01/2020,Cabo Verde,Johor,1,0,1
1/01/2020,Cabo Verde,Kedah,0,0,0
1/01/2020,Cabo Verde,Pulau Pinang,0,0,0
1/01/2020,Cabo Verde,Sabah,0,0,0
1/01/2020,Cabo Verde,Selangor,3,2,1
1/01/2020,Costa Rica,Johor,9,6,3
1/01/2020,Costa Rica,Kedah,1,1,0
1/01/2020,Costa Rica,Perak,1,0,1
1/01/2020,Costa Rica,Perlis,0,0,0
1/01/2020,Costa Rica,Pulau Pinang,2,1,1
1/01/2020,Costa Rica,Sabah,1,0,1
1/01/2020,Costa Rica,Sarawak,0,0,0
1/01/2020,Costa Rica,Selangor,73,44,29
1/01/2020,Cuba,Johor,7,7,0
1/01/2020,Cuba,Kedah,0,0,0
1/01/2020,Cuba,Perlis,0,0,0
1/01/2020,Cuba,Pulau Pinang,1,1,0
1/01/2020,Cuba,Sabah,0,0,0
1/01/2020,Cuba,Sarawak,0,0,0
1/01/2020,Cuba,Selangor,40,21,19
1/01/2020,Cyprus,Johor,15,9,6
1/01/2020,Cyprus,Kedah,7,3,4
1/01/2020,Cyprus,Perak,0,0,0
1/01/2020,Cyprus,Perlis,0,0,0
1/01/2020,Cyprus,Pulau Pinang,4,2,2
1/01/2020,Cyprus,Sabah,0,0,0
1/01/2020,Cyprus,Sarawak,1,0,1
1/01/2020,Cyprus,Selangor,61,37,24
1/01/2020,Czechia,Johor,163,99,64
1/01/2020,Czechia,Kedah,492,251,241
1/01/2020,Czechia,Kelantan,3,2,1
1/01/2020,Czechia,Melaka,2,2,0
1/01/2020,Czechia,Negeri Sembilan,0,0,0
1/01/2020,Czechia,Perak,0,0,0
1/01/2020,Czechia,Perlis,18,12,6
1/01/2020,Czechia,Pulau Pinang,89,43,46
1/01/2020,Czechia,Sabah,30,18,12
1/01/2020,Czechia,Sarawak,15,8,7
1/01/2020,Czechia,Selangor,966,559,407
1/01/2020,Czechia,W.P. Labuan,5,4,1
1/01/2020,Germany,Johor,2320,1507,813
1/01/2020,Germany,Kedah,1336,695,641
1/01/2020,Germany,Kelantan,39,31,8
1/01/2020,Germany,Melaka,3,2,1
1/01/2020,Germany,Negeri Sembilan,1,1,0
1/01/2020,Germany,Pahang,12,7,5
1/01/2020,Germany,Perak,34,25,9
1/01/2020,Germany,Perlis,255,166,89
1/01/2020,Germany,Pulau Pinang,550,378,172
1/01/2020,Germany,Sabah,143,100,43
1/01/2020,Germany,Sarawak,241,156,85
1/01/2020,Germany,Selangor,6725,4268,2457
1/01/2020,Germany,Terengganu,0,0,0
1/01/2020,Germany,W.P. Labuan,14,9,5
1/01/2020,Djibouti,Johor,0,0,0
1/01/2020,Djibouti,Selangor,9,3,6
1/01/2020,Dominica,Johor,9,7,2
1/01/2020,Dominica,Kedah,0,0,0
1/01/2020,Dominica,Pulau Pinang,0,0,0
1/01/2020,Dominica,Sabah,6,5,1
1/01/2020,Dominica,Sarawak,1,1,0
1/01/2020,Dominica,Selangor,41,33,8
1/01/2020,Dominica,W.P. Labuan,0,0,0
1/01/2020,Denmark,Johor,349,236,113
1/01/2020,Denmark,Kedah,416,205,211
1/01/2020,Denmark,Kelantan,2,2,0
1/01/2020,Denmark,Melaka,1,1,0
1/01/2020,Denmark,Negeri Sembilan,0,0,0
1/01/2020,Denmark,Pahang,0,0,0
1/01/2020,Denmark,Perak,20,12,8
1/01/2020,Denmark,Perlis,20,12,8
1/01/2020,Denmark,Pulau Pinang,148,89,59
1/01/2020,Denmark,Sabah,44,27,17
1/01/2020,Denmark,Sarawak,16,10,6
1/01/2020,Denmark,Selangor,1755,1049,706
1/01/2020,Denmark,W.P. Labuan,1,1,0
1/01/2020,Dominican Republic,Johor,2,1,1
1/01/2020,Dominican Republic,Kedah,0,0,0
1/01/2020,Dominican Republic,Perak,0,0,0
1/01/2020,Dominican Republic,Perlis,1,1,0
1/01/2020,Dominican Republic,Pulau Pinang,0,0,0
1/01/2020,Dominican Republic,Sabah,1,1,0
1/01/2020,Dominican Republic,Sarawak,0,0,0
1/01/2020,Dominican Republic,Selangor,19,10,9
1/01/2020,Algeria,Johor,27,23,4
1/01/2020,Algeria,Kedah,18,12,6
1/01/2020,Algeria,Kelantan,0,0,0
1/01/2020,Algeria,Melaka,0,0,0
1/01/2020,Algeria,Perak,0,0,0
1/01/2020,Algeria,Perlis,3,1,2
1/01/2020,Algeria,Pulau Pinang,9,6,3
1/01/2020,Algeria,Sabah,1,1,0
1/01/2020,Algeria,Sarawak,6,3,3
1/01/2020,Algeria,Selangor,719,524,195
1/01/2020,Algeria,W.P. Labuan,0,0,0
1/01/2020,Ecuador,Johor,26,9,17
1/01/2020,Ecuador,Kedah,2,1,1
1/01/2020,Ecuador,Perak,0,0,0
1/01/2020,Ecuador,Perlis,0,0,0
1/01/2020,Ecuador,Pulau Pinang,0,0,0
1/01/2020,Ecuador,Sabah,0,0,0
1/01/2020,Ecuador,Sarawak,2,0,2
1/01/2020,Ecuador,Selangor,77,38,39
1/01/2020,Egypt,Johor,244,184,60
1/01/2020,Egypt,Kedah,33,14,19
1/01/2020,Egypt,Kelantan,4,4,0
1/01/2020,Egypt,Melaka,0,0,0
1/01/2020,Egypt,Pahang,0,0,0
1/01/2020,Egypt,Perak,0,0,0
1/01/2020,Egypt,Perlis,0,0,0
1/01/2020,Egypt,Pulau Pinang,9,8,1
1/01/2020,Egypt,Sabah,5,4,1
1/01/2020,Egypt,Sarawak,87,53,34
1/01/2020,Egypt,Selangor,2697,1661,1036
1/01/2020,Egypt,Terengganu,0,0,0
1/01/2020,Egypt,W.P. Labuan,0,0,0
1/01/2020,Eritrea,Johor,0,0,0
1/01/2020,Eritrea,Pulau Pinang,0,0,0
1/01/2020,Eritrea,Sabah,0,0,0
1/01/2020,Eritrea,Selangor,31,20,11
1/01/2020,Spain,Johor,490,291,199
1/01/2020,Spain,Kedah,358,180,178
1/01/2020,Spain,Kelantan,6,5,1
1/01/2020,Spain,Melaka,2,1,1
1/01/2020,Spain,Negeri Sembilan,0,0,0
1/01/2020,Spain,Pahang,1,1,0
1/01/2020,Spain,Perak,6,4,2
1/01/2020,Spain,Perlis,34,19,15
1/01/2020,Spain,Pulau Pinang,71,43,28
1/01/2020,Spain,Sabah,44,24,20
1/01/2020,Spain,Sarawak,35,19,16
1/01/2020,Spain,Selangor,2140,1298,842
1/01/2020,Spain,W.P. Labuan,8,6,2
1/01/2020,Estonia,Johor,91,47,44
1/01/2020,Estonia,Kedah,107,56,51
1/01/2020,Estonia,Kelantan,0,0,0
1/01/2020,Estonia,Pahang,0,0,0
1/01/2020,Estonia,Perak,3,2,1
1/01/2020,Estonia,Perlis,1,1,0
1/01/2020,Estonia,Pulau Pinang,6,4,2
1/01/2020,Estonia,Sabah,16,10,6
1/01/2020,Estonia,Sarawak,4,3,1
1/01/2020,Estonia,Selangor,254,135,119
1/01/2020,Estonia,W.P. Labuan,0,0,0
1/01/2020,Ethiopia,Johor,5,4,1
1/01/2020,Ethiopia,Kedah,0,0,0
1/01/2020,Ethiopia,Pulau Pinang,0,0,0
1/01/2020,Ethiopia,Sarawak,2,0,2
1/01/2020,Ethiopia,Selangor,41,25,16
1/01/2020,Finland,Johor,335,208,127
1/01/2020,Finland,Kedah,476,209,267
1/01/2020,Finland,Kelantan,3,1,2
1/01/2020,Finland,Melaka,0,0,0
1/01/2020,Finland,Negeri Sembilan,0,0,0
1/01/2020,Finland,Pahang,0,0,0
1/01/2020,Finland,Perak,3,2,1
1/01/2020,Finland,Perlis,19,11,8
1/01/2020,Finland,Pulau Pinang,129,76,53
1/01/2020,Finland,Sabah,24,15,9
1/01/2020,Finland,Sarawak,16,9,7
1/01/2020,Finland,Selangor,1417,756,661
1/01/2020,Finland,W.P. Labuan,2,1,1
1/01/2020,Fiji,Johor,77,37,40
1/01/2020,Fiji,Kedah,4,0,4
1/01/2020,Fiji,Kelantan,0,0,0
1/01/2020,Fiji,Perak,0,0,0
1/01/2020,Fiji,Perlis,4,0,4
1/01/2020,Fiji,Pulau Pinang,1,1,0
1/01/2020,Fiji,Sabah,0,0,0
1/01/2020,Fiji,Sarawak,0,0,0
1/01/2020,Fiji,Selangor,151,84,67
1/01/2020,France,Johor,1957,1214,743
1/01/2020,France,Kedah,1149,671,478
1/01/2020,France,Kelantan,50,38,12
1/01/2020,France,Melaka,2,2,0
1/01/2020,France,Negeri Sembilan,1,1,0
1/01/2020,France,Pahang,12,5,7
1/01/2020,France,Perak,29,20,9
1/01/2020,France,Perlis,142,88,54
1/01/2020,France,Pulau Pinang,508,299,209
1/01/2020,France,Sabah,135,71,64
1/01/2020,France,Sarawak,100,68,32
1/01/2020,France,Selangor,8663,5373,3290
1/01/2020,France,Terengganu,0,0,0
1/01/2020,France,W.P. Labuan,5,3,2
1/01/2020,"Micronesia, Federated States of",Johor,1,1,0
1/01/2020,"Micronesia, Federated States of",Pulau Pinang,1,0,1
1/01/2020,"Micronesia, Federated States of",Selangor,1,1,0
1/01/2020,Gabon,Johor,1,1,0
1/01/2020,Gabon,Pulau Pinang,0,0,0
1/01/2020,Gabon,Sarawak,0,0,0
1/01/2020,Gabon,Selangor,3,1,2
1/01/2020,United Kingdom of Great Britain and Northern Ireland,Johor,5448,3473,1975
1/01/2020,United Kingdom of Great Britain and Northern Ireland,Kedah,2148,1206,942
1/01/2020,United Kingdom of Great Britain and Northern Ireland,Kelantan,37,31,6
1/01/2020,United Kingdom of Great Britain and Northern Ireland,Melaka,5,5,0
1/01/2020,United Kingdom of Great Britain and Northern Ireland,Negeri Sembilan,0,0,0
1/01/2020,United Kingdom of Great Britain and Northern Ireland,Pahang,18,13,5
1/01/2020,United Kingdom of Great Britain and Northern Ireland,Perak,75,50,25
1/01/2020,United Kingdom of Great Britain and Northern Ireland,Perlis,289,186,103
1/01/2020,United Kingdom of Great Britain and Northern Ireland,Pulau Pinang,1412,841,571
1/01/2020,United Kingdom of Great Britain and Northern Ireland,Sabah,581,327,254
1/01/2020,United Kingdom of Great Britain and Northern Ireland,Sarawak,1261,822,439
1/01/2020,United Kingdom of Great Britain and Northern Ireland,Selangor,20246,12997,7249
1/01/2020,United Kingdom of Great Britain and Northern Ireland,Terengganu,0,0,0
1/01/2020,United Kingdom of Great Britain and Northern Ireland,W.P. Labuan,119,74,45
1/01/2020,Georgia,Johor,3,2,1
1/01/2020,Georgia,Kedah,4,1,3
1/01/2020,Georgia,Melaka,1,1,0
1/01/2020,Georgia,Perak,0,0,0
1/01/2020,Georgia,Perlis,0,0,0
1/01/2020,Georgia,Pulau Pinang,3,2,1
1/01/2020,Georgia,Sabah,0,0,0
1/01/2020,Georgia,Sarawak,0,0,0
1/01/2020,Georgia,Selangor,46,24,22
1/01/2020,Ghana,Johor,14,11,3
1/01/2020,Ghana,Kedah,0,0,0
1/01/2020,Ghana,Kelantan,1,1,0
1/01/2020,Ghana,Pulau Pinang,1,1,0
1/01/2020,Ghana,Sabah,0,0,0
1/01/2020,Ghana,Sarawak,2,2,0
1/01/2020,Ghana,Selangor,82,50,32
1/01/2020,Gibraltar,Johor,0,0,0
1/01/2020,Gibraltar,Sarawak,0,0,0
1/01/2020,Guinea,Johor,14,14,0
1/01/2020,Guinea,Kedah,0,0,0
1/01/2020,Guinea,Kelantan,1,1,0
1/01/2020,Guinea,Perlis,0,0,0
1/01/2020,Guinea,Pulau Pinang,0,0,0
1/01/2020,Guinea,Sabah,0,0,0
1/01/2020,Guinea,Sarawak,2,1,1
1/01/2020,Guinea,Selangor,81,70,11
1/01/2020,Guadeloupe,Selangor,0,0,0
1/01/2020,Gambia,Johor,11,6,5
1/01/2020,Gambia,Kedah,0,0,0
1/01/2020,Gambia,Kelantan,2,2,0
1/01/2020,Gambia,Pulau Pinang,0,0,0
1/01/2020,Gambia,Sabah,0,0,0
1/01/2020,Gambia,Sarawak,0,0,0
1/01/2020,Gambia,Selangor,67,52,15
1/01/2020,Guinea-Bissau,Johor,2,2,0
1/01/2020,Guinea-Bissau,Selangor,3,3,0
1/01/2020,Equatorial Guinea,Johor,0,0,0
1/01/2020,Equatorial Guinea,Selangor,7,4,3
1/01/2020,Greece,Johor,65,53,12
1/01/2020,Greece,Kedah,41,21,20
1/01/2020,Greece,Kelantan,1,1,0
1/01/2020,Greece,Melaka,4,3,1
1/01/2020,Greece,Negeri Sembilan,0,0,0
1/01/2020,Greece,Pahang,0,0,0
1/01/2020,Greece,Perak,3,1,2
1/01/2020,Greece,Perlis,7,4,3
1/01/2020,Greece,Pulau Pinang,7,6,1
1/01/2020,Greece,Sabah,2,2,0
1/01/2020,Greece,Sarawak,8,4,4
1/01/2020,Greece,Selangor,258,183,75
1/01/2020,Grenada,Johor,12,10,2
1/01/2020,Grenada,Kedah,0,0,0
1/01/2020,Grenada,Pulau Pinang,1,1,0
1/01/2020,Grenada,Sabah,0,0,0
1/01/2020,Grenada,Sarawak,0,0,0
1/01/2020,Grenada,Selangor,25,15,10
1/01/2020,Greenland,Johor,0,0,0
1/01/2020,Greenland,Selangor,0,0,0
1/01/2020,Guatemala,Johor,0,0,0
1/01/2020,Guatemala,Kedah,0,0,0
1/01/2020,Guatemala,Pahang,1,0,1
1/01/2020,Guatemala,Perak,0,0,0
1/01/2020,Guatemala,Pulau Pinang,0,0,0
1/01/2020,Guatemala,Sabah,0,0,0
1/01/2020,Guatemala,Sarawak,0,0,0
1/01/2020,Guatemala,Selangor,26,15,11
1/01/2020,Guatemala,W.P. Labuan,0,0,0
1/01/2020,Guyana,Johor,2,2,0
1/01/2020,Guyana,Kedah,0,0,0
1/01/2020,Guyana,Pulau Pinang,0,0,0
1/01/2020,Guyana,Sarawak,0,0,0
1/01/2020,Guyana,Selangor,8,4,4
1/01/2020,Hong Kong,Johor,0,0,0
1/01/2020,Hong Kong,Kedah,0,0,0
1/01/2020,Hong Kong,Kelantan,0,0,0
1/01/2020,Hong Kong,Pahang,0,0,0
1/01/2020,Hong Kong,Perak,25,13,12
1/01/2020,Hong Kong,Perlis,0,0,0
1/01/2020,Hong Kong,Pulau Pinang,0,0,0
1/01/2020,Hong Kong,Sabah,3,1,2
1/01/2020,Hong Kong,Sarawak,7,5,2
1/01/2020,Hong Kong,Selangor,0,0,0
1/01/2020,Hong Kong,Terengganu,0,0,0
1/01/2020,Heard Island and McDonald Islands,Johor,0,0,0
1/01/2020,Honduras,Johor,10,4,6
1/01/2020,Honduras,Kedah,2,1,1
1/01/2020,Honduras,Perak,0,0,0
1/01/2020,Honduras,Pulau Pinang,0,0,0
1/01/2020,Honduras,Sabah,1,1,0
1/01/2020,Honduras,Sarawak,0,0,0
1/01/2020,Honduras,Selangor,21,13,8
1/01/2020,Croatia,Johor,72,44,28
1/01/2020,Croatia,Kedah,26,17,9
1/01/2020,Croatia,Kelantan,0,0,0
1/01/2020,Croatia,Melaka,0,0,0
1/01/2020,Croatia,Pahang,1,1,0
1/01/2020,Croatia,Perak,1,0,1
1/01/2020,Croatia,Perlis,1,1,0
1/01/2020,Croatia,Pulau Pinang,8,7,1
1/01/2020,Croatia,Sabah,0,0,0
1/01/2020,Croatia,Sarawak,9,8,1
1/01/2020,Croatia,Selangor,340,207,133
1/01/2020,Haiti,Johor,0,0,0
1/01/2020,Haiti,Kedah,0,0,0
1/01/2020,Haiti,Kelantan,0,0,0
1/01/2020,Haiti,Perak,0,0,0
1/01/2020,Haiti,Pulau Pinang,0,0,0
1/01/2020,Haiti,Sabah,0,0,0
1/01/2020,Haiti,Selangor,5,4,1
1/01/2020,Hungary,Johor,93,56,37
1/01/2020,Hungary,Kedah,281,148,133
1/01/2020,Hungary,Kelantan,1,0,1
1/01/2020,Hungary,Pahang,0,0,0
1/01/2020,Hungary,Perak,0,0,0
1/01/2020,Hungary,Perlis,6,3,3
1/01/2020,Hungary,Pulau Pinang,77,46,31
1/01/2020,Hungary,Sabah,20,12,8
1/01/2020,Hungary,Sarawak,19,14,5
1/01/2020,Hungary,Selangor,1067,555,512
1/01/2020,Hungary,W.P. Labuan,0,0,0
1/01/2020,Indonesia,Johor,146428,75004,71424
1/01/2020,Indonesia,Kedah,5574,2183,3391
1/01/2020,Indonesia,Kelantan,195,91,104
1/01/2020,Indonesia,Melaka,5852,2696,3156
1/01/2020,Indonesia,Negeri Sembilan,3379,2169,1210
1/01/2020,Indonesia,Pahang,24,12,12
1/01/2020,Indonesia,Perak,228,78,150
1/01/2020,Indonesia,Perlis,648,307,341
1/01/2020,Indonesia,Pulau Pinang,25021,8736,16285
1/01/2020,Indonesia,Sabah,4962,2523,2439
1/01/2020,Indonesia,Sarawak,43648,25764,17884
1/01/2020,Indonesia,Selangor,137859,65764,72095
1/01/2020,Indonesia,Terengganu,0,0,0
1/01/2020,Indonesia,W.P. Labuan,134,87,47
1/01/2020,India,Johor,25250,18364,6886
1/01/2020,India,Kedah,953,553,400
1/01/2020,India,Kelantan,22,20,2
1/01/2020,India,Melaka,20,16,4
1/01/2020,India,Negeri Sembilan,1,1,0
1/01/2020,India,Pahang,16,15,1
1/01/2020,India,Perak,357,248,109
1/01/2020,India,Perlis,30,27,3
1/01/2020,India,Pulau Pinang,736,524,212
1/01/2020,India,Sabah,102,64,38
1/01/2020,India,Sarawak,1989,1666,323
1/01/2020,India,Selangor,69072,48859,20213
1/01/2020,India,Terengganu,0,0,0
1/01/2020,India,W.P. Labuan,118,107,11
1/01/2020, British Indian Ocean Territory,Pulau Pinang,0,0,0
1/01/2020, British Indian Ocean Territory,Selangor,0,0,0
1/01/2020,Ireland,Johor,323,214,109
1/01/2020,Ireland,Kedah,128,74,54
1/01/2020,Ireland,Kelantan,3,3,0
1/01/2020,Ireland,Negeri Sembilan,0,0,0
1/01/2020,Ireland,Pahang,2,2,0
1/01/2020,Ireland,Perak,8,7,1
1/01/2020,Ireland,Perlis,17,9,8
1/01/2020,Ireland,Pulau Pinang,132,89,43
1/01/2020,Ireland,Sabah,36,23,13
1/01/2020,Ireland,Sarawak,35,22,13
1/01/2020,Ireland,Selangor,1463,921,542
1/01/2020,Ireland,Terengganu,0,0,0
1/01/2020,Ireland,W.P. Labuan,4,4,0
1/01/2020,"Iran, Islamic Republic of",Johor,443,245,198
1/01/2020,"Iran, Islamic Republic of",Kedah,20,15,5
1/01/2020,"Iran, Islamic Republic of",Kelantan,1,1,0
1/01/2020,"Iran, Islamic Republic of",Perak,0,0,0
1/01/2020,"Iran, Islamic Republic of",Perlis,1,1,0
1/01/2020,"Iran, Islamic Republic of",Pulau Pinang,3,2,1
1/01/2020,"Iran, Islamic Republic of",Sabah,10,6,4
1/01/2020,"Iran, Islamic Republic of",Sarawak,8,7,1
1/01/2020,"Iran, Islamic Republic of",Selangor,4149,2272,1877
1/01/2020,"Iran, Islamic Republic of",W.P. Labuan,1,1,0
1/01/2020,Iraq,Johor,95,64,31
1/01/2020,Iraq,Kedah,10,7,3
1/01/2020,Iraq,Kelantan,0,0,0
1/01/2020,Iraq,Melaka,0,0,0
1/01/2020,Iraq,Pahang,0,0,0
1/01/2020,Iraq,Perak,0,0,0
1/01/2020,Iraq,Perlis,0,0,0
1/01/2020,Iraq,Pulau Pinang,9,7,2
1/01/2020,Iraq,Sabah,2,2,0
1/01/2020,Iraq,Sarawak,0,0,0
1/01/2020,Iraq,Selangor,1635,1185,450
1/01/2020,Iceland,Johor,7,4,3
1/01/2020,Iceland,Kedah,6,4,2
1/01/2020,Iceland,Kelantan,0,0,0
1/01/2020,Iceland,Perak,0,0,0
1/01/2020,Iceland,Perlis,4,1,3
1/01/2020,Iceland,Pulau Pinang,1,1,0
1/01/2020,Iceland,Sabah,1,1,0
1/01/2020,Iceland,Sarawak,3,2,1
1/01/2020,Iceland,Selangor,104,57,47
1/01/2020,Iceland,W.P. Labuan,0,0,0
1/01/2020,Israel,Pulau Pinang,0,0,0
1/01/2020,Italy,Johor,696,498,198
1/01/2020,Italy,Kedah,1186,613,573
1/01/2020,Italy,Kelantan,10,9,1
1/01/2020,Italy,Melaka,1,1,0
1/01/2020,Italy,Negeri Sembilan,2,2,0
1/01/2020,Italy,Pahang,0,0,0
1/01/2020,Italy,Perak,14,12,2
1/01/2020,Italy,Perlis,47,35,12
1/01/2020,Italy,Pulau Pinang,157,98,59
1/01/2020,Italy,Sabah,53,33,20
1/01/2020,Italy,Sarawak,35,23,12
1/01/2020,Italy,Selangor,3411,2241,1170
1/01/2020,Italy,W.P. Labuan,2,0,2
1/01/2020,Jamaica,Johor,5,0,5
1/01/2020,Jamaica,Kedah,1,0,1
1/01/2020,Jamaica,Perak,0,0,0
1/01/2020,Jamaica,Pulau Pinang,0,0,0
1/01/2020,Jamaica,Sabah,0,0,0
1/01/2020,Jamaica,Sarawak,0,0,0
1/01/2020,Jamaica,Selangor,40,11,29
1/01/2020,Jamaica,W.P. Labuan,0,0,0
1/01/2020,Jordan,Johor,74,28,46
1/01/2020,Jordan,Kedah,33,17,16
1/01/2020,Jordan,Kelantan,1,1,0
1/01/2020,Jordan,Melaka,0,0,0
1/01/2020,Jordan,Perlis,1,1,0
1/01/2020,Jordan,Pulau Pinang,24,7,17
1/01/2020,Jordan,Sabah,9,8,1
1/01/2020,Jordan,Sarawak,2,2,0
1/01/2020,Jordan,Selangor,1227,751,476
1/01/2020,Jordan,W.P. Labuan,0,0,0
1/01/2020,Japan,Johor,9179,5771,3408
1/01/2020,Japan,Kedah,892,477,415
1/01/2020,Japan,Kelantan,18,17,1
1/01/2020,Japan,Melaka,2,2,0
1/01/2020,Japan,Negeri Sembilan,0,0,0
1/01/2020,Japan,Pahang,17,12,5
1/01/2020,Japan,Perak,74,51,23
1/01/2020,Japan,Perlis,123,86,37
1/01/2020,Japan,Pulau Pinang,1891,1286,605
1/01/2020,Japan,Sabah,899,424,475
1/01/2020,Japan,Sarawak,317,225,92
1/01/2020,Japan,Selangor,30603,18965,11638
1/01/2020,Japan,W.P. Labuan,14,10,4
1/01/2020,Kazakhstan,Johor,69,28,41
1/01/2020,Kazakhstan,Kedah,475,213,262
1/01/2020,Kazakhstan,Kelantan,3,0,3
1/01/2020,Kazakhstan,Melaka,0,0,0
1/01/2020,Kazakhstan,Perak,0,0,0
1/01/2020,Kazakhstan,Perlis,9,4,5
1/01/2020,Kazakhstan,Pulau Pinang,12,5,7
1/01/2020,Kazakhstan,Sabah,2,2,0
1/01/2020,Kazakhstan,Sarawak,10,5,5
1/01/2020,Kazakhstan,Selangor,3602,1509,2093
1/01/2020,Kazakhstan,W.P. Labuan,1,0,1
1/01/2020,Kenya,Johor,139,62,77
1/01/2020,Kenya,Kedah,2,2,0
1/01/2020,Kenya,Kelantan,0,0,0
1/01/2020,Kenya,Perak,0,0,0
1/01/2020,Kenya,Perlis,2,1,1
1/01/2020,Kenya,Pulau Pinang,4,2,2
1/01/2020,Kenya,Sabah,0,0,0
1/01/2020,Kenya,Sarawak,2,2,0
1/01/2020,Kenya,Selangor,386,209,177
1/01/2020,Kyrgyzstan,Johor,25,16,9
1/01/2020,Kyrgyzstan,Kedah,37,17,20
1/01/2020,Kyrgyzstan,Kelantan,0,0,0
1/01/2020,Kyrgyzstan,Perak,0,0,0
1/01/2020,Kyrgyzstan,Perlis,3,0,3
1/01/2020,Kyrgyzstan,Pulau Pinang,3,1,2
1/01/2020,Kyrgyzstan,Sabah,2,1,1
1/01/2020,Kyrgyzstan,Sarawak,0,0,0
1/01/2020,Kyrgyzstan,Selangor,717,334,383
1/01/2020,Cambodia,Johor,2942,1236,1706
1/01/2020,Cambodia,Kedah,209,121,88
1/01/2020,Cambodia,Kelantan,1111,831,280
1/01/2020,Cambodia,Melaka,0,0,0
1/01/2020,Cambodia,Negeri Sembilan,0,0,0
1/01/2020,Cambodia,Pahang,0,0,0
1/01/2020,Cambodia,Perak,24,18,6
1/01/2020,Cambodia,Perlis,801,629,172
1/01/2020,Cambodia,Pulau Pinang,4,0,4
1/01/2020,Cambodia,Sabah,2,1,1
1/01/2020,Cambodia,Sarawak,29,15,14
1/01/2020,Cambodia,Selangor,4784,2186,2598
1/01/2020,Cambodia,W.P. Labuan,0,0,0
1/01/2020,Kiribati,Johor,4,4,0
1/01/2020,Kiribati,Sabah,0,0,0
1/01/2020,Kiribati,Selangor,1,1,0
1/01/2020,Saint Kitts and Nevis,Johor,10,7,3
1/01/2020,Saint Kitts and Nevis,Kedah,0,0,0
1/01/2020,Saint Kitts and Nevis,Perlis,0,0,0
1/01/2020,Saint Kitts and Nevis,Pulau Pinang,4,2,2
1/01/2020,Saint Kitts and Nevis,Sabah,1,1,0
1/01/2020,Saint Kitts and Nevis,Selangor,48,34,14
1/01/2020,Saint Kitts and Nevis,W.P. Labuan,0,0,0
1/01/2020,"Korea, Republic of",Johor,29631,13776,15855
1/01/2020,"Korea, Republic of",Kedah,548,266,282
1/01/2020,"Korea, Republic of",Kelantan,7,5,2
1/01/2020,"Korea, Republic of",Melaka,1,1,0
1/01/2020,"Korea, Republic of",Negeri Sembilan,7,4,3
1/01/2020,"Korea, Republic of",Pahang,19,9,10
1/01/2020,"Korea, Republic of",Perak,17,8,9
1/01/2020,"Korea, Republic of",Perlis,111,80,31
1/01/2020,"Korea, Republic of",Pulau Pinang,765,379,386
1/01/2020,"Korea, Republic of",Sabah,33316,14024,19292
1/01/2020,"Korea, Republic of",Sarawak,425,258,167
1/01/2020,"Korea, Republic of",Selangor,33486,16434,17052
1/01/2020,"Korea, Republic of",Terengganu,0,0,0
1/01/2020,"Korea, Republic of",W.P. Labuan,24,16,8
1/01/2020,Kuwait,Johor,174,71,103
1/01/2020,Kuwait,Kedah,6,3,3
1/01/2020,Kuwait,Kelantan,0,0,0
1/01/2020,Kuwait,Perak,0,0,0
1/01/2020,Kuwait,Perlis,0,0,0
1/01/2020,Kuwait,Pulau Pinang,9,2,7
1/01/2020,Kuwait,Sabah,0,0,0
1/01/2020,Kuwait,Sarawak,0,0,0
1/01/2020,Kuwait,Selangor,1032,540,492
1/01/2020,Kuwait,W.P. Labuan,0,0,0
1/01/2020, Lao People's Democratic Republic,Johor,228,72,156
1/01/2020, Lao People's Democratic Republic,Kedah,1165,87,1078
1/01/2020, Lao People's Democratic Republic,Kelantan,209,78,131
1/01/2020, Lao People's Democratic Republic,Melaka,0,0,0
1/01/2020, Lao People's Democratic Republic,Perak,16,0,16
1/01/2020, Lao People's Democratic Republic,Perlis,533,134,399
1/01/2020, Lao People's Democratic Republic,Pulau Pinang,10,2,8
1/01/2020, Lao People's Democratic Republic,Sabah,1,0,1
1/01/2020, Lao People's Democratic Republic,Sarawak,0,0,0
1/01/2020, Lao People's Democratic Republic,Selangor,462,159,303
1/01/2020, Lao People's Democratic Republic,W.P. Labuan,0,0,0
1/01/2020,Lebanon,Johor,20,13,7
1/01/2020,Lebanon,Kedah,2,2,0
1/01/2020,Lebanon,Kelantan,0,0,0
1/01/2020,Lebanon,Pahang,0,0,0
1/01/2020,Lebanon,Perak,0,0,0
1/01/2020,Lebanon,Perlis,0,0,0
1/01/2020,Lebanon,Pulau Pinang,4,1,3
1/01/2020,Lebanon,Sabah,0,0,0
1/01/2020,Lebanon,Sarawak,1,1,0
1/01/2020,Lebanon,Selangor,258,160,98
1/01/2020,Lebanon,W.P. Labuan,0,0,0
1/01/2020,Liberia,Johor,5,5,0
1/01/2020,Liberia,Kedah,0,0,0
1/01/2020,Liberia,Sabah,0,0,0
1/01/2020,Liberia,Sarawak,0,0,0
1/01/2020,Liberia,Selangor,10,8,2
1/01/2020,Libya,Johor,22,14,8
1/01/2020,Libya,Kedah,2,2,0
1/01/2020,Libya,Perlis,0,0,0
1/01/2020,Libya,Pulau Pinang,7,3,4
1/01/2020,Libya,Sabah,1,1,0
1/01/2020,Libya,Sarawak,1,0,1
1/01/2020,Libya,Selangor,867,637,230
1/01/2020,Saint Lucia,Johor,4,2,2
1/01/2020,Saint Lucia,Kedah,0,0,0
1/01/2020,Saint Lucia,Pulau Pinang,0,0,0
1/01/2020,Saint Lucia,Sarawak,0,0,0
1/01/2020,Saint Lucia,Selangor,14,12,2
1/01/2020,Liechtenstein,Johor,4,4,0
1/01/2020,Liechtenstein,Kedah,2,2,0
1/01/2020,Liechtenstein,Perlis,0,0,0
1/01/2020,Liechtenstein,Pulau Pinang,1,1,0
1/01/2020,Liechtenstein,Sabah,0,0,0
1/01/2020,Liechtenstein,Sarawak,0,0,0
1/01/2020,Liechtenstein,Selangor,7,4,3
1/01/2020,LKA,Johor,1199,841,358
1/01/2020,LKA,Kedah,17,11,6
1/01/2020,LKA,Kelantan,0,0,0
1/01/2020,LKA,Melaka,0,0,0
1/01/2020,LKA,Pahang,1,1,0
1/01/2020,LKA,Perak,4,3,1
1/01/2020,LKA,Perlis,0,0,0
1/01/2020,LKA,Pulau Pinang,50,33,17
1/01/2020,LKA,Sabah,0,0,0
1/01/2020,LKA,Sarawak,20,16,4
1/01/2020,LKA,Selangor,3454,2153,1301
1/01/2020,LKA,W.P. Labuan,1,0,1
1/01/2020,Lesotho,Johor,0,0,0
1/01/2020,Lesotho,Kedah,0,0,0
1/01/2020,Lesotho,Pulau Pinang,0,0,0
1/01/2020,Lesotho,Sarawak,0,0,0
1/01/2020,Lesotho,Selangor,6,4,2
1/01/2020,Lithuania,Johor,91,41,50
1/01/2020,Lithuania,Kedah,48,25,23
1/01/2020,Lithuania,Kelantan,2,1,1
1/01/2020,Lithuania,Pahang,0,0,0
1/01/2020,Lithuania,Perak,0,0,0
1/01/2020,Lithuania,Perlis,12,9,3
1/01/2020,Lithuania,Pulau Pinang,3,0,3
1/01/2020,Lithuania,Sabah,9,6,3
1/01/2020,Lithuania,Sarawak,10,5,5
1/01/2020,Lithuania,Selangor,344,175,169
1/01/2020,Lithuania,W.P. Labuan,0,0,0
1/01/2020,Luxembourg,Johor,11,8,3
1/01/2020,Luxembourg,Kedah,2,1,1
1/01/2020,Luxembourg,Kelantan,0,0,0
1/01/2020,Luxembourg,Perak,0,0,0
1/01/2020,Luxembourg,Perlis,1,1,0
1/01/2020,Luxembourg,Pulau Pinang,2,1,1
1/01/2020,Luxembourg,Sabah,0,0,0
1/01/2020,Luxembourg,Sarawak,0,0,0
1/01/2020,Luxembourg,Selangor,38,23,15
1/01/2020,Latvia,Johor,61,27,34
1/01/2020,Latvia,Kedah,44,21,23
1/01/2020,Latvia,Kelantan,0,0,0
1/01/2020,Latvia,Pahang,0,0,0
1/01/2020,Latvia,Perak,0,0,0
1/01/2020,Latvia,Perlis,3,3,0
1/01/2020,Latvia,Pulau Pinang,6,4,2
1/01/2020,Latvia,Sabah,68,29,39
1/01/2020,Latvia,Sarawak,1,1,0
1/01/2020,Latvia,Selangor,254,119,135
1/01/2020,Latvia,W.P. Labuan,0,0,0
1/01/2020,Macao,Johor,0,0,0
1/01/2020,Macao,Pahang,0,0,0
1/01/2020,Macao,Perak,0,0,0
1/01/2020,Macao,Selangor,0,0,0
1/01/2020,Macao,W.P. Labuan,0,0,0
1/01/2020,Morocco,Johor,59,49,10
1/01/2020,Morocco,Kedah,17,14,3
1/01/2020,Morocco,Kelantan,1,1,0
1/01/2020,Morocco,Melaka,0,0,0
1/01/2020,Morocco,Pahang,0,0,0
1/01/2020,Morocco,Perak,0,0,0
1/01/2020,Morocco,Perlis,0,0,0
1/01/2020,Morocco,Pulau Pinang,6,2,4
1/01/2020,Morocco,Sabah,5,2,3
1/01/2020,Morocco,Sarawak,7,5,2
1/01/2020,Morocco,Selangor,858,438,420
1/01/2020,Morocco,W.P. Labuan,0,0,0
1/01/2020,Monaco,Johor,1,0,1
1/01/2020,Monaco,Kedah,0,0,0
1/01/2020,Monaco,Sabah,0,0,0
1/01/2020,Monaco,Selangor,2,1,1
1/01/2020,"Moldova, Republic of",Johor,3,2,1
1/01/2020,"Moldova, Republic of",Kedah,11,6,5
1/01/2020,"Moldova, Republic of",Kelantan,2,1,1
1/01/2020,"Moldova, Republic of",Negeri Sembilan,0,0,0
1/01/2020,"Moldova, Republic of",Perlis,0,0,0
1/01/2020,"Moldova, Republic of",Pulau Pinang,2,0,2
1/01/2020,"Moldova, Republic of",Sabah,9,5,4
1/01/2020,"Moldova, Republic of",Sarawak,0,0,0
1/01/2020,"Moldova, Republic of",Selangor,32,10,22
1/01/2020,Madagascar,Johor,18,9,9
1/01/2020,Madagascar,Kedah,3,1,2
1/01/2020,Madagascar,Perak,0,0,0
1/01/2020,Madagascar,Perlis,0,0,0
1/01/2020,Madagascar,Pulau Pinang,0,0,0
1/01/2020,Madagascar,Sabah,0,0,0
1/01/2020,Madagascar,Sarawak,0,0,0
1/01/2020,Madagascar,Selangor,55,32,23
1/01/2020,Maldives,Johor,295,144,151
1/01/2020,Maldives,Kedah,1,1,0
1/01/2020,Maldives,Kelantan,0,0,0
1/01/2020,Maldives,Perak,0,0,0
1/01/2020,Maldives,Perlis,2,1,1
1/01/2020,Maldives,Pulau Pinang,2,1,1
1/01/2020,Maldives,Sabah,0,0,0
1/01/2020,Maldives,Sarawak,0,0,0
1/01/2020,Maldives,Selangor,2241,1185,1056
1/01/2020,Mexico,Johor,151,78,73
1/01/2020,Mexico,Kedah,11,3,8
1/01/2020,Mexico,Kelantan,0,0,0
1/01/2020,Mexico,Pahang,0,0,0
1/01/2020,Mexico,Perak,2,1,1
1/01/2020,Mexico,Perlis,1,1,0
1/01/2020,Mexico,Pulau Pinang,27,17,10
1/01/2020,Mexico,Sabah,3,2,1
1/01/2020,Mexico,Sarawak,8,6,2
1/01/2020,Mexico,Selangor,554,313,241
1/01/2020,Mexico,W.P. Labuan,0,0,0
1/01/2020,Marshall Islands,Johor,0,0,0
1/01/2020,Marshall Islands,Kedah,0,0,0
1/01/2020,Marshall Islands,Perak,0,0,0
1/01/2020,Marshall Islands,Pulau Pinang,0,0,0
1/01/2020,Marshall Islands,Sabah,0,0,0
1/01/2020,Marshall Islands,Selangor,1,1,0
1/01/2020,North Macedonia,Johor,10,5,5
1/01/2020,North Macedonia,Kedah,2,2,0
1/01/2020,North Macedonia,Perak,0,0,0
1/01/2020,North Macedonia,Pulau Pinang,0,0,0
1/01/2020,North Macedonia,Sabah,2,1,1
1/01/2020,North Macedonia,Sarawak,1,1,0
1/01/2020,North Macedonia,Selangor,22,16,6
1/01/2020,Mali,Johor,0,0,0
1/01/2020,Mali,Sabah,0,0,0
1/01/2020,Mali,Selangor,11,8,3
1/01/2020,Malta,Johor,9,7,2
1/01/2020,Malta,Kedah,3,3,0
1/01/2020,Malta,Kelantan,0,0,0
1/01/2020,Malta,Perak,2,0,2
1/01/2020,Malta,Perlis,0,0,0
1/01/2020,Malta,Pulau Pinang,0,0,0
1/01/2020,Malta,Sabah,1,1,0
1/01/2020,Malta,Sarawak,0,0,0
1/01/2020,Malta,Selangor,47,31,16
1/01/2020,Malta,W.P. Labuan,2,1,1
1/01/2020,Myanmar,Johor,5305,1824,3481
1/01/2020,Myanmar,Kedah,12,6,6
1/01/2020,Myanmar,Kelantan,3,1,2
1/01/2020,Myanmar,Negeri Sembilan,0,0,0
1/01/2020,Myanmar,Pahang,2,1,1
1/01/2020,Myanmar,Perak,14,3,11
1/01/2020,Myanmar,Perlis,5,0,5
1/01/2020,Myanmar,Pulau Pinang,310,168,142
1/01/2020,Myanmar,Sabah,8,0,8
1/01/2020,Myanmar,Sarawak,121,63,58
1/01/2020,Myanmar,Selangor,10964,8342,2622
1/01/2020,Myanmar,Terengganu,0,0,0
1/01/2020,Myanmar,W.P. Labuan,0,0,0
1/01/2020,Montenegro,Johor,1,1,0
1/01/2020,Montenegro,Kedah,0,0,0
1/01/2020,Montenegro,Pulau Pinang,1,1,0
1/01/2020,Montenegro,Sabah,0,0,0
1/01/2020,Montenegro,Sarawak,0,0,0
1/01/2020,Montenegro,Selangor,22,17,5
1/01/2020,Mongolia,Johor,273,118,155
1/01/2020,Mongolia,Kedah,14,2,12
1/01/2020,Mongolia,Kelantan,0,0,0
1/01/2020,Mongolia,Perak,0,0,0
1/01/2020,Mongolia,Perlis,1,0,1
1/01/2020,Mongolia,Pulau Pinang,9,7,2
1/01/2020,Mongolia,Sabah,10,5,5
1/01/2020,Mongolia,Sarawak,5,5,0
1/01/2020,Mongolia,Selangor,607,249,358
1/01/2020,Northern Mariana Islands,Selangor,2,2,0
1/01/2020,Mozambique,Johor,0,0,0
1/01/2020,Mozambique,Kedah,0,0,0
1/01/2020,Mozambique,Perak,1,1,0
1/01/2020,Mozambique,Pulau Pinang,0,0,0
1/01/2020,Mozambique,Sabah,1,1,0
1/01/2020,Mozambique,Sarawak,0,0,0
1/01/2020,Mozambique,Selangor,86,51,35
1/01/2020,Mauritania,Johor,1,1,0
1/01/2020,Mauritania,Kedah,1,1,0
1/01/2020,Mauritania,Pulau Pinang,0,0,0
1/01/2020,Mauritania,Sabah,0,0,0
1/01/2020,Mauritania,Sarawak,0,0,0
1/01/2020,Mauritania,Selangor,34,22,12
1/01/2020,Mauritius,Johor,305,158,147
1/01/2020,Mauritius,Kedah,2,1,1
1/01/2020,Mauritius,Kelantan,0,0,0
1/01/2020,Mauritius,Pahang,0,0,0
1/01/2020,Mauritius,Perak,0,0,0
1/01/2020,Mauritius,Perlis,1,0,1
1/01/2020,Mauritius,Pulau Pinang,3,1,2
1/01/2020,Mauritius,Sabah,4,3,1
1/01/2020,Mauritius,Sarawak,0,0,0
1/01/2020,Mauritius,Selangor,1261,623,638
1/01/2020,Malawi,Johor,0,0,0
1/01/2020,Malawi,Pulau Pinang,0,0,0
1/01/2020,Malawi,Sabah,0,0,0
1/01/2020,Malawi,Sarawak,0,0,0
1/01/2020,Malawi,Selangor,37,15,22
1/01/2020,Mayotte,Selangor,1,0,1
1/01/2020,Namibia,Johor,2,1,1
1/01/2020,Namibia,Kedah,1,0,1
1/01/2020,Namibia,Perak,0,0,0
1/01/2020,Namibia,Perlis,0,0,0
1/01/2020,Namibia,Pulau Pinang,0,0,0
1/01/2020,Namibia,Sabah,0,0,0
1/01/2020,Namibia,Sarawak,0,0,0
1/01/2020,Namibia,Selangor,25,7,18
1/01/2020,New Caledonia,Selangor,0,0,0
1/01/2020,Niger,Johor,0,0,0
1/01/2020,Niger,Sabah,0,0,0
1/01/2020,Niger,Selangor,7,6,1
1/01/2020,Nigeria,Johor,31,23,8
1/01/2020,Nigeria,Kedah,2,2,0
1/01/2020,Nigeria,Perlis,1,1,0
1/01/2020,Nigeria,Pulau Pinang,9,7,2
1/01/2020,Nigeria,Sabah,0,0,0
1/01/2020,Nigeria,Sarawak,5,3,2
1/01/2020,Nigeria,Selangor,790,625,165
1/01/2020,Nicaragua,Johor,5,3,2
1/01/2020,Nicaragua,Kedah,0,0,0
1/01/2020,Nicaragua,Pulau Pinang,1,1,0
1/01/2020,Nicaragua,Sabah,0,0,0
1/01/2020,Nicaragua,Selangor,6,1,5
1/01/2020,Netherlands,Johor,1035,663,372
1/01/2020,Netherlands,Kedah,559,284,275
1/01/2020,Netherlands,Kelantan,7,6,1
1/01/2020,Netherlands,Melaka,1,1,0
1/01/2020,Netherlands,Negeri Sembilan,0,0,0
1/01/2020,Netherlands,Pahang,1,1,0
1/01/2020,Netherlands,Perak,24,14,10
1/01/2020,Netherlands,Perlis,74,46,28
1/01/2020,Netherlands,Pulau Pinang,280,177,103
1/01/2020,Netherlands,Sabah,71,41,30
1/01/2020,Netherlands,Sarawak,228,154,74
1/01/2020,Netherlands,Selangor,4862,3023,1839
1/01/2020,Netherlands,Terengganu,0,0,0
1/01/2020,Netherlands,W.P. Labuan,9,7,2
1/01/2020,Norway,Johor,244,150,94
1/01/2020,Norway,Kedah,232,122,110
1/01/2020,Norway,Kelantan,0,0,0
1/01/2020,Norway,Melaka,0,0,0
1/01/2020,Norway,Pahang,4,2,2
1/01/2020,Norway,Perak,2,2,0
1/01/2020,Norway,Perlis,12,9,3
1/01/2020,Norway,Pulau Pinang,63,39,24
1/01/2020,Norway,Sabah,14,11,3
1/01/2020,Norway,Sarawak,32,22,10
1/01/2020,Norway,Selangor,1148,679,469
1/01/2020,Norway,W.P. Labuan,2,2,0
1/01/2020,Nepal,Johor,1993,1713,280
1/01/2020,Nepal,Kedah,20,16,4
1/01/2020,Nepal,Pahang,0,0,0
1/01/2020,Nepal,Perak,0,0,0
1/01/2020,Nepal,Perlis,1,1,0
1/01/2020,Nepal,Pulau Pinang,75,72,3
1/01/2020,Nepal,Sabah,1,1,0
1/01/2020,Nepal,Sarawak,211,152,59
1/01/2020,Nepal,Selangor,11790,11056,734
1/01/2020,Nepal,W.P. Labuan,126,105,21
1/01/2020,Nauru,Johor,0,0,0
1/01/2020,Nauru,Pulau Pinang,0,0,0
1/01/2020,Nauru,Selangor,1,1,0
1/01/2020,New Zealand,Johor,1294,731,563
1/01/2020,New Zealand,Kedah,173,102,71
1/01/2020,New Zealand,Kelantan,7,4,3
1/01/2020,New Zealand,Melaka,5,2,3
1/01/2020,New Zealand,Negeri Sembilan,0,0,0
1/01/2020,New Zealand,Pahang,2,2,0
1/01/2020,New Zealand,Perak,32,21,11
1/01/2020,New Zealand,Perlis,38,26,12
1/01/2020,New Zealand,Pulau Pinang,286,160,126
1/01/2020,New Zealand,Sabah,103,60,43
1/01/2020,New Zealand,Sarawak,235,128,107
1/01/2020,New Zealand,Selangor,4014,2286,1728
1/01/2020,New Zealand,Terengganu,0,0,0
1/01/2020,New Zealand,W.P. Labuan,5,4,1
1/01/2020,Oman,Johor,71,47,24
1/01/2020,Oman,Kedah,15,9,6
1/01/2020,Oman,Kelantan,0,0,0
1/01/2020,Oman,Melaka,0,0,0
1/01/2020,Oman,Perak,0,0,0
1/01/2020,Oman,Perlis,4,4,0
1/01/2020,Oman,Pulau Pinang,17,8,9
1/01/2020,Oman,Sabah,0,0,0
1/01/2020,Oman,Sarawak,19,9,10
1/01/2020,Oman,Selangor,2213,1245,968
1/01/2020,Pakistan,Johor,984,729,255
1/01/2020,Pakistan,Kedah,150,100,50
1/01/2020,Pakistan,Kelantan,11,11,0
1/01/2020,Pakistan,Melaka,0,0,0
1/01/2020,Pakistan,Negeri Sembilan,0,0,0
1/01/2020,Pakistan,Pahang,0,0,0
1/01/2020,Pakistan,Perak,8,7,1
1/01/2020,Pakistan,Perlis,13,13,0
1/01/2020,Pakistan,Pulau Pinang,61,48,13
1/01/2020,Pakistan,Sabah,17,12,5
1/01/2020,Pakistan,Sarawak,360,326,34
1/01/2020,Pakistan,Selangor,12658,10329,2329
1/01/2020,Pakistan,W.P. Labuan,12,12,0
1/01/2020,Panama,Johor,13,9,4
1/01/2020,Panama,Kedah,1,0,1
1/01/2020,Panama,Perak,0,0,0
1/01/2020,Panama,Perlis,0,0,0
1/01/2020,Panama,Pulau Pinang,2,2,0
1/01/2020,Panama,Sabah,3,2,1
1/01/2020,Panama,Sarawak,0,0,0
1/01/2020,Panama,Selangor,53,25,28
1/01/2020,Peru,Johor,44,21,23
1/01/2020,Peru,Kedah,15,6,9
1/01/2020,Peru,Kelantan,1,1,0
1/01/2020,Peru,Pahang,0,0,0
1/01/2020,Peru,Perak,0,0,0
1/01/2020,Peru,Perlis,1,0,1
1/01/2020,Peru,Pulau Pinang,1,0,1
1/01/2020,Peru,Sabah,1,0,1
1/01/2020,Peru,Sarawak,0,0,0
1/01/2020,Peru,Selangor,159,85,74
1/01/2020,Peru,W.P. Labuan,0,0,0
1/01/2020,Philippines,Johor,21386,6642,14744
1/01/2020,Philippines,Kedah,1217,415,802
1/01/2020,Philippines,Kelantan,50,19,31
1/01/2020,Philippines,Melaka,0,0,0
1/01/2020,Philippines,Negeri Sembilan,1,0,1
1/01/2020,Philippines,Pahang,9,5,4
1/01/2020,Philippines,Perak,77,24,53
1/01/2020,Philippines,Perlis,169,59,110
1/01/2020,Philippines,Pulau Pinang,430,180,250
1/01/2020,Philippines,Sabah,2502,1221,1281
1/01/2020,Philippines,Sarawak,3771,1536,2235
1/01/2020,Philippines,Selangor,16643,6462,10181
1/01/2020,Philippines,Terengganu,0,0,0
1/01/2020,Philippines,W.P. Labuan,195,83,112
1/01/2020,Palau,Johor,0,0,0
1/01/2020,Palau,Pulau Pinang,0,0,0
1/01/2020,Palau,Selangor,0,0,0
1/01/2020,Papua New Guinea,Johor,21,15,6
1/01/2020,Papua New Guinea,Kedah,0,0,0
1/01/2020,Papua New Guinea,Kelantan,1,0,1
1/01/2020,Papua New Guinea,Perak,0,0,0
1/01/2020,Papua New Guinea,Pulau Pinang,1,0,1
1/01/2020,Papua New Guinea,Sabah,1,1,0
1/01/2020,Papua New Guinea,Sarawak,3,1,2
1/01/2020,Papua New Guinea,Selangor,82,43,39
1/01/2020,Poland,Johor,828,397,431
1/01/2020,Poland,Kedah,554,274,280
1/01/2020,Poland,Kelantan,5,1,4
1/01/2020,Poland,Melaka,1,1,0
1/01/2020,Poland,Negeri Sembilan,1,1,0
1/01/2020,Poland,Pahang,0,0,0
1/01/2020,Poland,Perak,3,1,2
1/01/2020,Poland,Perlis,75,40,35
1/01/2020,Poland,Pulau Pinang,108,59,49
1/01/2020,Poland,Sabah,65,25,40
1/01/2020,Poland,Sarawak,41,17,24
1/01/2020,Poland,Selangor,2079,1071,1008
1/01/2020,Poland,Terengganu,0,0,0
1/01/2020,Poland,W.P. Labuan,3,2,1
1/01/2020,"North Korea, Democratic People's Republic of",Selangor,3,3,0
1/01/2020,Portugal,Johor,199,104,95
1/01/2020,Portugal,Kedah,155,72,83
1/01/2020,Portugal,Kelantan,1,1,0
1/01/2020,Portugal,Melaka,0,0,0
1/01/2020,Portugal,Pahang,0,0,0
1/01/2020,Portugal,Perak,3,2,1
1/01/2020,Portugal,Perlis,14,7,7
1/01/2020,Portugal,Pulau Pinang,20,11,9
1/01/2020,Portugal,Sabah,27,12,15
1/01/2020,Portugal,Sarawak,11,6,5
1/01/2020,Portugal,Selangor,646,356,290
1/01/2020,Portugal,W.P. Labuan,1,1,0
1/01/2020,Paraguay,Johor,4,2,2
1/01/2020,Paraguay,Kedah,0,0,0
1/01/2020,Paraguay,Perak,0,0,0
1/01/2020,Paraguay,Perlis,0,0,0
1/01/2020,Paraguay,Pulau Pinang,0,0,0
1/01/2020,Paraguay,Sabah,0,0,0
1/01/2020,Paraguay,Sarawak,0,0,0
1/01/2020,Paraguay,Selangor,6,1,5
1/01/2020,"Palestine, State of",Johor,4,1,3
1/01/2020,"Palestine, State of",Kedah,17,10,7
1/01/2020,"Palestine, State of",Kelantan,0,0,0
1/01/2020,"Palestine, State of",Melaka,0,0,0
1/01/2020,"Palestine, State of",Perak,0,0,0
1/01/2020,"Palestine, State of",Perlis,0,0,0
1/01/2020,"Palestine, State of",Pulau Pinang,5,3,2
1/01/2020,"Palestine, State of",Sabah,2,2,0
1/01/2020,"Palestine, State of",Sarawak,1,1,0
1/01/2020,"Palestine, State of",Selangor,518,377,141
1/01/2020,Qatar,Johor,5,3,2
1/01/2020,Qatar,Kedah,9,4,5
1/01/2020,Qatar,Perlis,0,0,0
1/01/2020,Qatar,Pulau Pinang,2,1,1
1/01/2020,Qatar,Sabah,0,0,0
1/01/2020,Qatar,Sarawak,1,1,0
1/01/2020,Qatar,Selangor,122,88,34
1/01/2020,Réunion,Johor,0,0,0
1/01/2020,Réunion,Sarawak,0,0,0
1/01/2020,Romania,Johor,204,115,89
1/01/2020,Romania,Kedah,275,128,147
1/01/2020,Romania,Kelantan,2,2,0
1/01/2020,Romania,Negeri Sembilan,2,2,0
1/01/2020,Romania,Pahang,0,0,0
1/01/2020,Romania,Perak,2,2,0
1/01/2020,Romania,Perlis,3,0,3
1/01/2020,Romania,Pulau Pinang,33,21,12
1/01/2020,Romania,Sabah,11,5,6
1/01/2020,Romania,Sarawak,10,4,6
1/01/2020,Romania,Selangor,1053,533,520
1/01/2020,Romania,W.P. Labuan,2,1,1
1/01/2020,Russian Federation (Russia),Johor,538,307,231
1/01/2020,Russian Federation (Russia),Kedah,1788,849,939
1/01/2020,Russian Federation (Russia),Kelantan,93,45,48
1/01/2020,Russian Federation (Russia),Melaka,4,4,0
1/01/2020,Russian Federation (Russia),Negeri Sembilan,0,0,0
1/01/2020,Russian Federation (Russia),Pahang,6,4,2
1/01/2020,Russian Federation (Russia),Perak,6,4,2
1/01/2020,Russian Federation (Russia),Perlis,284,151,133
1/01/2020,Russian Federation (Russia),Pulau Pinang,151,83,68
1/01/2020,Russian Federation (Russia),Sabah,213,86,127
1/01/2020,Russian Federation (Russia),Sarawak,64,38,26
1/01/2020,Russian Federation (Russia),Selangor,11045,5134,5911
1/01/2020,Russian Federation (Russia),W.P. Labuan,9,5,4
1/01/2020,Rwanda,Johor,0,0,0
1/01/2020,Rwanda,Kedah,0,0,0
1/01/2020,Rwanda,Pulau Pinang,0,0,0
1/01/2020,Rwanda,Selangor,13,5,8
1/01/2020,Saudi Arabia,Johor,316,151,165
1/01/2020,Saudi Arabia,Kedah,72,32,40
1/01/2020,Saudi Arabia,Kelantan,5,2,3
1/01/2020,Saudi Arabia,Melaka,0,0,0
1/01/2020,Saudi Arabia,Perak,2,1,1
1/01/2020,Saudi Arabia,Perlis,1,1,0
1/01/2020,Saudi Arabia,Pulau Pinang,52,26,26
1/01/2020,Saudi Arabia,Sabah,2,2,0
1/01/2020,Saudi Arabia,Sarawak,10,9,1
1/01/2020,Saudi Arabia,Selangor,19141,9733,9408
1/01/2020,Saudi Arabia,W.P. Labuan,0,0,0
1/01/2020,Sudan,Johor,6,6,0
1/01/2020,Sudan,Kedah,1,1,0
1/01/2020,Sudan,Kelantan,0,0,0
1/01/2020,Sudan,Perlis,2,1,1
1/01/2020,Sudan,Pulau Pinang,2,1,1
1/01/2020,Sudan,Sabah,1,1,0
1/01/2020,Sudan,Sarawak,4,4,0
1/01/2020,Sudan,Selangor,1503,877,626
1/01/2020,Sudan,W.P. Labuan,0,0,0
1/01/2020,Senegal,Johor,11,7,4
1/01/2020,Senegal,Kedah,1,1,0
1/01/2020,Senegal,Kelantan,0,0,0
1/01/2020,Senegal,Perak,0,0,0
1/01/2020,Senegal,Perlis,0,0,0
1/01/2020,Senegal,Pulau Pinang,0,0,0
1/01/2020,Senegal,Sabah,0,0,0
1/01/2020,Senegal,Sarawak,0,0,0
1/01/2020,Senegal,Selangor,59,46,13
1/01/2020,Singapore,Johor,1209142,702096,507046
1/01/2020,Singapore,Kedah,2162,1276,886
1/01/2020,Singapore,Kelantan,373,182,191
1/01/2020,Singapore,Melaka,38,28,10
1/01/2020,Singapore,Negeri Sembilan,0,0,0
1/01/2020,Singapore,Pahang,471,239,232
1/01/2020,Singapore,Perak,4672,2349,2323
1/01/2020,Singapore,Perlis,260,157,103
1/01/2020,Singapore,Pulau Pinang,9240,4852,4388
1/01/2020,Singapore,Sabah,1800,950,850
1/01/2020,Singapore,Sarawak,3672,2056,1616
1/01/2020,Singapore,Selangor,33173,19025,14148
1/01/2020,Singapore,Terengganu,0,0,0
1/01/2020,Singapore,W.P. Labuan,31,27,4
1/01/2020,South Georgia and the South Sandwich Islands,Johor,0,0,0
1/01/2020,South Georgia and the South Sandwich Islands,Sabah,0,0,0
1/01/2020,South Georgia and the South Sandwich Islands,Selangor,0,0,0
1/01/2020,Saint Helena,Sarawak,0,0,0
1/01/2020,Solomon Islands,Johor,5,5,0
1/01/2020,Solomon Islands,Perlis,0,0,0
1/01/2020,Solomon Islands,Pulau Pinang,0,0,0
1/01/2020,Solomon Islands,Sabah,0,0,0
1/01/2020,Solomon Islands,Sarawak,18,6,12
1/01/2020,Solomon Islands,Selangor,12,4,8
1/01/2020,Solomon Islands,W.P. Labuan,0,0,0
1/01/2020,Sierra Leone,Johor,2,1,1
1/01/2020,Sierra Leone,Kedah,0,0,0
1/01/2020,Sierra Leone,Perak,0,0,0
1/01/2020,Sierra Leone,Pulau Pinang,0,0,0
1/01/2020,Sierra Leone,Sabah,0,0,0
1/01/2020,Sierra Leone,Selangor,52,33,19
1/01/2020,El Salvador,Johor,1,0,1
1/01/2020,El Salvador,Kedah,1,0,1
1/01/2020,El Salvador,Perak,0,0,0
1/01/2020,El Salvador,Perlis,0,0,0
1/01/2020,El Salvador,Pulau Pinang,1,0,1
1/01/2020,El Salvador,Sabah,2,1,1
1/01/2020,El Salvador,Selangor,19,8,11
1/01/2020,El Salvador,W.P. Labuan,0,0,0
1/01/2020,San Marino,Johor,0,0,0
1/01/2020,San Marino,Selangor,3,2,1
1/01/2020,Somalia,Johor,6,6,0
1/01/2020,Somalia,Kedah,2,2,0
1/01/2020,Somalia,Kelantan,0,0,0
1/01/2020,Somalia,Perlis,1,0,1
1/01/2020,Somalia,Sabah,0,0,0
1/01/2020,Somalia,Sarawak,0,0,0
1/01/2020,Somalia,Selangor,343,194,149
1/01/2020,Serbia,Johor,18,11,7
1/01/2020,Serbia,Kedah,12,6,6
1/01/2020,Serbia,Kelantan,0,0,0
1/01/2020,Serbia,Pahang,0,0,0
1/01/2020,Serbia,Perak,0,0,0
1/01/2020,Serbia,Perlis,0,0,0
1/01/2020,Serbia,Pulau Pinang,1,1,0
1/01/2020,Serbia,Sabah,7,4,3
1/01/2020,Serbia,Sarawak,0,0,0
1/01/2020,Serbia,Selangor,153,85,68
1/01/2020,South Sudan,Johor,0,0,0
1/01/2020,South Sudan,Kedah,1,1,0
1/01/2020,South Sudan,Sarawak,1,1,0
1/01/2020,South Sudan,Selangor,31,22,9
1/01/2020,South Sudan,W.P. Labuan,1,1,0
1/01/2020,Sao Tome and Principe,Selangor,8,3,5
1/01/2020,Suriname,Johor,6,3,3
1/01/2020,Suriname,Kedah,0,0,0
1/01/2020,Suriname,Kelantan,0,0,0
1/01/2020,Suriname,Perak,1,0,1
1/01/2020,Suriname,Perlis,0,0,0
1/01/2020,Suriname,Pulau Pinang,0,0,0
1/01/2020,Suriname,Sabah,0,0,0
1/01/2020,Suriname,Sarawak,1,1,0
1/01/2020,Suriname,Selangor,7,5,2
1/01/2020,Slovakia,Johor,34,19,15
1/01/2020,Slovakia,Kedah,242,126,116
1/01/2020,Slovakia,Kelantan,1,1,0
1/01/2020,Slovakia,Negeri Sembilan,0,0,0
1/01/2020,Slovakia,Pahang,1,0,1
1/01/2020,Slovakia,Perak,1,0,1
1/01/2020,Slovakia,Perlis,3,1,2
1/01/2020,Slovakia,Pulau Pinang,13,6,7
1/01/2020,Slovakia,Sabah,16,10,6
1/01/2020,Slovakia,Sarawak,7,4,3
1/01/2020,Slovakia,Selangor,571,311,260
1/01/2020,Slovakia,W.P. Labuan,2,2,0
1/01/2020,Slovenia,Johor,25,15,10
1/01/2020,Slovenia,Kedah,30,19,11
1/01/2020,Slovenia,Kelantan,0,0,0
1/01/2020,Slovenia,Perak,0,0,0
1/01/2020,Slovenia,Perlis,3,2,1
1/01/2020,Slovenia,Pulau Pinang,3,2,1
1/01/2020,Slovenia,Sabah,2,1,1
1/01/2020,Slovenia,Sarawak,4,3,1
1/01/2020,Slovenia,Selangor,138,81,57
1/01/2020,Slovenia,W.P. Labuan,0,0,0
1/01/2020,Sweden,Johor,491,277,214
1/01/2020,Sweden,Kedah,1241,609,632
1/01/2020,Sweden,Kelantan,15,12,3
1/01/2020,Sweden,Melaka,0,0,0
1/01/2020,Sweden,Negeri Sembilan,0,0,0
1/01/2020,Sweden,Pahang,3,1,2
1/01/2020,Sweden,Perak,8,6,2
1/01/2020,Sweden,Perlis,32,22,10
1/01/2020,Sweden,Pulau Pinang,172,107,65
1/01/2020,Sweden,Sabah,33,20,13
1/01/2020,Sweden,Sarawak,19,11,8
1/01/2020,Sweden,Selangor,2777,1614,1163
1/01/2020,Sweden,W.P. Labuan,1,1,0
1/01/2020,Eswatini,Johor,1,0,1
1/01/2020,Eswatini,Kedah,0,0,0
1/01/2020,Eswatini,Pulau Pinang,0,0,0
1/01/2020,Eswatini,Sabah,0,0,0
1/01/2020,Eswatini,Selangor,9,4,5
1/01/2020,Seychelles,Johor,17,9,8
1/01/2020,Seychelles,Kedah,0,0,0
1/01/2020,Seychelles,Pulau Pinang,0,0,0
1/01/2020,Seychelles,Sabah,0,0,0
1/01/2020,Seychelles,Sarawak,4,3,1
1/01/2020,Seychelles,Selangor,149,72,77
1/01/2020,Syrian Arab Republic,Johor,23,16,7
1/01/2020,Syrian Arab Republic,Kedah,11,6,5
1/01/2020,Syrian Arab Republic,Kelantan,0,0,0
1/01/2020,Syrian Arab Republic,Pahang,8,8,0
1/01/2020,Syrian Arab Republic,Perlis,0,0,0
1/01/2020,Syrian Arab Republic,Pulau Pinang,3,3,0
1/01/2020,Syrian Arab Republic,Sabah,2,2,0
1/01/2020,Syrian Arab Republic,Sarawak,2,1,1
1/01/2020,Syrian Arab Republic,Selangor,1021,660,361
1/01/2020,Syrian Arab Republic,W.P. Labuan,0,0,0
1/01/2020,Turks and Caicos Islands,Perlis,0,0,0
1/01/2020,TCD,Johor,2,1,1
1/01/2020,TCD,Kedah,0,0,0
1/01/2020,TCD,Perlis,0,0,0
1/01/2020,TCD,Selangor,25,19,6
1/01/2020,Togo,Johor,2,2,0
1/01/2020,Togo,Perak,0,0,0
1/01/2020,Togo,Pulau Pinang,0,0,0
1/01/2020,Togo,Selangor,14,12,2
1/01/2020,Thailand,Johor,5760,1637,4123
1/01/2020,Thailand,Kedah,47467,17473,29994
1/01/2020,Thailand,Kelantan,37479,19581,17898
1/01/2020,Thailand,Melaka,5,4,1
1/01/2020,Thailand,Negeri Sembilan,0,0,0
1/01/2020,Thailand,Pahang,0,0,0
1/01/2020,Thailand,Perak,14561,6674,7887
1/01/2020,Thailand,Perlis,47565,27702,19863
1/01/2020,Thailand,Pulau Pinang,1053,407,646
1/01/2020,Thailand,Sabah,56,15,41
1/01/2020,Thailand,Sarawak,660,263,397
1/01/2020,Thailand,Selangor,10453,4338,6115
1/01/2020,Thailand,Terengganu,0,0,0
1/01/2020,Thailand,W.P. Labuan,14,2,12
1/01/2020,Tajikistan,Johor,2,1,1
1/01/2020,Tajikistan,Kedah,3,3,0
1/01/2020,Tajikistan,Perlis,0,0,0
1/01/2020,Tajikistan,Pulau Pinang,1,0,1
1/01/2020,Tajikistan,Sabah,2,2,0
1/01/2020,Tajikistan,Selangor,142,96,46
1/01/2020,Tokelau,Selangor,2,2,0
1/01/2020,Turkmenistan,Johor,4,2,2
1/01/2020,Turkmenistan,Kedah,0,0,0
1/01/2020,Turkmenistan,Kelantan,0,0,0
1/01/2020,Turkmenistan,Perlis,0,0,0
1/01/2020,Turkmenistan,Pulau Pinang,0,0,0
1/01/2020,Turkmenistan,Sabah,5,2,3
1/01/2020,Turkmenistan,Sarawak,0,0,0
1/01/2020,Turkmenistan,Selangor,225,128,97
1/01/2020,Timor-Leste,Johor,4,2,2
1/01/2020,Timor-Leste,Kedah,0,0,0
1/01/2020,Timor-Leste,Perlis,0,0,0
1/01/2020,Timor-Leste,Pulau Pinang,10,5,5
1/01/2020,Timor-Leste,Sabah,0,0,0
1/01/2020,Timor-Leste,Sarawak,2,1,1
1/01/2020,Timor-Leste,Selangor,105,53,52
1/01/2020,Tonga,Johor,1,1,0
1/01/2020,Tonga,Pulau Pinang,1,0,1
1/01/2020,Tonga,Sarawak,1,0,1
1/01/2020,Tonga,Selangor,10,7,3
1/01/2020,Trinidad and Tobago,Johor,17,13,4
1/01/2020,Trinidad and Tobago,Kedah,0,0,0
1/01/2020,Trinidad and Tobago,Pahang,0,0,0
1/01/2020,Trinidad and Tobago,Pulau Pinang,2,1,1
1/01/2020,Trinidad and Tobago,Sabah,0,0,0
1/01/2020,Trinidad and Tobago,Sarawak,1,1,0
1/01/2020,Trinidad and Tobago,Selangor,32,18,14
1/01/2020,Tunisia,Johor,15,12,3
1/01/2020,Tunisia,Kedah,19,11,8
1/01/2020,Tunisia,Kelantan,0,0,0
1/01/2020,Tunisia,Melaka,0,0,0
1/01/2020,Tunisia,Perak,0,0,0
1/01/2020,Tunisia,Perlis,0,0,0
1/01/2020,Tunisia,Pulau Pinang,3,2,1
1/01/2020,Tunisia,Sabah,2,0,2
1/01/2020,Tunisia,Sarawak,2,1,1
1/01/2020,Tunisia,Selangor,363,194,169
1/01/2020,Tunisia,W.P. Labuan,0,0,0
1/01/2020,Türkiye,Johor,301,206,95
1/01/2020,Türkiye,Kedah,88,65,23
1/01/2020,Türkiye,Kelantan,6,6,0
1/01/2020,Türkiye,Melaka,1,1,0
1/01/2020,Türkiye,Negeri Sembilan,0,0,0
1/01/2020,Türkiye,Pahang,2,0,2
1/01/2020,Türkiye,Perak,0,0,0
1/01/2020,Türkiye,Perlis,8,7,1
1/01/2020,Türkiye,Pulau Pinang,13,8,5
1/01/2020,Türkiye,Sabah,13,10,3
1/01/2020,Türkiye,Sarawak,30,23,7
1/01/2020,Türkiye,Selangor,1359,877,482
1/01/2020,Türkiye,W.P. Labuan,0,0,0
1/01/2020,Tuvalu,Selangor,0,0,0
1/01/2020,"Taiwan, Province of China",Johor,9852,4268,5584
1/01/2020,"Taiwan, Province of China",Kedah,184,78,106
1/01/2020,"Taiwan, Province of China",Kelantan,6,4,2
1/01/2020,"Taiwan, Province of China",Melaka,12,5,7
1/01/2020,"Taiwan, Province of China",Negeri Sembilan,0,0,0
1/01/2020,"Taiwan, Province of China",Pahang,318,154,164
1/01/2020,"Taiwan, Province of China",Perak,32,10,22
1/01/2020,"Taiwan, Province of China",Perlis,29,16,13
1/01/2020,"Taiwan, Province of China",Pulau Pinang,3817,1903,1914
1/01/2020,"Taiwan, Province of China",Sabah,3684,1751,1933
1/01/2020,"Taiwan, Province of China",Sarawak,362,145,217
1/01/2020,"Taiwan, Province of China",Selangor,21324,10163,11161
1/01/2020,"Taiwan, Province of China",W.P. Labuan,11,4,7
1/01/2020,"Tanzania, United Republic of",Johor,48,31,17
1/01/2020,"Tanzania, United Republic of",Kedah,1,1,0
1/01/2020,"Tanzania, United Republic of",Perak,0,0,0
1/01/2020,"Tanzania, United Republic of",Perlis,0,0,0
1/01/2020,"Tanzania, United Republic of",Pulau Pinang,0,0,0
1/01/2020,"Tanzania, United Republic of",Sabah,0,0,0
1/01/2020,"Tanzania, United Republic of",Sarawak,1,0,1
1/01/2020,"Tanzania, United Republic of",Selangor,272,142,130
1/01/2020,Uganda,Johor,52,17,35
1/01/2020,Uganda,Kedah,1,0,1
1/01/2020,Uganda,Perak,0,0,0
1/01/2020,Uganda,Perlis,0,0,0
1/01/2020,Uganda,Pulau Pinang,1,0,1
1/01/2020,Uganda,Sabah,1,0,1
1/01/2020,Uganda,Sarawak,0,0,0
1/01/2020,Uganda,Selangor,132,63,69
1/01/2020,Ukraine,Johor,115,66,49
1/01/2020,Ukraine,Kedah,489,232,257
1/01/2020,Ukraine,Kelantan,18,12,6
1/01/2020,Ukraine,Melaka,0,0,0
1/01/2020,Ukraine,Negeri Sembilan,1,1,0
1/01/2020,Ukraine,Pahang,3,3,0
1/01/2020,Ukraine,Perak,1,1,0
1/01/2020,Ukraine,Perlis,38,21,17
1/01/2020,Ukraine,Pulau Pinang,49,21,28
1/01/2020,Ukraine,Sabah,35,12,23
1/01/2020,Ukraine,Sarawak,30,20,10
1/01/2020,Ukraine,Selangor,2165,1037,1128
1/01/2020,Ukraine,W.P. Labuan,7,4,3
1/01/2020,Uruguay,Johor,8,3,5
1/01/2020,Uruguay,Kedah,3,1,2
1/01/2020,Uruguay,Kelantan,0,0,0
1/01/2020,Uruguay,Perak,0,0,0
1/01/2020,Uruguay,Perlis,2,1,1
1/01/2020,Uruguay,Pulau Pinang,1,1,0
1/01/2020,Uruguay,Sabah,0,0,0
1/01/2020,Uruguay,Sarawak,0,0,0
1/01/2020,Uruguay,Selangor,81,40,41
1/01/2020,Uruguay,W.P. Labuan,0,0,0
1/01/2020,United States of America,Johor,5788,3284,2504
1/01/2020,United States of America,Kedah,800,429,371
1/01/2020,United States of America,Kelantan,32,21,11
1/01/2020,United States of America,Melaka,1,1,0
1/01/2020,United States of America,Negeri Sembilan,0,0,0
1/01/2020,United States of America,Pahang,14,5,9
1/01/2020,United States of America,Perak,101,57,44
1/01/2020,United States of America,Perlis,128,80,48
1/01/2020,United States of America,Pulau Pinang,2264,1332,932
1/01/2020,United States of America,Sabah,528,285,243
1/01/2020,United States of America,Sarawak,439,266,173
1/01/2020,United States of America,Selangor,19067,10998,8069
1/01/2020,United States of America,Terengganu,0,0,0
1/01/2020,United States of America,W.P. Labuan,18,12,6
1/01/2020,Uzbekistan,Johor,99,69,30
1/01/2020,Uzbekistan,Kedah,114,39,75
1/01/2020,Uzbekistan,Kelantan,5,4,1
1/01/2020,Uzbekistan,Perak,0,0,0
1/01/2020,Uzbekistan,Perlis,1,0,1
1/01/2020,Uzbekistan,Pulau Pinang,24,11,13
1/01/2020,Uzbekistan,Sabah,7,7,0
1/01/2020,Uzbekistan,Sarawak,1,1,0
1/01/2020,Uzbekistan,Selangor,2055,1226,829
1/01/2020,Holy See,Johor,1,1,0
1/01/2020,Holy See,Sarawak,0,0,0
1/01/2020,Holy See,Selangor,2,2,0
1/01/2020,Saint Vincent and the Grenadines,Johor,1,0,1
1/01/2020,Saint Vincent and the Grenadines,Kedah,0,0,0
1/01/2020,Saint Vincent and the Grenadines,Pulau Pinang,0,0,0
1/01/2020,Saint Vincent and the Grenadines,Sarawak,0,0,0
1/01/2020,Saint Vincent and the Grenadines,Selangor,0,0,0
1/01/2020,"Venezuela, Bolivarian Republic of",Johor,22,13,9
1/01/2020,"Venezuela, Bolivarian Republic of",Kedah,4,3,1
1/01/2020,"Venezuela, Bolivarian Republic of",Kelantan,1,1,0
1/01/2020,"Venezuela, Bolivarian Republic of",Melaka,1,0,1
1/01/2020,"Venezuela, Bolivarian Republic of",Perak,1,0,1
1/01/2020,"Venezuela, Bolivarian Republic of",Perlis,0,0,0
1/01/2020,"Venezuela, Bolivarian Republic of",Pulau Pinang,4,3,1
1/01/2020,"Venezuela, Bolivarian Republic of",Sabah,5,4,1
1/01/2020,"Venezuela, Bolivarian Republic of",Sarawak,8,5,3
1/01/2020,"Venezuela, Bolivarian Republic of",Selangor,98,55,43
1/01/2020,"Venezuela, Bolivarian Republic of",W.P. Labuan,0,0,0
1/01/2020,Viet Nam,Johor,13125,4305,8820
1/01/2020,Viet Nam,Kedah,581,55,526
1/01/2020,Viet Nam,Kelantan,20,6,14
1/01/2020,Viet Nam,Melaka,4,0,4
1/01/2020,Viet Nam,Negeri Sembilan,2,2,0
1/01/2020,Viet Nam,Pahang,1,0,1
1/01/2020,Viet Nam,Perak,80,17,63
1/01/2020,Viet Nam,Perlis,147,24,123
1/01/2020,Viet Nam,Pulau Pinang,946,248,698
1/01/2020,Viet Nam,Sabah,41,17,24
1/01/2020,Viet Nam,Sarawak,421,101,320
1/01/2020,Viet Nam,Selangor,17898,6592,11306
1/01/2020,Viet Nam,Terengganu,0,0,0
1/01/2020,Viet Nam,W.P. Labuan,12,9,3
1/01/2020,Vanuatu,Johor,40,28,12
1/01/2020,Vanuatu,Kedah,1,1,0
1/01/2020,Vanuatu,Pulau Pinang,7,5,2
1/01/2020,Vanuatu,Sabah,1,1,0
1/01/2020,Vanuatu,Sarawak,0,0,0
1/01/2020,Vanuatu,Selangor,66,52,14
1/01/2020, Samoa,Johor,0,0,0
1/01/2020, Samoa,Sarawak,0,0,0
1/01/2020, Samoa,Selangor,5,4,1
1/01/2020,Yemen,Johor,54,35,19
1/01/2020,Yemen,Kedah,3,3,0
1/01/2020,Yemen,Kelantan,0,0,0
1/01/2020,Yemen,Melaka,8,6,2
1/01/2020,Yemen,Pahang,0,0,0
1/01/2020,Yemen,Perak,0,0,0
1/01/2020,Yemen,Perlis,0,0,0
1/01/2020,Yemen,Pulau Pinang,5,5,0
1/01/2020,Yemen,Sabah,0,0,0
1/01/2020,Yemen,Sarawak,3,1,2
1/01/2020,Yemen,Selangor,2339,1610,729
1/01/2020,Yemen,W.P. Labuan,0,0,0
1/01/2020,South Africa,Johor,485,278,207
1/01/2020,South Africa,Kedah,116,67,49
1/01/2020,South Africa,Kelantan,15,5,10
1/01/2020,South Africa,Melaka,2,0,2
1/01/2020,South Africa,Pahang,2,1,1
1/01/2020,South Africa,Perak,1,1,0
1/01/2020,South Africa,Perlis,23,11,12
1/01/2020,South Africa,Pulau Pinang,64,33,31
1/01/2020,South Africa,Sabah,20,10,10
1/01/2020,South Africa,Sarawak,63,42,21
1/01/2020,South Africa,Selangor,1869,986,883
1/01/2020,South Africa,Terengganu,0,0,0
1/01/2020,South Africa,W.P. Labuan,16,7,9
1/01/2020,ZAR,Selangor,0,0,0
1/01/2020,Zambia,Johor,8,5,3
1/01/2020,Zambia,Kedah,0,0,0
1/01/2020,Zambia,Perak,0,0,0
1/01/2020,Zambia,Perlis,0,0,0
1/01/2020,Zambia,Pulau Pinang,3,1,2
1/01/2020,Zambia,Sabah,0,0,0
1/01/2020,Zambia,Sarawak,0,0,0
1/01/2020,Zambia,Selangor,102,52,50
1/01/2020,Zimbabwe,Johor,21,13,8
1/01/2020,Zimbabwe,Kedah,0,0,0
1/01/2020,Zimbabwe,Kelantan,2,2,0
1/01/2020,Zimbabwe,Perak,0,0,0
1/01/2020,Zimbabwe,Perlis,1,1,0
1/01/2020,Zimbabwe,Pulau Pinang,1,1,0
1/01/2020,Zimbabwe,Sabah,4,2,2
1/01/2020,Zimbabwe,Sarawak,1,0,1
1/01/2020,Zimbabwe,Selangor,192,100,92
1/02/2020,Aruba,Kedah,0,0,0
1/02/2020,Aruba,Pulau Pinang,0,0,0
1/02/2020,Afghanistan,Johor,2,1,1
1/02/2020,Afghanistan,Kedah,3,3,0
1/02/2020,Afghanistan,Perlis,0,0,0
1/02/2020,Afghanistan,Pulau Pinang,0,0,0
1/02/2020,Afghanistan,Sarawak,0,0,0
1/02/2020,Afghanistan,Selangor,249,187,62
1/02/2020,Angola,Johor,0,0,0
1/02/2020,Angola,Kedah,0,0,0
1/02/2020,Angola,Sabah,0,0,0
1/02/2020,Angola,Selangor,8,6,2
1/02/2020,Anguilla,Selangor,0,0,0
1/02/2020,Albania,Johor,28,15,13
1/02/2020,Albania,Kedah,0,0,0
1/02/2020,Albania,Perak,0,0,0
1/02/2020,Albania,Perlis,0,0,0
1/02/2020,Albania,Pulau Pinang,0,0,0
1/02/2020,Albania,Sabah,0,0,0
1/02/2020,Albania,Sarawak,0,0,0
1/02/2020,Albania,Selangor,29,15,14
1/02/2020,Andorra,Johor,0,0,0
1/02/2020,Andorra,Kedah,0,0,0
1/02/2020,Andorra,Perlis,0,0,0
1/02/2020,Andorra,Pulau Pinang,0,0,0
1/02/2020,Andorra,Selangor,9,5,4
1/02/2020,Antigua and Barbuda,Selangor,0,0,0
1/02/2020,United Arab Emirates,Johor,7,5,2
1/02/2020,United Arab Emirates,Kedah,5,3,2
1/02/2020,United Arab Emirates,Kelantan,0,0,0
1/02/2020,United Arab Emirates,Perak,0,0,0
1/02/2020,United Arab Emirates,Perlis,0,0,0
1/02/2020,United Arab Emirates,Pulau Pinang,2,0,2
1/02/2020,United Arab Emirates,Sabah,1,1,0
1/02/2020,United Arab Emirates,Sarawak,1,1,0
1/02/2020,United Arab Emirates,Selangor,236,171,65
1/02/2020,Argentina,Johor,87,43,44
1/02/2020,Argentina,Kedah,122,62,60
1/02/2020,Argentina,Kelantan,3,1,2
1/02/2020,Argentina,Melaka,0,0,0
1/02/2020,Argentina,Perak,0,0,0
1/02/2020,Argentina,Perlis,4,3,1
1/02/2020,Argentina,Pulau Pinang,7,4,3
1/02/2020,Argentina,Sabah,10,5,5
1/02/2020,Argentina,Sarawak,5,3,2
1/02/2020,Argentina,Selangor,586,323,263
1/02/2020,Argentina,W.P. Labuan,0,0,0
1/02/2020,Armenia,Johor,5,2,3
1/02/2020,Armenia,Kedah,3,2,1
1/02/2020,Armenia,Kelantan,0,0,0
1/02/2020,Armenia,Perak,0,0,0
1/02/2020,Armenia,Perlis,0,0,0
1/02/2020,Armenia,Pulau Pinang,0,0,0
1/02/2020,Armenia,Sabah,0,0,0
1/02/2020,Armenia,Sarawak,0,0,0
1/02/2020,Armenia,Selangor,61,34,27
1/02/2020,Antarctica,Selangor,1,0,1
1/02/2020,Antigua and Barbuda,Johor,0,0,0
1/02/2020,Antigua and Barbuda,Kedah,0,0,0
1/02/2020,Antigua and Barbuda,Pulau Pinang,0,0,0
1/02/2020,Antigua and Barbuda,Sarawak,0,0,0
1/02/2020,Antigua and Barbuda,Selangor,13,8,5
1/02/2020,Australia,Johor,3385,2170,1215
1/02/2020,Australia,Kedah,470,271,199
1/02/2020,Australia,Kelantan,24,10,14
1/02/2020,Australia,Melaka,3,2,1
1/02/2020,Australia,Negeri Sembilan,0,0,0
1/02/2020,Australia,Pahang,21,11,10
1/02/2020,Australia,Perak,123,72,51
1/02/2020,Australia,Perlis,66,40,26
1/02/2020,Australia,Pulau Pinang,1270,711,559
1/02/2020,Australia,Sabah,390,183,207
1/02/2020,Australia,Sarawak,402,260,142
1/02/2020,Australia,Selangor,16651,10384,6267
1/02/2020,Australia,Terengganu,0,0,0
1/02/2020,Australia,W.P. Labuan,13,8,5
1/02/2020,Austria,Johor,205,138,67
1/02/2020,Austria,Kedah,168,94,74
1/02/2020,Austria,Kelantan,11,10,1
1/02/2020,Austria,Melaka,1,1,0
1/02/2020,Austria,Negeri Sembilan,0,0,0
1/02/2020,Austria,Pahang,0,0,0
1/02/2020,Austria,Perak,14,9,5
1/02/2020,Austria,Perlis,32,18,14
1/02/2020,Austria,Pulau Pinang,54,32,22
1/02/2020,Austria,Sabah,20,10,10
1/02/2020,Austria,Sarawak,17,11,6
1/02/2020,Austria,Selangor,1106,656,450
1/02/2020,Austria,Terengganu,0,0,0
1/02/2020,Austria,W.P. Labuan,1,0,1
1/02/2020,Azerbaijan,Johor,3,1,2
1/02/2020,Azerbaijan,Kedah,6,3,3
1/02/2020,Azerbaijan,Kelantan,0,0,0
1/02/2020,Azerbaijan,Melaka,0,0,0
1/02/2020,Azerbaijan,Perlis,0,0,0
1/02/2020,Azerbaijan,Pulau Pinang,0,0,0
1/02/2020,Azerbaijan,Sabah,0,0,0
1/02/2020,Azerbaijan,Sarawak,1,0,1
1/02/2020,Azerbaijan,Selangor,90,56,34
1/02/2020,Azerbaijan,W.P. Labuan,0,0,0
1/02/2020,Burundi,Pulau Pinang,0,0,0
1/02/2020,Burundi,Sarawak,0,0,0
1/02/2020,Burundi,Selangor,1,0,1
1/02/2020,Belgium,Johor,242,171,71
1/02/2020,Belgium,Kedah,160,84,76
1/02/2020,Belgium,Kelantan,8,6,2
1/02/2020,Belgium,Melaka,1,1,0
1/02/2020,Belgium,Negeri Sembilan,2,1,1
1/02/2020,Belgium,Pahang,1,0,1
1/02/2020,Belgium,Perak,7,6,1
1/02/2020,Belgium,Perlis,30,19,11
1/02/2020,Belgium,Pulau Pinang,62,35,27
1/02/2020,Belgium,Sabah,23,13,10
1/02/2020,Belgium,Sarawak,15,7,8
1/02/2020,Belgium,Selangor,1206,803,403
1/02/2020,Belgium,W.P. Labuan,3,2,1
1/02/2020,Benin,Johor,3,1,2
1/02/2020,Benin,Kedah,0,0,0
1/02/2020,Benin,Perak,0,0,0
1/02/2020,Benin,Pulau Pinang,0,0,0
1/02/2020,Benin,Sabah,0,0,0
1/02/2020,Benin,Sarawak,0,0,0
1/02/2020,Benin,Selangor,4,2,2
1/02/2020,Burkina Faso,Perak,0,0,0
1/02/2020,Burkina Faso,Pulau Pinang,0,0,0
1/02/2020,Burkina Faso,Selangor,7,7,0
1/02/2020,Bangladesh,Johor,1625,1366,259
1/02/2020,Bangladesh,Kedah,11,6,5
1/02/2020,Bangladesh,Kelantan,1,0,1
1/02/2020,Bangladesh,Melaka,0,0,0
1/02/2020,Bangladesh,Negeri Sembilan,0,0,0
1/02/2020,Bangladesh,Pahang,0,0,0
1/02/2020,Bangladesh,Perak,0,0,0
1/02/2020,Bangladesh,Perlis,0,0,0
1/02/2020,Bangladesh,Pulau Pinang,90,80,10
1/02/2020,Bangladesh,Sabah,9,9,0
1/02/2020,Bangladesh,Sarawak,158,134,24
1/02/2020,Bangladesh,Selangor,17763,15754,2009
1/02/2020,Bangladesh,W.P. Labuan,11,11,0
1/02/2020,Bulgaria,Johor,36,24,12
1/02/2020,Bulgaria,Kedah,66,37,29
1/02/2020,Bulgaria,Kelantan,0,0,0
1/02/2020,Bulgaria,Pahang,4,4,0
1/02/2020,Bulgaria,Perak,4,4,0
1/02/2020,Bulgaria,Perlis,0,0,0
1/02/2020,Bulgaria,Pulau Pinang,5,3,2
1/02/2020,Bulgaria,Sabah,3,1,2
1/02/2020,Bulgaria,Sarawak,0,0,0
1/02/2020,Bulgaria,Selangor,369,211,158
1/02/2020,Bulgaria,W.P. Labuan,0,0,0
1/02/2020,Bahrain,Johor,17,8,9
1/02/2020,Bahrain,Kedah,0,0,0
1/02/2020,Bahrain,Kelantan,0,0,0
1/02/2020,Bahrain,Perlis,0,0,0
1/02/2020,Bahrain,Pulau Pinang,0,0,0
1/02/2020,Bahrain,Sabah,1,1,0
1/02/2020,Bahrain,Sarawak,4,4,0
1/02/2020,Bahrain,Selangor,72,48,24
1/02/2020,Bahamas,Johor,1,1,0
1/02/2020,Bahamas,Kedah,0,0,0
1/02/2020,Bahamas,Perak,0,0,0
1/02/2020,Bahamas,Sabah,1,0,1
1/02/2020,Bahamas,Sarawak,0,0,0
1/02/2020,Bahamas,Selangor,3,3,0
1/02/2020,Bosnia and Herzegovina,Johor,5,3,2
1/02/2020,Bosnia and Herzegovina,Kedah,7,2,5
1/02/2020,Bosnia and Herzegovina,Perlis,2,2,0
1/02/2020,Bosnia and Herzegovina,Pulau Pinang,1,0,1
1/02/2020,Bosnia and Herzegovina,Sabah,0,0,0
1/02/2020,Bosnia and Herzegovina,Sarawak,0,0,0
1/02/2020,Bosnia and Herzegovina,Selangor,67,37,30
1/02/2020,Belarus,Johor,13,7,6
1/02/2020,Belarus,Kedah,32,15,17
1/02/2020,Belarus,Kelantan,3,1,2
1/02/2020,Belarus,Pahang,0,0,0
1/02/2020,Belarus,Perak,0,0,0
1/02/2020,Belarus,Perlis,4,2,2
1/02/2020,Belarus,Pulau Pinang,2,0,2
1/02/2020,Belarus,Sabah,2,2,0
1/02/2020,Belarus,Sarawak,4,1,3
1/02/2020,Belarus,Selangor,444,207,237
1/02/2020,Belarus,W.P. Labuan,0,0,0
1/02/2020,Belize,Johor,1,1,0
1/02/2020,Belize,Pulau Pinang,0,0,0
1/02/2020,Belize,Sarawak,0,0,0
1/02/2020,Belize,Selangor,6,3,3
1/02/2020,Bermuda,Selangor,0,0,0
1/02/2020,Bolivia,Johor,0,0,0
1/02/2020,Bolivia,Kedah,1,0,1
1/02/2020,Bolivia,Melaka,0,0,0
1/02/2020,Bolivia,Perak,0,0,0
1/02/2020,Bolivia,Perlis,0,0,0
1/02/2020,Bolivia,Pulau Pinang,0,0,0
1/02/2020,Bolivia,Sabah,0,0,0
1/02/2020,Bolivia,Sarawak,0,0,0
1/02/2020,Bolivia,Selangor,21,12,9
1/02/2020,Brazil,Johor,153,88,65
1/02/2020,Brazil,Kedah,75,38,37
1/02/2020,Brazil,Kelantan,0,0,0
1/02/2020,Brazil,Melaka,0,0,0
1/02/2020,Brazil,Pahang,0,0,0
1/02/2020,Brazil,Perak,5,3,2
1/02/2020,Brazil,Perlis,10,4,6
1/02/2020,Brazil,Pulau Pinang,25,15,10
1/02/2020,Brazil,Sabah,11,8,3
1/02/2020,Brazil,Sarawak,12,3,9
1/02/2020,Brazil,Selangor,1114,627,487
1/02/2020,Brazil,W.P. Labuan,0,0,0
1/02/2020,Barbados,Johor,2,1,1
1/02/2020,Barbados,Kedah,0,0,0
1/02/2020,Barbados,Perlis,0,0,0
1/02/2020,Barbados,Pulau Pinang,0,0,0
1/02/2020,Barbados,Selangor,6,1,5
1/02/2020,Brunei Darussalam,Johor,167,70,97
1/02/2020,Brunei Darussalam,Kedah,6,3,3
1/02/2020,Brunei Darussalam,Kelantan,4,2,2
1/02/2020,Brunei Darussalam,Melaka,0,0,0
1/02/2020,Brunei Darussalam,Pahang,0,0,0
1/02/2020,Brunei Darussalam,Perak,1,1,0
1/02/2020,Brunei Darussalam,Perlis,6,1,5
1/02/2020,Brunei Darussalam,Pulau Pinang,5,5,0
1/02/2020,Brunei Darussalam,Sabah,474,254,220
1/02/2020,Brunei Darussalam,Sarawak,58473,34982,23491
1/02/2020,Brunei Darussalam,Selangor,4037,2042,1995
1/02/2020,Brunei Darussalam,W.P. Labuan,1556,1064,492
1/02/2020,Bhutan,Johor,6,6,0
1/02/2020,Bhutan,Kedah,2,2,0
1/02/2020,Bhutan,Perak,0,0,0
1/02/2020,Bhutan,Perlis,0,0,0
1/02/2020,Bhutan,Pulau Pinang,2,1,1
1/02/2020,Bhutan,Sabah,0,0,0
1/02/2020,Bhutan,Sarawak,1,1,0
1/02/2020,Bhutan,Selangor,32,18,14
1/02/2020,Botswana,Johor,5,0,5
1/02/2020,Botswana,Kedah,0,0,0
1/02/2020,Botswana,Perlis,0,0,0
1/02/2020,Botswana,Pulau Pinang,0,0,0
1/02/2020,Botswana,Sabah,0,0,0
1/02/2020,Botswana,Sarawak,0,0,0
1/02/2020,Botswana,Selangor,15,9,6
1/02/2020,Central African Republic,Kedah,0,0,0
1/02/2020,Central African Republic,Selangor,1,1,0
1/02/2020,Canada,Johor,1156,696,460
1/02/2020,Canada,Kedah,288,169,119
1/02/2020,Canada,Kelantan,16,9,7
1/02/2020,Canada,Melaka,0,0,0
1/02/2020,Canada,Negeri Sembilan,0,0,0
1/02/2020,Canada,Pahang,2,2,0
1/02/2020,Canada,Perak,31,16,15
1/02/2020,Canada,Perlis,84,51,33
1/02/2020,Canada,Pulau Pinang,361,212,149
1/02/2020,Canada,Sabah,183,102,81
1/02/2020,Canada,Sarawak,383,233,150
1/02/2020,Canada,Selangor,4474,2676,1798
1/02/2020,Canada,Terengganu,0,0,0
1/02/2020,Canada,W.P. Labuan,15,10,5
1/02/2020,Cocos (Keeling) Islands,Selangor,0,0,0
1/02/2020,Switzerland,Johor,401,240,161
1/02/2020,Switzerland,Kedah,279,140,139
1/02/2020,Switzerland,Kelantan,10,8,2
1/02/2020,Switzerland,Melaka,1,1,0
1/02/2020,Switzerland,Negeri Sembilan,0,0,0
1/02/2020,Switzerland,Pahang,4,2,2
1/02/2020,Switzerland,Perak,12,9,3
1/02/2020,Switzerland,Perlis,51,29,22
1/02/2020,Switzerland,Pulau Pinang,135,84,51
1/02/2020,Switzerland,Sabah,51,25,26
1/02/2020,Switzerland,Sarawak,48,27,21
1/02/2020,Switzerland,Selangor,1420,866,554
1/02/2020,Switzerland,W.P. Labuan,7,5,2
1/02/2020,Chile,Johor,36,23,13
1/02/2020,Chile,Kedah,58,27,31
1/02/2020,Chile,Kelantan,2,1,1
1/02/2020,Chile,Melaka,0,0,0
1/02/2020,Chile,Pahang,0,0,0
1/02/2020,Chile,Perak,1,1,0
1/02/2020,Chile,Perlis,7,3,4
1/02/2020,Chile,Pulau Pinang,9,3,6
1/02/2020,Chile,Sabah,6,2,4
1/02/2020,Chile,Sarawak,2,2,0
1/02/2020,Chile,Selangor,471,217,254
1/02/2020,China,Johor,8884,3906,4978
1/02/2020,China,Kedah,749,298,451
1/02/2020,China,Kelantan,10,6,4
1/02/2020,China,Melaka,6,3,3
1/02/2020,China,Pahang,6,3,3
1/02/2020,China,Perak,255,89,166
1/02/2020,China,Perlis,126,54,72
1/02/2020,China,Pulau Pinang,2571,1330,1241
1/02/2020,China,Sabah,772,370,402
1/02/2020,China,Sarawak,446,147,299
1/02/2020,China,Selangor,57021,32622,24399
1/02/2020,China,Terengganu,0,0,0
1/02/2020,China,W.P. Labuan,19,10,9
1/02/2020,Côte d'Ivoire,Johor,0,0,0
1/02/2020,Côte d'Ivoire,Kedah,0,0,0
1/02/2020,Côte d'Ivoire,Pulau Pinang,0,0,0
1/02/2020,Côte d'Ivoire,Sabah,0,0,0
1/02/2020,Côte d'Ivoire,Sarawak,0,0,0
1/02/2020,Côte d'Ivoire,Selangor,12,6,6
1/02/2020,Cameroon,Johor,1,1,0
1/02/2020,Cameroon,Kedah,0,0,0
1/02/2020,Cameroon,Pulau Pinang,2,0,2
1/02/2020,Cameroon,Sabah,1,1,0
1/02/2020,Cameroon,Sarawak,2,2,0
1/02/2020,Cameroon,Selangor,25,17,8
1/02/2020,Congo,Johor,0,0,0
1/02/2020,Congo,Pulau Pinang,1,1,0
1/02/2020,Congo,Sarawak,0,0,0
1/02/2020,Congo,Selangor,9,8,1
1/02/2020,Congo,Johor,0,0,0
1/02/2020,Congo,Kedah,0,0,0
1/02/2020,Congo,Selangor,3,1,2
1/02/2020,Cook Islands,Selangor,0,0,0
1/02/2020,Colombia,Johor,7,5,2
1/02/2020,Colombia,Kedah,3,1,2
1/02/2020,Colombia,Perak,0,0,0
1/02/2020,Colombia,Pulau Pinang,3,3,0
1/02/2020,Colombia,Sabah,4,3,1
1/02/2020,Colombia,Sarawak,0,0,0
1/02/2020,Colombia,Selangor,120,57,63
1/02/2020,Colombia,W.P. Labuan,0,0,0
1/02/2020,Comoros,Johor,0,0,0
1/02/2020,Comoros,Kedah,0,0,0
1/02/2020,Comoros,Selangor,18,14,4
1/02/2020,Cabo Verde,Johor,2,2,0
1/02/2020,Cabo Verde,Kedah,0,0,0
1/02/2020,Cabo Verde,Pulau Pinang,0,0,0
1/02/2020,Cabo Verde,Sabah,0,0,0
1/02/2020,Cabo Verde,Selangor,3,2,1
1/02/2020,Costa Rica,Johor,5,3,2
1/02/2020,Costa Rica,Kedah,1,0,1
1/02/2020,Costa Rica,Perak,0,0,0
1/02/2020,Costa Rica,Perlis,0,0,0
1/02/2020,Costa Rica,Pulau Pinang,1,0,1
1/02/2020,Costa Rica,Sabah,0,0,0
1/02/2020,Costa Rica,Sarawak,0,0,0
1/02/2020,Costa Rica,Selangor,68,47,21
1/02/2020,Cuba,Johor,6,6,0
1/02/2020,Cuba,Kedah,0,0,0
1/02/2020,Cuba,Perlis,0,0,0
1/02/2020,Cuba,Pulau Pinang,0,0,0
1/02/2020,Cuba,Sabah,0,0,0
1/02/2020,Cuba,Sarawak,0,0,0
1/02/2020,Cuba,Selangor,31,18,13
1/02/2020,Cyprus,Johor,11,6,5
1/02/2020,Cyprus,Kedah,0,0,0
1/02/2020,Cyprus,Perak,0,0,0
1/02/2020,Cyprus,Perlis,0,0,0
1/02/2020,Cyprus,Pulau Pinang,3,1,2
1/02/2020,Cyprus,Sabah,3,2,1
1/02/2020,Cyprus,Sarawak,0,0,0
1/02/2020,Cyprus,Selangor,58,34,24
1/02/2020,Czechia,Johor,236,122,114
1/02/2020,Czechia,Kedah,636,320,316
1/02/2020,Czechia,Kelantan,4,4,0
1/02/2020,Czechia,Melaka,0,0,0
1/02/2020,Czechia,Negeri Sembilan,0,0,0
1/02/2020,Czechia,Perak,0,0,0
1/02/2020,Czechia,Perlis,13,7,6
1/02/2020,Czechia,Pulau Pinang,109,47,62
1/02/2020,Czechia,Sabah,51,25,26
1/02/2020,Czechia,Sarawak,44,24,20
1/02/2020,Czechia,Selangor,1050,585,465
1/02/2020,Czechia,W.P. Labuan,8,5,3
1/02/2020,Germany,Johor,2021,1274,747
1/02/2020,Germany,Kedah,1216,611,605
1/02/2020,Germany,Kelantan,41,26,15
1/02/2020,Germany,Melaka,5,2,3
1/02/2020,Germany,Negeri Sembilan,0,0,0
1/02/2020,Germany,Pahang,6,4,2
1/02/2020,Germany,Perak,78,52,26
1/02/2020,Germany,Perlis,247,137,110
1/02/2020,Germany,Pulau Pinang,562,376,186
1/02/2020,Germany,Sabah,254,133,121
1/02/2020,Germany,Sarawak,283,174,109
1/02/2020,Germany,Selangor,7642,4704,2938
1/02/2020,Germany,Terengganu,0,0,0
1/02/2020,Germany,W.P. Labuan,31,24,7
1/02/2020,Djibouti,Johor,0,0,0
1/02/2020,Djibouti,Selangor,24,15,9
1/02/2020,Dominica,Johor,3,2,1
1/02/2020,Dominica,Kedah,0,0,0
1/02/2020,Dominica,Pulau Pinang,1,1,0
1/02/2020,Dominica,Sabah,0,0,0
1/02/2020,Dominica,Sarawak,0,0,0
1/02/2020,Dominica,Selangor,40,32,8
1/02/2020,Dominica,W.P. Labuan,1,1,0
1/02/2020,Denmark,Johor,352,222,130
1/02/2020,Denmark,Kedah,472,209,263
1/02/2020,Denmark,Kelantan,2,1,1
1/02/2020,Denmark,Melaka,2,2,0
1/02/2020,Denmark,Negeri Sembilan,0,0,0
1/02/2020,Denmark,Pahang,0,0,0
1/02/2020,Denmark,Perak,0,0,0
1/02/2020,Denmark,Perlis,24,19,5
1/02/2020,Denmark,Pulau Pinang,190,86,104
1/02/2020,Denmark,Sabah,105,64,41
1/02/2020,Denmark,Sarawak,39,20,19
1/02/2020,Denmark,Selangor,1816,1042,774
1/02/2020,Denmark,W.P. Labuan,7,4,3
1/02/2020,Dominican Republic,Johor,3,2,1
1/02/2020,Dominican Republic,Kedah,0,0,0
1/02/2020,Dominican Republic,Perak,0,0,0
1/02/2020,Dominican Republic,Perlis,0,0,0
1/02/2020,Dominican Republic,Pulau Pinang,1,1,0
1/02/2020,Dominican Republic,Sabah,0,0,0
1/02/2020,Dominican Republic,Sarawak,1,1,0
1/02/2020,Dominican Republic,Selangor,30,19,11
1/02/2020,Algeria,Johor,26,25,1
1/02/2020,Algeria,Kedah,29,21,8
1/02/2020,Algeria,Kelantan,0,0,0
1/02/2020,Algeria,Melaka,0,0,0
1/02/2020,Algeria,Perak,0,0,0
1/02/2020,Algeria,Perlis,0,0,0
1/02/2020,Algeria,Pulau Pinang,12,7,5
1/02/2020,Algeria,Sabah,0,0,0
1/02/2020,Algeria,Sarawak,6,2,4
1/02/2020,Algeria,Selangor,843,604,239
1/02/2020,Algeria,W.P. Labuan,0,0,0
1/02/2020,Ecuador,Johor,9,7,2
1/02/2020,Ecuador,Kedah,2,0,2
1/02/2020,Ecuador,Perak,0,0,0
1/02/2020,Ecuador,Perlis,0,0,0
1/02/2020,Ecuador,Pulau Pinang,0,0,0
1/02/2020,Ecuador,Sabah,0,0,0
1/02/2020,Ecuador,Sarawak,6,1,5
1/02/2020,Ecuador,Selangor,63,32,31
1/02/2020,Egypt,Johor,193,170,23
1/02/2020,Egypt,Kedah,15,9,6
1/02/2020,Egypt,Kelantan,3,3,0
1/02/2020,Egypt,Melaka,0,0,0
1/02/2020,Egypt,Pahang,0,0,0
1/02/2020,Egypt,Perak,0,0,0
1/02/2020,Egypt,Perlis,2,2,0
1/02/2020,Egypt,Pulau Pinang,7,6,1
1/02/2020,Egypt,Sabah,5,2,3
1/02/2020,Egypt,Sarawak,43,36,7
1/02/2020,Egypt,Selangor,2590,1764,826
1/02/2020,Egypt,Terengganu,0,0,0
1/02/2020,Egypt,W.P. Labuan,4,4,0
1/02/2020,Eritrea,Johor,0,0,0
1/02/2020,Eritrea,Pulau Pinang,0,0,0
1/02/2020,Eritrea,Sabah,2,1,1
1/02/2020,Eritrea,Selangor,29,20,9
1/02/2020,Spain,Johor,330,215,115
1/02/2020,Spain,Kedah,254,117,137
1/02/2020,Spain,Kelantan,10,6,4
1/02/2020,Spain,Melaka,1,1,0
1/02/2020,Spain,Negeri Sembilan,0,0,0
1/02/2020,Spain,Pahang,0,0,0
1/02/2020,Spain,Perak,6,4,2
1/02/2020,Spain,Perlis,35,21,14
1/02/2020,Spain,Pulau Pinang,67,40,27
1/02/2020,Spain,Sabah,61,38,23
1/02/2020,Spain,Sarawak,54,29,25
1/02/2020,Spain,Selangor,2058,1246,812
1/02/2020,Spain,W.P. Labuan,7,3,4
1/02/2020,Estonia,Johor,59,29,30
1/02/2020,Estonia,Kedah,115,56,59
1/02/2020,Estonia,Kelantan,0,0,0
1/02/2020,Estonia,Pahang,0,0,0
1/02/2020,Estonia,Perak,0,0,0
1/02/2020,Estonia,Perlis,3,2,1
1/02/2020,Estonia,Pulau Pinang,6,3,3
1/02/2020,Estonia,Sabah,5,2,3
1/02/2020,Estonia,Sarawak,10,4,6
1/02/2020,Estonia,Selangor,515,250,265
1/02/2020,Estonia,W.P. Labuan,0,0,0
1/02/2020,Ethiopia,Johor,2,2,0
1/02/2020,Ethiopia,Kedah,0,0,0
1/02/2020,Ethiopia,Pulau Pinang,0,0,0
1/02/2020,Ethiopia,Sarawak,0,0,0
1/02/2020,Ethiopia,Selangor,37,24,13
1/02/2020,Finland,Johor,241,136,105
1/02/2020,Finland,Kedah,459,207,252
1/02/2020,Finland,Kelantan,4,2,2
1/02/2020,Finland,Melaka,0,0,0
1/02/2020,Finland,Negeri Sembilan,0,0,0
1/02/2020,Finland,Pahang,0,0,0
1/02/2020,Finland,Perak,1,1,0
1/02/2020,Finland,Perlis,13,9,4
1/02/2020,Finland,Pulau Pinang,134,71,63
1/02/2020,Finland,Sabah,41,21,20
1/02/2020,Finland,Sarawak,20,11,9
1/02/2020,Finland,Selangor,1584,849,735
1/02/2020,Finland,W.P. Labuan,1,1,0
1/02/2020,Fiji,Johor,27,15,12
1/02/2020,Fiji,Kedah,3,2,1
1/02/2020,Fiji,Kelantan,0,0,0
1/02/2020,Fiji,Perak,0,0,0
1/02/2020,Fiji,Perlis,0,0,0
1/02/2020,Fiji,Pulau Pinang,3,3,0
1/02/2020,Fiji,Sabah,1,0,1
1/02/2020,Fiji,Sarawak,1,1,0
1/02/2020,Fiji,Selangor,77,48,29
1/02/2020,France,Johor,2063,1231,832
1/02/2020,France,Kedah,1396,726,670
1/02/2020,France,Kelantan,83,58,25
1/02/2020,France,Melaka,5,4,1
1/02/2020,France,Negeri Sembilan,0,0,0
1/02/2020,France,Pahang,41,21,20
1/02/2020,France,Perak,23,16,7
1/02/2020,France,Perlis,122,79,43
1/02/2020,France,Pulau Pinang,548,322,226
1/02/2020,France,Sabah,173,105,68
1/02/2020,France,Sarawak,143,91,52
1/02/2020,France,Selangor,9806,5882,3924
1/02/2020,France,Terengganu,0,0,0
1/02/2020,France,W.P. Labuan,11,9,2
1/02/2020,"Micronesia, Federated States of",Johor,0,0,0
1/02/2020,"Micronesia, Federated States of",Pulau Pinang,0,0,0
1/02/2020,"Micronesia, Federated States of",Selangor,0,0,0
1/02/2020,Gabon,Johor,0,0,0
1/02/2020,Gabon,Pulau Pinang,0,0,0
1/02/2020,Gabon,Sarawak,0,0,0
1/02/2020,Gabon,Selangor,6,4,2
1/02/2020,United Kingdom of Great Britain and Northern Ireland,Johor,4194,2809,1385
1/02/2020,United Kingdom of Great Britain and Northern Ireland,Kedah,1699,906,793
1/02/2020,United Kingdom of Great Britain and Northern Ireland,Kelantan,72,55,17
1/02/2020,United Kingdom of Great Britain and Northern Ireland,Melaka,2,2,0
1/02/2020,United Kingdom of Great Britain and Northern Ireland,Negeri Sembilan,0,0,0
1/02/2020,United Kingdom of Great Britain and Northern Ireland,Pahang,19,14,5
1/02/2020,United Kingdom of Great Britain and Northern Ireland,Perak,89,55,34
1/02/2020,United Kingdom of Great Britain and Northern Ireland,Perlis,367,228,139
1/02/2020,United Kingdom of Great Britain and Northern Ireland,Pulau Pinang,1616,946,670
1/02/2020,United Kingdom of Great Britain and Northern Ireland,Sabah,639,340,299
1/02/2020,United Kingdom of Great Britain and Northern Ireland,Sarawak,1159,757,402
1/02/2020,United Kingdom of Great Britain and Northern Ireland,Selangor,18590,11608,6982
1/02/2020,United Kingdom of Great Britain and Northern Ireland,Terengganu,0,0,0
1/02/2020,United Kingdom of Great Britain and Northern Ireland,W.P. Labuan,74,48,26
1/02/2020,Georgia,Johor,10,7,3
1/02/2020,Georgia,Kedah,13,10,3
1/02/2020,Georgia,Melaka,0,0,0
1/02/2020,Georgia,Perak,0,0,0
1/02/2020,Georgia,Perlis,0,0,0
1/02/2020,Georgia,Pulau Pinang,3,1,2
1/02/2020,Georgia,Sabah,0,0,0
1/02/2020,Georgia,Sarawak,0,0,0
1/02/2020,Georgia,Selangor,31,22,9
1/02/2020,Ghana,Johor,2,2,0
1/02/2020,Ghana,Kedah,0,0,0
1/02/2020,Ghana,Kelantan,0,0,0
1/02/2020,Ghana,Pulau Pinang,0,0,0
1/02/2020,Ghana,Sabah,0,0,0
1/02/2020,Ghana,Sarawak,0,0,0
1/02/2020,Ghana,Selangor,52,41,11
1/02/2020,Gibraltar,Johor,0,0,0
1/02/2020,Gibraltar,Sarawak,0,0,0
1/02/2020,Guinea,Johor,8,8,0
1/02/2020,Guinea,Kedah,0,0,0
1/02/2020,Guinea,Kelantan,0,0,0
1/02/2020,Guinea,Perlis,0,0,0
1/02/2020,Guinea,Pulau Pinang,0,0,0
1/02/2020,Guinea,Sabah,1,1,0
1/02/2020,Guinea,Sarawak,0,0,0
1/02/2020,Guinea,Selangor,56,45,11
1/02/2020,Guadeloupe,Selangor,0,0,0
1/02/2020,Gambia,Johor,0,0,0
1/02/2020,Gambia,Kedah,1,0,1
1/02/2020,Gambia,Kelantan,0,0,0
1/02/2020,Gambia,Pulau Pinang,3,2,1
1/02/2020,Gambia,Sabah,0,0,0
1/02/2020,Gambia,Sarawak,1,1,0
1/02/2020,Gambia,Selangor,53,44,9
1/02/2020,Guinea-Bissau,Johor,2,2,0
1/02/2020,Guinea-Bissau,Selangor,0,0,0
1/02/2020,Equatorial Guinea,Johor,0,0,0
1/02/2020,Equatorial Guinea,Selangor,1,0,1
1/02/2020,Greece,Johor,39,30,9
1/02/2020,Greece,Kedah,23,16,7
1/02/2020,Greece,Kelantan,0,0,0
1/02/2020,Greece,Melaka,0,0,0
1/02/2020,Greece,Negeri Sembilan,0,0,0
1/02/2020,Greece,Pahang,3,3,0
1/02/2020,Greece,Perak,0,0,0
1/02/2020,Greece,Perlis,5,5,0
1/02/2020,Greece,Pulau Pinang,7,7,0
1/02/2020,Greece,Sabah,2,1,1
1/02/2020,Greece,Sarawak,15,11,4
1/02/2020,Greece,Selangor,267,191,76
1/02/2020,Grenada,Johor,7,5,2
1/02/2020,Grenada,Kedah,0,0,0
1/02/2020,Grenada,Pulau Pinang,1,1,0
1/02/2020,Grenada,Sabah,0,0,0
1/02/2020,Grenada,Sarawak,0,0,0
1/02/2020,Grenada,Selangor,7,4,3
1/02/2020,Greenland,Johor,0,0,0
1/02/2020,Greenland,Selangor,0,0,0
1/02/2020,Guatemala,Johor,2,1,1
1/02/2020,Guatemala,Kedah,1,1,0
1/02/2020,Guatemala,Pahang,0,0,0
1/02/2020,Guatemala,Perak,0,0,0
1/02/2020,Guatemala,Pulau Pinang,0,0,0
1/02/2020,Guatemala,Sabah,1,0,1
1/02/2020,Guatemala,Sarawak,0,0,0
1/02/2020,Guatemala,Selangor,13,9,4
1/02/2020,Guatemala,W.P. Labuan,0,0,0
1/02/2020,Guyana,Johor,0,0,0
1/02/2020,Guyana,Kedah,1,0,1
1/02/2020,Guyana,Pulau Pinang,0,0,0
1/02/2020,Guyana,Sarawak,0,0,0
1/02/2020,Guyana,Selangor,4,2,2
1/02/2020,Hong Kong,Johor,3,0,3
1/02/2020,Hong Kong,Kedah,0,0,0
1/02/2020,Hong Kong,Kelantan,0,0,0
1/02/2020,Hong Kong,Pahang,0,0,0
1/02/2020,Hong Kong,Perak,20,12,8
1/02/2020,Hong Kong,Perlis,0,0,0
1/02/2020,Hong Kong,Pulau Pinang,0,0,0
1/02/2020,Hong Kong,Sabah,0,0,0
1/02/2020,Hong Kong,Sarawak,7,4,3
1/02/2020,Hong Kong,Selangor,0,0,0
1/02/2020,Hong Kong,Terengganu,0,0,0
1/02/2020,Heard Island and McDonald Islands,Johor,0,0,0
1/02/2020,Honduras,Johor,8,3,5
1/02/2020,Honduras,Kedah,0,0,0
1/02/2020,Honduras,Perak,0,0,0
1/02/2020,Honduras,Pulau Pinang,1,1,0
1/02/2020,Honduras,Sabah,0,0,0
1/02/2020,Honduras,Sarawak,1,1,0
1/02/2020,Honduras,Selangor,13,11,2
1/02/2020,Croatia,Johor,30,29,1
1/02/2020,Croatia,Kedah,18,10,8
1/02/2020,Croatia,Kelantan,0,0,0
1/02/2020,Croatia,Melaka,0,0,0
1/02/2020,Croatia,Pahang,10,9,1
1/02/2020,Croatia,Perak,0,0,0
1/02/2020,Croatia,Perlis,3,2,1
1/02/2020,Croatia,Pulau Pinang,3,2,1
1/02/2020,Croatia,Sabah,5,2,3
1/02/2020,Croatia,Sarawak,3,3,0
1/02/2020,Croatia,Selangor,248,165,83
1/02/2020,Haiti,Johor,0,0,0
1/02/2020,Haiti,Kedah,0,0,0
1/02/2020,Haiti,Kelantan,0,0,0
1/02/2020,Haiti,Perak,0,0,0
1/02/2020,Haiti,Pulau Pinang,0,0,0
1/02/2020,Haiti,Sabah,0,0,0
1/02/2020,Haiti,Selangor,10,8,2
1/02/2020,Hungary,Johor,59,39,20
1/02/2020,Hungary,Kedah,388,190,198
1/02/2020,Hungary,Kelantan,4,3,1
1/02/2020,Hungary,Pahang,0,0,0
1/02/2020,Hungary,Perak,0,0,0
1/02/2020,Hungary,Perlis,5,2,3
1/02/2020,Hungary,Pulau Pinang,44,20,24
1/02/2020,Hungary,Sabah,9,5,4
1/02/2020,Hungary,Sarawak,10,9,1
1/02/2020,Hungary,Selangor,1119,568,551
1/02/2020,Hungary,W.P. Labuan,2,1,1
1/02/2020,Indonesia,Johor,105615,60705,44910
1/02/2020,Indonesia,Kedah,2058,885,1173
1/02/2020,Indonesia,Kelantan,231,164,67
1/02/2020,Indonesia,Melaka,3134,1430,1704
1/02/2020,Indonesia,Negeri Sembilan,3252,2145,1107
1/02/2020,Indonesia,Pahang,14,12,2
1/02/2020,Indonesia,Perak,134,57,77
1/02/2020,Indonesia,Perlis,351,179,172
1/02/2020,Indonesia,Pulau Pinang,21871,8620,13251
1/02/2020,Indonesia,Sabah,4181,2264,1917
1/02/2020,Indonesia,Sarawak,28788,17818,10970
1/02/2020,Indonesia,Selangor,108102,52727,55375
1/02/2020,Indonesia,Terengganu,1,1,0
1/02/2020,Indonesia,W.P. Labuan,95,68,27
1/02/2020,India,Johor,13646,10636,3010
1/02/2020,India,Kedah,510,315,195
1/02/2020,India,Kelantan,15,10,5
1/02/2020,India,Melaka,20,19,1
1/02/2020,India,Negeri Sembilan,0,0,0
1/02/2020,India,Pahang,22,14,8
1/02/2020,India,Perak,276,176,100
1/02/2020,India,Perlis,30,18,12
1/02/2020,India,Pulau Pinang,467,335,132
1/02/2020,India,Sabah,96,81,15
1/02/2020,India,Sarawak,1505,1340,165
1/02/2020,India,Selangor,55552,42134,13418
1/02/2020,India,Terengganu,0,0,0
1/02/2020,India,W.P. Labuan,57,48,9
1/02/2020, British Indian Ocean Territory,Pulau Pinang,0,0,0
1/02/2020, British Indian Ocean Territory,Selangor,0,0,0
1/02/2020,Ireland,Johor,238,152,86
1/02/2020,Ireland,Kedah,97,50,47
1/02/2020,Ireland,Kelantan,1,1,0
1/02/2020,Ireland,Negeri Sembilan,0,0,0
1/02/2020,Ireland,Pahang,1,0,1
1/02/2020,Ireland,Perak,6,4,2
1/02/2020,Ireland,Perlis,22,15,7
1/02/2020,Ireland,Pulau Pinang,87,53,34
1/02/2020,Ireland,Sabah,37,17,20
1/02/2020,Ireland,Sarawak,31,18,13
1/02/2020,Ireland,Selangor,1126,705,421
1/02/2020,Ireland,Terengganu,0,0,0
1/02/2020,Ireland,W.P. Labuan,1,1,0
1/02/2020,"Iran, Islamic Republic of",Johor,483,246,237
1/02/2020,"Iran, Islamic Republic of",Kedah,11,8,3
1/02/2020,"Iran, Islamic Republic of",Kelantan,0,0,0
1/02/2020,"Iran, Islamic Republic of",Perak,0,0,0
1/02/2020,"Iran, Islamic Republic of",Perlis,3,2,1
1/02/2020,"Iran, Islamic Republic of",Pulau Pinang,3,2,1
1/02/2020,"Iran, Islamic Republic of",Sabah,6,3,3
1/02/2020,"Iran, Islamic Republic of",Sarawak,5,3,2
1/02/2020,"Iran, Islamic Republic of",Selangor,3439,1887,1552
1/02/2020,"Iran, Islamic Republic of",W.P. Labuan,0,0,0
1/02/2020,Iraq,Johor,14,10,4
1/02/2020,Iraq,Kedah,0,0,0
1/02/2020,Iraq,Kelantan,0,0,0
1/02/2020,Iraq,Melaka,0,0,0
1/02/2020,Iraq,Pahang,0,0,0
1/02/2020,Iraq,Perak,0,0,0
1/02/2020,Iraq,Perlis,0,0,0
1/02/2020,Iraq,Pulau Pinang,9,4,5
1/02/2020,Iraq,Sabah,1,1,0
1/02/2020,Iraq,Sarawak,0,0,0
1/02/2020,Iraq,Selangor,1563,1052,511
1/02/2020,Iceland,Johor,2,2,0
1/02/2020,Iceland,Kedah,2,2,0
1/02/2020,Iceland,Kelantan,0,0,0
1/02/2020,Iceland,Perak,0,0,0
1/02/2020,Iceland,Perlis,0,0,0
1/02/2020,Iceland,Pulau Pinang,1,0,1
1/02/2020,Iceland,Sabah,10,5,5
1/02/2020,Iceland,Sarawak,3,2,1
1/02/2020,Iceland,Selangor,75,40,35
1/02/2020,Iceland,W.P. Labuan,5,3,2
1/02/2020,Israel,Pulau Pinang,0,0,0
1/02/2020,Italy,Johor,465,347,118
1/02/2020,Italy,Kedah,625,362,263
1/02/2020,Italy,Kelantan,19,16,3
1/02/2020,Italy,Melaka,2,2,0
1/02/2020,Italy,Negeri Sembilan,0,0,0
1/02/2020,Italy,Pahang,1,0,1
1/02/2020,Italy,Perak,11,7,4
1/02/2020,Italy,Perlis,57,41,16
1/02/2020,Italy,Pulau Pinang,89,62,27
1/02/2020,Italy,Sabah,70,44,26
1/02/2020,Italy,Sarawak,68,47,21
1/02/2020,Italy,Selangor,2963,2055,908
1/02/2020,Italy,W.P. Labuan,2,1,1
1/02/2020,Jamaica,Johor,4,2,2
1/02/2020,Jamaica,Kedah,0,0,0
1/02/2020,Jamaica,Perak,0,0,0
1/02/2020,Jamaica,Pulau Pinang,1,1,0
1/02/2020,Jamaica,Sabah,1,1,0
1/02/2020,Jamaica,Sarawak,0,0,0
1/02/2020,Jamaica,Selangor,22,9,13
1/02/2020,Jamaica,W.P. Labuan,0,0,0
1/02/2020,Jordan,Johor,28,8,20
1/02/2020,Jordan,Kedah,39,24,15
1/02/2020,Jordan,Kelantan,0,0,0
1/02/2020,Jordan,Melaka,0,0,0
1/02/2020,Jordan,Perlis,2,2,0
1/02/2020,Jordan,Pulau Pinang,22,13,9
1/02/2020,Jordan,Sabah,1,0,1
1/02/2020,Jordan,Sarawak,1,1,0
1/02/2020,Jordan,Selangor,829,584,245
1/02/2020,Jordan,W.P. Labuan,0,0,0
1/02/2020,Japan,Johor,7273,4928,2345
1/02/2020,Japan,Kedah,280,140,140
1/02/2020,Japan,Kelantan,10,9,1
1/02/2020,Japan,Melaka,5,4,1
1/02/2020,Japan,Negeri Sembilan,0,0,0
1/02/2020,Japan,Pahang,6,5,1
1/02/2020,Japan,Perak,55,35,20
1/02/2020,Japan,Perlis,118,99,19
1/02/2020,Japan,Pulau Pinang,1378,996,382
1/02/2020,Japan,Sabah,1123,555,568
1/02/2020,Japan,Sarawak,237,172,65
1/02/2020,Japan,Selangor,30796,18629,12167
1/02/2020,Japan,W.P. Labuan,31,16,15
1/02/2020,Kazakhstan,Johor,38,15,23
1/02/2020,Kazakhstan,Kedah,80,35,45
1/02/2020,Kazakhstan,Kelantan,7,3,4
1/02/2020,Kazakhstan,Melaka,1,1,0
1/02/2020,Kazakhstan,Perak,1,0,1
1/02/2020,Kazakhstan,Perlis,3,3,0
1/02/2020,Kazakhstan,Pulau Pinang,3,2,1
1/02/2020,Kazakhstan,Sabah,11,6,5
1/02/2020,Kazakhstan,Sarawak,3,0,3
1/02/2020,Kazakhstan,Selangor,2340,994,1346
1/02/2020,Kazakhstan,W.P. Labuan,1,1,0
1/02/2020,Kenya,Johor,30,16,14
1/02/2020,Kenya,Kedah,2,0,2
1/02/2020,Kenya,Kelantan,0,0,0
1/02/2020,Kenya,Perak,0,0,0
1/02/2020,Kenya,Perlis,1,0,1
1/02/2020,Kenya,Pulau Pinang,3,2,1
1/02/2020,Kenya,Sabah,1,1,0
1/02/2020,Kenya,Sarawak,3,2,1
1/02/2020,Kenya,Selangor,313,169,144
1/02/2020,Kyrgyzstan,Johor,15,13,2
1/02/2020,Kyrgyzstan,Kedah,9,7,2
1/02/2020,Kyrgyzstan,Kelantan,0,0,0
1/02/2020,Kyrgyzstan,Perak,0,0,0
1/02/2020,Kyrgyzstan,Perlis,0,0,0
1/02/2020,Kyrgyzstan,Pulau Pinang,5,2,3
1/02/2020,Kyrgyzstan,Sabah,2,2,0
1/02/2020,Kyrgyzstan,Sarawak,0,0,0
1/02/2020,Kyrgyzstan,Selangor,329,146,183
1/02/2020,Cambodia,Johor,1507,603,904
1/02/2020,Cambodia,Kedah,167,82,85
1/02/2020,Cambodia,Kelantan,1617,1336,281
1/02/2020,Cambodia,Melaka,0,0,0
1/02/2020,Cambodia,Negeri Sembilan,2,2,0
1/02/2020,Cambodia,Pahang,0,0,0
1/02/2020,Cambodia,Perak,27,23,4
1/02/2020,Cambodia,Perlis,600,439,161
1/02/2020,Cambodia,Pulau Pinang,9,3,6
1/02/2020,Cambodia,Sabah,0,0,0
1/02/2020,Cambodia,Sarawak,22,5,17
1/02/2020,Cambodia,Selangor,4005,2113,1892
1/02/2020,Cambodia,W.P. Labuan,0,0,0
1/02/2020,Kiribati,Johor,1,1,0
1/02/2020,Kiribati,Sabah,0,0,0
1/02/2020,Kiribati,Selangor,2,1,1
1/02/2020,Saint Kitts and Nevis,Johor,6,5,1
1/02/2020,Saint Kitts and Nevis,Kedah,0,0,0
1/02/2020,Saint Kitts and Nevis,Perlis,0,0,0
1/02/2020,Saint Kitts and Nevis,Pulau Pinang,4,1,3
1/02/2020,Saint Kitts and Nevis,Sabah,0,0,0
1/02/2020,Saint Kitts and Nevis,Selangor,36,30,6
1/02/2020,Saint Kitts and Nevis,W.P. Labuan,0,0,0
1/02/2020,"Korea, Republic of",Johor,7227,3977,3250
1/02/2020,"Korea, Republic of",Kedah,271,138,133
1/02/2020,"Korea, Republic of",Kelantan,6,5,1
1/02/2020,"Korea, Republic of",Melaka,1,0,1
1/02/2020,"Korea, Republic of",Negeri Sembilan,0,0,0
1/02/2020,"Korea, Republic of",Pahang,4,1,3
1/02/2020,"Korea, Republic of",Perak,11,4,7
1/02/2020,"Korea, Republic of",Perlis,87,61,26
1/02/2020,"Korea, Republic of",Pulau Pinang,262,142,120
1/02/2020,"Korea, Republic of",Sabah,14366,6032,8334
1/02/2020,"Korea, Republic of",Sarawak,306,183,123
1/02/2020,"Korea, Republic of",Selangor,13031,7279,5752
1/02/2020,"Korea, Republic of",Terengganu,1,1,0
1/02/2020,"Korea, Republic of",W.P. Labuan,23,17,6
1/02/2020,Kuwait,Johor,5,4,1
1/02/2020,Kuwait,Kedah,2,2,0
1/02/2020,Kuwait,Kelantan,0,0,0
1/02/2020,Kuwait,Perak,0,0,0
1/02/2020,Kuwait,Perlis,0,0,0
1/02/2020,Kuwait,Pulau Pinang,3,2,1
1/02/2020,Kuwait,Sabah,0,0,0
1/02/2020,Kuwait,Sarawak,0,0,0
1/02/2020,Kuwait,Selangor,185,126,59
1/02/2020,Kuwait,W.P. Labuan,0,0,0
1/02/2020, Lao People's Democratic Republic,Johor,128,38,90
1/02/2020, Lao People's Democratic Republic,Kedah,1129,86,1043
1/02/2020, Lao People's Democratic Republic,Kelantan,759,654,105
1/02/2020, Lao People's Democratic Republic,Melaka,0,0,0
1/02/2020, Lao People's Democratic Republic,Perak,11,0,11
1/02/2020, Lao People's Democratic Republic,Perlis,423,136,287
1/02/2020, Lao People's Democratic Republic,Pulau Pinang,13,3,10
1/02/2020, Lao People's Democratic Republic,Sabah,1,0,1
1/02/2020, Lao People's Democratic Republic,Sarawak,4,0,4
1/02/2020, Lao People's Democratic Republic,Selangor,395,136,259
1/02/2020, Lao People's Democratic Republic,W.P. Labuan,0,0,0
1/02/2020,Lebanon,Johor,8,5,3
1/02/2020,Lebanon,Kedah,3,2,1
1/02/2020,Lebanon,Kelantan,1,1,0
1/02/2020,Lebanon,Pahang,0,0,0
1/02/2020,Lebanon,Perak,0,0,0
1/02/2020,Lebanon,Perlis,0,0,0
1/02/2020,Lebanon,Pulau Pinang,6,3,3
1/02/2020,Lebanon,Sabah,2,2,0
1/02/2020,Lebanon,Sarawak,1,1,0
1/02/2020,Lebanon,Selangor,225,167,58
1/02/2020,Lebanon,W.P. Labuan,0,0,0
1/02/2020,Liberia,Johor,0,0,0
1/02/2020,Liberia,Kedah,0,0,0
1/02/2020,Liberia,Sabah,0,0,0
1/02/2020,Liberia,Sarawak,0,0,0
1/02/2020,Liberia,Selangor,4,3,1
1/02/2020,Libya,Johor,5,3,2
1/02/2020,Libya,Kedah,3,2,1
1/02/2020,Libya,Perlis,0,0,0
1/02/2020,Libya,Pulau Pinang,4,4,0
1/02/2020,Libya,Sabah,3,3,0
1/02/2020,Libya,Sarawak,2,0,2
1/02/2020,Libya,Selangor,673,496,177
1/02/2020,Saint Lucia,Johor,2,2,0
1/02/2020,Saint Lucia,Kedah,0,0,0
1/02/2020,Saint Lucia,Pulau Pinang,0,0,0
1/02/2020,Saint Lucia,Sarawak,0,0,0
1/02/2020,Saint Lucia,Selangor,8,7,1
1/02/2020,Liechtenstein,Johor,2,1,1
1/02/2020,Liechtenstein,Kedah,0,0,0
1/02/2020,Liechtenstein,Perlis,0,0,0
1/02/2020,Liechtenstein,Pulau Pinang,0,0,0
1/02/2020,Liechtenstein,Sabah,0,0,0
1/02/2020,Liechtenstein,Sarawak,1,1,0
1/02/2020,Liechtenstein,Selangor,4,4,0
1/02/2020,LKA,Johor,661,487,174
1/02/2020,LKA,Kedah,9,5,4
1/02/2020,LKA,Kelantan,0,0,0
1/02/2020,LKA,Melaka,0,0,0
1/02/2020,LKA,Pahang,1,1,0
1/02/2020,LKA,Perak,2,1,1
1/02/2020,LKA,Perlis,0,0,0
1/02/2020,LKA,Pulau Pinang,24,18,6
1/02/2020,LKA,Sabah,3,3,0
1/02/2020,LKA,Sarawak,16,13,3
1/02/2020,LKA,Selangor,2922,1964,958
1/02/2020,LKA,W.P. Labuan,0,0,0
1/02/2020,Lesotho,Johor,0,0,0
1/02/2020,Lesotho,Kedah,0,0,0
1/02/2020,Lesotho,Pulau Pinang,0,0,0
1/02/2020,Lesotho,Sarawak,0,0,0
1/02/2020,Lesotho,Selangor,5,2,3
1/02/2020,Lithuania,Johor,132,62,70
1/02/2020,Lithuania,Kedah,45,23,22
1/02/2020,Lithuania,Kelantan,0,0,0
1/02/2020,Lithuania,Pahang,0,0,0
1/02/2020,Lithuania,Perak,10,1,9
1/02/2020,Lithuania,Perlis,3,3,0
1/02/2020,Lithuania,Pulau Pinang,8,5,3
1/02/2020,Lithuania,Sabah,13,7,6
1/02/2020,Lithuania,Sarawak,8,3,5
1/02/2020,Lithuania,Selangor,399,210,189
1/02/2020,Lithuania,W.P. Labuan,2,2,0
1/02/2020,Luxembourg,Johor,9,4,5
1/02/2020,Luxembourg,Kedah,4,0,4
1/02/2020,Luxembourg,Kelantan,0,0,0
1/02/2020,Luxembourg,Perak,1,1,0
1/02/2020,Luxembourg,Perlis,0,0,0
1/02/2020,Luxembourg,Pulau Pinang,1,1,0
1/02/2020,Luxembourg,Sabah,1,1,0
1/02/2020,Luxembourg,Sarawak,0,0,0
1/02/2020,Luxembourg,Selangor,41,26,15
1/02/2020,Latvia,Johor,105,41,64
1/02/2020,Latvia,Kedah,21,6,15
1/02/2020,Latvia,Kelantan,0,0,0
1/02/2020,Latvia,Pahang,0,0,0
1/02/2020,Latvia,Perak,0,0,0
1/02/2020,Latvia,Perlis,6,5,1
1/02/2020,Latvia,Pulau Pinang,11,7,4
1/02/2020,Latvia,Sabah,1,0,1
1/02/2020,Latvia,Sarawak,3,1,2
1/02/2020,Latvia,Selangor,191,89,102
1/02/2020,Latvia,W.P. Labuan,0,0,0
1/02/2020,Macao,Johor,0,0,0
1/02/2020,Macao,Pahang,0,0,0
1/02/2020,Macao,Perak,0,0,0
1/02/2020,Macao,Selangor,0,0,0
1/02/2020,Macao,W.P. Labuan,0,0,0
1/02/2020,Morocco,Johor,54,36,18
1/02/2020,Morocco,Kedah,23,9,14
1/02/2020,Morocco,Kelantan,5,4,1
1/02/2020,Morocco,Melaka,0,0,0
1/02/2020,Morocco,Pahang,0,0,0
1/02/2020,Morocco,Perak,1,0,1
1/02/2020,Morocco,Perlis,2,2,0
1/02/2020,Morocco,Pulau Pinang,7,2,5
1/02/2020,Morocco,Sabah,6,4,2
1/02/2020,Morocco,Sarawak,3,1,2
1/02/2020,Morocco,Selangor,870,474,396
1/02/2020,Morocco,W.P. Labuan,0,0,0
1/02/2020,Monaco,Johor,0,0,0
1/02/2020,Monaco,Kedah,1,1,0
1/02/2020,Monaco,Sabah,0,0,0
1/02/2020,Monaco,Selangor,5,1,4
1/02/2020,"Moldova, Republic of",Johor,5,2,3
1/02/2020,"Moldova, Republic of",Kedah,7,4,3
1/02/2020,"Moldova, Republic of",Kelantan,1,0,1
1/02/2020,"Moldova, Republic of",Negeri Sembilan,0,0,0
1/02/2020,"Moldova, Republic of",Perlis,0,0,0
1/02/2020,"Moldova, Republic of",Pulau Pinang,1,0,1
1/02/2020,"Moldova, Republic of",Sabah,0,0,0
1/02/2020,"Moldova, Republic of",Sarawak,0,0,0
1/02/2020,"Moldova, Republic of",Selangor,33,17,16
1/02/2020,Madagascar,Johor,5,1,4
1/02/2020,Madagascar,Kedah,0,0,0
1/02/2020,Madagascar,Perak,0,0,0
1/02/2020,Madagascar,Perlis,0,0,0
1/02/2020,Madagascar,Pulau Pinang,2,1,1
1/02/2020,Madagascar,Sabah,2,1,1
1/02/2020,Madagascar,Sarawak,0,0,0
1/02/2020,Madagascar,Selangor,29,16,13
1/02/2020,Maldives,Johor,46,35,11
1/02/2020,Maldives,Kedah,1,1,0
1/02/2020,Maldives,Kelantan,0,0,0
1/02/2020,Maldives,Perak,0,0,0
1/02/2020,Maldives,Perlis,0,0,0
1/02/2020,Maldives,Pulau Pinang,4,2,2
1/02/2020,Maldives,Sabah,1,1,0
1/02/2020,Maldives,Sarawak,0,0,0
1/02/2020,Maldives,Selangor,1320,755,565
1/02/2020,Mexico,Johor,75,41,34
1/02/2020,Mexico,Kedah,8,4,4
1/02/2020,Mexico,Kelantan,1,1,0
1/02/2020,Mexico,Pahang,0,0,0
1/02/2020,Mexico,Perak,0,0,0
1/02/2020,Mexico,Perlis,4,3,1
1/02/2020,Mexico,Pulau Pinang,8,5,3
1/02/2020,Mexico,Sabah,6,2,4
1/02/2020,Mexico,Sarawak,4,1,3
1/02/2020,Mexico,Selangor,396,203,193
1/02/2020,Mexico,W.P. Labuan,1,1,0
1/02/2020,Marshall Islands,Johor,0,0,0
1/02/2020,Marshall Islands,Kedah,0,0,0
1/02/2020,Marshall Islands,Perak,0,0,0
1/02/2020,Marshall Islands,Pulau Pinang,0,0,0
1/02/2020,Marshall Islands,Sabah,0,0,0
1/02/2020,Marshall Islands,Selangor,4,2,2
1/02/2020,North Macedonia,Johor,20,12,8
1/02/2020,North Macedonia,Kedah,2,2,0
1/02/2020,North Macedonia,Perak,0,0,0
1/02/2020,North Macedonia,Pulau Pinang,0,0,0
1/02/2020,North Macedonia,Sabah,0,0,0
1/02/2020,North Macedonia,Sarawak,0,0,0
1/02/2020,North Macedonia,Selangor,48,30,18
1/02/2020,Mali,Johor,1,1,0
1/02/2020,Mali,Sabah,0,0,0
1/02/2020,Mali,Selangor,5,5,0
1/02/2020,Malta,Johor,4,3,1
1/02/2020,Malta,Kedah,10,7,3
1/02/2020,Malta,Kelantan,0,0,0
1/02/2020,Malta,Perak,0,0,0
1/02/2020,Malta,Perlis,0,0,0
1/02/2020,Malta,Pulau Pinang,2,2,0
1/02/2020,Malta,Sabah,2,1,1
1/02/2020,Malta,Sarawak,0,0,0
1/02/2020,Malta,Selangor,36,25,11
1/02/2020,Malta,W.P. Labuan,0,0,0
1/02/2020,Myanmar,Johor,2196,755,1441
1/02/2020,Myanmar,Kedah,38,32,6
1/02/2020,Myanmar,Kelantan,2,0,2
1/02/2020,Myanmar,Negeri Sembilan,0,0,0
1/02/2020,Myanmar,Pahang,5,4,1
1/02/2020,Myanmar,Perak,7,1,6
1/02/2020,Myanmar,Perlis,4,0,4
1/02/2020,Myanmar,Pulau Pinang,349,270,79
1/02/2020,Myanmar,Sabah,6,4,2
1/02/2020,Myanmar,Sarawak,45,32,13
1/02/2020,Myanmar,Selangor,10268,7840,2428
1/02/2020,Myanmar,Terengganu,0,0,0
1/02/2020,Myanmar,W.P. Labuan,5,3,2
1/02/2020,Montenegro,Johor,5,5,0
1/02/2020,Montenegro,Kedah,0,0,0
1/02/2020,Montenegro,Pulau Pinang,0,0,0
1/02/2020,Montenegro,Sabah,3,2,1
1/02/2020,Montenegro,Sarawak,0,0,0
1/02/2020,Montenegro,Selangor,20,10,10
1/02/2020,Mongolia,Johor,56,19,37
1/02/2020,Mongolia,Kedah,20,2,18
1/02/2020,Mongolia,Kelantan,0,0,0
1/02/2020,Mongolia,Perak,0,0,0
1/02/2020,Mongolia,Perlis,3,0,3
1/02/2020,Mongolia,Pulau Pinang,2,0,2
1/02/2020,Mongolia,Sabah,2,0,2
1/02/2020,Mongolia,Sarawak,2,1,1
1/02/2020,Mongolia,Selangor,215,93,122
1/02/2020,Northern Mariana Islands,Selangor,0,0,0
1/02/2020,Mozambique,Johor,0,0,0
1/02/2020,Mozambique,Kedah,0,0,0
1/02/2020,Mozambique,Perak,0,0,0
1/02/2020,Mozambique,Pulau Pinang,0,0,0
1/02/2020,Mozambique,Sabah,0,0,0
1/02/2020,Mozambique,Sarawak,0,0,0
1/02/2020,Mozambique,Selangor,18,13,5
1/02/2020,Mauritania,Johor,0,0,0
1/02/2020,Mauritania,Kedah,0,0,0
1/02/2020,Mauritania,Pulau Pinang,0,0,0
1/02/2020,Mauritania,Sabah,0,0,0
1/02/2020,Mauritania,Sarawak,0,0,0
1/02/2020,Mauritania,Selangor,26,25,1
1/02/2020,Mauritius,Johor,57,38,19
1/02/2020,Mauritius,Kedah,1,0,1
1/02/2020,Mauritius,Kelantan,0,0,0
1/02/2020,Mauritius,Pahang,0,0,0
1/02/2020,Mauritius,Perak,0,0,0
1/02/2020,Mauritius,Perlis,0,0,0
1/02/2020,Mauritius,Pulau Pinang,6,3,3
1/02/2020,Mauritius,Sabah,1,1,0
1/02/2020,Mauritius,Sarawak,1,1,0
1/02/2020,Mauritius,Selangor,543,271,272
1/02/2020,Malawi,Johor,1,1,0
1/02/2020,Malawi,Pulau Pinang,1,1,0
1/02/2020,Malawi,Sabah,0,0,0
1/02/2020,Malawi,Sarawak,0,0,0
1/02/2020,Malawi,Selangor,20,14,6
1/02/2020,Mayotte,Selangor,0,0,0
1/02/2020,Namibia,Johor,2,1,1
1/02/2020,Namibia,Kedah,0,0,0
1/02/2020,Namibia,Perak,0,0,0
1/02/2020,Namibia,Perlis,0,0,0
1/02/2020,Namibia,Pulau Pinang,0,0,0
1/02/2020,Namibia,Sabah,0,0,0
1/02/2020,Namibia,Sarawak,0,0,0
1/02/2020,Namibia,Selangor,19,9,10
1/02/2020,New Caledonia,Selangor,0,0,0
1/02/2020,Niger,Johor,0,0,0
1/02/2020,Niger,Sabah,0,0,0
1/02/2020,Niger,Selangor,5,3,2
1/02/2020,Nigeria,Johor,19,19,0
1/02/2020,Nigeria,Kedah,0,0,0
1/02/2020,Nigeria,Perlis,0,0,0
1/02/2020,Nigeria,Pulau Pinang,13,10,3
1/02/2020,Nigeria,Sabah,0,0,0
1/02/2020,Nigeria,Sarawak,9,8,1
1/02/2020,Nigeria,Selangor,763,658,105
1/02/2020,Nicaragua,Johor,0,0,0
1/02/2020,Nicaragua,Kedah,0,0,0
1/02/2020,Nicaragua,Pulau Pinang,0,0,0
1/02/2020,Nicaragua,Sabah,1,0,1
1/02/2020,Nicaragua,Selangor,9,7,2
1/02/2020,Netherlands,Johor,844,551,293
1/02/2020,Netherlands,Kedah,405,188,217
1/02/2020,Netherlands,Kelantan,7,3,4
1/02/2020,Netherlands,Melaka,9,5,4
1/02/2020,Netherlands,Negeri Sembilan,0,0,0
1/02/2020,Netherlands,Pahang,1,1,0
1/02/2020,Netherlands,Perak,15,10,5
1/02/2020,Netherlands,Perlis,57,35,22
1/02/2020,Netherlands,Pulau Pinang,217,141,76
1/02/2020,Netherlands,Sabah,98,53,45
1/02/2020,Netherlands,Sarawak,246,141,105
1/02/2020,Netherlands,Selangor,4428,2686,1742
1/02/2020,Netherlands,Terengganu,0,0,0
1/02/2020,Netherlands,W.P. Labuan,16,9,7
1/02/2020,Norway,Johor,224,117,107
1/02/2020,Norway,Kedah,198,98,100
1/02/2020,Norway,Kelantan,2,1,1
1/02/2020,Norway,Melaka,0,0,0
1/02/2020,Norway,Pahang,1,1,0
1/02/2020,Norway,Perak,5,3,2
1/02/2020,Norway,Perlis,21,11,10
1/02/2020,Norway,Pulau Pinang,79,47,32
1/02/2020,Norway,Sabah,18,13,5
1/02/2020,Norway,Sarawak,42,30,12
1/02/2020,Norway,Selangor,1157,678,479
1/02/2020,Norway,W.P. Labuan,1,1,0
1/02/2020,Nepal,Johor,353,279,74
1/02/2020,Nepal,Kedah,1,1,0
1/02/2020,Nepal,Pahang,0,0,0
1/02/2020,Nepal,Perak,0,0,0
1/02/2020,Nepal,Perlis,1,1,0
1/02/2020,Nepal,Pulau Pinang,85,80,5
1/02/2020,Nepal,Sabah,15,15,0
1/02/2020,Nepal,Sarawak,138,100,38
1/02/2020,Nepal,Selangor,11932,11466,466
1/02/2020,Nepal,W.P. Labuan,100,84,16
1/02/2020,Nauru,Johor,0,0,0
1/02/2020,Nauru,Pulau Pinang,1,1,0
1/02/2020,Nauru,Selangor,1,1,0
1/02/2020,New Zealand,Johor,561,384,177
1/02/2020,New Zealand,Kedah,90,59,31
1/02/2020,New Zealand,Kelantan,2,1,1
1/02/2020,New Zealand,Melaka,0,0,0
1/02/2020,New Zealand,Negeri Sembilan,0,0,0
1/02/2020,New Zealand,Pahang,3,3,0
1/02/2020,New Zealand,Perak,9,5,4
1/02/2020,New Zealand,Perlis,16,11,5
1/02/2020,New Zealand,Pulau Pinang,155,93,62
1/02/2020,New Zealand,Sabah,50,27,23
1/02/2020,New Zealand,Sarawak,103,70,33
1/02/2020,New Zealand,Selangor,2047,1259,788
1/02/2020,New Zealand,Terengganu,0,0,0
1/02/2020,New Zealand,W.P. Labuan,7,6,1
1/02/2020,Oman,Johor,4,2,2
1/02/2020,Oman,Kedah,3,2,1
1/02/2020,Oman,Kelantan,0,0,0
1/02/2020,Oman,Melaka,0,0,0
1/02/2020,Oman,Perak,0,0,0
1/02/2020,Oman,Perlis,0,0,0
1/02/2020,Oman,Pulau Pinang,7,4,3
1/02/2020,Oman,Sabah,1,1,0
1/02/2020,Oman,Sarawak,38,21,17
1/02/2020,Oman,Selangor,737,481,256
1/02/2020,Pakistan,Johor,748,595,153
1/02/2020,Pakistan,Kedah,65,44,21
1/02/2020,Pakistan,Kelantan,9,9,0
1/02/2020,Pakistan,Melaka,0,0,0
1/02/2020,Pakistan,Negeri Sembilan,0,0,0
1/02/2020,Pakistan,Pahang,1,1,0
1/02/2020,Pakistan,Perak,2,2,0
1/02/2020,Pakistan,Perlis,22,16,6
1/02/2020,Pakistan,Pulau Pinang,45,41,4
1/02/2020,Pakistan,Sabah,22,20,2
1/02/2020,Pakistan,Sarawak,371,352,19
1/02/2020,Pakistan,Selangor,13424,11655,1769
1/02/2020,Pakistan,W.P. Labuan,23,23,0
1/02/2020,Panama,Johor,4,3,1
1/02/2020,Panama,Kedah,1,1,0
1/02/2020,Panama,Perak,0,0,0
1/02/2020,Panama,Perlis,0,0,0
1/02/2020,Panama,Pulau Pinang,0,0,0
1/02/2020,Panama,Sabah,1,0,1
1/02/2020,Panama,Sarawak,0,0,0
1/02/2020,Panama,Selangor,33,13,20
1/02/2020,Peru,Johor,28,14,14
1/02/2020,Peru,Kedah,6,2,4
1/02/2020,Peru,Kelantan,1,0,1
1/02/2020,Peru,Pahang,0,0,0
1/02/2020,Peru,Perak,0,0,0
1/02/2020,Peru,Perlis,0,0,0
1/02/2020,Peru,Pulau Pinang,7,3,4
1/02/2020,Peru,Sabah,5,2,3
1/02/2020,Peru,Sarawak,1,1,0
1/02/2020,Peru,Selangor,147,77,70
1/02/2020,Peru,W.P. Labuan,1,0,1
1/02/2020,Philippines,Johor,12116,3987,8129
1/02/2020,Philippines,Kedah,1096,374,722
1/02/2020,Philippines,Kelantan,59,25,34
1/02/2020,Philippines,Melaka,0,0,0
1/02/2020,Philippines,Negeri Sembilan,0,0,0
1/02/2020,Philippines,Pahang,18,16,2
1/02/2020,Philippines,Perak,38,10,28
1/02/2020,Philippines,Perlis,199,66,133
1/02/2020,Philippines,Pulau Pinang,348,134,214
1/02/2020,Philippines,Sabah,2134,1072,1062
1/02/2020,Philippines,Sarawak,2850,1232,1618
1/02/2020,Philippines,Selangor,13027,5783,7244
1/02/2020,Philippines,Terengganu,0,0,0
1/02/2020,Philippines,W.P. Labuan,193,84,109
1/02/2020,Palau,Johor,0,0,0
1/02/2020,Palau,Pulau Pinang,0,0,0
1/02/2020,Palau,Selangor,0,0,0
1/02/2020,Papua New Guinea,Johor,8,5,3
1/02/2020,Papua New Guinea,Kedah,0,0,0
1/02/2020,Papua New Guinea,Kelantan,0,0,0
1/02/2020,Papua New Guinea,Perak,0,0,0
1/02/2020,Papua New Guinea,Pulau Pinang,1,0,1
1/02/2020,Papua New Guinea,Sabah,4,2,2
1/02/2020,Papua New Guinea,Sarawak,3,1,2
1/02/2020,Papua New Guinea,Selangor,51,31,20
1/02/2020,Poland,Johor,643,348,295
1/02/2020,Poland,Kedah,431,216,215
1/02/2020,Poland,Kelantan,10,3,7
1/02/2020,Poland,Melaka,0,0,0
1/02/2020,Poland,Negeri Sembilan,0,0,0
1/02/2020,Poland,Pahang,0,0,0
1/02/2020,Poland,Perak,5,2,3
1/02/2020,Poland,Perlis,52,29,23
1/02/2020,Poland,Pulau Pinang,133,60,73
1/02/2020,Poland,Sabah,105,55,50
1/02/2020,Poland,Sarawak,106,59,47
1/02/2020,Poland,Selangor,1844,997,847
1/02/2020,Poland,Terengganu,0,0,0
1/02/2020,Poland,W.P. Labuan,5,3,2
1/02/2020,"North Korea, Democratic People's Republic of",Selangor,5,4,1
1/02/2020,Portugal,Johor,163,78,85
1/02/2020,Portugal,Kedah,69,39,30
1/02/2020,Portugal,Kelantan,4,2,2
1/02/2020,Portugal,Melaka,0,0,0
1/02/2020,Portugal,Pahang,0,0,0
1/02/2020,Portugal,Perak,1,0,1
1/02/2020,Portugal,Perlis,6,5,1
1/02/2020,Portugal,Pulau Pinang,12,4,8
1/02/2020,Portugal,Sabah,13,9,4
1/02/2020,Portugal,Sarawak,10,7,3
1/02/2020,Portugal,Selangor,479,284,195
1/02/2020,Portugal,W.P. Labuan,1,0,1
1/02/2020,Paraguay,Johor,2,1,1
1/02/2020,Paraguay,Kedah,2,2,0
1/02/2020,Paraguay,Perak,0,0,0
1/02/2020,Paraguay,Perlis,1,1,0
1/02/2020,Paraguay,Pulau Pinang,0,0,0
1/02/2020,Paraguay,Sabah,0,0,0
1/02/2020,Paraguay,Sarawak,0,0,0
1/02/2020,Paraguay,Selangor,9,3,6
1/02/2020,"Palestine, State of",Johor,14,8,6
1/02/2020,"Palestine, State of",Kedah,1,0,1
1/02/2020,"Palestine, State of",Kelantan,0,0,0
1/02/2020,"Palestine, State of",Melaka,0,0,0
1/02/2020,"Palestine, State of",Perak,0,0,0
1/02/2020,"Palestine, State of",Perlis,0,0,0
1/02/2020,"Palestine, State of",Pulau Pinang,5,3,2
1/02/2020,"Palestine, State of",Sabah,1,1,0
1/02/2020,"Palestine, State of",Sarawak,3,3,0
1/02/2020,"Palestine, State of",Selangor,408,332,76
1/02/2020,Qatar,Johor,3,1,2
1/02/2020,Qatar,Kedah,5,4,1
1/02/2020,Qatar,Perlis,0,0,0
1/02/2020,Qatar,Pulau Pinang,1,1,0
1/02/2020,Qatar,Sabah,0,0,0
1/02/2020,Qatar,Sarawak,0,0,0
1/02/2020,Qatar,Selangor,70,51,19
1/02/2020,Réunion,Johor,0,0,0
1/02/2020,Réunion,Sarawak,0,0,0
1/02/2020,Romania,Johor,98,57,41
1/02/2020,Romania,Kedah,131,68,63
1/02/2020,Romania,Kelantan,3,1,2
1/02/2020,Romania,Negeri Sembilan,0,0,0
1/02/2020,Romania,Pahang,0,0,0
1/02/2020,Romania,Perak,2,0,2
1/02/2020,Romania,Perlis,3,2,1
1/02/2020,Romania,Pulau Pinang,16,8,8
1/02/2020,Romania,Sabah,6,4,2
1/02/2020,Romania,Sarawak,6,4,2
1/02/2020,Romania,Selangor,638,352,286
1/02/2020,Romania,W.P. Labuan,0,0,0
1/02/2020,Russian Federation (Russia),Johor,439,281,158
1/02/2020,Russian Federation (Russia),Kedah,1215,537,678
1/02/2020,Russian Federation (Russia),Kelantan,143,61,82
1/02/2020,Russian Federation (Russia),Melaka,2,2,0
1/02/2020,Russian Federation (Russia),Negeri Sembilan,0,0,0
1/02/2020,Russian Federation (Russia),Pahang,4,4,0
1/02/2020,Russian Federation (Russia),Perak,7,3,4
1/02/2020,Russian Federation (Russia),Perlis,354,168,186
1/02/2020,Russian Federation (Russia),Pulau Pinang,135,62,73
1/02/2020,Russian Federation (Russia),Sabah,102,42,60
1/02/2020,Russian Federation (Russia),Sarawak,73,37,36
1/02/2020,Russian Federation (Russia),Selangor,10284,4766,5518
1/02/2020,Russian Federation (Russia),W.P. Labuan,22,6,16
1/02/2020,Rwanda,Johor,0,0,0
1/02/2020,Rwanda,Kedah,0,0,0
1/02/2020,Rwanda,Pulau Pinang,0,0,0
1/02/2020,Rwanda,Selangor,4,3,1
1/02/2020,Saudi Arabia,Johor,53,40,13
1/02/2020,Saudi Arabia,Kedah,8,7,1
1/02/2020,Saudi Arabia,Kelantan,3,1,2
1/02/2020,Saudi Arabia,Melaka,0,0,0
1/02/2020,Saudi Arabia,Perak,0,0,0
1/02/2020,Saudi Arabia,Perlis,0,0,0
1/02/2020,Saudi Arabia,Pulau Pinang,15,10,5
1/02/2020,Saudi Arabia,Sabah,2,1,1
1/02/2020,Saudi Arabia,Sarawak,2,2,0
1/02/2020,Saudi Arabia,Selangor,3685,2229,1456
1/02/2020,Saudi Arabia,W.P. Labuan,1,1,0
1/02/2020,Sudan,Johor,12,11,1
1/02/2020,Sudan,Kedah,1,1,0
1/02/2020,Sudan,Kelantan,0,0,0
1/02/2020,Sudan,Perlis,0,0,0
1/02/2020,Sudan,Pulau Pinang,0,0,0
1/02/2020,Sudan,Sabah,2,2,0
1/02/2020,Sudan,Sarawak,1,1,0
1/02/2020,Sudan,Selangor,1083,714,369
1/02/2020,Sudan,W.P. Labuan,0,0,0
1/02/2020,Senegal,Johor,1,1,0
1/02/2020,Senegal,Kedah,0,0,0
1/02/2020,Senegal,Kelantan,0,0,0
1/02/2020,Senegal,Perak,0,0,0
1/02/2020,Senegal,Perlis,0,0,0
1/02/2020,Senegal,Pulau Pinang,1,1,0
1/02/2020,Senegal,Sabah,0,0,0
1/02/2020,Senegal,Sarawak,1,0,1
1/02/2020,Senegal,Selangor,61,46,15
1/02/2020,Singapore,Johor,887821,557719,330102
1/02/2020,Singapore,Kedah,1332,834,498
1/02/2020,Singapore,Kelantan,147,87,60
1/02/2020,Singapore,Melaka,13,11,2
1/02/2020,Singapore,Negeri Sembilan,1,1,0
1/02/2020,Singapore,Pahang,236,135,101
1/02/2020,Singapore,Perak,2223,1107,1116
1/02/2020,Singapore,Perlis,56,40,16
1/02/2020,Singapore,Pulau Pinang,5711,3166,2545
1/02/2020,Singapore,Sabah,943,547,396
1/02/2020,Singapore,Sarawak,1686,1036,650
1/02/2020,Singapore,Selangor,20083,12332,7751
1/02/2020,Singapore,Terengganu,0,0,0
1/02/2020,Singapore,W.P. Labuan,25,21,4
1/02/2020,South Georgia and the South Sandwich Islands,Johor,0,0,0
1/02/2020,South Georgia and the South Sandwich Islands,Sabah,0,0,0
1/02/2020,South Georgia and the South Sandwich Islands,Selangor,0,0,0
1/02/2020,Saint Helena,Sarawak,0,0,0
1/02/2020,Solomon Islands,Johor,1,1,0
1/02/2020,Solomon Islands,Perlis,0,0,0
1/02/2020,Solomon Islands,Pulau Pinang,0,0,0
1/02/2020,Solomon Islands,Sabah,2,0,2
1/02/2020,Solomon Islands,Sarawak,4,2,2
1/02/2020,Solomon Islands,Selangor,1,1,0
1/02/2020,Solomon Islands,W.P. Labuan,0,0,0
1/02/2020,Sierra Leone,Johor,1,1,0
1/02/2020,Sierra Leone,Kedah,0,0,0
1/02/2020,Sierra Leone,Perak,0,0,0
1/02/2020,Sierra Leone,Pulau Pinang,3,2,1
1/02/2020,Sierra Leone,Sabah,0,0,0
1/02/2020,Sierra Leone,Selangor,39,27,12
1/02/2020,El Salvador,Johor,1,1,0
1/02/2020,El Salvador,Kedah,0,0,0
1/02/2020,El Salvador,Perak,0,0,0
1/02/2020,El Salvador,Perlis,0,0,0
1/02/2020,El Salvador,Pulau Pinang,2,0,2
1/02/2020,El Salvador,Sabah,1,0,1
1/02/2020,El Salvador,Selangor,17,8,9
1/02/2020,El Salvador,W.P. Labuan,1,0,1
1/02/2020,San Marino,Johor,0,0,0
1/02/2020,San Marino,Selangor,4,3,1
1/02/2020,Somalia,Johor,2,0,2
1/02/2020,Somalia,Kedah,0,0,0
1/02/2020,Somalia,Kelantan,0,0,0
1/02/2020,Somalia,Perlis,0,0,0
1/02/2020,Somalia,Sabah,1,0,1
1/02/2020,Somalia,Sarawak,0,0,0
1/02/2020,Somalia,Selangor,354,245,109
1/02/2020,Serbia,Johor,9,8,1
1/02/2020,Serbia,Kedah,7,7,0
1/02/2020,Serbia,Kelantan,0,0,0
1/02/2020,Serbia,Pahang,0,0,0
1/02/2020,Serbia,Perak,0,0,0
1/02/2020,Serbia,Perlis,0,0,0
1/02/2020,Serbia,Pulau Pinang,3,2,1
1/02/2020,Serbia,Sabah,0,0,0
1/02/2020,Serbia,Sarawak,0,0,0
1/02/2020,Serbia,Selangor,96,51,45
1/02/2020,South Sudan,Johor,2,2,0
1/02/2020,South Sudan,Kedah,0,0,0
1/02/2020,South Sudan,Sarawak,0,0,0
1/02/2020,South Sudan,Selangor,12,9,3
1/02/2020,South Sudan,W.P. Labuan,0,0,0
1/02/2020,Sao Tome and Principe,Selangor,2,2,0
1/02/2020,Suriname,Johor,4,2,2
1/02/2020,Suriname,Kedah,0,0,0
1/02/2020,Suriname,Kelantan,0,0,0
1/02/2020,Suriname,Perak,0,0,0
1/02/2020,Suriname,Perlis,0,0,0
1/02/2020,Suriname,Pulau Pinang,0,0,0
1/02/2020,Suriname,Sabah,0,0,0
1/02/2020,Suriname,Sarawak,0,0,0
1/02/2020,Suriname,Selangor,4,3,1
1/02/2020,Slovakia,Johor,42,27,15
1/02/2020,Slovakia,Kedah,273,132,141
1/02/2020,Slovakia,Kelantan,3,3,0
1/02/2020,Slovakia,Negeri Sembilan,0,0,0
1/02/2020,Slovakia,Pahang,0,0,0
1/02/2020,Slovakia,Perak,1,1,0
1/02/2020,Slovakia,Perlis,4,3,1
1/02/2020,Slovakia,Pulau Pinang,69,29,40
1/02/2020,Slovakia,Sabah,13,7,6
1/02/2020,Slovakia,Sarawak,3,3,0
1/02/2020,Slovakia,Selangor,542,279,263
1/02/2020,Slovakia,W.P. Labuan,3,2,1
1/02/2020,Slovenia,Johor,19,12,7
1/02/2020,Slovenia,Kedah,65,32,33
1/02/2020,Slovenia,Kelantan,0,0,0
1/02/2020,Slovenia,Perak,0,0,0
1/02/2020,Slovenia,Perlis,2,2,0
1/02/2020,Slovenia,Pulau Pinang,6,4,2
1/02/2020,Slovenia,Sabah,11,4,7
1/02/2020,Slovenia,Sarawak,1,0,1
1/02/2020,Slovenia,Selangor,281,158,123
1/02/2020,Slovenia,W.P. Labuan,0,0,0
1/02/2020,Sweden,Johor,329,196,133
1/02/2020,Sweden,Kedah,876,395,481
1/02/2020,Sweden,Kelantan,14,12,2
1/02/2020,Sweden,Melaka,0,0,0
1/02/2020,Sweden,Negeri Sembilan,0,0,0
1/02/2020,Sweden,Pahang,4,2,2
1/02/2020,Sweden,Perak,10,7,3
1/02/2020,Sweden,Perlis,37,29,8
1/02/2020,Sweden,Pulau Pinang,103,64,39
1/02/2020,Sweden,Sabah,60,28,32
1/02/2020,Sweden,Sarawak,45,28,17
1/02/2020,Sweden,Selangor,2478,1387,1091
1/02/2020,Sweden,W.P. Labuan,4,0,4
1/02/2020,Eswatini,Johor,0,0,0
1/02/2020,Eswatini,Kedah,0,0,0
1/02/2020,Eswatini,Pulau Pinang,0,0,0
1/02/2020,Eswatini,Sabah,0,0,0
1/02/2020,Eswatini,Selangor,6,5,1
1/02/2020,Seychelles,Johor,5,3,2
1/02/2020,Seychelles,Kedah,1,1,0
1/02/2020,Seychelles,Pulau Pinang,0,0,0
1/02/2020,Seychelles,Sabah,0,0,0
1/02/2020,Seychelles,Sarawak,0,0,0
1/02/2020,Seychelles,Selangor,70,36,34
1/02/2020,Syrian Arab Republic,Johor,12,10,2
1/02/2020,Syrian Arab Republic,Kedah,2,2,0
1/02/2020,Syrian Arab Republic,Kelantan,0,0,0
1/02/2020,Syrian Arab Republic,Pahang,0,0,0
1/02/2020,Syrian Arab Republic,Perlis,1,1,0
1/02/2020,Syrian Arab Republic,Pulau Pinang,6,3,3
1/02/2020,Syrian Arab Republic,Sabah,1,1,0
1/02/2020,Syrian Arab Republic,Sarawak,3,1,2
1/02/2020,Syrian Arab Republic,Selangor,760,527,233
1/02/2020,Syrian Arab Republic,W.P. Labuan,0,0,0
1/02/2020,Turks and Caicos Islands,Perlis,0,0,0
1/02/2020,TCD,Johor,0,0,0
1/02/2020,TCD,Kedah,0,0,0
1/02/2020,TCD,Perlis,0,0,0
1/02/2020,TCD,Selangor,26,23,3
1/02/2020,Togo,Johor,1,1,0
1/02/2020,Togo,Perak,0,0,0
1/02/2020,Togo,Pulau Pinang,0,0,0
1/02/2020,Togo,Selangor,8,8,0
1/02/2020,Thailand,Johor,4620,1253,3367
1/02/2020,Thailand,Kedah,41527,14919,26608
1/02/2020,Thailand,Kelantan,36173,19239,16934
1/02/2020,Thailand,Melaka,1,1,0
1/02/2020,Thailand,Negeri Sembilan,2,1,1
1/02/2020,Thailand,Pahang,0,0,0
1/02/2020,Thailand,Perak,11999,5604,6395
1/02/2020,Thailand,Perlis,41747,24293,17454
1/02/2020,Thailand,Pulau Pinang,1171,442,729
1/02/2020,Thailand,Sabah,138,51,87
1/02/2020,Thailand,Sarawak,505,206,299
1/02/2020,Thailand,Selangor,10529,4415,6114
1/02/2020,Thailand,Terengganu,0,0,0
1/02/2020,Thailand,W.P. Labuan,18,5,13
1/02/2020,Tajikistan,Johor,0,0,0
1/02/2020,Tajikistan,Kedah,5,4,1
1/02/2020,Tajikistan,Perlis,0,0,0
1/02/2020,Tajikistan,Pulau Pinang,1,0,1
1/02/2020,Tajikistan,Sabah,0,0,0
1/02/2020,Tajikistan,Selangor,106,84,22
1/02/2020,Tokelau,Selangor,0,0,0
1/02/2020,Turkmenistan,Johor,0,0,0
1/02/2020,Turkmenistan,Kedah,3,2,1
1/02/2020,Turkmenistan,Kelantan,0,0,0
1/02/2020,Turkmenistan,Perlis,0,0,0
1/02/2020,Turkmenistan,Pulau Pinang,0,0,0
1/02/2020,Turkmenistan,Sabah,0,0,0
1/02/2020,Turkmenistan,Sarawak,0,0,0
1/02/2020,Turkmenistan,Selangor,91,61,30
1/02/2020,Timor-Leste,Johor,3,1,2
1/02/2020,Timor-Leste,Kedah,0,0,0
1/02/2020,Timor-Leste,Perlis,0,0,0
1/02/2020,Timor-Leste,Pulau Pinang,1,1,0
1/02/2020,Timor-Leste,Sabah,0,0,0
1/02/2020,Timor-Leste,Sarawak,1,1,0
1/02/2020,Timor-Leste,Selangor,86,57,29
1/02/2020,Tonga,Johor,0,0,0
1/02/2020,Tonga,Pulau Pinang,1,1,0
1/02/2020,Tonga,Sarawak,0,0,0
1/02/2020,Tonga,Selangor,7,5,2
1/02/2020,Trinidad and Tobago,Johor,15,14,1
1/02/2020,Trinidad and Tobago,Kedah,0,0,0
1/02/2020,Trinidad and Tobago,Pahang,0,0,0
1/02/2020,Trinidad and Tobago,Pulau Pinang,2,1,1
1/02/2020,Trinidad and Tobago,Sabah,0,0,0
1/02/2020,Trinidad and Tobago,Sarawak,0,0,0
1/02/2020,Trinidad and Tobago,Selangor,25,16,9
1/02/2020,Tunisia,Johor,7,5,2
1/02/2020,Tunisia,Kedah,14,12,2
1/02/2020,Tunisia,Kelantan,0,0,0
1/02/2020,Tunisia,Melaka,0,0,0
1/02/2020,Tunisia,Perak,0,0,0
1/02/2020,Tunisia,Perlis,0,0,0
1/02/2020,Tunisia,Pulau Pinang,9,5,4
1/02/2020,Tunisia,Sabah,1,0,1
1/02/2020,Tunisia,Sarawak,0,0,0
1/02/2020,Tunisia,Selangor,289,164,125
1/02/2020,Tunisia,W.P. Labuan,0,0,0
1/02/2020,Türkiye,Johor,259,179,80
1/02/2020,Türkiye,Kedah,50,37,13
1/02/2020,Türkiye,Kelantan,4,4,0
1/02/2020,Türkiye,Melaka,0,0,0
1/02/2020,Türkiye,Negeri Sembilan,0,0,0
1/02/2020,Türkiye,Pahang,0,0,0
1/02/2020,Türkiye,Perak,1,1,0
1/02/2020,Türkiye,Perlis,17,15,2
1/02/2020,Türkiye,Pulau Pinang,13,9,4
1/02/2020,Türkiye,Sabah,13,10,3
1/02/2020,Türkiye,Sarawak,21,19,2
1/02/2020,Türkiye,Selangor,926,663,263
1/02/2020,Türkiye,W.P. Labuan,2,2,0
1/02/2020,Tuvalu,Selangor,0,0,0
1/02/2020,"Taiwan, Province of China",Johor,5036,2173,2863
1/02/2020,"Taiwan, Province of China",Kedah,171,95,76
1/02/2020,"Taiwan, Province of China",Kelantan,3,2,1
1/02/2020,"Taiwan, Province of China",Melaka,11,3,8
1/02/2020,"Taiwan, Province of China",Negeri Sembilan,0,0,0
1/02/2020,"Taiwan, Province of China",Pahang,1,0,1
1/02/2020,"Taiwan, Province of China",Perak,24,9,15
1/02/2020,"Taiwan, Province of China",Perlis,9,3,6
1/02/2020,"Taiwan, Province of China",Pulau Pinang,2937,1523,1414
1/02/2020,"Taiwan, Province of China",Sabah,2608,1233,1375
1/02/2020,"Taiwan, Province of China",Sarawak,311,111,200
1/02/2020,"Taiwan, Province of China",Selangor,11217,5789,5428
1/02/2020,"Taiwan, Province of China",W.P. Labuan,14,8,6
1/02/2020,"Tanzania, United Republic of",Johor,9,2,7
1/02/2020,"Tanzania, United Republic of",Kedah,0,0,0
1/02/2020,"Tanzania, United Republic of",Perak,0,0,0
1/02/2020,"Tanzania, United Republic of",Perlis,0,0,0
1/02/2020,"Tanzania, United Republic of",Pulau Pinang,0,0,0
1/02/2020,"Tanzania, United Republic of",Sabah,0,0,0
1/02/2020,"Tanzania, United Republic of",Sarawak,1,1,0
1/02/2020,"Tanzania, United Republic of",Selangor,183,102,81
1/02/2020,Uganda,Johor,29,14,15
1/02/2020,Uganda,Kedah,0,0,0
1/02/2020,Uganda,Perak,0,0,0
1/02/2020,Uganda,Perlis,0,0,0
1/02/2020,Uganda,Pulau Pinang,2,0,2
1/02/2020,Uganda,Sabah,0,0,0
1/02/2020,Uganda,Sarawak,0,0,0
1/02/2020,Uganda,Selangor,63,33,30
1/02/2020,Ukraine,Johor,97,59,38
1/02/2020,Ukraine,Kedah,386,183,203
1/02/2020,Ukraine,Kelantan,22,11,11
1/02/2020,Ukraine,Melaka,0,0,0
1/02/2020,Ukraine,Negeri Sembilan,0,0,0
1/02/2020,Ukraine,Pahang,3,3,0
1/02/2020,Ukraine,Perak,2,1,1
1/02/2020,Ukraine,Perlis,27,13,14
1/02/2020,Ukraine,Pulau Pinang,41,19,22
1/02/2020,Ukraine,Sabah,15,6,9
1/02/2020,Ukraine,Sarawak,28,15,13
1/02/2020,Ukraine,Selangor,2150,1079,1071
1/02/2020,Ukraine,W.P. Labuan,0,0,0
1/02/2020,Uruguay,Johor,8,3,5
1/02/2020,Uruguay,Kedah,1,0,1
1/02/2020,Uruguay,Kelantan,1,0,1
1/02/2020,Uruguay,Perak,0,0,0
1/02/2020,Uruguay,Perlis,1,0,1
1/02/2020,Uruguay,Pulau Pinang,2,0,2
1/02/2020,Uruguay,Sabah,1,1,0
1/02/2020,Uruguay,Sarawak,0,0,0
1/02/2020,Uruguay,Selangor,64,30,34
1/02/2020,Uruguay,W.P. Labuan,0,0,0
1/02/2020,United States of America,Johor,2947,1771,1176
1/02/2020,United States of America,Kedah,566,330,236
1/02/2020,United States of America,Kelantan,30,22,8
1/02/2020,United States of America,Melaka,5,2,3
1/02/2020,United States of America,Negeri Sembilan,0,0,0
1/02/2020,United States of America,Pahang,4,1,3
1/02/2020,United States of America,Perak,68,36,32
1/02/2020,United States of America,Perlis,114,74,40
1/02/2020,United States of America,Pulau Pinang,1199,703,496
1/02/2020,United States of America,Sabah,414,226,188
1/02/2020,United States of America,Sarawak,290,165,125
1/02/2020,United States of America,Selangor,11838,7168,4670
1/02/2020,United States of America,Terengganu,0,0,0
1/02/2020,United States of America,W.P. Labuan,7,5,2
1/02/2020,Uzbekistan,Johor,65,37,28
1/02/2020,Uzbekistan,Kedah,102,25,77
1/02/2020,Uzbekistan,Kelantan,1,0,1
1/02/2020,Uzbekistan,Perak,0,0,0
1/02/2020,Uzbekistan,Perlis,0,0,0
1/02/2020,Uzbekistan,Pulau Pinang,4,0,4
1/02/2020,Uzbekistan,Sabah,3,3,0
1/02/2020,Uzbekistan,Sarawak,5,4,1
1/02/2020,Uzbekistan,Selangor,1107,715,392
1/02/2020,Holy See,Johor,0,0,0
1/02/2020,Holy See,Sarawak,0,0,0
1/02/2020,Holy See,Selangor,2,2,0
1/02/2020,Saint Vincent and the Grenadines,Johor,0,0,0
1/02/2020,Saint Vincent and the Grenadines,Kedah,1,0,1
1/02/2020,Saint Vincent and the Grenadines,Pulau Pinang,0,0,0
1/02/2020,Saint Vincent and the Grenadines,Sarawak,0,0,0
1/02/2020,Saint Vincent and the Grenadines,Selangor,3,3,0
1/02/2020,"Venezuela, Bolivarian Republic of",Johor,24,16,8
1/02/2020,"Venezuela, Bolivarian Republic of",Kedah,1,0,1
1/02/2020,"Venezuela, Bolivarian Republic of",Kelantan,1,1,0
1/02/2020,"Venezuela, Bolivarian Republic of",Melaka,0,0,0
1/02/2020,"Venezuela, Bolivarian Republic of",Perak,0,0,0
1/02/2020,"Venezuela, Bolivarian Republic of",Perlis,0,0,0
1/02/2020,"Venezuela, Bolivarian Republic of",Pulau Pinang,0,0,0
1/02/2020,"Venezuela, Bolivarian Republic of",Sabah,1,1,0
1/02/2020,"Venezuela, Bolivarian Republic of",Sarawak,7,4,3
1/02/2020,"Venezuela, Bolivarian Republic of",Selangor,88,50,38
1/02/2020,"Venezuela, Bolivarian Republic of",W.P. Labuan,0,0,0
1/02/2020,Viet Nam,Johor,8786,2492,6294
1/02/2020,Viet Nam,Kedah,485,34,451
1/02/2020,Viet Nam,Kelantan,28,17,11
1/02/2020,Viet Nam,Melaka,0,0,0
1/02/2020,Viet Nam,Negeri Sembilan,0,0,0
1/02/2020,Viet Nam,Pahang,2,2,0
1/02/2020,Viet Nam,Perak,51,4,47
1/02/2020,Viet Nam,Perlis,93,19,74
1/02/2020,Viet Nam,Pulau Pinang,899,198,701
1/02/2020,Viet Nam,Sabah,34,8,26
1/02/2020,Viet Nam,Sarawak,571,151,420
1/02/2020,Viet Nam,Selangor,17058,5766,11292
1/02/2020,Viet Nam,Terengganu,0,0,0
1/02/2020,Viet Nam,W.P. Labuan,4,3,1
1/02/2020,Vanuatu,Johor,12,10,2
1/02/2020,Vanuatu,Kedah,1,1,0
1/02/2020,Vanuatu,Pulau Pinang,1,1,0
1/02/2020,Vanuatu,Sabah,3,3,0
1/02/2020,Vanuatu,Sarawak,0,0,0
1/02/2020,Vanuatu,Selangor,51,46,5
1/02/2020, Samoa,Johor,0,0,0
1/02/2020, Samoa,Sarawak,0,0,0
1/02/2020, Samoa,Selangor,3,1,2
1/02/2020,Yemen,Johor,44,27,17
1/02/2020,Yemen,Kedah,6,4,2
1/02/2020,Yemen,Kelantan,1,1,0
1/02/2020,Yemen,Melaka,5,3,2
1/02/2020,Yemen,Pahang,0,0,0
1/02/2020,Yemen,Perak,0,0,0
1/02/2020,Yemen,Perlis,2,2,0
1/02/2020,Yemen,Pulau Pinang,12,10,2
1/02/2020,Yemen,Sabah,1,1,0
1/02/2020,Yemen,Sarawak,2,2,0
1/02/2020,Yemen,Selangor,2987,2308,679
1/02/2020,Yemen,W.P. Labuan,0,0,0
1/02/2020,South Africa,Johor,199,132,67
1/02/2020,South Africa,Kedah,67,34,33
1/02/2020,South Africa,Kelantan,18,9,9
1/02/2020,South Africa,Melaka,0,0,0
1/02/2020,South Africa,Pahang,0,0,0
1/02/2020,South Africa,Perak,1,1,0
1/02/2020,South Africa,Perlis,7,5,2
1/02/2020,South Africa,Pulau Pinang,46,30,16
1/02/2020,South Africa,Sabah,11,6,5
1/02/2020,South Africa,Sarawak,71,46,25
1/02/2020,South Africa,Selangor,938,519,419
1/02/2020,South Africa,Terengganu,0,0,0
1/02/2020,South Africa,W.P. Labuan,0,0,0
1/02/2020,ZAR,Selangor,1,0,1
1/02/2020,Zambia,Johor,2,1,1
1/02/2020,Zambia,Kedah,0,0,0
1/02/2020,Zambia,Perak,0,0,0
1/02/2020,Zambia,Perlis,0,0,0
1/02/2020,Zambia,Pulau Pinang,2,1,1
1/02/2020,Zambia,Sabah,0,0,0
1/02/2020,Zambia,Sarawak,1,1,0
1/02/2020,Zambia,Selangor,76,41,35
1/02/2020,Zimbabwe,Johor,33,20,13
1/02/2020,Zimbabwe,Kedah,0,0,0
1/02/2020,Zimbabwe,Kelantan,1,1,0
1/02/2020,Zimbabwe,Perak,0,0,0
1/02/2020,Zimbabwe,Perlis,0,0,0
1/02/2020,Zimbabwe,Pulau Pinang,1,1,0
1/02/2020,Zimbabwe,Sabah,0,0,0
1/02/2020,Zimbabwe,Sarawak,0,0,0
1/02/2020,Zimbabwe,Selangor,134,82,52
1/03/2020,Aruba,Kedah,0,0,0
1/03/2020,Aruba,Pulau Pinang,0,0,0
1/03/2020,Afghanistan,Johor,3,3,0
1/03/2020,Afghanistan,Kedah,0,0,0
1/03/2020,Afghanistan,Perlis,0,0,0
1/03/2020,Afghanistan,Pulau Pinang,0,0,0
1/03/2020,Afghanistan,Sarawak,0,0,0
1/03/2020,Afghanistan,Selangor,84,68,16
1/03/2020,Angola,Johor,0,0,0
1/03/2020,Angola,Kedah,0,0,0
1/03/2020,Angola,Sabah,0,0,0
1/03/2020,Angola,Selangor,1,0,1
1/03/2020,Anguilla,Selangor,0,0,0
1/03/2020,Albania,Johor,7,6,1
1/03/2020,Albania,Kedah,0,0,0
1/03/2020,Albania,Perak,0,0,0
1/03/2020,Albania,Perlis,0,0,0
1/03/2020,Albania,Pulau Pinang,1,1,0
1/03/2020,Albania,Sabah,0,0,0
1/03/2020,Albania,Sarawak,0,0,0
1/03/2020,Albania,Selangor,19,10,9
1/03/2020,Andorra,Johor,0,0,0
1/03/2020,Andorra,Kedah,0,0,0
1/03/2020,Andorra,Perlis,0,0,0
1/03/2020,Andorra,Pulau Pinang,0,0,0
1/03/2020,Andorra,Selangor,1,1,0
1/03/2020,Antigua and Barbuda,Selangor,0,0,0
1/03/2020,United Arab Emirates,Johor,4,4,0
1/03/2020,United Arab Emirates,Kedah,0,0,0
1/03/2020,United Arab Emirates,Kelantan,0,0,0
1/03/2020,United Arab Emirates,Perak,0,0,0
1/03/2020,United Arab Emirates,Perlis,0,0,0
1/03/2020,United Arab Emirates,Pulau Pinang,0,0,0
1/03/2020,United Arab Emirates,Sabah,0,0,0
1/03/2020,United Arab Emirates,Sarawak,0,0,0
1/03/2020,United Arab Emirates,Selangor,60,49,11
1/03/2020,Argentina,Johor,56,25,31
1/03/2020,Argentina,Kedah,99,51,48
1/03/2020,Argentina,Kelantan,0,0,0
1/03/2020,Argentina,Melaka,0,0,0
1/03/2020,Argentina,Perak,0,0,0
1/03/2020,Argentina,Perlis,14,4,10
1/03/2020,Argentina,Pulau Pinang,6,2,4
1/03/2020,Argentina,Sabah,3,3,0
1/03/2020,Argentina,Sarawak,3,3,0
1/03/2020,Argentina,Selangor,329,181,148
1/03/2020,Argentina,W.P. Labuan,1,1,0
1/03/2020,Armenia,Johor,5,2,3
1/03/2020,Armenia,Kedah,0,0,0
1/03/2020,Armenia,Kelantan,0,0,0
1/03/2020,Armenia,Perak,0,0,0
1/03/2020,Armenia,Perlis,0,0,0
1/03/2020,Armenia,Pulau Pinang,1,1,0
1/03/2020,Armenia,Sabah,0,0,0
1/03/2020,Armenia,Sarawak,0,0,0
1/03/2020,Armenia,Selangor,18,9,9
1/03/2020,Antarctica,Selangor,0,0,0
1/03/2020,Antigua and Barbuda,Johor,1,1,0
1/03/2020,Antigua and Barbuda,Kedah,0,0,0
1/03/2020,Antigua and Barbuda,Pulau Pinang,0,0,0
1/03/2020,Antigua and Barbuda,Sarawak,0,0,0
1/03/2020,Antigua and Barbuda,Selangor,6,5,1
1/03/2020,Australia,Johor,1347,887,460
1/03/2020,Australia,Kedah,253,148,105
1/03/2020,Australia,Kelantan,8,4,4
1/03/2020,Australia,Melaka,1,1,0
1/03/2020,Australia,Negeri Sembilan,1,1,0
1/03/2020,Australia,Pahang,2,1,1
1/03/2020,Australia,Perak,42,22,20
1/03/2020,Australia,Perlis,30,22,8
1/03/2020,Australia,Pulau Pinang,583,306,277
1/03/2020,Australia,Sabah,170,71,99
1/03/2020,Australia,Sarawak,160,102,58
1/03/2020,Australia,Selangor,6804,4239,2565
1/03/2020,Australia,Terengganu,2,2,0
1/03/2020,Australia,W.P. Labuan,6,4,2
1/03/2020,Austria,Johor,88,64,24
1/03/2020,Austria,Kedah,51,30,21
1/03/2020,Austria,Kelantan,7,6,1
1/03/2020,Austria,Melaka,0,0,0
1/03/2020,Austria,Negeri Sembilan,0,0,0
1/03/2020,Austria,Pahang,0,0,0
1/03/2020,Austria,Perak,0,0,0
1/03/2020,Austria,Perlis,6,4,2
1/03/2020,Austria,Pulau Pinang,42,26,16
1/03/2020,Austria,Sabah,9,5,4
1/03/2020,Austria,Sarawak,3,3,0
1/03/2020,Austria,Selangor,403,241,162
1/03/2020,Austria,Terengganu,0,0,0
1/03/2020,Austria,W.P. Labuan,0,0,0
1/03/2020,Azerbaijan,Johor,1,1,0
1/03/2020,Azerbaijan,Kedah,0,0,0
1/03/2020,Azerbaijan,Kelantan,0,0,0
1/03/2020,Azerbaijan,Melaka,0,0,0
1/03/2020,Azerbaijan,Perlis,0,0,0
1/03/2020,Azerbaijan,Pulau Pinang,0,0,0
1/03/2020,Azerbaijan,Sabah,0,0,0
1/03/2020,Azerbaijan,Sarawak,0,0,0
1/03/2020,Azerbaijan,Selangor,27,19,8
1/03/2020,Azerbaijan,W.P. Labuan,0,0,0
1/03/2020,Burundi,Pulau Pinang,0,0,0
1/03/2020,Burundi,Sarawak,0,0,0
1/03/2020,Burundi,Selangor,1,1,0
1/03/2020,Belgium,Johor,121,86,35
1/03/2020,Belgium,Kedah,70,37,33
1/03/2020,Belgium,Kelantan,6,4,2
1/03/2020,Belgium,Melaka,0,0,0
1/03/2020,Belgium,Negeri Sembilan,0,0,0
1/03/2020,Belgium,Pahang,4,2,2
1/03/2020,Belgium,Perak,0,0,0
1/03/2020,Belgium,Perlis,9,5,4
1/03/2020,Belgium,Pulau Pinang,30,22,8
1/03/2020,Belgium,Sabah,16,12,4
1/03/2020,Belgium,Sarawak,16,6,10
1/03/2020,Belgium,Selangor,580,378,202
1/03/2020,Belgium,W.P. Labuan,2,1,1
1/03/2020,Benin,Johor,0,0,0
1/03/2020,Benin,Kedah,0,0,0
1/03/2020,Benin,Perak,0,0,0
1/03/2020,Benin,Pulau Pinang,0,0,0
1/03/2020,Benin,Sabah,0,0,0
1/03/2020,Benin,Sarawak,0,0,0
1/03/2020,Benin,Selangor,1,1,0
1/03/2020,Burkina Faso,Perak,0,0,0
1/03/2020,Burkina Faso,Pulau Pinang,0,0,0
1/03/2020,Burkina Faso,Selangor,1,1,0
1/03/2020,Bangladesh,Johor,794,699,95
1/03/2020,Bangladesh,Kedah,0,0,0
1/03/2020,Bangladesh,Kelantan,0,0,0
1/03/2020,Bangladesh,Melaka,0,0,0
1/03/2020,Bangladesh,Negeri Sembilan,0,0,0
1/03/2020,Bangladesh,Pahang,0,0,0
1/03/2020,Bangladesh,Perak,0,0,0
1/03/2020,Bangladesh,Perlis,0,0,0
1/03/2020,Bangladesh,Pulau Pinang,51,51,0
1/03/2020,Bangladesh,Sabah,1,1,0
1/03/2020,Bangladesh,Sarawak,48,48,0
1/03/2020,Bangladesh,Selangor,9470,8768,702
1/03/2020,Bangladesh,W.P. Labuan,5,5,0
1/03/2020,Bulgaria,Johor,24,18,6
1/03/2020,Bulgaria,Kedah,12,6,6
1/03/2020,Bulgaria,Kelantan,0,0,0
1/03/2020,Bulgaria,Pahang,0,0,0
1/03/2020,Bulgaria,Perak,0,0,0
1/03/2020,Bulgaria,Perlis,1,1,0
1/03/2020,Bulgaria,Pulau Pinang,3,2,1
1/03/2020,Bulgaria,Sabah,0,0,0
1/03/2020,Bulgaria,Sarawak,0,0,0
1/03/2020,Bulgaria,Selangor,146,90,56
1/03/2020,Bulgaria,W.P. Labuan,0,0,0
1/03/2020,Bahrain,Johor,0,0,0
1/03/2020,Bahrain,Kedah,1,1,0
1/03/2020,Bahrain,Kelantan,0,0,0
1/03/2020,Bahrain,Perlis,0,0,0
1/03/2020,Bahrain,Pulau Pinang,0,0,0
1/03/2020,Bahrain,Sabah,0,0,0
1/03/2020,Bahrain,Sarawak,1,1,0
1/03/2020,Bahrain,Selangor,18,14,4
1/03/2020,Bahamas,Johor,0,0,0
1/03/2020,Bahamas,Kedah,0,0,0
1/03/2020,Bahamas,Perak,0,0,0
1/03/2020,Bahamas,Sabah,0,0,0
1/03/2020,Bahamas,Sarawak,0,0,0
1/03/2020,Bahamas,Selangor,2,1,1
1/03/2020,Bosnia and Herzegovina,Johor,1,1,0
1/03/2020,Bosnia and Herzegovina,Kedah,0,0,0
1/03/2020,Bosnia and Herzegovina,Perlis,0,0,0
1/03/2020,Bosnia and Herzegovina,Pulau Pinang,4,3,1
1/03/2020,Bosnia and Herzegovina,Sabah,0,0,0
1/03/2020,Bosnia and Herzegovina,Sarawak,0,0,0
1/03/2020,Bosnia and Herzegovina,Selangor,24,17,7
1/03/2020,Belarus,Johor,7,2,5
1/03/2020,Belarus,Kedah,16,7,9
1/03/2020,Belarus,Kelantan,0,0,0
1/03/2020,Belarus,Pahang,0,0,0
1/03/2020,Belarus,Perak,0,0,0
1/03/2020,Belarus,Perlis,1,1,0
1/03/2020,Belarus,Pulau Pinang,0,0,0
1/03/2020,Belarus,Sabah,0,0,0
1/03/2020,Belarus,Sarawak,2,0,2
1/03/2020,Belarus,Selangor,208,97,111
1/03/2020,Belarus,W.P. Labuan,1,0,1
1/03/2020,Belize,Johor,0,0,0
1/03/2020,Belize,Pulau Pinang,0,0,0
1/03/2020,Belize,Sarawak,0,0,0
1/03/2020,Belize,Selangor,2,2,0
1/03/2020,Bermuda,Selangor,0,0,0
1/03/2020,Bolivia,Johor,1,1,0
1/03/2020,Bolivia,Kedah,1,0,1
1/03/2020,Bolivia,Melaka,0,0,0
1/03/2020,Bolivia,Perak,0,0,0
1/03/2020,Bolivia,Perlis,0,0,0
1/03/2020,Bolivia,Pulau Pinang,0,0,0
1/03/2020,Bolivia,Sabah,0,0,0
1/03/2020,Bolivia,Sarawak,0,0,0
1/03/2020,Bolivia,Selangor,10,6,4
1/03/2020,Brazil,Johor,71,39,32
1/03/2020,Brazil,Kedah,53,29,24
1/03/2020,Brazil,Kelantan,0,0,0
1/03/2020,Brazil,Melaka,0,0,0
1/03/2020,Brazil,Pahang,0,0,0
1/03/2020,Brazil,Perak,0,0,0
1/03/2020,Brazil,Perlis,2,0,2
1/03/2020,Brazil,Pulau Pinang,14,7,7
1/03/2020,Brazil,Sabah,5,2,3
1/03/2020,Brazil,Sarawak,2,0,2
1/03/2020,Brazil,Selangor,517,288,229
1/03/2020,Brazil,W.P. Labuan,0,0,0
1/03/2020,Barbados,Johor,1,0,1
1/03/2020,Barbados,Kedah,0,0,0
1/03/2020,Barbados,Perlis,0,0,0
1/03/2020,Barbados,Pulau Pinang,0,0,0
1/03/2020,Barbados,Selangor,0,0,0
1/03/2020,Brunei Darussalam,Johor,59,33,26
1/03/2020,Brunei Darussalam,Kedah,6,4,2
1/03/2020,Brunei Darussalam,Kelantan,4,2,2
1/03/2020,Brunei Darussalam,Melaka,0,0,0
1/03/2020,Brunei Darussalam,Pahang,0,0,0
1/03/2020,Brunei Darussalam,Perak,0,0,0
1/03/2020,Brunei Darussalam,Perlis,0,0,0
1/03/2020,Brunei Darussalam,Pulau Pinang,1,0,1
1/03/2020,Brunei Darussalam,Sabah,217,137,80
1/03/2020,Brunei Darussalam,Sarawak,29596,17860,11736
1/03/2020,Brunei Darussalam,Selangor,1243,669,574
1/03/2020,Brunei Darussalam,W.P. Labuan,470,341,129
1/03/2020,Bhutan,Johor,2,0,2
1/03/2020,Bhutan,Kedah,1,1,0
1/03/2020,Bhutan,Perak,0,0,0
1/03/2020,Bhutan,Perlis,0,0,0
1/03/2020,Bhutan,Pulau Pinang,0,0,0
1/03/2020,Bhutan,Sabah,0,0,0
1/03/2020,Bhutan,Sarawak,0,0,0
1/03/2020,Bhutan,Selangor,10,8,2
1/03/2020,Botswana,Johor,0,0,0
1/03/2020,Botswana,Kedah,0,0,0
1/03/2020,Botswana,Perlis,0,0,0
1/03/2020,Botswana,Pulau Pinang,0,0,0
1/03/2020,Botswana,Sabah,0,0,0
1/03/2020,Botswana,Sarawak,0,0,0
1/03/2020,Botswana,Selangor,6,2,4
1/03/2020,Central African Republic,Kedah,0,0,0
1/03/2020,Central African Republic,Selangor,0,0,0
1/03/2020,Canada,Johor,450,272,178
1/03/2020,Canada,Kedah,130,76,54
1/03/2020,Canada,Kelantan,12,9,3
1/03/2020,Canada,Melaka,0,0,0
1/03/2020,Canada,Negeri Sembilan,0,0,0
1/03/2020,Canada,Pahang,2,1,1
1/03/2020,Canada,Perak,6,6,0
1/03/2020,Canada,Perlis,35,23,12
1/03/2020,Canada,Pulau Pinang,211,127,84
1/03/2020,Canada,Sabah,64,34,30
1/03/2020,Canada,Sarawak,131,83,48
1/03/2020,Canada,Selangor,1730,1023,707
1/03/2020,Canada,Terengganu,0,0,0
1/03/2020,Canada,W.P. Labuan,6,3,3
1/03/2020,Cocos (Keeling) Islands,Selangor,0,0,0
1/03/2020,Switzerland,Johor,174,104,70
1/03/2020,Switzerland,Kedah,134,70,64
1/03/2020,Switzerland,Kelantan,3,1,2
1/03/2020,Switzerland,Melaka,0,0,0
1/03/2020,Switzerland,Negeri Sembilan,0,0,0
1/03/2020,Switzerland,Pahang,0,0,0
1/03/2020,Switzerland,Perak,5,2,3
1/03/2020,Switzerland,Perlis,26,15,11
1/03/2020,Switzerland,Pulau Pinang,63,42,21
1/03/2020,Switzerland,Sabah,32,13,19
1/03/2020,Switzerland,Sarawak,21,8,13
1/03/2020,Switzerland,Selangor,624,368,256
1/03/2020,Switzerland,W.P. Labuan,0,0,0
1/03/2020,Chile,Johor,15,7,8
1/03/2020,Chile,Kedah,26,12,14
1/03/2020,Chile,Kelantan,2,0,2
1/03/2020,Chile,Melaka,0,0,0
1/03/2020,Chile,Pahang,0,0,0
1/03/2020,Chile,Perak,0,0,0
1/03/2020,Chile,Perlis,1,0,1
1/03/2020,Chile,Pulau Pinang,3,2,1
1/03/2020,Chile,Sabah,2,1,1
1/03/2020,Chile,Sarawak,0,0,0
1/03/2020,Chile,Selangor,163,81,82
1/03/2020,China,Johor,4791,1978,2813
1/03/2020,China,Kedah,232,92,140
1/03/2020,China,Kelantan,10,7,3
1/03/2020,China,Melaka,0,0,0
1/03/2020,China,Pahang,2,0,2
1/03/2020,China,Perak,197,73,124
1/03/2020,China,Perlis,30,17,13
1/03/2020,China,Pulau Pinang,954,530,424
1/03/2020,China,Sabah,105,51,54
1/03/2020,China,Sarawak,173,58,115
1/03/2020,China,Selangor,25271,15716,9555
1/03/2020,China,Terengganu,0,0,0
1/03/2020,China,W.P. Labuan,0,0,0
1/03/2020,Côte d'Ivoire,Johor,0,0,0
1/03/2020,Côte d'Ivoire,Kedah,0,0,0
1/03/2020,Côte d'Ivoire,Pulau Pinang,0,0,0
1/03/2020,Côte d'Ivoire,Sabah,0,0,0
1/03/2020,Côte d'Ivoire,Sarawak,0,0,0
1/03/2020,Côte d'Ivoire,Selangor,6,6,0
1/03/2020,Cameroon,Johor,4,4,0
1/03/2020,Cameroon,Kedah,0,0,0
1/03/2020,Cameroon,Pulau Pinang,0,0,0
1/03/2020,Cameroon,Sabah,0,0,0
1/03/2020,Cameroon,Sarawak,0,0,0
1/03/2020,Cameroon,Selangor,10,5,5
1/03/2020,Congo,Johor,0,0,0
1/03/2020,Congo,Pulau Pinang,0,0,0
1/03/2020,Congo,Sarawak,0,0,0
1/03/2020,Congo,Selangor,11,6,5
1/03/2020,Congo,Johor,0,0,0
1/03/2020,Congo,Kedah,1,0,1
1/03/2020,Congo,Selangor,0,0,0
1/03/2020,Cook Islands,Selangor,0,0,0
1/03/2020,Colombia,Johor,3,1,2
1/03/2020,Colombia,Kedah,0,0,0
1/03/2020,Colombia,Perak,0,0,0
1/03/2020,Colombia,Pulau Pinang,1,1,0
1/03/2020,Colombia,Sabah,0,0,0
1/03/2020,Colombia,Sarawak,1,0,1
1/03/2020,Colombia,Selangor,54,28,26
1/03/2020,Colombia,W.P. Labuan,0,0,0
1/03/2020,Comoros,Johor,0,0,0
1/03/2020,Comoros,Kedah,0,0,0
1/03/2020,Comoros,Selangor,7,7,0
1/03/2020,Cabo Verde,Johor,0,0,0
1/03/2020,Cabo Verde,Kedah,0,0,0
1/03/2020,Cabo Verde,Pulau Pinang,0,0,0
1/03/2020,Cabo Verde,Sabah,0,0,0
1/03/2020,Cabo Verde,Selangor,2,2,0
1/03/2020,Costa Rica,Johor,5,4,1
1/03/2020,Costa Rica,Kedah,1,1,0
1/03/2020,Costa Rica,Perak,0,0,0
1/03/2020,Costa Rica,Perlis,0,0,0
1/03/2020,Costa Rica,Pulau Pinang,1,0,1
1/03/2020,Costa Rica,Sabah,0,0,0
1/03/2020,Costa Rica,Sarawak,0,0,0
1/03/2020,Costa Rica,Selangor,16,7,9
1/03/2020,Cuba,Johor,2,2,0
1/03/2020,Cuba,Kedah,1,1,0
1/03/2020,Cuba,Perlis,0,0,0
1/03/2020,Cuba,Pulau Pinang,0,0,0
1/03/2020,Cuba,Sabah,0,0,0
1/03/2020,Cuba,Sarawak,0,0,0
1/03/2020,Cuba,Selangor,9,4,5
1/03/2020,Cyprus,Johor,4,3,1
1/03/2020,Cyprus,Kedah,0,0,0
1/03/2020,Cyprus,Perak,0,0,0
1/03/2020,Cyprus,Perlis,0,0,0
1/03/2020,Cyprus,Pulau Pinang,0,0,0
1/03/2020,Cyprus,Sabah,0,0,0
1/03/2020,Cyprus,Sarawak,0,0,0
1/03/2020,Cyprus,Selangor,17,12,5
1/03/2020,Czechia,Johor,125,73,52
1/03/2020,Czechia,Kedah,172,78,94
1/03/2020,Czechia,Kelantan,1,1,0
1/03/2020,Czechia,Melaka,0,0,0
1/03/2020,Czechia,Negeri Sembilan,0,0,0
1/03/2020,Czechia,Perak,0,0,0
1/03/2020,Czechia,Perlis,8,6,2
1/03/2020,Czechia,Pulau Pinang,10,7,3
1/03/2020,Czechia,Sabah,22,11,11
1/03/2020,Czechia,Sarawak,27,18,9
1/03/2020,Czechia,Selangor,418,242,176
1/03/2020,Czechia,W.P. Labuan,0,0,0
1/03/2020,Germany,Johor,1069,695,374
1/03/2020,Germany,Kedah,873,463,410
1/03/2020,Germany,Kelantan,31,21,10
1/03/2020,Germany,Melaka,0,0,0
1/03/2020,Germany,Negeri Sembilan,0,0,0
1/03/2020,Germany,Pahang,1,1,0
1/03/2020,Germany,Perak,11,6,5
1/03/2020,Germany,Perlis,90,58,32
1/03/2020,Germany,Pulau Pinang,318,204,114
1/03/2020,Germany,Sabah,105,65,40
1/03/2020,Germany,Sarawak,148,89,59
1/03/2020,Germany,Selangor,3930,2284,1646
1/03/2020,Germany,Terengganu,0,0,0
1/03/2020,Germany,W.P. Labuan,14,11,3
1/03/2020,Djibouti,Johor,0,0,0
1/03/2020,Djibouti,Selangor,4,0,4
1/03/2020,Dominica,Johor,2,2,0
1/03/2020,Dominica,Kedah,0,0,0
1/03/2020,Dominica,Pulau Pinang,0,0,0
1/03/2020,Dominica,Sabah,0,0,0
1/03/2020,Dominica,Sarawak,0,0,0
1/03/2020,Dominica,Selangor,12,10,2
1/03/2020,Dominica,W.P. Labuan,0,0,0
1/03/2020,Denmark,Johor,111,74,37
1/03/2020,Denmark,Kedah,136,58,78
1/03/2020,Denmark,Kelantan,0,0,0
1/03/2020,Denmark,Melaka,0,0,0
1/03/2020,Denmark,Negeri Sembilan,0,0,0
1/03/2020,Denmark,Pahang,0,0,0
1/03/2020,Denmark,Perak,2,1,1
1/03/2020,Denmark,Perlis,3,1,2
1/03/2020,Denmark,Pulau Pinang,44,28,16
1/03/2020,Denmark,Sabah,47,22,25
1/03/2020,Denmark,Sarawak,20,12,8
1/03/2020,Denmark,Selangor,527,310,217
1/03/2020,Denmark,W.P. Labuan,0,0,0
1/03/2020,Dominican Republic,Johor,0,0,0
1/03/2020,Dominican Republic,Kedah,0,0,0
1/03/2020,Dominican Republic,Perak,0,0,0
1/03/2020,Dominican Republic,Perlis,0,0,0
1/03/2020,Dominican Republic,Pulau Pinang,0,0,0
1/03/2020,Dominican Republic,Sabah,0,0,0
1/03/2020,Dominican Republic,Sarawak,0,0,0
1/03/2020,Dominican Republic,Selangor,6,4,2
1/03/2020,Algeria,Johor,21,21,0
1/03/2020,Algeria,Kedah,6,3,3
1/03/2020,Algeria,Kelantan,0,0,0
1/03/2020,Algeria,Melaka,0,0,0
1/03/2020,Algeria,Perak,0,0,0
1/03/2020,Algeria,Perlis,2,1,1
1/03/2020,Algeria,Pulau Pinang,5,4,1
1/03/2020,Algeria,Sabah,0,0,0
1/03/2020,Algeria,Sarawak,0,0,0
1/03/2020,Algeria,Selangor,333,239,94
1/03/2020,Algeria,W.P. Labuan,0,0,0
1/03/2020,Ecuador,Johor,0,0,0
1/03/2020,Ecuador,Kedah,0,0,0
1/03/2020,Ecuador,Perak,0,0,0
1/03/2020,Ecuador,Perlis,0,0,0
1/03/2020,Ecuador,Pulau Pinang,0,0,0
1/03/2020,Ecuador,Sabah,0,0,0
1/03/2020,Ecuador,Sarawak,0,0,0
1/03/2020,Ecuador,Selangor,15,7,8
1/03/2020,Egypt,Johor,91,80,11
1/03/2020,Egypt,Kedah,4,2,2
1/03/2020,Egypt,Kelantan,5,5,0
1/03/2020,Egypt,Melaka,0,0,0
1/03/2020,Egypt,Pahang,0,0,0
1/03/2020,Egypt,Perak,0,0,0
1/03/2020,Egypt,Perlis,0,0,0
1/03/2020,Egypt,Pulau Pinang,7,4,3
1/03/2020,Egypt,Sabah,1,1,0
1/03/2020,Egypt,Sarawak,8,8,0
1/03/2020,Egypt,Selangor,645,478,167
1/03/2020,Egypt,Terengganu,0,0,0
1/03/2020,Egypt,W.P. Labuan,2,2,0
1/03/2020,Eritrea,Johor,0,0,0
1/03/2020,Eritrea,Pulau Pinang,0,0,0
1/03/2020,Eritrea,Sabah,0,0,0
1/03/2020,Eritrea,Selangor,3,3,0
1/03/2020,Spain,Johor,160,101,59
1/03/2020,Spain,Kedah,114,53,61
1/03/2020,Spain,Kelantan,7,5,2
1/03/2020,Spain,Melaka,1,1,0
1/03/2020,Spain,Negeri Sembilan,0,0,0
1/03/2020,Spain,Pahang,1,1,0
1/03/2020,Spain,Perak,0,0,0
1/03/2020,Spain,Perlis,19,11,8
1/03/2020,Spain,Pulau Pinang,36,20,16
1/03/2020,Spain,Sabah,19,10,9
1/03/2020,Spain,Sarawak,16,7,9
1/03/2020,Spain,Selangor,1054,615,439
1/03/2020,Spain,W.P. Labuan,1,1,0
1/03/2020,Estonia,Johor,24,8,16
1/03/2020,Estonia,Kedah,65,27,38
1/03/2020,Estonia,Kelantan,1,0,1
1/03/2020,Estonia,Pahang,0,0,0
1/03/2020,Estonia,Perak,0,0,0
1/03/2020,Estonia,Perlis,0,0,0
1/03/2020,Estonia,Pulau Pinang,3,1,2
1/03/2020,Estonia,Sabah,2,0,2
1/03/2020,Estonia,Sarawak,2,0,2
1/03/2020,Estonia,Selangor,110,61,49
1/03/2020,Estonia,W.P. Labuan,2,1,1
1/03/2020,Ethiopia,Johor,0,0,0
1/03/2020,Ethiopia,Kedah,0,0,0
1/03/2020,Ethiopia,Pulau Pinang,0,0,0
1/03/2020,Ethiopia,Sarawak,0,0,0
1/03/2020,Ethiopia,Selangor,13,6,7
1/03/2020,Finland,Johor,104,76,28
1/03/2020,Finland,Kedah,180,84,96
1/03/2020,Finland,Kelantan,3,2,1
1/03/2020,Finland,Melaka,2,1,1
1/03/2020,Finland,Negeri Sembilan,0,0,0
1/03/2020,Finland,Pahang,0,0,0
1/03/2020,Finland,Perak,2,1,1
1/03/2020,Finland,Perlis,6,5,1
1/03/2020,Finland,Pulau Pinang,43,26,17
1/03/2020,Finland,Sabah,12,6,6
1/03/2020,Finland,Sarawak,5,2,3
1/03/2020,Finland,Selangor,425,238,187
1/03/2020,Finland,W.P. Labuan,4,2,2
1/03/2020,Fiji,Johor,0,0,0
1/03/2020,Fiji,Kedah,0,0,0
1/03/2020,Fiji,Kelantan,0,0,0
1/03/2020,Fiji,Perak,0,0,0
1/03/2020,Fiji,Perlis,0,0,0
1/03/2020,Fiji,Pulau Pinang,0,0,0
1/03/2020,Fiji,Sabah,0,0,0
1/03/2020,Fiji,Sarawak,1,1,0
1/03/2020,Fiji,Selangor,28,14,14
1/03/2020,France,Johor,792,518,274
1/03/2020,France,Kedah,693,391,302
1/03/2020,France,Kelantan,61,36,25
1/03/2020,France,Melaka,0,0,0
1/03/2020,France,Negeri Sembilan,1,1,0
1/03/2020,France,Pahang,12,7,5
1/03/2020,France,Perak,8,6,2
1/03/2020,France,Perlis,68,38,30
1/03/2020,France,Pulau Pinang,231,146,85
1/03/2020,France,Sabah,60,43,17
1/03/2020,France,Sarawak,43,32,11
1/03/2020,France,Selangor,4310,2537,1773
1/03/2020,France,Terengganu,0,0,0
1/03/2020,France,W.P. Labuan,1,1,0
1/03/2020,"Micronesia, Federated States of",Johor,0,0,0
1/03/2020,"Micronesia, Federated States of",Pulau Pinang,0,0,0
1/03/2020,"Micronesia, Federated States of",Selangor,0,0,0
1/03/2020,Gabon,Johor,0,0,0
1/03/2020,Gabon,Pulau Pinang,0,0,0
1/03/2020,Gabon,Sarawak,0,0,0
1/03/2020,Gabon,Selangor,5,3,2
1/03/2020,United Kingdom of Great Britain and Northern Ireland,Johor,2111,1405,706
1/03/2020,United Kingdom of Great Britain and Northern Ireland,Kedah,794,443,351
1/03/2020,United Kingdom of Great Britain and Northern Ireland,Kelantan,27,15,12
1/03/2020,United Kingdom of Great Britain and Northern Ireland,Melaka,1,1,0
1/03/2020,United Kingdom of Great Britain and Northern Ireland,Negeri Sembilan,1,1,0
1/03/2020,United Kingdom of Great Britain and Northern Ireland,Pahang,2,1,1
1/03/2020,United Kingdom of Great Britain and Northern Ireland,Perak,36,21,15
1/03/2020,United Kingdom of Great Britain and Northern Ireland,Perlis,152,93,59
1/03/2020,United Kingdom of Great Britain and Northern Ireland,Pulau Pinang,832,499,333
1/03/2020,United Kingdom of Great Britain and Northern Ireland,Sabah,291,146,145
1/03/2020,United Kingdom of Great Britain and Northern Ireland,Sarawak,449,312,137
1/03/2020,United Kingdom of Great Britain and Northern Ireland,Selangor,8560,5286,3274
1/03/2020,United Kingdom of Great Britain and Northern Ireland,Terengganu,2,2,0
1/03/2020,United Kingdom of Great Britain and Northern Ireland,W.P. Labuan,48,38,10
1/03/2020,Georgia,Johor,3,3,0
1/03/2020,Georgia,Kedah,1,1,0
1/03/2020,Georgia,Melaka,0,0,0
1/03/2020,Georgia,Perak,0,0,0
1/03/2020,Georgia,Perlis,0,0,0
1/03/2020,Georgia,Pulau Pinang,1,1,0
1/03/2020,Georgia,Sabah,0,0,0
1/03/2020,Georgia,Sarawak,0,0,0
1/03/2020,Georgia,Selangor,14,12,2
1/03/2020,Ghana,Johor,2,1,1
1/03/2020,Ghana,Kedah,0,0,0
1/03/2020,Ghana,Kelantan,0,0,0
1/03/2020,Ghana,Pulau Pinang,0,0,0
1/03/2020,Ghana,Sabah,0,0,0
1/03/2020,Ghana,Sarawak,0,0,0
1/03/2020,Ghana,Selangor,19,14,5
1/03/2020,Gibraltar,Johor,0,0,0
1/03/2020,Gibraltar,Sarawak,0,0,0
1/03/2020,Guinea,Johor,0,0,0
1/03/2020,Guinea,Kedah,0,0,0
1/03/2020,Guinea,Kelantan,1,1,0
1/03/2020,Guinea,Perlis,0,0,0
1/03/2020,Guinea,Pulau Pinang,0,0,0
1/03/2020,Guinea,Sabah,0,0,0
1/03/2020,Guinea,Sarawak,0,0,0
1/03/2020,Guinea,Selangor,25,18,7
1/03/2020,Guadeloupe,Selangor,1,1,0
1/03/2020,Gambia,Johor,0,0,0
1/03/2020,Gambia,Kedah,0,0,0
1/03/2020,Gambia,Kelantan,0,0,0
1/03/2020,Gambia,Pulau Pinang,0,0,0
1/03/2020,Gambia,Sabah,0,0,0
1/03/2020,Gambia,Sarawak,0,0,0
1/03/2020,Gambia,Selangor,33,26,7
1/03/2020,Guinea-Bissau,Johor,1,1,0
1/03/2020,Guinea-Bissau,Selangor,0,0,0
1/03/2020,Equatorial Guinea,Johor,0,0,0
1/03/2020,Equatorial Guinea,Selangor,0,0,0
1/03/2020,Greece,Johor,18,15,3
1/03/2020,Greece,Kedah,6,4,2
1/03/2020,Greece,Kelantan,1,1,0
1/03/2020,Greece,Melaka,0,0,0
1/03/2020,Greece,Negeri Sembilan,0,0,0
1/03/2020,Greece,Pahang,0,0,0
1/03/2020,Greece,Perak,0,0,0
1/03/2020,Greece,Perlis,0,0,0
1/03/2020,Greece,Pulau Pinang,4,3,1
1/03/2020,Greece,Sabah,2,2,0
1/03/2020,Greece,Sarawak,0,0,0
1/03/2020,Greece,Selangor,104,72,32
1/03/2020,Grenada,Johor,6,6,0
1/03/2020,Grenada,Kedah,0,0,0
1/03/2020,Grenada,Pulau Pinang,0,0,0
1/03/2020,Grenada,Sabah,0,0,0
1/03/2020,Grenada,Sarawak,0,0,0
1/03/2020,Grenada,Selangor,1,1,0
1/03/2020,Greenland,Johor,0,0,0
1/03/2020,Greenland,Selangor,0,0,0
1/03/2020,Guatemala,Johor,0,0,0
1/03/2020,Guatemala,Kedah,0,0,0
1/03/2020,Guatemala,Pahang,0,0,0
1/03/2020,Guatemala,Perak,0,0,0
1/03/2020,Guatemala,Pulau Pinang,0,0,0
1/03/2020,Guatemala,Sabah,0,0,0
1/03/2020,Guatemala,Sarawak,0,0,0
1/03/2020,Guatemala,Selangor,2,2,0
1/03/2020,Guatemala,W.P. Labuan,0,0,0
1/03/2020,Guyana,Johor,0,0,0
1/03/2020,Guyana,Kedah,0,0,0
1/03/2020,Guyana,Pulau Pinang,0,0,0
1/03/2020,Guyana,Sarawak,0,0,0
1/03/2020,Guyana,Selangor,3,3,0
1/03/2020,Hong Kong,Johor,0,0,0
1/03/2020,Hong Kong,Kedah,0,0,0
1/03/2020,Hong Kong,Kelantan,0,0,0
1/03/2020,Hong Kong,Pahang,0,0,0
1/03/2020,Hong Kong,Perak,7,4,3
1/03/2020,Hong Kong,Perlis,1,1,0
1/03/2020,Hong Kong,Pulau Pinang,0,0,0
1/03/2020,Hong Kong,Sabah,0,0,0
1/03/2020,Hong Kong,Sarawak,1,0,1
1/03/2020,Hong Kong,Selangor,0,0,0
1/03/2020,Hong Kong,Terengganu,0,0,0
1/03/2020,Heard Island and McDonald Islands,Johor,0,0,0
1/03/2020,Honduras,Johor,2,2,0
1/03/2020,Honduras,Kedah,2,0,2
1/03/2020,Honduras,Perak,0,0,0
1/03/2020,Honduras,Pulau Pinang,0,0,0
1/03/2020,Honduras,Sabah,0,0,0
1/03/2020,Honduras,Sarawak,0,0,0
1/03/2020,Honduras,Selangor,6,3,3
1/03/2020,Croatia,Johor,20,17,3
1/03/2020,Croatia,Kedah,6,4,2
1/03/2020,Croatia,Kelantan,0,0,0
1/03/2020,Croatia,Melaka,0,0,0
1/03/2020,Croatia,Pahang,0,0,0
1/03/2020,Croatia,Perak,0,0,0
1/03/2020,Croatia,Perlis,0,0,0
1/03/2020,Croatia,Pulau Pinang,4,2,2
1/03/2020,Croatia,Sabah,1,1,0
1/03/2020,Croatia,Sarawak,2,2,0
1/03/2020,Croatia,Selangor,56,43,13
1/03/2020,Haiti,Johor,0,0,0
1/03/2020,Haiti,Kedah,0,0,0
1/03/2020,Haiti,Kelantan,0,0,0
1/03/2020,Haiti,Perak,0,0,0
1/03/2020,Haiti,Pulau Pinang,0,0,0
1/03/2020,Haiti,Sabah,0,0,0
1/03/2020,Haiti,Selangor,0,0,0
1/03/2020,Hungary,Johor,30,20,10
1/03/2020,Hungary,Kedah,70,37,33
1/03/2020,Hungary,Kelantan,1,1,0
1/03/2020,Hungary,Pahang,0,0,0
1/03/2020,Hungary,Perak,2,1,1
1/03/2020,Hungary,Perlis,1,1,0
1/03/2020,Hungary,Pulau Pinang,17,10,7
1/03/2020,Hungary,Sabah,7,4,3
1/03/2020,Hungary,Sarawak,3,2,1
1/03/2020,Hungary,Selangor,396,204,192
1/03/2020,Hungary,W.P. Labuan,0,0,0
1/03/2020,Indonesia,Johor,59621,34831,24790
1/03/2020,Indonesia,Kedah,813,312,501
1/03/2020,Indonesia,Kelantan,103,77,26
1/03/2020,Indonesia,Melaka,1014,482,532
1/03/2020,Indonesia,Negeri Sembilan,1686,1134,552
1/03/2020,Indonesia,Pahang,2,2,0
1/03/2020,Indonesia,Perak,93,35,58
1/03/2020,Indonesia,Perlis,203,109,94
1/03/2020,Indonesia,Pulau Pinang,11656,4678,6978
1/03/2020,Indonesia,Sabah,2945,1545,1400
1/03/2020,Indonesia,Sarawak,14387,8918,5469
1/03/2020,Indonesia,Selangor,39093,19629,19464
1/03/2020,Indonesia,Terengganu,7,7,0
1/03/2020,Indonesia,W.P. Labuan,60,40,20
1/03/2020,India,Johor,6925,5476,1449
1/03/2020,India,Kedah,130,87,43
1/03/2020,India,Kelantan,4,4,0
1/03/2020,India,Melaka,1,1,0
1/03/2020,India,Negeri Sembilan,1,1,0
1/03/2020,India,Pahang,3,2,1
1/03/2020,India,Perak,104,72,32
1/03/2020,India,Perlis,15,11,4
1/03/2020,India,Pulau Pinang,172,127,45
1/03/2020,India,Sabah,39,28,11
1/03/2020,India,Sarawak,544,485,59
1/03/2020,India,Selangor,19251,15243,4008
1/03/2020,India,Terengganu,3,3,0
1/03/2020,India,W.P. Labuan,18,16,2
1/03/2020, British Indian Ocean Territory,Pulau Pinang,0,0,0
1/03/2020, British Indian Ocean Territory,Selangor,0,0,0
1/03/2020,Ireland,Johor,121,86,35
1/03/2020,Ireland,Kedah,56,25,31
1/03/2020,Ireland,Kelantan,2,1,1
1/03/2020,Ireland,Negeri Sembilan,0,0,0
1/03/2020,Ireland,Pahang,0,0,0
1/03/2020,Ireland,Perak,5,2,3
1/03/2020,Ireland,Perlis,9,5,4
1/03/2020,Ireland,Pulau Pinang,36,24,12
1/03/2020,Ireland,Sabah,2,1,1
1/03/2020,Ireland,Sarawak,9,7,2
1/03/2020,Ireland,Selangor,514,318,196
1/03/2020,Ireland,Terengganu,0,0,0
1/03/2020,Ireland,W.P. Labuan,1,0,1
1/03/2020,"Iran, Islamic Republic of",Johor,52,32,20
1/03/2020,"Iran, Islamic Republic of",Kedah,0,0,0
1/03/2020,"Iran, Islamic Republic of",Kelantan,0,0,0
1/03/2020,"Iran, Islamic Republic of",Perak,0,0,0
1/03/2020,"Iran, Islamic Republic of",Perlis,0,0,0
1/03/2020,"Iran, Islamic Republic of",Pulau Pinang,2,2,0
1/03/2020,"Iran, Islamic Republic of",Sabah,1,1,0
1/03/2020,"Iran, Islamic Republic of",Sarawak,0,0,0
1/03/2020,"Iran, Islamic Republic of",Selangor,651,381,270
1/03/2020,"Iran, Islamic Republic of",W.P. Labuan,0,0,0
1/03/2020,Iraq,Johor,9,7,2
1/03/2020,Iraq,Kedah,0,0,0
1/03/2020,Iraq,Kelantan,0,0,0
1/03/2020,Iraq,Melaka,0,0,0
1/03/2020,Iraq,Pahang,0,0,0
1/03/2020,Iraq,Perak,0,0,0
1/03/2020,Iraq,Perlis,0,0,0
1/03/2020,Iraq,Pulau Pinang,5,4,1
1/03/2020,Iraq,Sabah,0,0,0
1/03/2020,Iraq,Sarawak,0,0,0
1/03/2020,Iraq,Selangor,597,405,192
1/03/2020,Iceland,Johor,4,4,0
1/03/2020,Iceland,Kedah,4,2,2
1/03/2020,Iceland,Kelantan,0,0,0
1/03/2020,Iceland,Perak,0,0,0
1/03/2020,Iceland,Perlis,1,1,0
1/03/2020,Iceland,Pulau Pinang,0,0,0
1/03/2020,Iceland,Sabah,0,0,0
1/03/2020,Iceland,Sarawak,0,0,0
1/03/2020,Iceland,Selangor,33,18,15
1/03/2020,Iceland,W.P. Labuan,0,0,0
1/03/2020,Israel,Pulau Pinang,0,0,0
1/03/2020,Italy,Johor,196,157,39
1/03/2020,Italy,Kedah,165,91,74
1/03/2020,Italy,Kelantan,16,12,4
1/03/2020,Italy,Melaka,0,0,0
1/03/2020,Italy,Negeri Sembilan,0,0,0
1/03/2020,Italy,Pahang,0,0,0
1/03/2020,Italy,Perak,7,4,3
1/03/2020,Italy,Perlis,19,15,4
1/03/2020,Italy,Pulau Pinang,32,23,9
1/03/2020,Italy,Sabah,8,5,3
1/03/2020,Italy,Sarawak,29,14,15
1/03/2020,Italy,Selangor,685,485,200
1/03/2020,Italy,W.P. Labuan,4,4,0
1/03/2020,Jamaica,Johor,0,0,0
1/03/2020,Jamaica,Kedah,0,0,0
1/03/2020,Jamaica,Perak,0,0,0
1/03/2020,Jamaica,Pulau Pinang,2,1,1
1/03/2020,Jamaica,Sabah,0,0,0
1/03/2020,Jamaica,Sarawak,1,1,0
1/03/2020,Jamaica,Selangor,4,2,2
1/03/2020,Jamaica,W.P. Labuan,0,0,0
1/03/2020,Jordan,Johor,8,4,4
1/03/2020,Jordan,Kedah,11,7,4
1/03/2020,Jordan,Kelantan,0,0,0
1/03/2020,Jordan,Melaka,0,0,0
1/03/2020,Jordan,Perlis,0,0,0
1/03/2020,Jordan,Pulau Pinang,13,11,2
1/03/2020,Jordan,Sabah,0,0,0
1/03/2020,Jordan,Sarawak,1,1,0
1/03/2020,Jordan,Selangor,263,196,67
1/03/2020,Jordan,W.P. Labuan,0,0,0
1/03/2020,Japan,Johor,2284,1682,602
1/03/2020,Japan,Kedah,127,64,63
1/03/2020,Japan,Kelantan,8,8,0
1/03/2020,Japan,Melaka,1,1,0
1/03/2020,Japan,Negeri Sembilan,0,0,0
1/03/2020,Japan,Pahang,0,0,0
1/03/2020,Japan,Perak,11,6,5
1/03/2020,Japan,Perlis,45,38,7
1/03/2020,Japan,Pulau Pinang,306,211,95
1/03/2020,Japan,Sabah,303,149,154
1/03/2020,Japan,Sarawak,97,74,23
1/03/2020,Japan,Selangor,7593,4799,2794
1/03/2020,Japan,W.P. Labuan,27,15,12
1/03/2020,Kazakhstan,Johor,10,2,8
1/03/2020,Kazakhstan,Kedah,25,13,12
1/03/2020,Kazakhstan,Kelantan,0,0,0
1/03/2020,Kazakhstan,Melaka,0,0,0
1/03/2020,Kazakhstan,Perak,0,0,0
1/03/2020,Kazakhstan,Perlis,4,2,2
1/03/2020,Kazakhstan,Pulau Pinang,3,2,1
1/03/2020,Kazakhstan,Sabah,0,0,0
1/03/2020,Kazakhstan,Sarawak,4,1,3
1/03/2020,Kazakhstan,Selangor,1163,452,711
1/03/2020,Kazakhstan,W.P. Labuan,0,0,0
1/03/2020,Kenya,Johor,6,1,5
1/03/2020,Kenya,Kedah,1,1,0
1/03/2020,Kenya,Kelantan,1,0,1
1/03/2020,Kenya,Perak,0,0,0
1/03/2020,Kenya,Perlis,0,0,0
1/03/2020,Kenya,Pulau Pinang,1,1,0
1/03/2020,Kenya,Sabah,0,0,0
1/03/2020,Kenya,Sarawak,0,0,0
1/03/2020,Kenya,Selangor,103,65,38
1/03/2020,Kyrgyzstan,Johor,8,7,1
1/03/2020,Kyrgyzstan,Kedah,9,7,2
1/03/2020,Kyrgyzstan,Kelantan,0,0,0
1/03/2020,Kyrgyzstan,Perak,0,0,0
1/03/2020,Kyrgyzstan,Perlis,1,0,1
1/03/2020,Kyrgyzstan,Pulau Pinang,1,0,1
1/03/2020,Kyrgyzstan,Sabah,0,0,0
1/03/2020,Kyrgyzstan,Sarawak,0,0,0
1/03/2020,Kyrgyzstan,Selangor,130,58,72
1/03/2020,Cambodia,Johor,370,133,237
1/03/2020,Cambodia,Kedah,149,95,54
1/03/2020,Cambodia,Kelantan,337,211,126
1/03/2020,Cambodia,Melaka,0,0,0
1/03/2020,Cambodia,Negeri Sembilan,0,0,0
1/03/2020,Cambodia,Pahang,0,0,0
1/03/2020,Cambodia,Perak,20,17,3
1/03/2020,Cambodia,Perlis,481,365,116
1/03/2020,Cambodia,Pulau Pinang,6,1,5
1/03/2020,Cambodia,Sabah,5,4,1
1/03/2020,Cambodia,Sarawak,5,0,5
1/03/2020,Cambodia,Selangor,1386,600,786
1/03/2020,Cambodia,W.P. Labuan,0,0,0
1/03/2020,Kiribati,Johor,2,2,0
1/03/2020,Kiribati,Sabah,0,0,0
1/03/2020,Kiribati,Selangor,0,0,0
1/03/2020,Saint Kitts and Nevis,Johor,3,3,0
1/03/2020,Saint Kitts and Nevis,Kedah,0,0,0
1/03/2020,Saint Kitts and Nevis,Perlis,0,0,0
1/03/2020,Saint Kitts and Nevis,Pulau Pinang,2,1,1
1/03/2020,Saint Kitts and Nevis,Sabah,0,0,0
1/03/2020,Saint Kitts and Nevis,Selangor,18,14,4
1/03/2020,Saint Kitts and Nevis,W.P. Labuan,0,0,0
1/03/2020,"Korea, Republic of",Johor,1761,1062,699
1/03/2020,"Korea, Republic of",Kedah,54,30,24
1/03/2020,"Korea, Republic of",Kelantan,3,1,2
1/03/2020,"Korea, Republic of",Melaka,0,0,0
1/03/2020,"Korea, Republic of",Negeri Sembilan,0,0,0
1/03/2020,"Korea, Republic of",Pahang,5,4,1
1/03/2020,"Korea, Republic of",Perak,11,8,3
1/03/2020,"Korea, Republic of",Perlis,160,93,67
1/03/2020,"Korea, Republic of",Pulau Pinang,92,51,41
1/03/2020,"Korea, Republic of",Sabah,24,19,5
1/03/2020,"Korea, Republic of",Sarawak,70,36,34
1/03/2020,"Korea, Republic of",Selangor,2376,1423,953
1/03/2020,"Korea, Republic of",Terengganu,0,0,0
1/03/2020,"Korea, Republic of",W.P. Labuan,3,3,0
1/03/2020,Kuwait,Johor,1,0,1
1/03/2020,Kuwait,Kedah,5,2,3
1/03/2020,Kuwait,Kelantan,1,0,1
1/03/2020,Kuwait,Perak,0,0,0
1/03/2020,Kuwait,Perlis,0,0,0
1/03/2020,Kuwait,Pulau Pinang,1,1,0
1/03/2020,Kuwait,Sabah,0,0,0
1/03/2020,Kuwait,Sarawak,0,0,0
1/03/2020,Kuwait,Selangor,48,39,9
1/03/2020,Kuwait,W.P. Labuan,0,0,0
1/03/2020, Lao People's Democratic Republic,Johor,29,5,24
1/03/2020, Lao People's Democratic Republic,Kedah,670,54,616
1/03/2020, Lao People's Democratic Republic,Kelantan,102,20,82
1/03/2020, Lao People's Democratic Republic,Melaka,0,0,0
1/03/2020, Lao People's Democratic Republic,Perak,7,2,5
1/03/2020, Lao People's Democratic Republic,Perlis,223,66,157
1/03/2020, Lao People's Democratic Republic,Pulau Pinang,0,0,0
1/03/2020, Lao People's Democratic Republic,Sabah,0,0,0
1/03/2020, Lao People's Democratic Republic,Sarawak,3,2,1
1/03/2020, Lao People's Democratic Republic,Selangor,99,31,68
1/03/2020, Lao People's Democratic Republic,W.P. Labuan,0,0,0
1/03/2020,Lebanon,Johor,6,4,2
1/03/2020,Lebanon,Kedah,0,0,0
1/03/2020,Lebanon,Kelantan,0,0,0
1/03/2020,Lebanon,Pahang,0,0,0
1/03/2020,Lebanon,Perak,0,0,0
1/03/2020,Lebanon,Perlis,0,0,0
1/03/2020,Lebanon,Pulau Pinang,0,0,0
1/03/2020,Lebanon,Sabah,0,0,0
1/03/2020,Lebanon,Sarawak,0,0,0
1/03/2020,Lebanon,Selangor,82,66,16
1/03/2020,Lebanon,W.P. Labuan,0,0,0
1/03/2020,Liberia,Johor,0,0,0
1/03/2020,Liberia,Kedah,0,0,0
1/03/2020,Liberia,Sabah,0,0,0
1/03/2020,Liberia,Sarawak,0,0,0
1/03/2020,Liberia,Selangor,3,3,0
1/03/2020,Libya,Johor,1,1,0
1/03/2020,Libya,Kedah,1,1,0
1/03/2020,Libya,Perlis,0,0,0
1/03/2020,Libya,Pulau Pinang,0,0,0
1/03/2020,Libya,Sabah,0,0,0
1/03/2020,Libya,Sarawak,2,0,2
1/03/2020,Libya,Selangor,256,184,72
1/03/2020,Saint Lucia,Johor,2,2,0
1/03/2020,Saint Lucia,Kedah,0,0,0
1/03/2020,Saint Lucia,Pulau Pinang,0,0,0
1/03/2020,Saint Lucia,Sarawak,0,0,0
1/03/2020,Saint Lucia,Selangor,3,3,0
1/03/2020,Liechtenstein,Johor,0,0,0
1/03/2020,Liechtenstein,Kedah,0,0,0
1/03/2020,Liechtenstein,Perlis,0,0,0
1/03/2020,Liechtenstein,Pulau Pinang,0,0,0
1/03/2020,Liechtenstein,Sabah,0,0,0
1/03/2020,Liechtenstein,Sarawak,0,0,0
1/03/2020,Liechtenstein,Selangor,4,1,3
1/03/2020,LKA,Johor,340,265,75
1/03/2020,LKA,Kedah,4,3,1
1/03/2020,LKA,Kelantan,2,1,1
1/03/2020,LKA,Melaka,0,0,0
1/03/2020,LKA,Pahang,0,0,0
1/03/2020,LKA,Perak,1,1,0
1/03/2020,LKA,Perlis,0,0,0
1/03/2020,LKA,Pulau Pinang,7,7,0
1/03/2020,LKA,Sabah,1,1,0
1/03/2020,LKA,Sarawak,6,5,1
1/03/2020,LKA,Selangor,1437,907,530
1/03/2020,LKA,W.P. Labuan,0,0,0
1/03/2020,Lesotho,Johor,0,0,0
1/03/2020,Lesotho,Kedah,0,0,0
1/03/2020,Lesotho,Pulau Pinang,0,0,0
1/03/2020,Lesotho,Sarawak,0,0,0
1/03/2020,Lesotho,Selangor,2,2,0
1/03/2020,Lithuania,Johor,20,10,10
1/03/2020,Lithuania,Kedah,23,13,10
1/03/2020,Lithuania,Kelantan,1,1,0
1/03/2020,Lithuania,Pahang,0,0,0
1/03/2020,Lithuania,Perak,0,0,0
1/03/2020,Lithuania,Perlis,4,2,2
1/03/2020,Lithuania,Pulau Pinang,6,4,2
1/03/2020,Lithuania,Sabah,1,1,0
1/03/2020,Lithuania,Sarawak,2,1,1
1/03/2020,Lithuania,Selangor,131,71,60
1/03/2020,Lithuania,W.P. Labuan,3,2,1
1/03/2020,Luxembourg,Johor,1,0,1
1/03/2020,Luxembourg,Kedah,2,2,0
1/03/2020,Luxembourg,Kelantan,2,0,2
1/03/2020,Luxembourg,Perak,0,0,0
1/03/2020,Luxembourg,Perlis,0,0,0
1/03/2020,Luxembourg,Pulau Pinang,3,1,2
1/03/2020,Luxembourg,Sabah,2,1,1
1/03/2020,Luxembourg,Sarawak,0,0,0
1/03/2020,Luxembourg,Selangor,23,13,10
1/03/2020,Latvia,Johor,26,19,7
1/03/2020,Latvia,Kedah,8,4,4
1/03/2020,Latvia,Kelantan,0,0,0
1/03/2020,Latvia,Pahang,0,0,0
1/03/2020,Latvia,Perak,0,0,0
1/03/2020,Latvia,Perlis,1,0,1
1/03/2020,Latvia,Pulau Pinang,3,2,1
1/03/2020,Latvia,Sabah,3,1,2
1/03/2020,Latvia,Sarawak,0,0,0
1/03/2020,Latvia,Selangor,97,43,54
1/03/2020,Latvia,W.P. Labuan,0,0,0
1/03/2020,Macao,Johor,0,0,0
1/03/2020,Macao,Pahang,0,0,0
1/03/2020,Macao,Perak,0,0,0
1/03/2020,Macao,Selangor,0,0,0
1/03/2020,Macao,W.P. Labuan,0,0,0
1/03/2020,Morocco,Johor,44,33,11
1/03/2020,Morocco,Kedah,2,1,1
1/03/2020,Morocco,Kelantan,0,0,0
1/03/2020,Morocco,Melaka,0,0,0
1/03/2020,Morocco,Pahang,0,0,0
1/03/2020,Morocco,Perak,0,0,0
1/03/2020,Morocco,Perlis,0,0,0
1/03/2020,Morocco,Pulau Pinang,2,2,0
1/03/2020,Morocco,Sabah,2,1,1
1/03/2020,Morocco,Sarawak,1,1,0
1/03/2020,Morocco,Selangor,324,176,148
1/03/2020,Morocco,W.P. Labuan,1,1,0
1/03/2020,Monaco,Johor,0,0,0
1/03/2020,Monaco,Kedah,0,0,0
1/03/2020,Monaco,Sabah,0,0,0
1/03/2020,Monaco,Selangor,2,1,1
1/03/2020,"Moldova, Republic of",Johor,5,2,3
1/03/2020,"Moldova, Republic of",Kedah,3,1,2
1/03/2020,"Moldova, Republic of",Kelantan,0,0,0
1/03/2020,"Moldova, Republic of",Negeri Sembilan,0,0,0
1/03/2020,"Moldova, Republic of",Perlis,0,0,0
1/03/2020,"Moldova, Republic of",Pulau Pinang,2,1,1
1/03/2020,"Moldova, Republic of",Sabah,0,0,0
1/03/2020,"Moldova, Republic of",Sarawak,0,0,0
1/03/2020,"Moldova, Republic of",Selangor,21,10,11
1/03/2020,Madagascar,Johor,2,2,0
1/03/2020,Madagascar,Kedah,1,0,1
1/03/2020,Madagascar,Perak,0,0,0
1/03/2020,Madagascar,Perlis,0,0,0
1/03/2020,Madagascar,Pulau Pinang,0,0,0
1/03/2020,Madagascar,Sabah,0,0,0
1/03/2020,Madagascar,Sarawak,0,0,0
1/03/2020,Madagascar,Selangor,25,12,13
1/03/2020,Maldives,Johor,23,15,8
1/03/2020,Maldives,Kedah,0,0,0
1/03/2020,Maldives,Kelantan,0,0,0
1/03/2020,Maldives,Perak,0,0,0
1/03/2020,Maldives,Perlis,1,1,0
1/03/2020,Maldives,Pulau Pinang,3,2,1
1/03/2020,Maldives,Sabah,2,2,0
1/03/2020,Maldives,Sarawak,0,0,0
1/03/2020,Maldives,Selangor,951,546,405
1/03/2020,Mexico,Johor,50,29,21
1/03/2020,Mexico,Kedah,5,3,2
1/03/2020,Mexico,Kelantan,1,1,0
1/03/2020,Mexico,Pahang,0,0,0
1/03/2020,Mexico,Perak,0,0,0
1/03/2020,Mexico,Perlis,2,2,0
1/03/2020,Mexico,Pulau Pinang,8,4,4
1/03/2020,Mexico,Sabah,1,1,0
1/03/2020,Mexico,Sarawak,5,3,2
1/03/2020,Mexico,Selangor,201,101,100
1/03/2020,Mexico,W.P. Labuan,0,0,0
1/03/2020,Marshall Islands,Johor,2,1,1
1/03/2020,Marshall Islands,Kedah,0,0,0
1/03/2020,Marshall Islands,Perak,0,0,0
1/03/2020,Marshall Islands,Pulau Pinang,0,0,0
1/03/2020,Marshall Islands,Sabah,0,0,0
1/03/2020,Marshall Islands,Selangor,3,2,1
1/03/2020,North Macedonia,Johor,1,0,1
1/03/2020,North Macedonia,Kedah,1,0,1
1/03/2020,North Macedonia,Perak,0,0,0
1/03/2020,North Macedonia,Pulau Pinang,0,0,0
1/03/2020,North Macedonia,Sabah,0,0,0
1/03/2020,North Macedonia,Sarawak,3,3,0
1/03/2020,North Macedonia,Selangor,12,8,4
1/03/2020,Mali,Johor,3,3,0
1/03/2020,Mali,Sabah,0,0,0
1/03/2020,Mali,Selangor,9,7,2
1/03/2020,Malta,Johor,4,3,1
1/03/2020,Malta,Kedah,0,0,0
1/03/2020,Malta,Kelantan,0,0,0
1/03/2020,Malta,Perak,0,0,0
1/03/2020,Malta,Perlis,0,0,0
1/03/2020,Malta,Pulau Pinang,1,1,0
1/03/2020,Malta,Sabah,0,0,0
1/03/2020,Malta,Sarawak,0,0,0
1/03/2020,Malta,Selangor,8,7,1
1/03/2020,Malta,W.P. Labuan,0,0,0
1/03/2020,Myanmar,Johor,1309,453,856
1/03/2020,Myanmar,Kedah,8,2,6
1/03/2020,Myanmar,Kelantan,4,1,3
1/03/2020,Myanmar,Negeri Sembilan,0,0,0
1/03/2020,Myanmar,Pahang,6,6,0
1/03/2020,Myanmar,Perak,6,1,5
1/03/2020,Myanmar,Perlis,1,1,0
1/03/2020,Myanmar,Pulau Pinang,163,115,48
1/03/2020,Myanmar,Sabah,5,2,3
1/03/2020,Myanmar,Sarawak,13,10,3
1/03/2020,Myanmar,Selangor,4948,3764,1184
1/03/2020,Myanmar,Terengganu,0,0,0
1/03/2020,Myanmar,W.P. Labuan,0,0,0
1/03/2020,Montenegro,Johor,0,0,0
1/03/2020,Montenegro,Kedah,0,0,0
1/03/2020,Montenegro,Pulau Pinang,0,0,0
1/03/2020,Montenegro,Sabah,0,0,0
1/03/2020,Montenegro,Sarawak,0,0,0
1/03/2020,Montenegro,Selangor,7,5,2
1/03/2020,Mongolia,Johor,34,17,17
1/03/2020,Mongolia,Kedah,18,3,15
1/03/2020,Mongolia,Kelantan,0,0,0
1/03/2020,Mongolia,Perak,0,0,0
1/03/2020,Mongolia,Perlis,1,1,0
1/03/2020,Mongolia,Pulau Pinang,5,2,3
1/03/2020,Mongolia,Sabah,0,0,0
1/03/2020,Mongolia,Sarawak,0,0,0
1/03/2020,Mongolia,Selangor,93,37,56
1/03/2020,Northern Mariana Islands,Selangor,0,0,0
1/03/2020,Mozambique,Johor,0,0,0
1/03/2020,Mozambique,Kedah,0,0,0
1/03/2020,Mozambique,Perak,0,0,0
1/03/2020,Mozambique,Pulau Pinang,0,0,0
1/03/2020,Mozambique,Sabah,0,0,0
1/03/2020,Mozambique,Sarawak,0,0,0
1/03/2020,Mozambique,Selangor,7,4,3
1/03/2020,Mauritania,Johor,0,0,0
1/03/2020,Mauritania,Kedah,0,0,0
1/03/2020,Mauritania,Pulau Pinang,0,0,0
1/03/2020,Mauritania,Sabah,0,0,0
1/03/2020,Mauritania,Sarawak,0,0,0
1/03/2020,Mauritania,Selangor,8,7,1
1/03/2020,Mauritius,Johor,35,22,13
1/03/2020,Mauritius,Kedah,1,1,0
1/03/2020,Mauritius,Kelantan,0,0,0
1/03/2020,Mauritius,Pahang,1,1,0
1/03/2020,Mauritius,Perak,0,0,0
1/03/2020,Mauritius,Perlis,0,0,0
1/03/2020,Mauritius,Pulau Pinang,0,0,0
1/03/2020,Mauritius,Sabah,2,1,1
1/03/2020,Mauritius,Sarawak,0,0,0
1/03/2020,Mauritius,Selangor,188,128,60
1/03/2020,Malawi,Johor,2,2,0
1/03/2020,Malawi,Pulau Pinang,0,0,0
1/03/2020,Malawi,Sabah,0,0,0
1/03/2020,Malawi,Sarawak,0,0,0
1/03/2020,Malawi,Selangor,4,3,1
1/03/2020,Mayotte,Selangor,0,0,0
1/03/2020,Namibia,Johor,0,0,0
1/03/2020,Namibia,Kedah,0,0,0
1/03/2020,Namibia,Perak,0,0,0
1/03/2020,Namibia,Perlis,1,0,1
1/03/2020,Namibia,Pulau Pinang,2,0,2
1/03/2020,Namibia,Sabah,0,0,0
1/03/2020,Namibia,Sarawak,0,0,0
1/03/2020,Namibia,Selangor,7,4,3
1/03/2020,New Caledonia,Selangor,0,0,0
1/03/2020,Niger,Johor,0,0,0
1/03/2020,Niger,Sabah,0,0,0
1/03/2020,Niger,Selangor,0,0,0
1/03/2020,Nigeria,Johor,6,6,0
1/03/2020,Nigeria,Kedah,0,0,0
1/03/2020,Nigeria,Perlis,0,0,0
1/03/2020,Nigeria,Pulau Pinang,3,2,1
1/03/2020,Nigeria,Sabah,0,0,0
1/03/2020,Nigeria,Sarawak,1,1,0
1/03/2020,Nigeria,Selangor,284,238,46
1/03/2020,Nicaragua,Johor,0,0,0
1/03/2020,Nicaragua,Kedah,1,1,0
1/03/2020,Nicaragua,Pulau Pinang,0,0,0
1/03/2020,Nicaragua,Sabah,0,0,0
1/03/2020,Nicaragua,Selangor,2,1,1
1/03/2020,Netherlands,Johor,511,344,167
1/03/2020,Netherlands,Kedah,217,130,87
1/03/2020,Netherlands,Kelantan,14,10,4
1/03/2020,Netherlands,Melaka,2,0,2
1/03/2020,Netherlands,Negeri Sembilan,0,0,0
1/03/2020,Netherlands,Pahang,2,1,1
1/03/2020,Netherlands,Perak,2,2,0
1/03/2020,Netherlands,Perlis,27,16,11
1/03/2020,Netherlands,Pulau Pinang,108,71,37
1/03/2020,Netherlands,Sabah,40,23,17
1/03/2020,Netherlands,Sarawak,84,64,20
1/03/2020,Netherlands,Selangor,2187,1297,890
1/03/2020,Netherlands,Terengganu,0,0,0
1/03/2020,Netherlands,W.P. Labuan,1,0,1
1/03/2020,Norway,Johor,70,50,20
1/03/2020,Norway,Kedah,73,32,41
1/03/2020,Norway,Kelantan,0,0,0
1/03/2020,Norway,Melaka,0,0,0
1/03/2020,Norway,Pahang,0,0,0
1/03/2020,Norway,Perak,1,1,0
1/03/2020,Norway,Perlis,8,4,4
1/03/2020,Norway,Pulau Pinang,20,13,7
1/03/2020,Norway,Sabah,3,3,0
1/03/2020,Norway,Sarawak,16,11,5
1/03/2020,Norway,Selangor,400,212,188
1/03/2020,Norway,W.P. Labuan,0,0,0
1/03/2020,Nepal,Johor,123,110,13
1/03/2020,Nepal,Kedah,2,1,1
1/03/2020,Nepal,Pahang,0,0,0
1/03/2020,Nepal,Perak,0,0,0
1/03/2020,Nepal,Perlis,0,0,0
1/03/2020,Nepal,Pulau Pinang,65,58,7
1/03/2020,Nepal,Sabah,46,46,0
1/03/2020,Nepal,Sarawak,48,36,12
1/03/2020,Nepal,Selangor,5976,5665,311
1/03/2020,Nepal,W.P. Labuan,14,13,1
1/03/2020,Nauru,Johor,0,0,0
1/03/2020,Nauru,Pulau Pinang,0,0,0
1/03/2020,Nauru,Selangor,0,0,0
1/03/2020,New Zealand,Johor,221,148,73
1/03/2020,New Zealand,Kedah,39,23,16
1/03/2020,New Zealand,Kelantan,2,2,0
1/03/2020,New Zealand,Melaka,0,0,0
1/03/2020,New Zealand,Negeri Sembilan,0,0,0
1/03/2020,New Zealand,Pahang,0,0,0
1/03/2020,New Zealand,Perak,10,6,4
1/03/2020,New Zealand,Perlis,7,6,1
1/03/2020,New Zealand,Pulau Pinang,71,38,33
1/03/2020,New Zealand,Sabah,18,5,13
1/03/2020,New Zealand,Sarawak,54,36,18
1/03/2020,New Zealand,Selangor,889,555,334
1/03/2020,New Zealand,Terengganu,0,0,0
1/03/2020,New Zealand,W.P. Labuan,0,0,0
1/03/2020,Oman,Johor,0,0,0
1/03/2020,Oman,Kedah,4,3,1
1/03/2020,Oman,Kelantan,0,0,0
1/03/2020,Oman,Melaka,0,0,0
1/03/2020,Oman,Perak,0,0,0
1/03/2020,Oman,Perlis,0,0,0
1/03/2020,Oman,Pulau Pinang,5,3,2
1/03/2020,Oman,Sabah,0,0,0
1/03/2020,Oman,Sarawak,3,3,0
1/03/2020,Oman,Selangor,175,124,51
1/03/2020,Pakistan,Johor,396,308,88
1/03/2020,Pakistan,Kedah,31,21,10
1/03/2020,Pakistan,Kelantan,5,5,0
1/03/2020,Pakistan,Melaka,0,0,0
1/03/2020,Pakistan,Negeri Sembilan,0,0,0
1/03/2020,Pakistan,Pahang,0,0,0
1/03/2020,Pakistan,Perak,2,2,0
1/03/2020,Pakistan,Perlis,9,8,1
1/03/2020,Pakistan,Pulau Pinang,16,15,1
1/03/2020,Pakistan,Sabah,3,3,0
1/03/2020,Pakistan,Sarawak,162,157,5
1/03/2020,Pakistan,Selangor,5966,5345,621
1/03/2020,Pakistan,W.P. Labuan,4,4,0
1/03/2020,Panama,Johor,1,1,0
1/03/2020,Panama,Kedah,0,0,0
1/03/2020,Panama,Perak,0,0,0
1/03/2020,Panama,Perlis,0,0,0
1/03/2020,Panama,Pulau Pinang,0,0,0
1/03/2020,Panama,Sabah,0,0,0
1/03/2020,Panama,Sarawak,0,0,0
1/03/2020,Panama,Selangor,8,3,5
1/03/2020,Peru,Johor,8,5,3
1/03/2020,Peru,Kedah,2,0,2
1/03/2020,Peru,Kelantan,0,0,0
1/03/2020,Peru,Pahang,0,0,0
1/03/2020,Peru,Perak,0,0,0
1/03/2020,Peru,Perlis,2,2,0
1/03/2020,Peru,Pulau Pinang,1,1,0
1/03/2020,Peru,Sabah,1,1,0
1/03/2020,Peru,Sarawak,2,1,1
1/03/2020,Peru,Selangor,48,24,24
1/03/2020,Peru,W.P. Labuan,0,0,0
1/03/2020,Philippines,Johor,6568,2051,4517
1/03/2020,Philippines,Kedah,746,257,489
1/03/2020,Philippines,Kelantan,36,23,13
1/03/2020,Philippines,Melaka,0,0,0
1/03/2020,Philippines,Negeri Sembilan,0,0,0
1/03/2020,Philippines,Pahang,15,12,3
1/03/2020,Philippines,Perak,25,8,17
1/03/2020,Philippines,Perlis,138,45,93
1/03/2020,Philippines,Pulau Pinang,205,54,151
1/03/2020,Philippines,Sabah,1062,594,468
1/03/2020,Philippines,Sarawak,1281,582,699
1/03/2020,Philippines,Selangor,5551,2651,2900
1/03/2020,Philippines,Terengganu,0,0,0
1/03/2020,Philippines,W.P. Labuan,133,62,71
1/03/2020,Palau,Johor,0,0,0
1/03/2020,Palau,Pulau Pinang,0,0,0
1/03/2020,Palau,Selangor,0,0,0
1/03/2020,Papua New Guinea,Johor,5,5,0
1/03/2020,Papua New Guinea,Kedah,0,0,0
1/03/2020,Papua New Guinea,Kelantan,0,0,0
1/03/2020,Papua New Guinea,Perak,0,0,0
1/03/2020,Papua New Guinea,Pulau Pinang,0,0,0
1/03/2020,Papua New Guinea,Sabah,3,2,1
1/03/2020,Papua New Guinea,Sarawak,2,1,1
1/03/2020,Papua New Guinea,Selangor,13,8,5
1/03/2020,Poland,Johor,166,100,66
1/03/2020,Poland,Kedah,104,54,50
1/03/2020,Poland,Kelantan,1,0,1
1/03/2020,Poland,Melaka,0,0,0
1/03/2020,Poland,Negeri Sembilan,0,0,0
1/03/2020,Poland,Pahang,0,0,0
1/03/2020,Poland,Perak,0,0,0
1/03/2020,Poland,Perlis,19,9,10
1/03/2020,Poland,Pulau Pinang,33,16,17
1/03/2020,Poland,Sabah,31,17,14
1/03/2020,Poland,Sarawak,33,22,11
1/03/2020,Poland,Selangor,749,394,355
1/03/2020,Poland,Terengganu,0,0,0
1/03/2020,Poland,W.P. Labuan,14,10,4
1/03/2020,"North Korea, Democratic People's Republic of",Selangor,0,0,0
1/03/2020,Portugal,Johor,56,35,21
1/03/2020,Portugal,Kedah,28,18,10
1/03/2020,Portugal,Kelantan,0,0,0
1/03/2020,Portugal,Melaka,0,0,0
1/03/2020,Portugal,Pahang,0,0,0
1/03/2020,Portugal,Perak,0,0,0
1/03/2020,Portugal,Perlis,2,2,0
1/03/2020,Portugal,Pulau Pinang,10,6,4
1/03/2020,Portugal,Sabah,13,6,7
1/03/2020,Portugal,Sarawak,4,2,2
1/03/2020,Portugal,Selangor,234,138,96
1/03/2020,Portugal,W.P. Labuan,0,0,0
1/03/2020,Paraguay,Johor,0,0,0
1/03/2020,Paraguay,Kedah,0,0,0
1/03/2020,Paraguay,Perak,0,0,0
1/03/2020,Paraguay,Perlis,0,0,0
1/03/2020,Paraguay,Pulau Pinang,0,0,0
1/03/2020,Paraguay,Sabah,0,0,0
1/03/2020,Paraguay,Sarawak,0,0,0
1/03/2020,Paraguay,Selangor,11,3,8
1/03/2020,"Palestine, State of",Johor,3,3,0
1/03/2020,"Palestine, State of",Kedah,0,0,0
1/03/2020,"Palestine, State of",Kelantan,0,0,0
1/03/2020,"Palestine, State of",Melaka,0,0,0
1/03/2020,"Palestine, State of",Perak,0,0,0
1/03/2020,"Palestine, State of",Perlis,0,0,0
1/03/2020,"Palestine, State of",Pulau Pinang,1,1,0
1/03/2020,"Palestine, State of",Sabah,0,0,0
1/03/2020,"Palestine, State of",Sarawak,1,1,0
1/03/2020,"Palestine, State of",Selangor,196,163,33
1/03/2020,Qatar,Johor,0,0,0
1/03/2020,Qatar,Kedah,1,1,0
1/03/2020,Qatar,Perlis,0,0,0
1/03/2020,Qatar,Pulau Pinang,0,0,0
1/03/2020,Qatar,Sabah,0,0,0
1/03/2020,Qatar,Sarawak,0,0,0
1/03/2020,Qatar,Selangor,6,6,0
1/03/2020,Réunion,Johor,0,0,0
1/03/2020,Réunion,Sarawak,0,0,0
1/03/2020,Romania,Johor,54,35,19
1/03/2020,Romania,Kedah,36,18,18
1/03/2020,Romania,Kelantan,1,1,0
1/03/2020,Romania,Negeri Sembilan,0,0,0
1/03/2020,Romania,Pahang,0,0,0
1/03/2020,Romania,Perak,0,0,0
1/03/2020,Romania,Perlis,1,1,0
1/03/2020,Romania,Pulau Pinang,8,4,4
1/03/2020,Romania,Sabah,4,2,2
1/03/2020,Romania,Sarawak,7,5,2
1/03/2020,Romania,Selangor,385,191,194
1/03/2020,Romania,W.P. Labuan,3,2,1
1/03/2020,Russian Federation (Russia),Johor,218,130,88
1/03/2020,Russian Federation (Russia),Kedah,561,250,311
1/03/2020,Russian Federation (Russia),Kelantan,69,34,35
1/03/2020,Russian Federation (Russia),Melaka,0,0,0
1/03/2020,Russian Federation (Russia),Negeri Sembilan,0,0,0
1/03/2020,Russian Federation (Russia),Pahang,3,3,0
1/03/2020,Russian Federation (Russia),Perak,3,1,2
1/03/2020,Russian Federation (Russia),Perlis,167,81,86
1/03/2020,Russian Federation (Russia),Pulau Pinang,83,39,44
1/03/2020,Russian Federation (Russia),Sabah,46,24,22
1/03/2020,Russian Federation (Russia),Sarawak,42,21,21
1/03/2020,Russian Federation (Russia),Selangor,4991,2199,2792
1/03/2020,Russian Federation (Russia),W.P. Labuan,9,6,3
1/03/2020,Rwanda,Johor,1,1,0
1/03/2020,Rwanda,Kedah,0,0,0
1/03/2020,Rwanda,Pulau Pinang,0,0,0
1/03/2020,Rwanda,Selangor,1,0,1
1/03/2020,Saudi Arabia,Johor,13,11,2
1/03/2020,Saudi Arabia,Kedah,1,1,0
1/03/2020,Saudi Arabia,Kelantan,1,1,0
1/03/2020,Saudi Arabia,Melaka,0,0,0
1/03/2020,Saudi Arabia,Perak,0,0,0
1/03/2020,Saudi Arabia,Perlis,0,0,0
1/03/2020,Saudi Arabia,Pulau Pinang,11,6,5
1/03/2020,Saudi Arabia,Sabah,0,0,0
1/03/2020,Saudi Arabia,Sarawak,0,0,0
1/03/2020,Saudi Arabia,Selangor,984,600,384
1/03/2020,Saudi Arabia,W.P. Labuan,0,0,0
1/03/2020,Sudan,Johor,2,2,0
1/03/2020,Sudan,Kedah,0,0,0
1/03/2020,Sudan,Kelantan,0,0,0
1/03/2020,Sudan,Perlis,0,0,0
1/03/2020,Sudan,Pulau Pinang,0,0,0
1/03/2020,Sudan,Sabah,0,0,0
1/03/2020,Sudan,Sarawak,0,0,0
1/03/2020,Sudan,Selangor,373,233,140
1/03/2020,Sudan,W.P. Labuan,0,0,0
1/03/2020,Senegal,Johor,6,6,0
1/03/2020,Senegal,Kedah,0,0,0
1/03/2020,Senegal,Kelantan,0,0,0
1/03/2020,Senegal,Perak,0,0,0
1/03/2020,Senegal,Perlis,0,0,0
1/03/2020,Senegal,Pulau Pinang,0,0,0
1/03/2020,Senegal,Sabah,0,0,0
1/03/2020,Senegal,Sarawak,0,0,0
1/03/2020,Senegal,Selangor,19,17,2
1/03/2020,Singapore,Johor,567130,351191,215939
1/03/2020,Singapore,Kedah,1328,723,605
1/03/2020,Singapore,Kelantan,201,107,94
1/03/2020,Singapore,Melaka,6,6,0
1/03/2020,Singapore,Negeri Sembilan,2,1,1
1/03/2020,Singapore,Pahang,196,92,104
1/03/2020,Singapore,Perak,1516,769,747
1/03/2020,Singapore,Perlis,58,35,23
1/03/2020,Singapore,Pulau Pinang,4627,2411,2216
1/03/2020,Singapore,Sabah,814,454,360
1/03/2020,Singapore,Sarawak,837,515,322
1/03/2020,Singapore,Selangor,11654,6915,4739
1/03/2020,Singapore,Terengganu,9,8,1
1/03/2020,Singapore,W.P. Labuan,13,9,4
1/03/2020,South Georgia and the South Sandwich Islands,Johor,0,0,0
1/03/2020,South Georgia and the South Sandwich Islands,Sabah,0,0,0
1/03/2020,South Georgia and the South Sandwich Islands,Selangor,0,0,0
1/03/2020,Saint Helena,Sarawak,0,0,0
1/03/2020,Solomon Islands,Johor,1,1,0
1/03/2020,Solomon Islands,Perlis,0,0,0
1/03/2020,Solomon Islands,Pulau Pinang,0,0,0
1/03/2020,Solomon Islands,Sabah,0,0,0
1/03/2020,Solomon Islands,Sarawak,0,0,0
1/03/2020,Solomon Islands,Selangor,1,1,0
1/03/2020,Solomon Islands,W.P. Labuan,0,0,0
1/03/2020,Sierra Leone,Johor,0,0,0
1/03/2020,Sierra Leone,Kedah,0,0,0
1/03/2020,Sierra Leone,Perak,0,0,0
1/03/2020,Sierra Leone,Pulau Pinang,0,0,0
1/03/2020,Sierra Leone,Sabah,0,0,0
1/03/2020,Sierra Leone,Selangor,25,15,10
1/03/2020,El Salvador,Johor,0,0,0
1/03/2020,El Salvador,Kedah,0,0,0
1/03/2020,El Salvador,Perak,0,0,0
1/03/2020,El Salvador,Perlis,0,0,0
1/03/2020,El Salvador,Pulau Pinang,0,0,0
1/03/2020,El Salvador,Sabah,0,0,0
1/03/2020,El Salvador,Selangor,7,5,2
1/03/2020,El Salvador,W.P. Labuan,0,0,0
1/03/2020,San Marino,Johor,0,0,0
1/03/2020,San Marino,Selangor,1,1,0
1/03/2020,Somalia,Johor,0,0,0
1/03/2020,Somalia,Kedah,0,0,0
1/03/2020,Somalia,Kelantan,0,0,0
1/03/2020,Somalia,Perlis,0,0,0
1/03/2020,Somalia,Sabah,0,0,0
1/03/2020,Somalia,Sarawak,0,0,0
1/03/2020,Somalia,Selangor,153,98,55
1/03/2020,Serbia,Johor,3,1,2
1/03/2020,Serbia,Kedah,3,1,2
1/03/2020,Serbia,Kelantan,0,0,0
1/03/2020,Serbia,Pahang,0,0,0
1/03/2020,Serbia,Perak,0,0,0
1/03/2020,Serbia,Perlis,0,0,0
1/03/2020,Serbia,Pulau Pinang,2,2,0
1/03/2020,Serbia,Sabah,1,1,0
1/03/2020,Serbia,Sarawak,0,0,0
1/03/2020,Serbia,Selangor,28,18,10
1/03/2020,South Sudan,Johor,0,0,0
1/03/2020,South Sudan,Kedah,0,0,0
1/03/2020,South Sudan,Sarawak,0,0,0
1/03/2020,South Sudan,Selangor,11,8,3
1/03/2020,South Sudan,W.P. Labuan,0,0,0
1/03/2020,Sao Tome and Principe,Selangor,0,0,0
1/03/2020,Suriname,Johor,0,0,0
1/03/2020,Suriname,Kedah,0,0,0
1/03/2020,Suriname,Kelantan,0,0,0
1/03/2020,Suriname,Perak,0,0,0
1/03/2020,Suriname,Perlis,0,0,0
1/03/2020,Suriname,Pulau Pinang,0,0,0
1/03/2020,Suriname,Sabah,0,0,0
1/03/2020,Suriname,Sarawak,0,0,0
1/03/2020,Suriname,Selangor,9,5,4
1/03/2020,Slovakia,Johor,14,12,2
1/03/2020,Slovakia,Kedah,141,67,74
1/03/2020,Slovakia,Kelantan,2,2,0
1/03/2020,Slovakia,Negeri Sembilan,0,0,0
1/03/2020,Slovakia,Pahang,0,0,0
1/03/2020,Slovakia,Perak,0,0,0
1/03/2020,Slovakia,Perlis,0,0,0
1/03/2020,Slovakia,Pulau Pinang,2,1,1
1/03/2020,Slovakia,Sabah,11,4,7
1/03/2020,Slovakia,Sarawak,4,2,2
1/03/2020,Slovakia,Selangor,218,103,115
1/03/2020,Slovakia,W.P. Labuan,1,1,0
1/03/2020,Slovenia,Johor,5,3,2
1/03/2020,Slovenia,Kedah,15,7,8
1/03/2020,Slovenia,Kelantan,0,0,0
1/03/2020,Slovenia,Perak,0,0,0
1/03/2020,Slovenia,Perlis,0,0,0
1/03/2020,Slovenia,Pulau Pinang,0,0,0
1/03/2020,Slovenia,Sabah,1,1,0
1/03/2020,Slovenia,Sarawak,0,0,0
1/03/2020,Slovenia,Selangor,43,23,20
1/03/2020,Slovenia,W.P. Labuan,0,0,0
1/03/2020,Sweden,Johor,142,83,59
1/03/2020,Sweden,Kedah,286,128,158
1/03/2020,Sweden,Kelantan,5,4,1
1/03/2020,Sweden,Melaka,1,0,1
1/03/2020,Sweden,Negeri Sembilan,0,0,0
1/03/2020,Sweden,Pahang,0,0,0
1/03/2020,Sweden,Perak,0,0,0
1/03/2020,Sweden,Perlis,16,14,2
1/03/2020,Sweden,Pulau Pinang,58,38,20
1/03/2020,Sweden,Sabah,17,10,7
1/03/2020,Sweden,Sarawak,12,7,5
1/03/2020,Sweden,Selangor,839,469,370
1/03/2020,Sweden,W.P. Labuan,4,3,1
1/03/2020,Eswatini,Johor,0,0,0
1/03/2020,Eswatini,Kedah,0,0,0
1/03/2020,Eswatini,Pulau Pinang,0,0,0
1/03/2020,Eswatini,Sabah,0,0,0
1/03/2020,Eswatini,Selangor,6,2,4
1/03/2020,Seychelles,Johor,0,0,0
1/03/2020,Seychelles,Kedah,0,0,0
1/03/2020,Seychelles,Pulau Pinang,0,0,0
1/03/2020,Seychelles,Sabah,0,0,0
1/03/2020,Seychelles,Sarawak,0,0,0
1/03/2020,Seychelles,Selangor,25,8,17
1/03/2020,Syrian Arab Republic,Johor,3,2,1
1/03/2020,Syrian Arab Republic,Kedah,2,2,0
1/03/2020,Syrian Arab Republic,Kelantan,0,0,0
1/03/2020,Syrian Arab Republic,Pahang,0,0,0
1/03/2020,Syrian Arab Republic,Perlis,0,0,0
1/03/2020,Syrian Arab Republic,Pulau Pinang,0,0,0
1/03/2020,Syrian Arab Republic,Sabah,0,0,0
1/03/2020,Syrian Arab Republic,Sarawak,0,0,0
1/03/2020,Syrian Arab Republic,Selangor,336,264,72
1/03/2020,Syrian Arab Republic,W.P. Labuan,0,0,0
1/03/2020,Turks and Caicos Islands,Perlis,0,0,0
1/03/2020,TCD,Johor,0,0,0
1/03/2020,TCD,Kedah,0,0,0
1/03/2020,TCD,Perlis,0,0,0
1/03/2020,TCD,Selangor,5,5,0
1/03/2020,Togo,Johor,0,0,0
1/03/2020,Togo,Perak,0,0,0
1/03/2020,Togo,Pulau Pinang,0,0,0
1/03/2020,Togo,Selangor,4,4,0
1/03/2020,Thailand,Johor,1928,438,1490
1/03/2020,Thailand,Kedah,26140,11342,14798
1/03/2020,Thailand,Kelantan,19386,10005,9381
1/03/2020,Thailand,Melaka,1,1,0
1/03/2020,Thailand,Negeri Sembilan,2,2,0
1/03/2020,Thailand,Pahang,0,0,0
1/03/2020,Thailand,Perak,7402,3404,3998
1/03/2020,Thailand,Perlis,27314,15943,11371
1/03/2020,Thailand,Pulau Pinang,425,172,253
1/03/2020,Thailand,Sabah,75,15,60
1/03/2020,Thailand,Sarawak,275,97,178
1/03/2020,Thailand,Selangor,3221,1307,1914
1/03/2020,Thailand,Terengganu,3,3,0
1/03/2020,Thailand,W.P. Labuan,5,2,3
1/03/2020,Tajikistan,Johor,3,3,0
1/03/2020,Tajikistan,Kedah,0,0,0
1/03/2020,Tajikistan,Perlis,0,0,0
1/03/2020,Tajikistan,Pulau Pinang,0,0,0
1/03/2020,Tajikistan,Sabah,0,0,0
1/03/2020,Tajikistan,Selangor,54,41,13
1/03/2020,Tokelau,Selangor,0,0,0
1/03/2020,Turkmenistan,Johor,1,0,1
1/03/2020,Turkmenistan,Kedah,0,0,0
1/03/2020,Turkmenistan,Kelantan,0,0,0
1/03/2020,Turkmenistan,Perlis,1,1,0
1/03/2020,Turkmenistan,Pulau Pinang,0,0,0
1/03/2020,Turkmenistan,Sabah,0,0,0
1/03/2020,Turkmenistan,Sarawak,0,0,0
1/03/2020,Turkmenistan,Selangor,29,18,11
1/03/2020,Timor-Leste,Johor,0,0,0
1/03/2020,Timor-Leste,Kedah,0,0,0
1/03/2020,Timor-Leste,Perlis,0,0,0
1/03/2020,Timor-Leste,Pulau Pinang,1,0,1
1/03/2020,Timor-Leste,Sabah,0,0,0
1/03/2020,Timor-Leste,Sarawak,1,1,0
1/03/2020,Timor-Leste,Selangor,26,14,12
1/03/2020,Tonga,Johor,0,0,0
1/03/2020,Tonga,Pulau Pinang,0,0,0
1/03/2020,Tonga,Sarawak,0,0,0
1/03/2020,Tonga,Selangor,2,1,1
1/03/2020,Trinidad and Tobago,Johor,7,7,0
1/03/2020,Trinidad and Tobago,Kedah,0,0,0
1/03/2020,Trinidad and Tobago,Pahang,0,0,0
1/03/2020,Trinidad and Tobago,Pulau Pinang,0,0,0
1/03/2020,Trinidad and Tobago,Sabah,0,0,0
1/03/2020,Trinidad and Tobago,Sarawak,0,0,0
1/03/2020,Trinidad and Tobago,Selangor,13,8,5
1/03/2020,Tunisia,Johor,6,2,4
1/03/2020,Tunisia,Kedah,3,2,1
1/03/2020,Tunisia,Kelantan,0,0,0
1/03/2020,Tunisia,Melaka,0,0,0
1/03/2020,Tunisia,Perak,0,0,0
1/03/2020,Tunisia,Perlis,0,0,0
1/03/2020,Tunisia,Pulau Pinang,0,0,0
1/03/2020,Tunisia,Sabah,0,0,0
1/03/2020,Tunisia,Sarawak,0,0,0
1/03/2020,Tunisia,Selangor,128,70,58
1/03/2020,Tunisia,W.P. Labuan,0,0,0
1/03/2020,Türkiye,Johor,70,63,7
1/03/2020,Türkiye,Kedah,26,19,7
1/03/2020,Türkiye,Kelantan,1,1,0
1/03/2020,Türkiye,Melaka,0,0,0
1/03/2020,Türkiye,Negeri Sembilan,0,0,0
1/03/2020,Türkiye,Pahang,0,0,0
1/03/2020,Türkiye,Perak,0,0,0
1/03/2020,Türkiye,Perlis,6,5,1
1/03/2020,Türkiye,Pulau Pinang,13,8,5
1/03/2020,Türkiye,Sabah,3,3,0
1/03/2020,Türkiye,Sarawak,7,6,1
1/03/2020,Türkiye,Selangor,364,284,80
1/03/2020,Türkiye,W.P. Labuan,1,1,0
1/03/2020,Tuvalu,Selangor,0,0,0
1/03/2020,"Taiwan, Province of China",Johor,1199,463,736
1/03/2020,"Taiwan, Province of China",Kedah,31,23,8
1/03/2020,"Taiwan, Province of China",Kelantan,4,2,2
1/03/2020,"Taiwan, Province of China",Melaka,2,0,2
1/03/2020,"Taiwan, Province of China",Negeri Sembilan,0,0,0
1/03/2020,"Taiwan, Province of China",Pahang,0,0,0
1/03/2020,"Taiwan, Province of China",Perak,12,4,8
1/03/2020,"Taiwan, Province of China",Perlis,4,4,0
1/03/2020,"Taiwan, Province of China",Pulau Pinang,322,203,119
1/03/2020,"Taiwan, Province of China",Sabah,368,188,180
1/03/2020,"Taiwan, Province of China",Sarawak,55,22,33
1/03/2020,"Taiwan, Province of China",Selangor,2288,1430,858
1/03/2020,"Taiwan, Province of China",W.P. Labuan,6,5,1
1/03/2020,"Tanzania, United Republic of",Johor,7,5,2
1/03/2020,"Tanzania, United Republic of",Kedah,0,0,0
1/03/2020,"Tanzania, United Republic of",Perak,0,0,0
1/03/2020,"Tanzania, United Republic of",Perlis,0,0,0
1/03/2020,"Tanzania, United Republic of",Pulau Pinang,0,0,0
1/03/2020,"Tanzania, United Republic of",Sabah,4,1,3
1/03/2020,"Tanzania, United Republic of",Sarawak,0,0,0
1/03/2020,"Tanzania, United Republic of",Selangor,72,34,38
1/03/2020,Uganda,Johor,5,1,4
1/03/2020,Uganda,Kedah,0,0,0
1/03/2020,Uganda,Perak,0,0,0
1/03/2020,Uganda,Perlis,0,0,0
1/03/2020,Uganda,Pulau Pinang,0,0,0
1/03/2020,Uganda,Sabah,0,0,0
1/03/2020,Uganda,Sarawak,1,1,0
1/03/2020,Uganda,Selangor,50,29,21
1/03/2020,Ukraine,Johor,74,39,35
1/03/2020,Ukraine,Kedah,122,59,63
1/03/2020,Ukraine,Kelantan,8,3,5
1/03/2020,Ukraine,Melaka,0,0,0
1/03/2020,Ukraine,Negeri Sembilan,0,0,0
1/03/2020,Ukraine,Pahang,6,6,0
1/03/2020,Ukraine,Perak,1,1,0
1/03/2020,Ukraine,Perlis,15,8,7
1/03/2020,Ukraine,Pulau Pinang,40,18,22
1/03/2020,Ukraine,Sabah,7,3,4
1/03/2020,Ukraine,Sarawak,7,6,1
1/03/2020,Ukraine,Selangor,978,513,465
1/03/2020,Ukraine,W.P. Labuan,11,7,4
1/03/2020,Uruguay,Johor,186,87,99
1/03/2020,Uruguay,Kedah,1,1,0
1/03/2020,Uruguay,Kelantan,27,10,17
1/03/2020,Uruguay,Perak,0,0,0
1/03/2020,Uruguay,Perlis,1,0,1
1/03/2020,Uruguay,Pulau Pinang,5,2,3
1/03/2020,Uruguay,Sabah,0,0,0
1/03/2020,Uruguay,Sarawak,0,0,0
1/03/2020,Uruguay,Selangor,86,33,53
1/03/2020,Uruguay,W.P. Labuan,0,0,0
1/03/2020,United States of America,Johor,1236,807,429
1/03/2020,United States of America,Kedah,232,143,89
1/03/2020,United States of America,Kelantan,27,17,10
1/03/2020,United States of America,Melaka,2,2,0
1/03/2020,United States of America,Negeri Sembilan,0,0,0
1/03/2020,United States of America,Pahang,4,3,1
1/03/2020,United States of America,Perak,23,14,9
1/03/2020,United States of America,Perlis,53,34,19
1/03/2020,United States of America,Pulau Pinang,449,277,172
1/03/2020,United States of America,Sabah,141,84,57
1/03/2020,United States of America,Sarawak,86,40,46
1/03/2020,United States of America,Selangor,4577,2883,1694
1/03/2020,United States of America,Terengganu,0,0,0
1/03/2020,United States of America,W.P. Labuan,11,8,3
1/03/2020,Uzbekistan,Johor,20,11,9
1/03/2020,Uzbekistan,Kedah,26,3,23
1/03/2020,Uzbekistan,Kelantan,0,0,0
1/03/2020,Uzbekistan,Perak,1,1,0
1/03/2020,Uzbekistan,Perlis,1,0,1
1/03/2020,Uzbekistan,Pulau Pinang,3,2,1
1/03/2020,Uzbekistan,Sabah,0,0,0
1/03/2020,Uzbekistan,Sarawak,1,1,0
1/03/2020,Uzbekistan,Selangor,454,286,168
1/03/2020,Holy See,Johor,0,0,0
1/03/2020,Holy See,Sarawak,0,0,0
1/03/2020,Holy See,Selangor,0,0,0
1/03/2020,Saint Vincent and the Grenadines,Johor,0,0,0
1/03/2020,Saint Vincent and the Grenadines,Kedah,0,0,0
1/03/2020,Saint Vincent and the Grenadines,Pulau Pinang,0,0,0
1/03/2020,Saint Vincent and the Grenadines,Sarawak,0,0,0
1/03/2020,Saint Vincent and the Grenadines,Selangor,0,0,0
1/03/2020,"Venezuela, Bolivarian Republic of",Johor,9,3,6
1/03/2020,"Venezuela, Bolivarian Republic of",Kedah,1,1,0
1/03/2020,"Venezuela, Bolivarian Republic of",Kelantan,0,0,0
1/03/2020,"Venezuela, Bolivarian Republic of",Melaka,0,0,0
1/03/2020,"Venezuela, Bolivarian Republic of",Perak,0,0,0
1/03/2020,"Venezuela, Bolivarian Republic of",Perlis,0,0,0
1/03/2020,"Venezuela, Bolivarian Republic of",Pulau Pinang,0,0,0
1/03/2020,"Venezuela, Bolivarian Republic of",Sabah,0,0,0
1/03/2020,"Venezuela, Bolivarian Republic of",Sarawak,1,0,1
1/03/2020,"Venezuela, Bolivarian Republic of",Selangor,40,23,17
1/03/2020,"Venezuela, Bolivarian Republic of",W.P. Labuan,0,0,0
1/03/2020,Viet Nam,Johor,3089,576,2513
1/03/2020,Viet Nam,Kedah,412,34,378
1/03/2020,Viet Nam,Kelantan,28,12,16
1/03/2020,Viet Nam,Melaka,0,0,0
1/03/2020,Viet Nam,Negeri Sembilan,0,0,0
1/03/2020,Viet Nam,Pahang,2,1,1
1/03/2020,Viet Nam,Perak,33,2,31
1/03/2020,Viet Nam,Perlis,100,23,77
1/03/2020,Viet Nam,Pulau Pinang,388,74,314
1/03/2020,Viet Nam,Sabah,17,5,12
1/03/2020,Viet Nam,Sarawak,352,98,254
1/03/2020,Viet Nam,Selangor,5528,1776,3752
1/03/2020,Viet Nam,Terengganu,0,0,0
1/03/2020,Viet Nam,W.P. Labuan,2,2,0
1/03/2020,Vanuatu,Johor,7,7,0
1/03/2020,Vanuatu,Kedah,0,0,0
1/03/2020,Vanuatu,Pulau Pinang,1,1,0
1/03/2020,Vanuatu,Sabah,1,1,0
1/03/2020,Vanuatu,Sarawak,0,0,0
1/03/2020,Vanuatu,Selangor,33,32,1
1/03/2020, Samoa,Johor,0,0,0
1/03/2020, Samoa,Sarawak,0,0,0
1/03/2020, Samoa,Selangor,1,0,1
1/03/2020,Yemen,Johor,9,6,3
1/03/2020,Yemen,Kedah,4,3,1
1/03/2020,Yemen,Kelantan,0,0,0
1/03/2020,Yemen,Melaka,5,3,2
1/03/2020,Yemen,Pahang,0,0,0
1/03/2020,Yemen,Perak,0,0,0
1/03/2020,Yemen,Perlis,0,0,0
1/03/2020,Yemen,Pulau Pinang,3,3,0
1/03/2020,Yemen,Sabah,0,0,0
1/03/2020,Yemen,Sarawak,0,0,0
1/03/2020,Yemen,Selangor,820,605,215
1/03/2020,Yemen,W.P. Labuan,0,0,0
1/03/2020,South Africa,Johor,85,54,31
1/03/2020,South Africa,Kedah,38,26,12
1/03/2020,South Africa,Kelantan,9,6,3
1/03/2020,South Africa,Melaka,0,0,0
1/03/2020,South Africa,Pahang,0,0,0
1/03/2020,South Africa,Perak,0,0,0
1/03/2020,South Africa,Perlis,3,1,2
1/03/2020,South Africa,Pulau Pinang,21,9,12
1/03/2020,South Africa,Sabah,6,4,2
1/03/2020,South Africa,Sarawak,28,17,11
1/03/2020,South Africa,Selangor,511,338,173
1/03/2020,South Africa,Terengganu,0,0,0
1/03/2020,South Africa,W.P. Labuan,0,0,0
1/03/2020,ZAR,Selangor,0,0,0
1/03/2020,Zambia,Johor,0,0,0
1/03/2020,Zambia,Kedah,1,1,0
1/03/2020,Zambia,Perak,0,0,0
1/03/2020,Zambia,Perlis,0,0,0
1/03/2020,Zambia,Pulau Pinang,0,0,0
1/03/2020,Zambia,Sabah,0,0,0
1/03/2020,Zambia,Sarawak,0,0,0
1/03/2020,Zambia,Selangor,24,16,8
1/03/2020,Zimbabwe,Johor,10,7,3
1/03/2020,Zimbabwe,Kedah,0,0,0
1/03/2020,Zimbabwe,Kelantan,0,0,0
1/03/2020,Zimbabwe,Perak,0,0,0
1/03/2020,Zimbabwe,Perlis,0,0,0
1/03/2020,Zimbabwe,Pulau Pinang,0,0,0
1/03/2020,Zimbabwe,Sabah,0,0,0
1/03/2020,Zimbabwe,Sarawak,0,0,0
1/03/2020,Zimbabwe,Selangor,60,30,30
1/04/2020,Aruba,Kedah,0,0,0
1/04/2020,Aruba,Pulau Pinang,0,0,0
1/04/2020,Afghanistan,Johor,0,0,0
1/04/2020,Afghanistan,Kedah,0,0,0
1/04/2020,Afghanistan,Perlis,0,0,0
1/04/2020,Afghanistan,Pulau Pinang,0,0,0
1/04/2020,Afghanistan,Sarawak,0,0,0
1/04/2020,Afghanistan,Selangor,0,0,0
1/04/2020,Angola,Johor,0,0,0
1/04/2020,Angola,Kedah,0,0,0
1/04/2020,Angola,Sabah,0,0,0
1/04/2020,Angola,Selangor,0,0,0
1/04/2020,Anguilla,Selangor,0,0,0
1/04/2020,Albania,Johor,0,0,0
1/04/2020,Albania,Kedah,0,0,0
1/04/2020,Albania,Perak,0,0,0
1/04/2020,Albania,Perlis,0,0,0
1/04/2020,Albania,Pulau Pinang,0,0,0
1/04/2020,Albania,Sabah,0,0,0
1/04/2020,Albania,Sarawak,0,0,0
1/04/2020,Albania,Selangor,0,0,0
1/04/2020,Andorra,Johor,0,0,0
1/04/2020,Andorra,Kedah,0,0,0
1/04/2020,Andorra,Perlis,0,0,0
1/04/2020,Andorra,Pulau Pinang,0,0,0
1/04/2020,Andorra,Selangor,0,0,0
1/04/2020,Antigua and Barbuda,Selangor,0,0,0
1/04/2020,United Arab Emirates,Johor,0,0,0
1/04/2020,United Arab Emirates,Kedah,0,0,0
1/04/2020,United Arab Emirates,Kelantan,0,0,0
1/04/2020,United Arab Emirates,Perak,0,0,0
1/04/2020,United Arab Emirates,Perlis,0,0,0
1/04/2020,United Arab Emirates,Pulau Pinang,0,0,0
1/04/2020,United Arab Emirates,Sabah,0,0,0
1/04/2020,United Arab Emirates,Sarawak,0,0,0
1/04/2020,United Arab Emirates,Selangor,2,2,0
1/04/2020,Argentina,Johor,0,0,0
1/04/2020,Argentina,Kedah,0,0,0
1/04/2020,Argentina,Kelantan,0,0,0
1/04/2020,Argentina,Melaka,0,0,0
1/04/2020,Argentina,Perak,0,0,0
1/04/2020,Argentina,Perlis,0,0,0
1/04/2020,Argentina,Pulau Pinang,0,0,0
1/04/2020,Argentina,Sabah,0,0,0
1/04/2020,Argentina,Sarawak,0,0,0
1/04/2020,Argentina,Selangor,0,0,0
1/04/2020,Argentina,W.P. Labuan,0,0,0
1/04/2020,Armenia,Johor,0,0,0
1/04/2020,Armenia,Kedah,0,0,0
1/04/2020,Armenia,Kelantan,0,0,0
1/04/2020,Armenia,Perak,0,0,0
1/04/2020,Armenia,Perlis,0,0,0
1/04/2020,Armenia,Pulau Pinang,0,0,0
1/04/2020,Armenia,Sabah,0,0,0
1/04/2020,Armenia,Sarawak,0,0,0
1/04/2020,Armenia,Selangor,0,0,0
1/04/2020,Antarctica,Selangor,0,0,0
1/04/2020,Antigua and Barbuda,Johor,0,0,0
1/04/2020,Antigua and Barbuda,Kedah,0,0,0
1/04/2020,Antigua and Barbuda,Pulau Pinang,0,0,0
1/04/2020,Antigua and Barbuda,Sarawak,0,0,0
1/04/2020,Antigua and Barbuda,Selangor,0,0,0
1/04/2020,Australia,Johor,0,0,0
1/04/2020,Australia,Kedah,0,0,0
1/04/2020,Australia,Kelantan,0,0,0
1/04/2020,Australia,Melaka,0,0,0
1/04/2020,Australia,Negeri Sembilan,0,0,0
1/04/2020,Australia,Pahang,0,0,0
1/04/2020,Australia,Perak,0,0,0
1/04/2020,Australia,Perlis,0,0,0
1/04/2020,Australia,Pulau Pinang,0,0,0
1/04/2020,Australia,Sabah,0,0,0
1/04/2020,Australia,Sarawak,0,0,0
1/04/2020,Australia,Selangor,9,8,1
1/04/2020,Australia,Terengganu,0,0,0
1/04/2020,Australia,W.P. Labuan,0,0,0
1/04/2020,Austria,Johor,0,0,0
1/04/2020,Austria,Kedah,1,1,0
1/04/2020,Austria,Kelantan,0,0,0
1/04/2020,Austria,Melaka,0,0,0
1/04/2020,Austria,Negeri Sembilan,0,0,0
1/04/2020,Austria,Pahang,0,0,0
1/04/2020,Austria,Perak,0,0,0
1/04/2020,Austria,Perlis,0,0,0
1/04/2020,Austria,Pulau Pinang,0,0,0
1/04/2020,Austria,Sabah,0,0,0
1/04/2020,Austria,Sarawak,0,0,0
1/04/2020,Austria,Selangor,0,0,0
1/04/2020,Austria,Terengganu,0,0,0
1/04/2020,Austria,W.P. Labuan,0,0,0
1/04/2020,Azerbaijan,Johor,0,0,0
1/04/2020,Azerbaijan,Kedah,0,0,0
1/04/2020,Azerbaijan,Kelantan,0,0,0
1/04/2020,Azerbaijan,Melaka,0,0,0
1/04/2020,Azerbaijan,Perlis,0,0,0
1/04/2020,Azerbaijan,Pulau Pinang,0,0,0
1/04/2020,Azerbaijan,Sabah,0,0,0
1/04/2020,Azerbaijan,Sarawak,0,0,0
1/04/2020,Azerbaijan,Selangor,0,0,0
1/04/2020,Azerbaijan,W.P. Labuan,0,0,0
1/04/2020,Burundi,Pulau Pinang,0,0,0
1/04/2020,Burundi,Sarawak,0,0,0
1/04/2020,Burundi,Selangor,0,0,0
1/04/2020,Belgium,Johor,1,0,1
1/04/2020,Belgium,Kedah,0,0,0
1/04/2020,Belgium,Kelantan,0,0,0
1/04/2020,Belgium,Melaka,0,0,0
1/04/2020,Belgium,Negeri Sembilan,0,0,0
1/04/2020,Belgium,Pahang,0,0,0
1/04/2020,Belgium,Perak,0,0,0
1/04/2020,Belgium,Perlis,0,0,0
1/04/2020,Belgium,Pulau Pinang,0,0,0
1/04/2020,Belgium,Sabah,0,0,0
1/04/2020,Belgium,Sarawak,0,0,0
1/04/2020,Belgium,Selangor,6,6,0
1/04/2020,Belgium,W.P. Labuan,0,0,0
1/04/2020,Benin,Johor,0,0,0
1/04/2020,Benin,Kedah,0,0,0
1/04/2020,Benin,Perak,0,0,0
1/04/2020,Benin,Pulau Pinang,0,0,0
1/04/2020,Benin,Sabah,0,0,0
1/04/2020,Benin,Sarawak,0,0,0
1/04/2020,Benin,Selangor,0,0,0
1/04/2020,Burkina Faso,Perak,0,0,0
1/04/2020,Burkina Faso,Pulau Pinang,0,0,0
1/04/2020,Burkina Faso,Selangor,0,0,0
1/04/2020,Bangladesh,Johor,0,0,0
1/04/2020,Bangladesh,Kedah,0,0,0
1/04/2020,Bangladesh,Kelantan,0,0,0
1/04/2020,Bangladesh,Melaka,0,0,0
1/04/2020,Bangladesh,Negeri Sembilan,0,0,0
1/04/2020,Bangladesh,Pahang,0,0,0
1/04/2020,Bangladesh,Perak,0,0,0
1/04/2020,Bangladesh,Perlis,0,0,0
1/04/2020,Bangladesh,Pulau Pinang,0,0,0
1/04/2020,Bangladesh,Sabah,0,0,0
1/04/2020,Bangladesh,Sarawak,0,0,0
1/04/2020,Bangladesh,Selangor,2,2,0
1/04/2020,Bangladesh,W.P. Labuan,0,0,0
1/04/2020,Bulgaria,Johor,0,0,0
1/04/2020,Bulgaria,Kedah,0,0,0
1/04/2020,Bulgaria,Kelantan,0,0,0
1/04/2020,Bulgaria,Pahang,0,0,0
1/04/2020,Bulgaria,Perak,0,0,0
1/04/2020,Bulgaria,Perlis,0,0,0
1/04/2020,Bulgaria,Pulau Pinang,0,0,0
1/04/2020,Bulgaria,Sabah,0,0,0
1/04/2020,Bulgaria,Sarawak,0,0,0
1/04/2020,Bulgaria,Selangor,0,0,0
1/04/2020,Bulgaria,W.P. Labuan,0,0,0
1/04/2020,Bahrain,Johor,0,0,0
1/04/2020,Bahrain,Kedah,0,0,0
1/04/2020,Bahrain,Kelantan,0,0,0
1/04/2020,Bahrain,Perlis,0,0,0
1/04/2020,Bahrain,Pulau Pinang,0,0,0
1/04/2020,Bahrain,Sabah,0,0,0
1/04/2020,Bahrain,Sarawak,0,0,0
1/04/2020,Bahrain,Selangor,0,0,0
1/04/2020,Bahamas,Johor,0,0,0
1/04/2020,Bahamas,Kedah,0,0,0
1/04/2020,Bahamas,Perak,0,0,0
1/04/2020,Bahamas,Sabah,0,0,0
1/04/2020,Bahamas,Sarawak,0,0,0
1/04/2020,Bahamas,Selangor,0,0,0
1/04/2020,Bosnia and Herzegovina,Johor,0,0,0
1/04/2020,Bosnia and Herzegovina,Kedah,0,0,0
1/04/2020,Bosnia and Herzegovina,Perlis,0,0,0
1/04/2020,Bosnia and Herzegovina,Pulau Pinang,0,0,0
1/04/2020,Bosnia and Herzegovina,Sabah,0,0,0
1/04/2020,Bosnia and Herzegovina,Sarawak,0,0,0
1/04/2020,Bosnia and Herzegovina,Selangor,1,1,0
1/04/2020,Belarus,Johor,0,0,0
1/04/2020,Belarus,Kedah,0,0,0
1/04/2020,Belarus,Kelantan,0,0,0
1/04/2020,Belarus,Pahang,0,0,0
1/04/2020,Belarus,Perak,0,0,0
1/04/2020,Belarus,Perlis,0,0,0
1/04/2020,Belarus,Pulau Pinang,0,0,0
1/04/2020,Belarus,Sabah,0,0,0
1/04/2020,Belarus,Sarawak,0,0,0
1/04/2020,Belarus,Selangor,0,0,0
1/04/2020,Belarus,W.P. Labuan,0,0,0
1/04/2020,Belize,Johor,0,0,0
1/04/2020,Belize,Pulau Pinang,0,0,0
1/04/2020,Belize,Sarawak,0,0,0
1/04/2020,Belize,Selangor,0,0,0
1/04/2020,Bermuda,Selangor,0,0,0
1/04/2020,Bolivia,Johor,0,0,0
1/04/2020,Bolivia,Kedah,0,0,0
1/04/2020,Bolivia,Melaka,0,0,0
1/04/2020,Bolivia,Perak,0,0,0
1/04/2020,Bolivia,Perlis,0,0,0
1/04/2020,Bolivia,Pulau Pinang,0,0,0
1/04/2020,Bolivia,Sabah,0,0,0
1/04/2020,Bolivia,Sarawak,0,0,0
1/04/2020,Bolivia,Selangor,0,0,0
1/04/2020,Brazil,Johor,0,0,0
1/04/2020,Brazil,Kedah,0,0,0
1/04/2020,Brazil,Kelantan,0,0,0
1/04/2020,Brazil,Melaka,0,0,0
1/04/2020,Brazil,Pahang,0,0,0
1/04/2020,Brazil,Perak,0,0,0
1/04/2020,Brazil,Perlis,0,0,0
1/04/2020,Brazil,Pulau Pinang,0,0,0
1/04/2020,Brazil,Sabah,0,0,0
1/04/2020,Brazil,Sarawak,0,0,0
1/04/2020,Brazil,Selangor,0,0,0
1/04/2020,Brazil,W.P. Labuan,0,0,0
1/04/2020,Barbados,Johor,0,0,0
1/04/2020,Barbados,Kedah,0,0,0
1/04/2020,Barbados,Perlis,0,0,0
1/04/2020,Barbados,Pulau Pinang,0,0,0
1/04/2020,Barbados,Selangor,0,0,0
1/04/2020,Brunei Darussalam,Johor,0,0,0
1/04/2020,Brunei Darussalam,Kedah,0,0,0
1/04/2020,Brunei Darussalam,Kelantan,0,0,0
1/04/2020,Brunei Darussalam,Melaka,0,0,0
1/04/2020,Brunei Darussalam,Pahang,0,0,0
1/04/2020,Brunei Darussalam,Perak,0,0,0
1/04/2020,Brunei Darussalam,Perlis,0,0,0
1/04/2020,Brunei Darussalam,Pulau Pinang,0,0,0
1/04/2020,Brunei Darussalam,Sabah,0,0,0
1/04/2020,Brunei Darussalam,Sarawak,251,233,18
1/04/2020,Brunei Darussalam,Selangor,1,1,0
1/04/2020,Brunei Darussalam,W.P. Labuan,2,2,0
1/04/2020,Bhutan,Johor,0,0,0
1/04/2020,Bhutan,Kedah,0,0,0
1/04/2020,Bhutan,Perak,0,0,0
1/04/2020,Bhutan,Perlis,0,0,0
1/04/2020,Bhutan,Pulau Pinang,0,0,0
1/04/2020,Bhutan,Sabah,0,0,0
1/04/2020,Bhutan,Sarawak,0,0,0
1/04/2020,Bhutan,Selangor,0,0,0
1/04/2020,Botswana,Johor,0,0,0
1/04/2020,Botswana,Kedah,0,0,0
1/04/2020,Botswana,Perlis,0,0,0
1/04/2020,Botswana,Pulau Pinang,0,0,0
1/04/2020,Botswana,Sabah,0,0,0
1/04/2020,Botswana,Sarawak,0,0,0
1/04/2020,Botswana,Selangor,0,0,0
1/04/2020,Central African Republic,Kedah,0,0,0
1/04/2020,Central African Republic,Selangor,0,0,0
1/04/2020,Canada,Johor,0,0,0
1/04/2020,Canada,Kedah,0,0,0
1/04/2020,Canada,Kelantan,0,0,0
1/04/2020,Canada,Melaka,0,0,0
1/04/2020,Canada,Negeri Sembilan,0,0,0
1/04/2020,Canada,Pahang,0,0,0
1/04/2020,Canada,Perak,0,0,0
1/04/2020,Canada,Perlis,0,0,0
1/04/2020,Canada,Pulau Pinang,0,0,0
1/04/2020,Canada,Sabah,0,0,0
1/04/2020,Canada,Sarawak,0,0,0
1/04/2020,Canada,Selangor,2,2,0
1/04/2020,Canada,Terengganu,0,0,0
1/04/2020,Canada,W.P. Labuan,0,0,0
1/04/2020,Cocos (Keeling) Islands,Selangor,0,0,0
1/04/2020,Switzerland,Johor,0,0,0
1/04/2020,Switzerland,Kedah,0,0,0
1/04/2020,Switzerland,Kelantan,0,0,0
1/04/2020,Switzerland,Melaka,0,0,0
1/04/2020,Switzerland,Negeri Sembilan,0,0,0
1/04/2020,Switzerland,Pahang,0,0,0
1/04/2020,Switzerland,Perak,0,0,0
1/04/2020,Switzerland,Perlis,0,0,0
1/04/2020,Switzerland,Pulau Pinang,0,0,0
1/04/2020,Switzerland,Sabah,0,0,0
1/04/2020,Switzerland,Sarawak,0,0,0
1/04/2020,Switzerland,Selangor,1,1,0
1/04/2020,Switzerland,W.P. Labuan,0,0,0
1/04/2020,Chile,Johor,0,0,0
1/04/2020,Chile,Kedah,0,0,0
1/04/2020,Chile,Kelantan,0,0,0
1/04/2020,Chile,Melaka,0,0,0
1/04/2020,Chile,Pahang,0,0,0
1/04/2020,Chile,Perak,0,0,0
1/04/2020,Chile,Perlis,0,0,0
1/04/2020,Chile,Pulau Pinang,0,0,0
1/04/2020,Chile,Sabah,0,0,0
1/04/2020,Chile,Sarawak,0,0,0
1/04/2020,Chile,Selangor,0,0,0
1/04/2020,China,Johor,2,0,2
1/04/2020,China,Kedah,0,0,0
1/04/2020,China,Kelantan,0,0,0
1/04/2020,China,Melaka,0,0,0
1/04/2020,China,Pahang,0,0,0
1/04/2020,China,Perak,0,0,0
1/04/2020,China,Perlis,0,0,0
1/04/2020,China,Pulau Pinang,0,0,0
1/04/2020,China,Sabah,0,0,0
1/04/2020,China,Sarawak,1,0,1
1/04/2020,China,Selangor,57,28,29
1/04/2020,China,Terengganu,0,0,0
1/04/2020,China,W.P. Labuan,0,0,0
1/04/2020,Côte d'Ivoire,Johor,0,0,0
1/04/2020,Côte d'Ivoire,Kedah,0,0,0
1/04/2020,Côte d'Ivoire,Pulau Pinang,0,0,0
1/04/2020,Côte d'Ivoire,Sabah,0,0,0
1/04/2020,Côte d'Ivoire,Sarawak,0,0,0
1/04/2020,Côte d'Ivoire,Selangor,0,0,0
1/04/2020,Cameroon,Johor,0,0,0
1/04/2020,Cameroon,Kedah,0,0,0
1/04/2020,Cameroon,Pulau Pinang,0,0,0
1/04/2020,Cameroon,Sabah,0,0,0
1/04/2020,Cameroon,Sarawak,0,0,0
1/04/2020,Cameroon,Selangor,0,0,0
1/04/2020,Congo,Johor,0,0,0
1/04/2020,Congo,Pulau Pinang,0,0,0
1/04/2020,Congo,Sarawak,0,0,0
1/04/2020,Congo,Selangor,0,0,0
1/04/2020,Congo,Johor,0,0,0
1/04/2020,Congo,Kedah,0,0,0
1/04/2020,Congo,Selangor,0,0,0
1/04/2020,Cook Islands,Selangor,0,0,0
1/04/2020,Colombia,Johor,0,0,0
1/04/2020,Colombia,Kedah,0,0,0
1/04/2020,Colombia,Perak,0,0,0
1/04/2020,Colombia,Pulau Pinang,0,0,0
1/04/2020,Colombia,Sabah,0,0,0
1/04/2020,Colombia,Sarawak,0,0,0
1/04/2020,Colombia,Selangor,0,0,0
1/04/2020,Colombia,W.P. Labuan,0,0,0
1/04/2020,Comoros,Johor,0,0,0
1/04/2020,Comoros,Kedah,0,0,0
1/04/2020,Comoros,Selangor,0,0,0
1/04/2020,Cabo Verde,Johor,0,0,0
1/04/2020,Cabo Verde,Kedah,0,0,0
1/04/2020,Cabo Verde,Pulau Pinang,0,0,0
1/04/2020,Cabo Verde,Sabah,0,0,0
1/04/2020,Cabo Verde,Selangor,0,0,0
1/04/2020,Costa Rica,Johor,0,0,0
1/04/2020,Costa Rica,Kedah,0,0,0
1/04/2020,Costa Rica,Perak,0,0,0
1/04/2020,Costa Rica,Perlis,0,0,0
1/04/2020,Costa Rica,Pulau Pinang,0,0,0
1/04/2020,Costa Rica,Sabah,0,0,0
1/04/2020,Costa Rica,Sarawak,0,0,0
1/04/2020,Costa Rica,Selangor,0,0,0
1/04/2020,Cuba,Johor,0,0,0
1/04/2020,Cuba,Kedah,0,0,0
1/04/2020,Cuba,Perlis,0,0,0
1/04/2020,Cuba,Pulau Pinang,0,0,0
1/04/2020,Cuba,Sabah,0,0,0
1/04/2020,Cuba,Sarawak,0,0,0
1/04/2020,Cuba,Selangor,0,0,0
1/04/2020,Cyprus,Johor,0,0,0
1/04/2020,Cyprus,Kedah,0,0,0
1/04/2020,Cyprus,Perak,0,0,0
1/04/2020,Cyprus,Perlis,0,0,0
1/04/2020,Cyprus,Pulau Pinang,0,0,0
1/04/2020,Cyprus,Sabah,0,0,0
1/04/2020,Cyprus,Sarawak,0,0,0
1/04/2020,Cyprus,Selangor,0,0,0
1/04/2020,Czechia,Johor,0,0,0
1/04/2020,Czechia,Kedah,0,0,0
1/04/2020,Czechia,Kelantan,0,0,0
1/04/2020,Czechia,Melaka,0,0,0
1/04/2020,Czechia,Negeri Sembilan,0,0,0
1/04/2020,Czechia,Perak,0,0,0
1/04/2020,Czechia,Perlis,0,0,0
1/04/2020,Czechia,Pulau Pinang,0,0,0
1/04/2020,Czechia,Sabah,0,0,0
1/04/2020,Czechia,Sarawak,0,0,0
1/04/2020,Czechia,Selangor,0,0,0
1/04/2020,Czechia,W.P. Labuan,0,0,0
1/04/2020,Germany,Johor,4,2,2
1/04/2020,Germany,Kedah,0,0,0
1/04/2020,Germany,Kelantan,0,0,0
1/04/2020,Germany,Melaka,0,0,0
1/04/2020,Germany,Negeri Sembilan,0,0,0
1/04/2020,Germany,Pahang,0,0,0
1/04/2020,Germany,Perak,0,0,0
1/04/2020,Germany,Perlis,0,0,0
1/04/2020,Germany,Pulau Pinang,0,0,0
1/04/2020,Germany,Sabah,0,0,0
1/04/2020,Germany,Sarawak,0,0,0
1/04/2020,Germany,Selangor,2,2,0
1/04/2020,Germany,Terengganu,0,0,0
1/04/2020,Germany,W.P. Labuan,0,0,0
1/04/2020,Djibouti,Johor,0,0,0
1/04/2020,Djibouti,Selangor,0,0,0
1/04/2020,Dominica,Johor,0,0,0
1/04/2020,Dominica,Kedah,0,0,0
1/04/2020,Dominica,Pulau Pinang,0,0,0
1/04/2020,Dominica,Sabah,0,0,0
1/04/2020,Dominica,Sarawak,0,0,0
1/04/2020,Dominica,Selangor,0,0,0
1/04/2020,Dominica,W.P. Labuan,0,0,0
1/04/2020,Denmark,Johor,0,0,0
1/04/2020,Denmark,Kedah,0,0,0
1/04/2020,Denmark,Kelantan,0,0,0
1/04/2020,Denmark,Melaka,0,0,0
1/04/2020,Denmark,Negeri Sembilan,0,0,0
1/04/2020,Denmark,Pahang,0,0,0
1/04/2020,Denmark,Perak,0,0,0
1/04/2020,Denmark,Perlis,0,0,0
1/04/2020,Denmark,Pulau Pinang,0,0,0
1/04/2020,Denmark,Sabah,0,0,0
1/04/2020,Denmark,Sarawak,0,0,0
1/04/2020,Denmark,Selangor,0,0,0
1/04/2020,Denmark,W.P. Labuan,0,0,0
1/04/2020,Dominican Republic,Johor,0,0,0
1/04/2020,Dominican Republic,Kedah,0,0,0
1/04/2020,Dominican Republic,Perak,0,0,0
1/04/2020,Dominican Republic,Perlis,0,0,0
1/04/2020,Dominican Republic,Pulau Pinang,0,0,0
1/04/2020,Dominican Republic,Sabah,0,0,0
1/04/2020,Dominican Republic,Sarawak,0,0,0
1/04/2020,Dominican Republic,Selangor,0,0,0
1/04/2020,Algeria,Johor,0,0,0
1/04/2020,Algeria,Kedah,0,0,0
1/04/2020,Algeria,Kelantan,0,0,0
1/04/2020,Algeria,Melaka,0,0,0
1/04/2020,Algeria,Perak,0,0,0
1/04/2020,Algeria,Perlis,0,0,0
1/04/2020,Algeria,Pulau Pinang,0,0,0
1/04/2020,Algeria,Sabah,0,0,0
1/04/2020,Algeria,Sarawak,0,0,0
1/04/2020,Algeria,Selangor,0,0,0
1/04/2020,Algeria,W.P. Labuan,0,0,0
1/04/2020,Ecuador,Johor,0,0,0
1/04/2020,Ecuador,Kedah,0,0,0
1/04/2020,Ecuador,Perak,0,0,0
1/04/2020,Ecuador,Perlis,0,0,0
1/04/2020,Ecuador,Pulau Pinang,0,0,0
1/04/2020,Ecuador,Sabah,0,0,0
1/04/2020,Ecuador,Sarawak,0,0,0
1/04/2020,Ecuador,Selangor,0,0,0
1/04/2020,Egypt,Johor,6,6,0
1/04/2020,Egypt,Kedah,0,0,0
1/04/2020,Egypt,Kelantan,0,0,0
1/04/2020,Egypt,Melaka,0,0,0
1/04/2020,Egypt,Pahang,0,0,0
1/04/2020,Egypt,Perak,0,0,0
1/04/2020,Egypt,Perlis,0,0,0
1/04/2020,Egypt,Pulau Pinang,0,0,0
1/04/2020,Egypt,Sabah,0,0,0
1/04/2020,Egypt,Sarawak,0,0,0
1/04/2020,Egypt,Selangor,2,1,1
1/04/2020,Egypt,Terengganu,0,0,0
1/04/2020,Egypt,W.P. Labuan,0,0,0
1/04/2020,Eritrea,Johor,0,0,0
1/04/2020,Eritrea,Pulau Pinang,0,0,0
1/04/2020,Eritrea,Sabah,0,0,0
1/04/2020,Eritrea,Selangor,0,0,0
1/04/2020,Spain,Johor,0,0,0
1/04/2020,Spain,Kedah,0,0,0
1/04/2020,Spain,Kelantan,0,0,0
1/04/2020,Spain,Melaka,0,0,0
1/04/2020,Spain,Negeri Sembilan,0,0,0
1/04/2020,Spain,Pahang,0,0,0
1/04/2020,Spain,Perak,0,0,0
1/04/2020,Spain,Perlis,0,0,0
1/04/2020,Spain,Pulau Pinang,0,0,0
1/04/2020,Spain,Sabah,0,0,0
1/04/2020,Spain,Sarawak,0,0,0
1/04/2020,Spain,Selangor,0,0,0
1/04/2020,Spain,W.P. Labuan,0,0,0
1/04/2020,Estonia,Johor,0,0,0
1/04/2020,Estonia,Kedah,0,0,0
1/04/2020,Estonia,Kelantan,0,0,0
1/04/2020,Estonia,Pahang,0,0,0
1/04/2020,Estonia,Perak,0,0,0
1/04/2020,Estonia,Perlis,0,0,0
1/04/2020,Estonia,Pulau Pinang,0,0,0
1/04/2020,Estonia,Sabah,0,0,0
1/04/2020,Estonia,Sarawak,0,0,0
1/04/2020,Estonia,Selangor,0,0,0
1/04/2020,Estonia,W.P. Labuan,0,0,0
1/04/2020,Ethiopia,Johor,0,0,0
1/04/2020,Ethiopia,Kedah,0,0,0
1/04/2020,Ethiopia,Pulau Pinang,0,0,0
1/04/2020,Ethiopia,Sarawak,0,0,0
1/04/2020,Ethiopia,Selangor,0,0,0
1/04/2020,Finland,Johor,1,1,0
1/04/2020,Finland,Kedah,0,0,0
1/04/2020,Finland,Kelantan,0,0,0
1/04/2020,Finland,Melaka,0,0,0
1/04/2020,Finland,Negeri Sembilan,0,0,0
1/04/2020,Finland,Pahang,0,0,0
1/04/2020,Finland,Perak,0,0,0
1/04/2020,Finland,Perlis,0,0,0
1/04/2020,Finland,Pulau Pinang,1,1,0
1/04/2020,Finland,Sabah,0,0,0
1/04/2020,Finland,Sarawak,0,0,0
1/04/2020,Finland,Selangor,0,0,0
1/04/2020,Finland,W.P. Labuan,0,0,0
1/04/2020,Fiji,Johor,0,0,0
1/04/2020,Fiji,Kedah,0,0,0
1/04/2020,Fiji,Kelantan,0,0,0
1/04/2020,Fiji,Perak,0,0,0
1/04/2020,Fiji,Perlis,0,0,0
1/04/2020,Fiji,Pulau Pinang,0,0,0
1/04/2020,Fiji,Sabah,0,0,0
1/04/2020,Fiji,Sarawak,0,0,0
1/04/2020,Fiji,Selangor,0,0,0
1/04/2020,France,Johor,1,1,0
1/04/2020,France,Kedah,0,0,0
1/04/2020,France,Kelantan,0,0,0
1/04/2020,France,Melaka,0,0,0
1/04/2020,France,Negeri Sembilan,0,0,0
1/04/2020,France,Pahang,0,0,0
1/04/2020,France,Perak,0,0,0
1/04/2020,France,Perlis,0,0,0
1/04/2020,France,Pulau Pinang,0,0,0
1/04/2020,France,Sabah,0,0,0
1/04/2020,France,Sarawak,0,0,0
1/04/2020,France,Selangor,2,1,1
1/04/2020,France,Terengganu,0,0,0
1/04/2020,France,W.P. Labuan,0,0,0
1/04/2020,"Micronesia, Federated States of",Johor,0,0,0
1/04/2020,"Micronesia, Federated States of",Pulau Pinang,0,0,0
1/04/2020,"Micronesia, Federated States of",Selangor,0,0,0
1/04/2020,Gabon,Johor,0,0,0
1/04/2020,Gabon,Pulau Pinang,0,0,0
1/04/2020,Gabon,Sarawak,0,0,0
1/04/2020,Gabon,Selangor,0,0,0
1/04/2020,United Kingdom of Great Britain and Northern Ireland,Johor,1,1,0
1/04/2020,United Kingdom of Great Britain and Northern Ireland,Kedah,0,0,0
1/04/2020,United Kingdom of Great Britain and Northern Ireland,Kelantan,0,0,0
1/04/2020,United Kingdom of Great Britain and Northern Ireland,Melaka,0,0,0
1/04/2020,United Kingdom of Great Britain and Northern Ireland,Negeri Sembilan,0,0,0
1/04/2020,United Kingdom of Great Britain and Northern Ireland,Pahang,0,0,0
1/04/2020,United Kingdom of Great Britain and Northern Ireland,Perak,0,0,0
1/04/2020,United Kingdom of Great Britain and Northern Ireland,Perlis,0,0,0
1/04/2020,United Kingdom of Great Britain and Northern Ireland,Pulau Pinang,0,0,0
1/04/2020,United Kingdom of Great Britain and Northern Ireland,Sabah,0,0,0
1/04/2020,United Kingdom of Great Britain and Northern Ireland,Sarawak,0,0,0
1/04/2020,United Kingdom of Great Britain and Northern Ireland,Selangor,17,14,3
1/04/2020,United Kingdom of Great Britain and Northern Ireland,Terengganu,0,0,0
1/04/2020,United Kingdom of Great Britain and Northern Ireland,W.P. Labuan,0,0,0
1/04/2020,Georgia,Johor,0,0,0
1/04/2020,Georgia,Kedah,0,0,0
1/04/2020,Georgia,Melaka,0,0,0
1/04/2020,Georgia,Perak,0,0,0
1/04/2020,Georgia,Perlis,0,0,0
1/04/2020,Georgia,Pulau Pinang,0,0,0
1/04/2020,Georgia,Sabah,0,0,0
1/04/2020,Georgia,Sarawak,0,0,0
1/04/2020,Georgia,Selangor,0,0,0
1/04/2020,Ghana,Johor,0,0,0
1/04/2020,Ghana,Kedah,0,0,0
1/04/2020,Ghana,Kelantan,0,0,0
1/04/2020,Ghana,Pulau Pinang,0,0,0
1/04/2020,Ghana,Sabah,0,0,0
1/04/2020,Ghana,Sarawak,0,0,0
1/04/2020,Ghana,Selangor,0,0,0
1/04/2020,Gibraltar,Johor,0,0,0
1/04/2020,Gibraltar,Sarawak,0,0,0
1/04/2020,Guinea,Johor,0,0,0
1/04/2020,Guinea,Kedah,0,0,0
1/04/2020,Guinea,Kelantan,0,0,0
1/04/2020,Guinea,Perlis,0,0,0
1/04/2020,Guinea,Pulau Pinang,0,0,0
1/04/2020,Guinea,Sabah,0,0,0
1/04/2020,Guinea,Sarawak,0,0,0
1/04/2020,Guinea,Selangor,0,0,0
1/04/2020,Guadeloupe,Selangor,0,0,0
1/04/2020,Gambia,Johor,0,0,0
1/04/2020,Gambia,Kedah,0,0,0
1/04/2020,Gambia,Kelantan,0,0,0
1/04/2020,Gambia,Pulau Pinang,0,0,0
1/04/2020,Gambia,Sabah,0,0,0
1/04/2020,Gambia,Sarawak,0,0,0
1/04/2020,Gambia,Selangor,0,0,0
1/04/2020,Guinea-Bissau,Johor,0,0,0
1/04/2020,Guinea-Bissau,Selangor,0,0,0
1/04/2020,Equatorial Guinea,Johor,0,0,0
1/04/2020,Equatorial Guinea,Selangor,0,0,0
1/04/2020,Greece,Johor,0,0,0
1/04/2020,Greece,Kedah,0,0,0
1/04/2020,Greece,Kelantan,0,0,0
1/04/2020,Greece,Melaka,0,0,0
1/04/2020,Greece,Negeri Sembilan,0,0,0
1/04/2020,Greece,Pahang,0,0,0
1/04/2020,Greece,Perak,0,0,0
1/04/2020,Greece,Perlis,0,0,0
1/04/2020,Greece,Pulau Pinang,0,0,0
1/04/2020,Greece,Sabah,0,0,0
1/04/2020,Greece,Sarawak,0,0,0
1/04/2020,Greece,Selangor,0,0,0
1/04/2020,Grenada,Johor,0,0,0
1/04/2020,Grenada,Kedah,0,0,0
1/04/2020,Grenada,Pulau Pinang,0,0,0
1/04/2020,Grenada,Sabah,0,0,0
1/04/2020,Grenada,Sarawak,0,0,0
1/04/2020,Grenada,Selangor,0,0,0
1/04/2020,Greenland,Johor,0,0,0
1/04/2020,Greenland,Selangor,0,0,0
1/04/2020,Guatemala,Johor,0,0,0
1/04/2020,Guatemala,Kedah,0,0,0
1/04/2020,Guatemala,Pahang,0,0,0
1/04/2020,Guatemala,Perak,0,0,0
1/04/2020,Guatemala,Pulau Pinang,0,0,0
1/04/2020,Guatemala,Sabah,0,0,0
1/04/2020,Guatemala,Sarawak,0,0,0
1/04/2020,Guatemala,Selangor,0,0,0
1/04/2020,Guatemala,W.P. Labuan,0,0,0
1/04/2020,Guyana,Johor,0,0,0
1/04/2020,Guyana,Kedah,0,0,0
1/04/2020,Guyana,Pulau Pinang,0,0,0
1/04/2020,Guyana,Sarawak,0,0,0
1/04/2020,Guyana,Selangor,0,0,0
1/04/2020,Hong Kong,Johor,0,0,0
1/04/2020,Hong Kong,Kedah,0,0,0
1/04/2020,Hong Kong,Kelantan,0,0,0
1/04/2020,Hong Kong,Pahang,0,0,0
1/04/2020,Hong Kong,Perak,0,0,0
1/04/2020,Hong Kong,Perlis,0,0,0
1/04/2020,Hong Kong,Pulau Pinang,0,0,0
1/04/2020,Hong Kong,Sabah,0,0,0
1/04/2020,Hong Kong,Sarawak,0,0,0
1/04/2020,Hong Kong,Selangor,0,0,0
1/04/2020,Hong Kong,Terengganu,0,0,0
1/04/2020,Heard Island and McDonald Islands,Johor,0,0,0
1/04/2020,Honduras,Johor,0,0,0
1/04/2020,Honduras,Kedah,0,0,0
1/04/2020,Honduras,Perak,0,0,0
1/04/2020,Honduras,Pulau Pinang,0,0,0
1/04/2020,Honduras,Sabah,0,0,0
1/04/2020,Honduras,Sarawak,0,0,0
1/04/2020,Honduras,Selangor,0,0,0
1/04/2020,Croatia,Johor,2,2,0
1/04/2020,Croatia,Kedah,0,0,0
1/04/2020,Croatia,Kelantan,0,0,0
1/04/2020,Croatia,Melaka,0,0,0
1/04/2020,Croatia,Pahang,0,0,0
1/04/2020,Croatia,Perak,0,0,0
1/04/2020,Croatia,Perlis,0,0,0
1/04/2020,Croatia,Pulau Pinang,0,0,0
1/04/2020,Croatia,Sabah,0,0,0
1/04/2020,Croatia,Sarawak,0,0,0
1/04/2020,Croatia,Selangor,0,0,0
1/04/2020,Haiti,Johor,0,0,0
1/04/2020,Haiti,Kedah,0,0,0
1/04/2020,Haiti,Kelantan,0,0,0
1/04/2020,Haiti,Perak,0,0,0
1/04/2020,Haiti,Pulau Pinang,0,0,0
1/04/2020,Haiti,Sabah,0,0,0
1/04/2020,Haiti,Selangor,0,0,0
1/04/2020,Hungary,Johor,0,0,0
1/04/2020,Hungary,Kedah,0,0,0
1/04/2020,Hungary,Kelantan,0,0,0
1/04/2020,Hungary,Pahang,0,0,0
1/04/2020,Hungary,Perak,0,0,0
1/04/2020,Hungary,Perlis,0,0,0
1/04/2020,Hungary,Pulau Pinang,2,2,0
1/04/2020,Hungary,Sabah,0,0,0
1/04/2020,Hungary,Sarawak,0,0,0
1/04/2020,Hungary,Selangor,0,0,0
1/04/2020,Hungary,W.P. Labuan,0,0,0
1/04/2020,Indonesia,Johor,89,52,37
1/04/2020,Indonesia,Kedah,16,16,0
1/04/2020,Indonesia,Kelantan,1,0,1
1/04/2020,Indonesia,Melaka,0,0,0
1/04/2020,Indonesia,Negeri Sembilan,1,1,0
1/04/2020,Indonesia,Pahang,0,0,0
1/04/2020,Indonesia,Perak,0,0,0
1/04/2020,Indonesia,Perlis,0,0,0
1/04/2020,Indonesia,Pulau Pinang,0,0,0
1/04/2020,Indonesia,Sabah,18,2,16
1/04/2020,Indonesia,Sarawak,201,188,13
1/04/2020,Indonesia,Selangor,104,46,58
1/04/2020,Indonesia,Terengganu,0,0,0
1/04/2020,Indonesia,W.P. Labuan,0,0,0
1/04/2020,India,Johor,5,5,0
1/04/2020,India,Kedah,0,0,0
1/04/2020,India,Kelantan,0,0,0
1/04/2020,India,Melaka,0,0,0
1/04/2020,India,Negeri Sembilan,0,0,0
1/04/2020,India,Pahang,0,0,0
1/04/2020,India,Perak,0,0,0
1/04/2020,India,Perlis,0,0,0
1/04/2020,India,Pulau Pinang,0,0,0
1/04/2020,India,Sabah,0,0,0
1/04/2020,India,Sarawak,0,0,0
1/04/2020,India,Selangor,42,21,21
1/04/2020,India,Terengganu,0,0,0
1/04/2020,India,W.P. Labuan,0,0,0
1/04/2020, British Indian Ocean Territory,Pulau Pinang,0,0,0
1/04/2020, British Indian Ocean Territory,Selangor,0,0,0
1/04/2020,Ireland,Johor,0,0,0
1/04/2020,Ireland,Kedah,0,0,0
1/04/2020,Ireland,Kelantan,0,0,0
1/04/2020,Ireland,Negeri Sembilan,0,0,0
1/04/2020,Ireland,Pahang,0,0,0
1/04/2020,Ireland,Perak,0,0,0
1/04/2020,Ireland,Perlis,0,0,0
1/04/2020,Ireland,Pulau Pinang,0,0,0
1/04/2020,Ireland,Sabah,0,0,0
1/04/2020,Ireland,Sarawak,0,0,0
1/04/2020,Ireland,Selangor,2,2,0
1/04/2020,Ireland,Terengganu,0,0,0
1/04/2020,Ireland,W.P. Labuan,0,0,0
1/04/2020,"Iran, Islamic Republic of",Johor,0,0,0
1/04/2020,"Iran, Islamic Republic of",Kedah,0,0,0
1/04/2020,"Iran, Islamic Republic of",Kelantan,0,0,0
1/04/2020,"Iran, Islamic Republic of",Perak,0,0,0
1/04/2020,"Iran, Islamic Republic of",Perlis,0,0,0
1/04/2020,"Iran, Islamic Republic of",Pulau Pinang,0,0,0
1/04/2020,"Iran, Islamic Republic of",Sabah,0,0,0
1/04/2020,"Iran, Islamic Republic of",Sarawak,0,0,0
1/04/2020,"Iran, Islamic Republic of",Selangor,0,0,0
1/04/2020,"Iran, Islamic Republic of",W.P. Labuan,0,0,0
1/04/2020,Iraq,Johor,0,0,0
1/04/2020,Iraq,Kedah,0,0,0
1/04/2020,Iraq,Kelantan,0,0,0
1/04/2020,Iraq,Melaka,0,0,0
1/04/2020,Iraq,Pahang,0,0,0
1/04/2020,Iraq,Perak,0,0,0
1/04/2020,Iraq,Perlis,0,0,0
1/04/2020,Iraq,Pulau Pinang,0,0,0
1/04/2020,Iraq,Sabah,0,0,0
1/04/2020,Iraq,Sarawak,0,0,0
1/04/2020,Iraq,Selangor,0,0,0
1/04/2020,Iceland,Johor,0,0,0
1/04/2020,Iceland,Kedah,0,0,0
1/04/2020,Iceland,Kelantan,0,0,0
1/04/2020,Iceland,Perak,0,0,0
1/04/2020,Iceland,Perlis,0,0,0
1/04/2020,Iceland,Pulau Pinang,0,0,0
1/04/2020,Iceland,Sabah,0,0,0
1/04/2020,Iceland,Sarawak,0,0,0
1/04/2020,Iceland,Selangor,0,0,0
1/04/2020,Iceland,W.P. Labuan,0,0,0
1/04/2020,Israel,Pulau Pinang,0,0,0
1/04/2020,Italy,Johor,0,0,0
1/04/2020,Italy,Kedah,0,0,0
1/04/2020,Italy,Kelantan,0,0,0
1/04/2020,Italy,Melaka,0,0,0
1/04/2020,Italy,Negeri Sembilan,0,0,0
1/04/2020,Italy,Pahang,0,0,0
1/04/2020,Italy,Perak,0,0,0
1/04/2020,Italy,Perlis,0,0,0
1/04/2020,Italy,Pulau Pinang,0,0,0
1/04/2020,Italy,Sabah,0,0,0
1/04/2020,Italy,Sarawak,0,0,0
1/04/2020,Italy,Selangor,2,2,0
1/04/2020,Italy,W.P. Labuan,0,0,0
1/04/2020,Jamaica,Johor,0,0,0
1/04/2020,Jamaica,Kedah,0,0,0
1/04/2020,Jamaica,Perak,0,0,0
1/04/2020,Jamaica,Pulau Pinang,0,0,0
1/04/2020,Jamaica,Sabah,0,0,0
1/04/2020,Jamaica,Sarawak,0,0,0
1/04/2020,Jamaica,Selangor,0,0,0
1/04/2020,Jamaica,W.P. Labuan,0,0,0
1/04/2020,Jordan,Johor,0,0,0
1/04/2020,Jordan,Kedah,0,0,0
1/04/2020,Jordan,Kelantan,0,0,0
1/04/2020,Jordan,Melaka,0,0,0
1/04/2020,Jordan,Perlis,0,0,0
1/04/2020,Jordan,Pulau Pinang,0,0,0
1/04/2020,Jordan,Sabah,0,0,0
1/04/2020,Jordan,Sarawak,0,0,0
1/04/2020,Jordan,Selangor,0,0,0
1/04/2020,Jordan,W.P. Labuan,0,0,0
1/04/2020,Japan,Johor,0,0,0
1/04/2020,Japan,Kedah,0,0,0
1/04/2020,Japan,Kelantan,0,0,0
1/04/2020,Japan,Melaka,0,0,0
1/04/2020,Japan,Negeri Sembilan,0,0,0
1/04/2020,Japan,Pahang,0,0,0
1/04/2020,Japan,Perak,0,0,0
1/04/2020,Japan,Perlis,0,0,0
1/04/2020,Japan,Pulau Pinang,0,0,0
1/04/2020,Japan,Sabah,0,0,0
1/04/2020,Japan,Sarawak,0,0,0
1/04/2020,Japan,Selangor,7,6,1
1/04/2020,Japan,W.P. Labuan,0,0,0
1/04/2020,Kazakhstan,Johor,0,0,0
1/04/2020,Kazakhstan,Kedah,0,0,0
1/04/2020,Kazakhstan,Kelantan,0,0,0
1/04/2020,Kazakhstan,Melaka,0,0,0
1/04/2020,Kazakhstan,Perak,0,0,0
1/04/2020,Kazakhstan,Perlis,0,0,0
1/04/2020,Kazakhstan,Pulau Pinang,0,0,0
1/04/2020,Kazakhstan,Sabah,0,0,0
1/04/2020,Kazakhstan,Sarawak,0,0,0
1/04/2020,Kazakhstan,Selangor,0,0,0
1/04/2020,Kazakhstan,W.P. Labuan,0,0,0
1/04/2020,Kenya,Johor,0,0,0
1/04/2020,Kenya,Kedah,0,0,0
1/04/2020,Kenya,Kelantan,0,0,0
1/04/2020,Kenya,Perak,0,0,0
1/04/2020,Kenya,Perlis,0,0,0
1/04/2020,Kenya,Pulau Pinang,0,0,0
1/04/2020,Kenya,Sabah,0,0,0
1/04/2020,Kenya,Sarawak,0,0,0
1/04/2020,Kenya,Selangor,0,0,0
1/04/2020,Kyrgyzstan,Johor,0,0,0
1/04/2020,Kyrgyzstan,Kedah,0,0,0
1/04/2020,Kyrgyzstan,Kelantan,0,0,0
1/04/2020,Kyrgyzstan,Perak,0,0,0
1/04/2020,Kyrgyzstan,Perlis,0,0,0
1/04/2020,Kyrgyzstan,Pulau Pinang,0,0,0
1/04/2020,Kyrgyzstan,Sabah,0,0,0
1/04/2020,Kyrgyzstan,Sarawak,0,0,0
1/04/2020,Kyrgyzstan,Selangor,0,0,0
1/04/2020,Cambodia,Johor,0,0,0
1/04/2020,Cambodia,Kedah,1,0,1
1/04/2020,Cambodia,Kelantan,1,1,0
1/04/2020,Cambodia,Melaka,0,0,0
1/04/2020,Cambodia,Negeri Sembilan,0,0,0
1/04/2020,Cambodia,Pahang,0,0,0
1/04/2020,Cambodia,Perak,0,0,0
1/04/2020,Cambodia,Perlis,0,0,0
1/04/2020,Cambodia,Pulau Pinang,0,0,0
1/04/2020,Cambodia,Sabah,0,0,0
1/04/2020,Cambodia,Sarawak,0,0,0
1/04/2020,Cambodia,Selangor,5,1,4
1/04/2020,Cambodia,W.P. Labuan,0,0,0
1/04/2020,Kiribati,Johor,0,0,0
1/04/2020,Kiribati,Sabah,0,0,0
1/04/2020,Kiribati,Selangor,0,0,0
1/04/2020,Saint Kitts and Nevis,Johor,0,0,0
1/04/2020,Saint Kitts and Nevis,Kedah,0,0,0
1/04/2020,Saint Kitts and Nevis,Perlis,0,0,0
1/04/2020,Saint Kitts and Nevis,Pulau Pinang,0,0,0
1/04/2020,Saint Kitts and Nevis,Sabah,0,0,0
1/04/2020,Saint Kitts and Nevis,Selangor,0,0,0
1/04/2020,Saint Kitts and Nevis,W.P. Labuan,0,0,0
1/04/2020,"Korea, Republic of",Johor,1,1,0
1/04/2020,"Korea, Republic of",Kedah,0,0,0
1/04/2020,"Korea, Republic of",Kelantan,0,0,0
1/04/2020,"Korea, Republic of",Melaka,0,0,0
1/04/2020,"Korea, Republic of",Negeri Sembilan,0,0,0
1/04/2020,"Korea, Republic of",Pahang,0,0,0
1/04/2020,"Korea, Republic of",Perak,0,0,0
1/04/2020,"Korea, Republic of",Perlis,0,0,0
1/04/2020,"Korea, Republic of",Pulau Pinang,0,0,0
1/04/2020,"Korea, Republic of",Sabah,0,0,0
1/04/2020,"Korea, Republic of",Sarawak,0,0,0
1/04/2020,"Korea, Republic of",Selangor,1,1,0
1/04/2020,"Korea, Republic of",Terengganu,0,0,0
1/04/2020,"Korea, Republic of",W.P. Labuan,0,0,0
1/04/2020,Kuwait,Johor,0,0,0
1/04/2020,Kuwait,Kedah,0,0,0
1/04/2020,Kuwait,Kelantan,0,0,0
1/04/2020,Kuwait,Perak,0,0,0
1/04/2020,Kuwait,Perlis,0,0,0
1/04/2020,Kuwait,Pulau Pinang,0,0,0
1/04/2020,Kuwait,Sabah,0,0,0
1/04/2020,Kuwait,Sarawak,0,0,0
1/04/2020,Kuwait,Selangor,0,0,0
1/04/2020,Kuwait,W.P. Labuan,0,0,0
1/04/2020, Lao People's Democratic Republic,Johor,0,0,0
1/04/2020, Lao People's Democratic Republic,Kedah,1,0,1
1/04/2020, Lao People's Democratic Republic,Kelantan,0,0,0
1/04/2020, Lao People's Democratic Republic,Melaka,0,0,0
1/04/2020, Lao People's Democratic Republic,Perak,0,0,0
1/04/2020, Lao People's Democratic Republic,Perlis,0,0,0
1/04/2020, Lao People's Democratic Republic,Pulau Pinang,0,0,0
1/04/2020, Lao People's Democratic Republic,Sabah,0,0,0
1/04/2020, Lao People's Democratic Republic,Sarawak,0,0,0
1/04/2020, Lao People's Democratic Republic,Selangor,1,0,1
1/04/2020, Lao People's Democratic Republic,W.P. Labuan,0,0,0
1/04/2020,Lebanon,Johor,0,0,0
1/04/2020,Lebanon,Kedah,0,0,0
1/04/2020,Lebanon,Kelantan,0,0,0
1/04/2020,Lebanon,Pahang,0,0,0
1/04/2020,Lebanon,Perak,0,0,0
1/04/2020,Lebanon,Perlis,0,0,0
1/04/2020,Lebanon,Pulau Pinang,0,0,0
1/04/2020,Lebanon,Sabah,0,0,0
1/04/2020,Lebanon,Sarawak,0,0,0
1/04/2020,Lebanon,Selangor,0,0,0
1/04/2020,Lebanon,W.P. Labuan,0,0,0
1/04/2020,Liberia,Johor,0,0,0
1/04/2020,Liberia,Kedah,0,0,0
1/04/2020,Liberia,Sabah,0,0,0
1/04/2020,Liberia,Sarawak,0,0,0
1/04/2020,Liberia,Selangor,0,0,0
1/04/2020,Libya,Johor,0,0,0
1/04/2020,Libya,Kedah,0,0,0
1/04/2020,Libya,Perlis,0,0,0
1/04/2020,Libya,Pulau Pinang,0,0,0
1/04/2020,Libya,Sabah,0,0,0
1/04/2020,Libya,Sarawak,0,0,0
1/04/2020,Libya,Selangor,0,0,0
1/04/2020,Saint Lucia,Johor,0,0,0
1/04/2020,Saint Lucia,Kedah,0,0,0
1/04/2020,Saint Lucia,Pulau Pinang,0,0,0
1/04/2020,Saint Lucia,Sarawak,0,0,0
1/04/2020,Saint Lucia,Selangor,0,0,0
1/04/2020,Liechtenstein,Johor,0,0,0
1/04/2020,Liechtenstein,Kedah,0,0,0
1/04/2020,Liechtenstein,Perlis,0,0,0
1/04/2020,Liechtenstein,Pulau Pinang,0,0,0
1/04/2020,Liechtenstein,Sabah,0,0,0
1/04/2020,Liechtenstein,Sarawak,0,0,0
1/04/2020,Liechtenstein,Selangor,0,0,0
1/04/2020,LKA,Johor,1,1,0
1/04/2020,LKA,Kedah,0,0,0
1/04/2020,LKA,Kelantan,0,0,0
1/04/2020,LKA,Melaka,0,0,0
1/04/2020,LKA,Pahang,0,0,0
1/04/2020,LKA,Perak,0,0,0
1/04/2020,LKA,Perlis,0,0,0
1/04/2020,LKA,Pulau Pinang,0,0,0
1/04/2020,LKA,Sabah,0,0,0
1/04/2020,LKA,Sarawak,0,0,0
1/04/2020,LKA,Selangor,4,3,1
1/04/2020,LKA,W.P. Labuan,0,0,0
1/04/2020,Lesotho,Johor,0,0,0
1/04/2020,Lesotho,Kedah,0,0,0
1/04/2020,Lesotho,Pulau Pinang,0,0,0
1/04/2020,Lesotho,Sarawak,0,0,0
1/04/2020,Lesotho,Selangor,0,0,0
1/04/2020,Lithuania,Johor,0,0,0
1/04/2020,Lithuania,Kedah,0,0,0
1/04/2020,Lithuania,Kelantan,0,0,0
1/04/2020,Lithuania,Pahang,0,0,0
1/04/2020,Lithuania,Perak,0,0,0
1/04/2020,Lithuania,Perlis,0,0,0
1/04/2020,Lithuania,Pulau Pinang,0,0,0
1/04/2020,Lithuania,Sabah,0,0,0
1/04/2020,Lithuania,Sarawak,0,0,0
1/04/2020,Lithuania,Selangor,0,0,0
1/04/2020,Lithuania,W.P. Labuan,0,0,0
1/04/2020,Luxembourg,Johor,0,0,0
1/04/2020,Luxembourg,Kedah,0,0,0
1/04/2020,Luxembourg,Kelantan,0,0,0
1/04/2020,Luxembourg,Perak,0,0,0
1/04/2020,Luxembourg,Perlis,0,0,0
1/04/2020,Luxembourg,Pulau Pinang,0,0,0
1/04/2020,Luxembourg,Sabah,0,0,0
1/04/2020,Luxembourg,Sarawak,0,0,0
1/04/2020,Luxembourg,Selangor,0,0,0
1/04/2020,Latvia,Johor,0,0,0
1/04/2020,Latvia,Kedah,0,0,0
1/04/2020,Latvia,Kelantan,0,0,0
1/04/2020,Latvia,Pahang,0,0,0
1/04/2020,Latvia,Perak,0,0,0
1/04/2020,Latvia,Perlis,0,0,0
1/04/2020,Latvia,Pulau Pinang,0,0,0
1/04/2020,Latvia,Sabah,0,0,0
1/04/2020,Latvia,Sarawak,0,0,0
1/04/2020,Latvia,Selangor,0,0,0
1/04/2020,Latvia,W.P. Labuan,0,0,0
1/04/2020,Macao,Johor,0,0,0
1/04/2020,Macao,Pahang,0,0,0
1/04/2020,Macao,Perak,0,0,0
1/04/2020,Macao,Selangor,0,0,0
1/04/2020,Macao,W.P. Labuan,0,0,0
1/04/2020,Morocco,Johor,0,0,0
1/04/2020,Morocco,Kedah,0,0,0
1/04/2020,Morocco,Kelantan,0,0,0
1/04/2020,Morocco,Melaka,0,0,0
1/04/2020,Morocco,Pahang,0,0,0
1/04/2020,Morocco,Perak,0,0,0
1/04/2020,Morocco,Perlis,0,0,0
1/04/2020,Morocco,Pulau Pinang,0,0,0
1/04/2020,Morocco,Sabah,0,0,0
1/04/2020,Morocco,Sarawak,0,0,0
1/04/2020,Morocco,Selangor,1,0,1
1/04/2020,Morocco,W.P. Labuan,0,0,0
1/04/2020,Monaco,Johor,0,0,0
1/04/2020,Monaco,Kedah,0,0,0
1/04/2020,Monaco,Sabah,0,0,0
1/04/2020,Monaco,Selangor,0,0,0
1/04/2020,"Moldova, Republic of",Johor,0,0,0
1/04/2020,"Moldova, Republic of",Kedah,0,0,0
1/04/2020,"Moldova, Republic of",Kelantan,0,0,0
1/04/2020,"Moldova, Republic of",Negeri Sembilan,0,0,0
1/04/2020,"Moldova, Republic of",Perlis,0,0,0
1/04/2020,"Moldova, Republic of",Pulau Pinang,0,0,0
1/04/2020,"Moldova, Republic of",Sabah,0,0,0
1/04/2020,"Moldova, Republic of",Sarawak,0,0,0
1/04/2020,"Moldova, Republic of",Selangor,0,0,0
1/04/2020,Madagascar,Johor,0,0,0
1/04/2020,Madagascar,Kedah,0,0,0
1/04/2020,Madagascar,Perak,0,0,0
1/04/2020,Madagascar,Perlis,0,0,0
1/04/2020,Madagascar,Pulau Pinang,0,0,0
1/04/2020,Madagascar,Sabah,0,0,0
1/04/2020,Madagascar,Sarawak,0,0,0
1/04/2020,Madagascar,Selangor,0,0,0
1/04/2020,Maldives,Johor,0,0,0
1/04/2020,Maldives,Kedah,0,0,0
1/04/2020,Maldives,Kelantan,0,0,0
1/04/2020,Maldives,Perak,0,0,0
1/04/2020,Maldives,Perlis,0,0,0
1/04/2020,Maldives,Pulau Pinang,0,0,0
1/04/2020,Maldives,Sabah,0,0,0
1/04/2020,Maldives,Sarawak,0,0,0
1/04/2020,Maldives,Selangor,0,0,0
1/04/2020,Mexico,Johor,0,0,0
1/04/2020,Mexico,Kedah,0,0,0
1/04/2020,Mexico,Kelantan,0,0,0
1/04/2020,Mexico,Pahang,0,0,0
1/04/2020,Mexico,Perak,0,0,0
1/04/2020,Mexico,Perlis,0,0,0
1/04/2020,Mexico,Pulau Pinang,0,0,0
1/04/2020,Mexico,Sabah,0,0,0
1/04/2020,Mexico,Sarawak,0,0,0
1/04/2020,Mexico,Selangor,0,0,0
1/04/2020,Mexico,W.P. Labuan,0,0,0
1/04/2020,Marshall Islands,Johor,0,0,0
1/04/2020,Marshall Islands,Kedah,0,0,0
1/04/2020,Marshall Islands,Perak,0,0,0
1/04/2020,Marshall Islands,Pulau Pinang,0,0,0
1/04/2020,Marshall Islands,Sabah,0,0,0
1/04/2020,Marshall Islands,Selangor,0,0,0
1/04/2020,North Macedonia,Johor,0,0,0
1/04/2020,North Macedonia,Kedah,0,0,0
1/04/2020,North Macedonia,Perak,0,0,0
1/04/2020,North Macedonia,Pulau Pinang,0,0,0
1/04/2020,North Macedonia,Sabah,0,0,0
1/04/2020,North Macedonia,Sarawak,0,0,0
1/04/2020,North Macedonia,Selangor,0,0,0
1/04/2020,Mali,Johor,0,0,0
1/04/2020,Mali,Sabah,0,0,0
1/04/2020,Mali,Selangor,0,0,0
1/04/2020,Malta,Johor,0,0,0
1/04/2020,Malta,Kedah,0,0,0
1/04/2020,Malta,Kelantan,0,0,0
1/04/2020,Malta,Perak,0,0,0
1/04/2020,Malta,Perlis,0,0,0
1/04/2020,Malta,Pulau Pinang,0,0,0
1/04/2020,Malta,Sabah,0,0,0
1/04/2020,Malta,Sarawak,0,0,0
1/04/2020,Malta,Selangor,0,0,0
1/04/2020,Malta,W.P. Labuan,0,0,0
1/04/2020,Myanmar,Johor,10,10,0
1/04/2020,Myanmar,Kedah,0,0,0
1/04/2020,Myanmar,Kelantan,0,0,0
1/04/2020,Myanmar,Negeri Sembilan,0,0,0
1/04/2020,Myanmar,Pahang,0,0,0
1/04/2020,Myanmar,Perak,0,0,0
1/04/2020,Myanmar,Perlis,0,0,0
1/04/2020,Myanmar,Pulau Pinang,0,0,0
1/04/2020,Myanmar,Sabah,0,0,0
1/04/2020,Myanmar,Sarawak,0,0,0
1/04/2020,Myanmar,Selangor,6,1,5
1/04/2020,Myanmar,Terengganu,0,0,0
1/04/2020,Myanmar,W.P. Labuan,0,0,0
1/04/2020,Montenegro,Johor,0,0,0
1/04/2020,Montenegro,Kedah,0,0,0
1/04/2020,Montenegro,Pulau Pinang,0,0,0
1/04/2020,Montenegro,Sabah,0,0,0
1/04/2020,Montenegro,Sarawak,0,0,0
1/04/2020,Montenegro,Selangor,0,0,0
1/04/2020,Mongolia,Johor,0,0,0
1/04/2020,Mongolia,Kedah,0,0,0
1/04/2020,Mongolia,Kelantan,0,0,0
1/04/2020,Mongolia,Perak,0,0,0
1/04/2020,Mongolia,Perlis,0,0,0
1/04/2020,Mongolia,Pulau Pinang,0,0,0
1/04/2020,Mongolia,Sabah,0,0,0
1/04/2020,Mongolia,Sarawak,0,0,0
1/04/2020,Mongolia,Selangor,0,0,0
1/04/2020,Northern Mariana Islands,Selangor,0,0,0
1/04/2020,Mozambique,Johor,0,0,0
1/04/2020,Mozambique,Kedah,0,0,0
1/04/2020,Mozambique,Perak,0,0,0
1/04/2020,Mozambique,Pulau Pinang,0,0,0
1/04/2020,Mozambique,Sabah,0,0,0
1/04/2020,Mozambique,Sarawak,0,0,0
1/04/2020,Mozambique,Selangor,0,0,0
1/04/2020,Mauritania,Johor,0,0,0
1/04/2020,Mauritania,Kedah,0,0,0
1/04/2020,Mauritania,Pulau Pinang,0,0,0
1/04/2020,Mauritania,Sabah,0,0,0
1/04/2020,Mauritania,Sarawak,0,0,0
1/04/2020,Mauritania,Selangor,1,1,0
1/04/2020,Mauritius,Johor,0,0,0
1/04/2020,Mauritius,Kedah,0,0,0
1/04/2020,Mauritius,Kelantan,0,0,0
1/04/2020,Mauritius,Pahang,0,0,0
1/04/2020,Mauritius,Perak,0,0,0
1/04/2020,Mauritius,Perlis,0,0,0
1/04/2020,Mauritius,Pulau Pinang,0,0,0
1/04/2020,Mauritius,Sabah,0,0,0
1/04/2020,Mauritius,Sarawak,0,0,0
1/04/2020,Mauritius,Selangor,0,0,0
1/04/2020,Malawi,Johor,0,0,0
1/04/2020,Malawi,Pulau Pinang,0,0,0
1/04/2020,Malawi,Sabah,0,0,0
1/04/2020,Malawi,Sarawak,0,0,0
1/04/2020,Malawi,Selangor,0,0,0
1/04/2020,Mayotte,Selangor,0,0,0
1/04/2020,Namibia,Johor,0,0,0
1/04/2020,Namibia,Kedah,0,0,0
1/04/2020,Namibia,Perak,0,0,0
1/04/2020,Namibia,Perlis,0,0,0
1/04/2020,Namibia,Pulau Pinang,0,0,0
1/04/2020,Namibia,Sabah,0,0,0
1/04/2020,Namibia,Sarawak,0,0,0
1/04/2020,Namibia,Selangor,0,0,0
1/04/2020,New Caledonia,Selangor,0,0,0
1/04/2020,Niger,Johor,0,0,0
1/04/2020,Niger,Sabah,0,0,0
1/04/2020,Niger,Selangor,0,0,0
1/04/2020,Nigeria,Johor,0,0,0
1/04/2020,Nigeria,Kedah,0,0,0
1/04/2020,Nigeria,Perlis,0,0,0
1/04/2020,Nigeria,Pulau Pinang,0,0,0
1/04/2020,Nigeria,Sabah,0,0,0
1/04/2020,Nigeria,Sarawak,0,0,0
1/04/2020,Nigeria,Selangor,2,2,0
1/04/2020,Nicaragua,Johor,0,0,0
1/04/2020,Nicaragua,Kedah,0,0,0
1/04/2020,Nicaragua,Pulau Pinang,0,0,0
1/04/2020,Nicaragua,Sabah,0,0,0
1/04/2020,Nicaragua,Selangor,0,0,0
1/04/2020,Netherlands,Johor,0,0,0
1/04/2020,Netherlands,Kedah,0,0,0
1/04/2020,Netherlands,Kelantan,0,0,0
1/04/2020,Netherlands,Melaka,0,0,0
1/04/2020,Netherlands,Negeri Sembilan,0,0,0
1/04/2020,Netherlands,Pahang,0,0,0
1/04/2020,Netherlands,Perak,0,0,0
1/04/2020,Netherlands,Perlis,0,0,0
1/04/2020,Netherlands,Pulau Pinang,1,1,0
1/04/2020,Netherlands,Sabah,0,0,0
1/04/2020,Netherlands,Sarawak,0,0,0
1/04/2020,Netherlands,Selangor,31,14,17
1/04/2020,Netherlands,Terengganu,0,0,0
1/04/2020,Netherlands,W.P. Labuan,0,0,0
1/04/2020,Norway,Johor,0,0,0
1/04/2020,Norway,Kedah,0,0,0
1/04/2020,Norway,Kelantan,0,0,0
1/04/2020,Norway,Melaka,0,0,0
1/04/2020,Norway,Pahang,0,0,0
1/04/2020,Norway,Perak,0,0,0
1/04/2020,Norway,Perlis,0,0,0
1/04/2020,Norway,Pulau Pinang,0,0,0
1/04/2020,Norway,Sabah,0,0,0
1/04/2020,Norway,Sarawak,0,0,0
1/04/2020,Norway,Selangor,0,0,0
1/04/2020,Norway,W.P. Labuan,0,0,0
1/04/2020,Nepal,Johor,0,0,0
1/04/2020,Nepal,Kedah,0,0,0
1/04/2020,Nepal,Pahang,0,0,0
1/04/2020,Nepal,Perak,0,0,0
1/04/2020,Nepal,Perlis,0,0,0
1/04/2020,Nepal,Pulau Pinang,0,0,0
1/04/2020,Nepal,Sabah,0,0,0
1/04/2020,Nepal,Sarawak,0,0,0
1/04/2020,Nepal,Selangor,0,0,0
1/04/2020,Nepal,W.P. Labuan,0,0,0
1/04/2020,Nauru,Johor,0,0,0
1/04/2020,Nauru,Pulau Pinang,0,0,0
1/04/2020,Nauru,Selangor,0,0,0
1/04/2020,New Zealand,Johor,0,0,0
1/04/2020,New Zealand,Kedah,0,0,0
1/04/2020,New Zealand,Kelantan,0,0,0
1/04/2020,New Zealand,Melaka,0,0,0
1/04/2020,New Zealand,Negeri Sembilan,0,0,0
1/04/2020,New Zealand,Pahang,0,0,0
1/04/2020,New Zealand,Perak,0,0,0
1/04/2020,New Zealand,Perlis,0,0,0
1/04/2020,New Zealand,Pulau Pinang,0,0,0
1/04/2020,New Zealand,Sabah,0,0,0
1/04/2020,New Zealand,Sarawak,0,0,0
1/04/2020,New Zealand,Selangor,2,1,1
1/04/2020,New Zealand,Terengganu,0,0,0
1/04/2020,New Zealand,W.P. Labuan,0,0,0
1/04/2020,Oman,Johor,0,0,0
1/04/2020,Oman,Kedah,0,0,0
1/04/2020,Oman,Kelantan,0,0,0
1/04/2020,Oman,Melaka,0,0,0
1/04/2020,Oman,Perak,0,0,0
1/04/2020,Oman,Perlis,0,0,0
1/04/2020,Oman,Pulau Pinang,0,0,0
1/04/2020,Oman,Sabah,0,0,0
1/04/2020,Oman,Sarawak,0,0,0
1/04/2020,Oman,Selangor,0,0,0
1/04/2020,Pakistan,Johor,0,0,0
1/04/2020,Pakistan,Kedah,0,0,0
1/04/2020,Pakistan,Kelantan,0,0,0
1/04/2020,Pakistan,Melaka,0,0,0
1/04/2020,Pakistan,Negeri Sembilan,0,0,0
1/04/2020,Pakistan,Pahang,0,0,0
1/04/2020,Pakistan,Perak,0,0,0
1/04/2020,Pakistan,Perlis,0,0,0
1/04/2020,Pakistan,Pulau Pinang,0,0,0
1/04/2020,Pakistan,Sabah,0,0,0
1/04/2020,Pakistan,Sarawak,0,0,0
1/04/2020,Pakistan,Selangor,31,29,2
1/04/2020,Pakistan,W.P. Labuan,0,0,0
1/04/2020,Panama,Johor,0,0,0
1/04/2020,Panama,Kedah,0,0,0
1/04/2020,Panama,Perak,0,0,0
1/04/2020,Panama,Perlis,0,0,0
1/04/2020,Panama,Pulau Pinang,0,0,0
1/04/2020,Panama,Sabah,0,0,0
1/04/2020,Panama,Sarawak,0,0,0
1/04/2020,Panama,Selangor,0,0,0
1/04/2020,Peru,Johor,0,0,0
1/04/2020,Peru,Kedah,0,0,0
1/04/2020,Peru,Kelantan,0,0,0
1/04/2020,Peru,Pahang,0,0,0
1/04/2020,Peru,Perak,0,0,0
1/04/2020,Peru,Perlis,0,0,0
1/04/2020,Peru,Pulau Pinang,0,0,0
1/04/2020,Peru,Sabah,0,0,0
1/04/2020,Peru,Sarawak,0,0,0
1/04/2020,Peru,Selangor,0,0,0
1/04/2020,Peru,W.P. Labuan,0,0,0
1/04/2020,Philippines,Johor,3,2,1
1/04/2020,Philippines,Kedah,0,0,0
1/04/2020,Philippines,Kelantan,0,0,0
1/04/2020,Philippines,Melaka,0,0,0
1/04/2020,Philippines,Negeri Sembilan,0,0,0
1/04/2020,Philippines,Pahang,0,0,0
1/04/2020,Philippines,Perak,0,0,0
1/04/2020,Philippines,Perlis,0,0,0
1/04/2020,Philippines,Pulau Pinang,0,0,0
1/04/2020,Philippines,Sabah,0,0,0
1/04/2020,Philippines,Sarawak,9,9,0
1/04/2020,Philippines,Selangor,4,1,3
1/04/2020,Philippines,Terengganu,0,0,0
1/04/2020,Philippines,W.P. Labuan,0,0,0
1/04/2020,Palau,Johor,0,0,0
1/04/2020,Palau,Pulau Pinang,0,0,0
1/04/2020,Palau,Selangor,0,0,0
1/04/2020,Papua New Guinea,Johor,0,0,0
1/04/2020,Papua New Guinea,Kedah,0,0,0
1/04/2020,Papua New Guinea,Kelantan,0,0,0
1/04/2020,Papua New Guinea,Perak,0,0,0
1/04/2020,Papua New Guinea,Pulau Pinang,0,0,0
1/04/2020,Papua New Guinea,Sabah,0,0,0
1/04/2020,Papua New Guinea,Sarawak,0,0,0
1/04/2020,Papua New Guinea,Selangor,0,0,0
1/04/2020,Poland,Johor,0,0,0
1/04/2020,Poland,Kedah,0,0,0
1/04/2020,Poland,Kelantan,0,0,0
1/04/2020,Poland,Melaka,0,0,0
1/04/2020,Poland,Negeri Sembilan,0,0,0
1/04/2020,Poland,Pahang,0,0,0
1/04/2020,Poland,Perak,0,0,0
1/04/2020,Poland,Perlis,0,0,0
1/04/2020,Poland,Pulau Pinang,0,0,0
1/04/2020,Poland,Sabah,0,0,0
1/04/2020,Poland,Sarawak,0,0,0
1/04/2020,Poland,Selangor,0,0,0
1/04/2020,Poland,Terengganu,0,0,0
1/04/2020,Poland,W.P. Labuan,0,0,0
1/04/2020,"North Korea, Democratic People's Republic of",Selangor,0,0,0
1/04/2020,Portugal,Johor,0,0,0
1/04/2020,Portugal,Kedah,0,0,0
1/04/2020,Portugal,Kelantan,0,0,0
1/04/2020,Portugal,Melaka,0,0,0
1/04/2020,Portugal,Pahang,0,0,0
1/04/2020,Portugal,Perak,0,0,0
1/04/2020,Portugal,Perlis,0,0,0
1/04/2020,Portugal,Pulau Pinang,0,0,0
1/04/2020,Portugal,Sabah,0,0,0
1/04/2020,Portugal,Sarawak,0,0,0
1/04/2020,Portugal,Selangor,0,0,0
1/04/2020,Portugal,W.P. Labuan,0,0,0
1/04/2020,Paraguay,Johor,0,0,0
1/04/2020,Paraguay,Kedah,0,0,0
1/04/2020,Paraguay,Perak,0,0,0
1/04/2020,Paraguay,Perlis,0,0,0
1/04/2020,Paraguay,Pulau Pinang,0,0,0
1/04/2020,Paraguay,Sabah,0,0,0
1/04/2020,Paraguay,Sarawak,0,0,0
1/04/2020,Paraguay,Selangor,0,0,0
1/04/2020,"Palestine, State of",Johor,0,0,0
1/04/2020,"Palestine, State of",Kedah,0,0,0
1/04/2020,"Palestine, State of",Kelantan,0,0,0
1/04/2020,"Palestine, State of",Melaka,0,0,0
1/04/2020,"Palestine, State of",Perak,0,0,0
1/04/2020,"Palestine, State of",Perlis,0,0,0
1/04/2020,"Palestine, State of",Pulau Pinang,0,0,0
1/04/2020,"Palestine, State of",Sabah,0,0,0
1/04/2020,"Palestine, State of",Sarawak,0,0,0
1/04/2020,"Palestine, State of",Selangor,0,0,0
1/04/2020,Qatar,Johor,0,0,0
1/04/2020,Qatar,Kedah,0,0,0
1/04/2020,Qatar,Perlis,0,0,0
1/04/2020,Qatar,Pulau Pinang,0,0,0
1/04/2020,Qatar,Sabah,0,0,0
1/04/2020,Qatar,Sarawak,0,0,0
1/04/2020,Qatar,Selangor,0,0,0
1/04/2020,Réunion,Johor,0,0,0
1/04/2020,Réunion,Sarawak,0,0,0
1/04/2020,Romania,Johor,0,0,0
1/04/2020,Romania,Kedah,0,0,0
1/04/2020,Romania,Kelantan,0,0,0
1/04/2020,Romania,Negeri Sembilan,0,0,0
1/04/2020,Romania,Pahang,0,0,0
1/04/2020,Romania,Perak,0,0,0
1/04/2020,Romania,Perlis,0,0,0
1/04/2020,Romania,Pulau Pinang,0,0,0
1/04/2020,Romania,Sabah,0,0,0
1/04/2020,Romania,Sarawak,0,0,0
1/04/2020,Romania,Selangor,3,1,2
1/04/2020,Romania,W.P. Labuan,0,0,0
1/04/2020,Russian Federation (Russia),Johor,1,1,0
1/04/2020,Russian Federation (Russia),Kedah,0,0,0
1/04/2020,Russian Federation (Russia),Kelantan,0,0,0
1/04/2020,Russian Federation (Russia),Melaka,0,0,0
1/04/2020,Russian Federation (Russia),Negeri Sembilan,0,0,0
1/04/2020,Russian Federation (Russia),Pahang,0,0,0
1/04/2020,Russian Federation (Russia),Perak,0,0,0
1/04/2020,Russian Federation (Russia),Perlis,0,0,0
1/04/2020,Russian Federation (Russia),Pulau Pinang,0,0,0
1/04/2020,Russian Federation (Russia),Sabah,0,0,0
1/04/2020,Russian Federation (Russia),Sarawak,0,0,0
1/04/2020,Russian Federation (Russia),Selangor,1,0,1
1/04/2020,Russian Federation (Russia),W.P. Labuan,0,0,0
1/04/2020,Rwanda,Johor,0,0,0
1/04/2020,Rwanda,Kedah,0,0,0
1/04/2020,Rwanda,Pulau Pinang,0,0,0
1/04/2020,Rwanda,Selangor,0,0,0
1/04/2020,Saudi Arabia,Johor,0,0,0
1/04/2020,Saudi Arabia,Kedah,0,0,0
1/04/2020,Saudi Arabia,Kelantan,0,0,0
1/04/2020,Saudi Arabia,Melaka,0,0,0
1/04/2020,Saudi Arabia,Perak,0,0,0
1/04/2020,Saudi Arabia,Perlis,0,0,0
1/04/2020,Saudi Arabia,Pulau Pinang,0,0,0
1/04/2020,Saudi Arabia,Sabah,0,0,0
1/04/2020,Saudi Arabia,Sarawak,0,0,0
1/04/2020,Saudi Arabia,Selangor,0,0,0
1/04/2020,Saudi Arabia,W.P. Labuan,0,0,0
1/04/2020,Sudan,Johor,0,0,0
1/04/2020,Sudan,Kedah,0,0,0
1/04/2020,Sudan,Kelantan,0,0,0
1/04/2020,Sudan,Perlis,0,0,0
1/04/2020,Sudan,Pulau Pinang,0,0,0
1/04/2020,Sudan,Sabah,0,0,0
1/04/2020,Sudan,Sarawak,0,0,0
1/04/2020,Sudan,Selangor,0,0,0
1/04/2020,Sudan,W.P. Labuan,0,0,0
1/04/2020,Senegal,Johor,0,0,0
1/04/2020,Senegal,Kedah,0,0,0
1/04/2020,Senegal,Kelantan,0,0,0
1/04/2020,Senegal,Perak,0,0,0
1/04/2020,Senegal,Perlis,0,0,0
1/04/2020,Senegal,Pulau Pinang,0,0,0
1/04/2020,Senegal,Sabah,0,0,0
1/04/2020,Senegal,Sarawak,0,0,0
1/04/2020,Senegal,Selangor,0,0,0
1/04/2020,Singapore,Johor,81,67,14
1/04/2020,Singapore,Kedah,1,1,0
1/04/2020,Singapore,Kelantan,0,0,0
1/04/2020,Singapore,Melaka,0,0,0
1/04/2020,Singapore,Negeri Sembilan,0,0,0
1/04/2020,Singapore,Pahang,0,0,0
1/04/2020,Singapore,Perak,0,0,0
1/04/2020,Singapore,Perlis,0,0,0
1/04/2020,Singapore,Pulau Pinang,0,0,0
1/04/2020,Singapore,Sabah,0,0,0
1/04/2020,Singapore,Sarawak,0,0,0
1/04/2020,Singapore,Selangor,15,7,8
1/04/2020,Singapore,Terengganu,0,0,0
1/04/2020,Singapore,W.P. Labuan,0,0,0
1/04/2020,South Georgia and the South Sandwich Islands,Johor,0,0,0
1/04/2020,South Georgia and the South Sandwich Islands,Sabah,0,0,0
1/04/2020,South Georgia and the South Sandwich Islands,Selangor,0,0,0
1/04/2020,Saint Helena,Sarawak,0,0,0
1/04/2020,Solomon Islands,Johor,0,0,0
1/04/2020,Solomon Islands,Perlis,0,0,0
1/04/2020,Solomon Islands,Pulau Pinang,0,0,0
1/04/2020,Solomon Islands,Sabah,0,0,0
1/04/2020,Solomon Islands,Sarawak,0,0,0
1/04/2020,Solomon Islands,Selangor,0,0,0
1/04/2020,Solomon Islands,W.P. Labuan,0,0,0
1/04/2020,Sierra Leone,Johor,0,0,0
1/04/2020,Sierra Leone,Kedah,0,0,0
1/04/2020,Sierra Leone,Perak,0,0,0
1/04/2020,Sierra Leone,Pulau Pinang,0,0,0
1/04/2020,Sierra Leone,Sabah,0,0,0
1/04/2020,Sierra Leone,Selangor,0,0,0
1/04/2020,El Salvador,Johor,0,0,0
1/04/2020,El Salvador,Kedah,0,0,0
1/04/2020,El Salvador,Perak,0,0,0
1/04/2020,El Salvador,Perlis,0,0,0
1/04/2020,El Salvador,Pulau Pinang,0,0,0
1/04/2020,El Salvador,Sabah,0,0,0
1/04/2020,El Salvador,Selangor,0,0,0
1/04/2020,El Salvador,W.P. Labuan,0,0,0
1/04/2020,San Marino,Johor,0,0,0
1/04/2020,San Marino,Selangor,0,0,0
1/04/2020,Somalia,Johor,0,0,0
1/04/2020,Somalia,Kedah,0,0,0
1/04/2020,Somalia,Kelantan,0,0,0
1/04/2020,Somalia,Perlis,0,0,0
1/04/2020,Somalia,Sabah,0,0,0
1/04/2020,Somalia,Sarawak,0,0,0
1/04/2020,Somalia,Selangor,0,0,0
1/04/2020,Serbia,Johor,0,0,0
1/04/2020,Serbia,Kedah,0,0,0
1/04/2020,Serbia,Kelantan,0,0,0
1/04/2020,Serbia,Pahang,0,0,0
1/04/2020,Serbia,Perak,0,0,0
1/04/2020,Serbia,Perlis,0,0,0
1/04/2020,Serbia,Pulau Pinang,0,0,0
1/04/2020,Serbia,Sabah,0,0,0
1/04/2020,Serbia,Sarawak,0,0,0
1/04/2020,Serbia,Selangor,0,0,0
1/04/2020,South Sudan,Johor,0,0,0
1/04/2020,South Sudan,Kedah,0,0,0
1/04/2020,South Sudan,Sarawak,0,0,0
1/04/2020,South Sudan,Selangor,0,0,0
1/04/2020,South Sudan,W.P. Labuan,0,0,0
1/04/2020,Sao Tome and Principe,Selangor,0,0,0
1/04/2020,Suriname,Johor,0,0,0
1/04/2020,Suriname,Kedah,0,0,0
1/04/2020,Suriname,Kelantan,0,0,0
1/04/2020,Suriname,Perak,0,0,0
1/04/2020,Suriname,Perlis,0,0,0
1/04/2020,Suriname,Pulau Pinang,0,0,0
1/04/2020,Suriname,Sabah,0,0,0
1/04/2020,Suriname,Sarawak,0,0,0
1/04/2020,Suriname,Selangor,0,0,0
1/04/2020,Slovakia,Johor,0,0,0
1/04/2020,Slovakia,Kedah,0,0,0
1/04/2020,Slovakia,Kelantan,0,0,0
1/04/2020,Slovakia,Negeri Sembilan,0,0,0
1/04/2020,Slovakia,Pahang,0,0,0
1/04/2020,Slovakia,Perak,0,0,0
1/04/2020,Slovakia,Perlis,0,0,0
1/04/2020,Slovakia,Pulau Pinang,0,0,0
1/04/2020,Slovakia,Sabah,0,0,0
1/04/2020,Slovakia,Sarawak,0,0,0
1/04/2020,Slovakia,Selangor,0,0,0
1/04/2020,Slovakia,W.P. Labuan,0,0,0
1/04/2020,Slovenia,Johor,0,0,0
1/04/2020,Slovenia,Kedah,0,0,0
1/04/2020,Slovenia,Kelantan,0,0,0
1/04/2020,Slovenia,Perak,0,0,0
1/04/2020,Slovenia,Perlis,0,0,0
1/04/2020,Slovenia,Pulau Pinang,0,0,0
1/04/2020,Slovenia,Sabah,0,0,0
1/04/2020,Slovenia,Sarawak,0,0,0
1/04/2020,Slovenia,Selangor,0,0,0
1/04/2020,Slovenia,W.P. Labuan,0,0,0
1/04/2020,Sweden,Johor,0,0,0
1/04/2020,Sweden,Kedah,0,0,0
1/04/2020,Sweden,Kelantan,0,0,0
1/04/2020,Sweden,Melaka,0,0,0
1/04/2020,Sweden,Negeri Sembilan,0,0,0
1/04/2020,Sweden,Pahang,0,0,0
1/04/2020,Sweden,Perak,0,0,0
1/04/2020,Sweden,Perlis,0,0,0
1/04/2020,Sweden,Pulau Pinang,2,2,0
1/04/2020,Sweden,Sabah,0,0,0
1/04/2020,Sweden,Sarawak,0,0,0
1/04/2020,Sweden,Selangor,1,1,0
1/04/2020,Sweden,W.P. Labuan,0,0,0
1/04/2020,Eswatini,Johor,0,0,0
1/04/2020,Eswatini,Kedah,0,0,0
1/04/2020,Eswatini,Pulau Pinang,0,0,0
1/04/2020,Eswatini,Sabah,0,0,0
1/04/2020,Eswatini,Selangor,0,0,0
1/04/2020,Seychelles,Johor,0,0,0
1/04/2020,Seychelles,Kedah,0,0,0
1/04/2020,Seychelles,Pulau Pinang,0,0,0
1/04/2020,Seychelles,Sabah,0,0,0
1/04/2020,Seychelles,Sarawak,0,0,0
1/04/2020,Seychelles,Selangor,0,0,0
1/04/2020,Syrian Arab Republic,Johor,0,0,0
1/04/2020,Syrian Arab Republic,Kedah,0,0,0
1/04/2020,Syrian Arab Republic,Kelantan,0,0,0
1/04/2020,Syrian Arab Republic,Pahang,0,0,0
1/04/2020,Syrian Arab Republic,Perlis,0,0,0
1/04/2020,Syrian Arab Republic,Pulau Pinang,0,0,0
1/04/2020,Syrian Arab Republic,Sabah,0,0,0
1/04/2020,Syrian Arab Republic,Sarawak,0,0,0
1/04/2020,Syrian Arab Republic,Selangor,0,0,0
1/04/2020,Syrian Arab Republic,W.P. Labuan,0,0,0
1/04/2020,Turks and Caicos Islands,Perlis,0,0,0
1/04/2020,TCD,Johor,0,0,0
1/04/2020,TCD,Kedah,0,0,0
1/04/2020,TCD,Perlis,0,0,0
1/04/2020,TCD,Selangor,1,1,0
1/04/2020,Togo,Johor,0,0,0
1/04/2020,Togo,Perak,0,0,0
1/04/2020,Togo,Pulau Pinang,0,0,0
1/04/2020,Togo,Selangor,0,0,0
1/04/2020,Thailand,Johor,85,84,1
1/04/2020,Thailand,Kedah,13817,13143,674
1/04/2020,Thailand,Kelantan,20,4,16
1/04/2020,Thailand,Melaka,0,0,0
1/04/2020,Thailand,Negeri Sembilan,0,0,0
1/04/2020,Thailand,Pahang,0,0,0
1/04/2020,Thailand,Perak,2,0,2
1/04/2020,Thailand,Perlis,2,0,2
1/04/2020,Thailand,Pulau Pinang,0,0,0
1/04/2020,Thailand,Sabah,0,0,0
1/04/2020,Thailand,Sarawak,8,8,0
1/04/2020,Thailand,Selangor,16,4,12
1/04/2020,Thailand,Terengganu,0,0,0
1/04/2020,Thailand,W.P. Labuan,0,0,0
1/04/2020,Tajikistan,Johor,0,0,0
1/04/2020,Tajikistan,Kedah,0,0,0
1/04/2020,Tajikistan,Perlis,0,0,0
1/04/2020,Tajikistan,Pulau Pinang,0,0,0
1/04/2020,Tajikistan,Sabah,0,0,0
1/04/2020,Tajikistan,Selangor,0,0,0
1/04/2020,Tokelau,Selangor,0,0,0
1/04/2020,Turkmenistan,Johor,0,0,0
1/04/2020,Turkmenistan,Kedah,0,0,0
1/04/2020,Turkmenistan,Kelantan,0,0,0
1/04/2020,Turkmenistan,Perlis,0,0,0
1/04/2020,Turkmenistan,Pulau Pinang,0,0,0
1/04/2020,Turkmenistan,Sabah,0,0,0
1/04/2020,Turkmenistan,Sarawak,0,0,0
1/04/2020,Turkmenistan,Selangor,0,0,0
1/04/2020,Timor-Leste,Johor,0,0,0
1/04/2020,Timor-Leste,Kedah,0,0,0
1/04/2020,Timor-Leste,Perlis,0,0,0
1/04/2020,Timor-Leste,Pulau Pinang,0,0,0
1/04/2020,Timor-Leste,Sabah,0,0,0
1/04/2020,Timor-Leste,Sarawak,0,0,0
1/04/2020,Timor-Leste,Selangor,0,0,0
1/04/2020,Tonga,Johor,0,0,0
1/04/2020,Tonga,Pulau Pinang,0,0,0
1/04/2020,Tonga,Sarawak,0,0,0
1/04/2020,Tonga,Selangor,0,0,0
1/04/2020,Trinidad and Tobago,Johor,0,0,0
1/04/2020,Trinidad and Tobago,Kedah,0,0,0
1/04/2020,Trinidad and Tobago,Pahang,0,0,0
1/04/2020,Trinidad and Tobago,Pulau Pinang,0,0,0
1/04/2020,Trinidad and Tobago,Sabah,0,0,0
1/04/2020,Trinidad and Tobago,Sarawak,0,0,0
1/04/2020,Trinidad and Tobago,Selangor,0,0,0
1/04/2020,Tunisia,Johor,0,0,0
1/04/2020,Tunisia,Kedah,0,0,0
1/04/2020,Tunisia,Kelantan,0,0,0
1/04/2020,Tunisia,Melaka,0,0,0
1/04/2020,Tunisia,Perak,0,0,0
1/04/2020,Tunisia,Perlis,0,0,0
1/04/2020,Tunisia,Pulau Pinang,0,0,0
1/04/2020,Tunisia,Sabah,0,0,0
1/04/2020,Tunisia,Sarawak,0,0,0
1/04/2020,Tunisia,Selangor,0,0,0
1/04/2020,Tunisia,W.P. Labuan,0,0,0
1/04/2020,Türkiye,Johor,0,0,0
1/04/2020,Türkiye,Kedah,0,0,0
1/04/2020,Türkiye,Kelantan,0,0,0
1/04/2020,Türkiye,Melaka,0,0,0
1/04/2020,Türkiye,Negeri Sembilan,0,0,0
1/04/2020,Türkiye,Pahang,0,0,0
1/04/2020,Türkiye,Perak,0,0,0
1/04/2020,Türkiye,Perlis,0,0,0
1/04/2020,Türkiye,Pulau Pinang,0,0,0
1/04/2020,Türkiye,Sabah,0,0,0
1/04/2020,Türkiye,Sarawak,0,0,0
1/04/2020,Türkiye,Selangor,1,1,0
1/04/2020,Türkiye,W.P. Labuan,0,0,0
1/04/2020,Tuvalu,Selangor,0,0,0
1/04/2020,"Taiwan, Province of China",Johor,0,0,0
1/04/2020,"Taiwan, Province of China",Kedah,0,0,0
1/04/2020,"Taiwan, Province of China",Kelantan,0,0,0
1/04/2020,"Taiwan, Province of China",Melaka,0,0,0
1/04/2020,"Taiwan, Province of China",Negeri Sembilan,0,0,0
1/04/2020,"Taiwan, Province of China",Pahang,0,0,0
1/04/2020,"Taiwan, Province of China",Perak,0,0,0
1/04/2020,"Taiwan, Province of China",Perlis,0,0,0
1/04/2020,"Taiwan, Province of China",Pulau Pinang,0,0,0
1/04/2020,"Taiwan, Province of China",Sabah,0,0,0
1/04/2020,"Taiwan, Province of China",Sarawak,0,0,0
1/04/2020,"Taiwan, Province of China",Selangor,3,3,0
1/04/2020,"Taiwan, Province of China",W.P. Labuan,0,0,0
1/04/2020,"Tanzania, United Republic of",Johor,0,0,0
1/04/2020,"Tanzania, United Republic of",Kedah,0,0,0
1/04/2020,"Tanzania, United Republic of",Perak,0,0,0
1/04/2020,"Tanzania, United Republic of",Perlis,0,0,0
1/04/2020,"Tanzania, United Republic of",Pulau Pinang,0,0,0
1/04/2020,"Tanzania, United Republic of",Sabah,0,0,0
1/04/2020,"Tanzania, United Republic of",Sarawak,0,0,0
1/04/2020,"Tanzania, United Republic of",Selangor,0,0,0
1/04/2020,Uganda,Johor,0,0,0
1/04/2020,Uganda,Kedah,0,0,0
1/04/2020,Uganda,Perak,0,0,0
1/04/2020,Uganda,Perlis,0,0,0
1/04/2020,Uganda,Pulau Pinang,0,0,0
1/04/2020,Uganda,Sabah,0,0,0
1/04/2020,Uganda,Sarawak,0,0,0
1/04/2020,Uganda,Selangor,0,0,0
1/04/2020,Ukraine,Johor,0,0,0
1/04/2020,Ukraine,Kedah,0,0,0
1/04/2020,Ukraine,Kelantan,0,0,0
1/04/2020,Ukraine,Melaka,0,0,0
1/04/2020,Ukraine,Negeri Sembilan,0,0,0
1/04/2020,Ukraine,Pahang,0,0,0
1/04/2020,Ukraine,Perak,0,0,0
1/04/2020,Ukraine,Perlis,0,0,0
1/04/2020,Ukraine,Pulau Pinang,0,0,0
1/04/2020,Ukraine,Sabah,0,0,0
1/04/2020,Ukraine,Sarawak,0,0,0
1/04/2020,Ukraine,Selangor,0,0,0
1/04/2020,Ukraine,W.P. Labuan,0,0,0
1/04/2020,Uruguay,Johor,0,0,0
1/04/2020,Uruguay,Kedah,0,0,0
1/04/2020,Uruguay,Kelantan,0,0,0
1/04/2020,Uruguay,Perak,0,0,0
1/04/2020,Uruguay,Perlis,0,0,0
1/04/2020,Uruguay,Pulau Pinang,0,0,0
1/04/2020,Uruguay,Sabah,0,0,0
1/04/2020,Uruguay,Sarawak,0,0,0
1/04/2020,Uruguay,Selangor,0,0,0
1/04/2020,Uruguay,W.P. Labuan,0,0,0
1/04/2020,United States of America,Johor,0,0,0
1/04/2020,United States of America,Kedah,0,0,0
1/04/2020,United States of America,Kelantan,0,0,0
1/04/2020,United States of America,Melaka,0,0,0
1/04/2020,United States of America,Negeri Sembilan,0,0,0
1/04/2020,United States of America,Pahang,0,0,0
1/04/2020,United States of America,Perak,0,0,0
1/04/2020,United States of America,Perlis,0,0,0
1/04/2020,United States of America,Pulau Pinang,5,4,1
1/04/2020,United States of America,Sabah,0,0,0
1/04/2020,United States of America,Sarawak,0,0,0
1/04/2020,United States of America,Selangor,11,9,2
1/04/2020,United States of America,Terengganu,0,0,0
1/04/2020,United States of America,W.P. Labuan,0,0,0
1/04/2020,Uzbekistan,Johor,0,0,0
1/04/2020,Uzbekistan,Kedah,0,0,0
1/04/2020,Uzbekistan,Kelantan,0,0,0
1/04/2020,Uzbekistan,Perak,0,0,0
1/04/2020,Uzbekistan,Perlis,0,0,0
1/04/2020,Uzbekistan,Pulau Pinang,0,0,0
1/04/2020,Uzbekistan,Sabah,0,0,0
1/04/2020,Uzbekistan,Sarawak,0,0,0
1/04/2020,Uzbekistan,Selangor,0,0,0
1/04/2020,Holy See,Johor,0,0,0
1/04/2020,Holy See,Sarawak,0,0,0
1/04/2020,Holy See,Selangor,0,0,0
1/04/2020,Saint Vincent and the Grenadines,Johor,0,0,0
1/04/2020,Saint Vincent and the Grenadines,Kedah,0,0,0
1/04/2020,Saint Vincent and the Grenadines,Pulau Pinang,0,0,0
1/04/2020,Saint Vincent and the Grenadines,Sarawak,0,0,0
1/04/2020,Saint Vincent and the Grenadines,Selangor,0,0,0
1/04/2020,"Venezuela, Bolivarian Republic of",Johor,0,0,0
1/04/2020,"Venezuela, Bolivarian Republic of",Kedah,0,0,0
1/04/2020,"Venezuela, Bolivarian Republic of",Kelantan,0,0,0
1/04/2020,"Venezuela, Bolivarian Republic of",Melaka,0,0,0
1/04/2020,"Venezuela, Bolivarian Republic of",Perak,0,0,0
1/04/2020,"Venezuela, Bolivarian Republic of",Perlis,0,0,0
1/04/2020,"Venezuela, Bolivarian Republic of",Pulau Pinang,0,0,0
1/04/2020,"Venezuela, Bolivarian Republic of",Sabah,0,0,0
1/04/2020,"Venezuela, Bolivarian Republic of",Sarawak,0,0,0
1/04/2020,"Venezuela, Bolivarian Republic of",Selangor,0,0,0
1/04/2020,"Venezuela, Bolivarian Republic of",W.P. Labuan,0,0,0
1/04/2020,Viet Nam,Johor,2,0,2
1/04/2020,Viet Nam,Kedah,0,0,0
1/04/2020,Viet Nam,Kelantan,0,0,0
1/04/2020,Viet Nam,Melaka,0,0,0
1/04/2020,Viet Nam,Negeri Sembilan,0,0,0
1/04/2020,Viet Nam,Pahang,0,0,0
1/04/2020,Viet Nam,Perak,0,0,0
1/04/2020,Viet Nam,Perlis,0,0,0
1/04/2020,Viet Nam,Pulau Pinang,0,0,0
1/04/2020,Viet Nam,Sabah,0,0,0
1/04/2020,Viet Nam,Sarawak,0,0,0
1/04/2020,Viet Nam,Selangor,14,4,10
1/04/2020,Viet Nam,Terengganu,0,0,0
1/04/2020,Viet Nam,W.P. Labuan,0,0,0
1/04/2020,Vanuatu,Johor,0,0,0
1/04/2020,Vanuatu,Kedah,0,0,0
1/04/2020,Vanuatu,Pulau Pinang,0,0,0
1/04/2020,Vanuatu,Sabah,0,0,0
1/04/2020,Vanuatu,Sarawak,0,0,0
1/04/2020,Vanuatu,Selangor,0,0,0
1/04/2020, Samoa,Johor,0,0,0
1/04/2020, Samoa,Sarawak,0,0,0
1/04/2020, Samoa,Selangor,0,0,0
1/04/2020,Yemen,Johor,0,0,0
1/04/2020,Yemen,Kedah,0,0,0
1/04/2020,Yemen,Kelantan,0,0,0
1/04/2020,Yemen,Melaka,0,0,0
1/04/2020,Yemen,Pahang,0,0,0
1/04/2020,Yemen,Perak,0,0,0
1/04/2020,Yemen,Perlis,0,0,0
1/04/2020,Yemen,Pulau Pinang,0,0,0
1/04/2020,Yemen,Sabah,0,0,0
1/04/2020,Yemen,Sarawak,0,0,0
1/04/2020,Yemen,Selangor,0,0,0
1/04/2020,Yemen,W.P. Labuan,0,0,0
1/04/2020,South Africa,Johor,0,0,0
1/04/2020,South Africa,Kedah,0,0,0
1/04/2020,South Africa,Kelantan,0,0,0
1/04/2020,South Africa,Melaka,0,0,0
1/04/2020,South Africa,Pahang,0,0,0
1/04/2020,South Africa,Perak,0,0,0
1/04/2020,South Africa,Perlis,0,0,0
1/04/2020,South Africa,Pulau Pinang,0,0,0
1/04/2020,South Africa,Sabah,0,0,0
1/04/2020,South Africa,Sarawak,0,0,0
1/04/2020,South Africa,Selangor,0,0,0
1/04/2020,South Africa,Terengganu,0,0,0
1/04/2020,South Africa,W.P. Labuan,0,0,0
1/04/2020,ZAR,Selangor,0,0,0
1/04/2020,Zambia,Johor,0,0,0
1/04/2020,Zambia,Kedah,0,0,0
1/04/2020,Zambia,Perak,0,0,0
1/04/2020,Zambia,Perlis,0,0,0
1/04/2020,Zambia,Pulau Pinang,0,0,0
1/04/2020,Zambia,Sabah,0,0,0
1/04/2020,Zambia,Sarawak,0,0,0
1/04/2020,Zambia,Selangor,0,0,0
1/04/2020,Zimbabwe,Johor,0,0,0
1/04/2020,Zimbabwe,Kedah,0,0,0
1/04/2020,Zimbabwe,Kelantan,0,0,0
1/04/2020,Zimbabwe,Perak,0,0,0
1/04/2020,Zimbabwe,Perlis,0,0,0
1/04/2020,Zimbabwe,Pulau Pinang,0,0,0
1/04/2020,Zimbabwe,Sabah,0,0,0
1/04/2020,Zimbabwe,Sarawak,0,0,0
1/04/2020,Zimbabwe,Selangor,0,0,0
1/05/2020,Aruba,Kedah,0,0,0
1/05/2020,Aruba,Pulau Pinang,0,0,0
1/05/2020,Afghanistan,Johor,0,0,0
1/05/2020,Afghanistan,Kedah,0,0,0
1/05/2020,Afghanistan,Perlis,0,0,0
1/05/2020,Afghanistan,Pulau Pinang,0,0,0
1/05/2020,Afghanistan,Sarawak,0,0,0
1/05/2020,Afghanistan,Selangor,1,1,0
1/05/2020,Angola,Johor,0,0,0
1/05/2020,Angola,Kedah,0,0,0
1/05/2020,Angola,Sabah,0,0,0
1/05/2020,Angola,Selangor,0,0,0
1/05/2020,Anguilla,Selangor,0,0,0
1/05/2020,Albania,Johor,0,0,0
1/05/2020,Albania,Kedah,0,0,0
1/05/2020,Albania,Perak,0,0,0
1/05/2020,Albania,Perlis,0,0,0
1/05/2020,Albania,Pulau Pinang,0,0,0
1/05/2020,Albania,Sabah,0,0,0
1/05/2020,Albania,Sarawak,0,0,0
1/05/2020,Albania,Selangor,0,0,0
1/05/2020,Andorra,Johor,0,0,0
1/05/2020,Andorra,Kedah,0,0,0
1/05/2020,Andorra,Perlis,0,0,0
1/05/2020,Andorra,Pulau Pinang,0,0,0
1/05/2020,Andorra,Selangor,0,0,0
1/05/2020,Antigua and Barbuda,Selangor,0,0,0
1/05/2020,United Arab Emirates,Johor,0,0,0
1/05/2020,United Arab Emirates,Kedah,0,0,0
1/05/2020,United Arab Emirates,Kelantan,0,0,0
1/05/2020,United Arab Emirates,Perak,0,0,0
1/05/2020,United Arab Emirates,Perlis,0,0,0
1/05/2020,United Arab Emirates,Pulau Pinang,0,0,0
1/05/2020,United Arab Emirates,Sabah,0,0,0
1/05/2020,United Arab Emirates,Sarawak,0,0,0
1/05/2020,United Arab Emirates,Selangor,0,0,0
1/05/2020,Argentina,Johor,0,0,0
1/05/2020,Argentina,Kedah,0,0,0
1/05/2020,Argentina,Kelantan,0,0,0
1/05/2020,Argentina,Melaka,0,0,0
1/05/2020,Argentina,Perak,0,0,0
1/05/2020,Argentina,Perlis,0,0,0
1/05/2020,Argentina,Pulau Pinang,0,0,0
1/05/2020,Argentina,Sabah,0,0,0
1/05/2020,Argentina,Sarawak,0,0,0
1/05/2020,Argentina,Selangor,0,0,0
1/05/2020,Argentina,W.P. Labuan,0,0,0
1/05/2020,Armenia,Johor,0,0,0
1/05/2020,Armenia,Kedah,0,0,0
1/05/2020,Armenia,Kelantan,0,0,0
1/05/2020,Armenia,Perak,0,0,0
1/05/2020,Armenia,Perlis,0,0,0
1/05/2020,Armenia,Pulau Pinang,0,0,0
1/05/2020,Armenia,Sabah,0,0,0
1/05/2020,Armenia,Sarawak,0,0,0
1/05/2020,Armenia,Selangor,0,0,0
1/05/2020,Antarctica,Selangor,0,0,0
1/05/2020,Antigua and Barbuda,Johor,0,0,0
1/05/2020,Antigua and Barbuda,Kedah,0,0,0
1/05/2020,Antigua and Barbuda,Pulau Pinang,0,0,0
1/05/2020,Antigua and Barbuda,Sarawak,0,0,0
1/05/2020,Antigua and Barbuda,Selangor,0,0,0
1/05/2020,Australia,Johor,0,0,0
1/05/2020,Australia,Kedah,0,0,0
1/05/2020,Australia,Kelantan,0,0,0
1/05/2020,Australia,Melaka,0,0,0
1/05/2020,Australia,Negeri Sembilan,0,0,0
1/05/2020,Australia,Pahang,0,0,0
1/05/2020,Australia,Perak,0,0,0
1/05/2020,Australia,Perlis,0,0,0
1/05/2020,Australia,Pulau Pinang,0,0,0
1/05/2020,Australia,Sabah,0,0,0
1/05/2020,Australia,Sarawak,0,0,0
1/05/2020,Australia,Selangor,42,35,7
1/05/2020,Australia,Terengganu,0,0,0
1/05/2020,Australia,W.P. Labuan,0,0,0
1/05/2020,Austria,Johor,0,0,0
1/05/2020,Austria,Kedah,0,0,0
1/05/2020,Austria,Kelantan,0,0,0
1/05/2020,Austria,Melaka,0,0,0
1/05/2020,Austria,Negeri Sembilan,0,0,0
1/05/2020,Austria,Pahang,0,0,0
1/05/2020,Austria,Perak,0,0,0
1/05/2020,Austria,Perlis,0,0,0
1/05/2020,Austria,Pulau Pinang,0,0,0
1/05/2020,Austria,Sabah,0,0,0
1/05/2020,Austria,Sarawak,0,0,0
1/05/2020,Austria,Selangor,0,0,0
1/05/2020,Austria,Terengganu,0,0,0
1/05/2020,Austria,W.P. Labuan,0,0,0
1/05/2020,Azerbaijan,Johor,0,0,0
1/05/2020,Azerbaijan,Kedah,0,0,0
1/05/2020,Azerbaijan,Kelantan,0,0,0
1/05/2020,Azerbaijan,Melaka,0,0,0
1/05/2020,Azerbaijan,Perlis,0,0,0
1/05/2020,Azerbaijan,Pulau Pinang,0,0,0
1/05/2020,Azerbaijan,Sabah,0,0,0
1/05/2020,Azerbaijan,Sarawak,0,0,0
1/05/2020,Azerbaijan,Selangor,1,1,0
1/05/2020,Azerbaijan,W.P. Labuan,0,0,0
1/05/2020,Burundi,Pulau Pinang,0,0,0
1/05/2020,Burundi,Sarawak,0,0,0
1/05/2020,Burundi,Selangor,0,0,0
1/05/2020,Belgium,Johor,0,0,0
1/05/2020,Belgium,Kedah,0,0,0
1/05/2020,Belgium,Kelantan,0,0,0
1/05/2020,Belgium,Melaka,0,0,0
1/05/2020,Belgium,Negeri Sembilan,0,0,0
1/05/2020,Belgium,Pahang,0,0,0
1/05/2020,Belgium,Perak,0,0,0
1/05/2020,Belgium,Perlis,0,0,0
1/05/2020,Belgium,Pulau Pinang,0,0,0
1/05/2020,Belgium,Sabah,0,0,0
1/05/2020,Belgium,Sarawak,0,0,0
1/05/2020,Belgium,Selangor,1,0,1
1/05/2020,Belgium,W.P. Labuan,0,0,0
1/05/2020,Benin,Johor,0,0,0
1/05/2020,Benin,Kedah,0,0,0
1/05/2020,Benin,Perak,0,0,0
1/05/2020,Benin,Pulau Pinang,0,0,0
1/05/2020,Benin,Sabah,0,0,0
1/05/2020,Benin,Sarawak,0,0,0
1/05/2020,Benin,Selangor,0,0,0
1/05/2020,Burkina Faso,Perak,0,0,0
1/05/2020,Burkina Faso,Pulau Pinang,0,0,0
1/05/2020,Burkina Faso,Selangor,0,0,0
1/05/2020,Bangladesh,Johor,0,0,0
1/05/2020,Bangladesh,Kedah,0,0,0
1/05/2020,Bangladesh,Kelantan,0,0,0
1/05/2020,Bangladesh,Melaka,0,0,0
1/05/2020,Bangladesh,Negeri Sembilan,0,0,0
1/05/2020,Bangladesh,Pahang,0,0,0
1/05/2020,Bangladesh,Perak,0,0,0
1/05/2020,Bangladesh,Perlis,0,0,0
1/05/2020,Bangladesh,Pulau Pinang,0,0,0
1/05/2020,Bangladesh,Sabah,0,0,0
1/05/2020,Bangladesh,Sarawak,0,0,0
1/05/2020,Bangladesh,Selangor,10,9,1
1/05/2020,Bangladesh,W.P. Labuan,0,0,0
1/05/2020,Bulgaria,Johor,0,0,0
1/05/2020,Bulgaria,Kedah,0,0,0
1/05/2020,Bulgaria,Kelantan,0,0,0
1/05/2020,Bulgaria,Pahang,0,0,0
1/05/2020,Bulgaria,Perak,0,0,0
1/05/2020,Bulgaria,Perlis,0,0,0
1/05/2020,Bulgaria,Pulau Pinang,0,0,0
1/05/2020,Bulgaria,Sabah,0,0,0
1/05/2020,Bulgaria,Sarawak,0,0,0
1/05/2020,Bulgaria,Selangor,0,0,0
1/05/2020,Bulgaria,W.P. Labuan,0,0,0
1/05/2020,Bahrain,Johor,0,0,0
1/05/2020,Bahrain,Kedah,0,0,0
1/05/2020,Bahrain,Kelantan,0,0,0
1/05/2020,Bahrain,Perlis,0,0,0
1/05/2020,Bahrain,Pulau Pinang,0,0,0
1/05/2020,Bahrain,Sabah,0,0,0
1/05/2020,Bahrain,Sarawak,0,0,0
1/05/2020,Bahrain,Selangor,0,0,0
1/05/2020,Bahamas,Johor,0,0,0
1/05/2020,Bahamas,Kedah,0,0,0
1/05/2020,Bahamas,Perak,0,0,0
1/05/2020,Bahamas,Sabah,0,0,0
1/05/2020,Bahamas,Sarawak,0,0,0
1/05/2020,Bahamas,Selangor,0,0,0
1/05/2020,Bosnia and Herzegovina,Johor,0,0,0
1/05/2020,Bosnia and Herzegovina,Kedah,0,0,0
1/05/2020,Bosnia and Herzegovina,Perlis,0,0,0
1/05/2020,Bosnia and Herzegovina,Pulau Pinang,0,0,0
1/05/2020,Bosnia and Herzegovina,Sabah,0,0,0
1/05/2020,Bosnia and Herzegovina,Sarawak,0,0,0
1/05/2020,Bosnia and Herzegovina,Selangor,0,0,0
1/05/2020,Belarus,Johor,0,0,0
1/05/2020,Belarus,Kedah,0,0,0
1/05/2020,Belarus,Kelantan,0,0,0
1/05/2020,Belarus,Pahang,0,0,0
1/05/2020,Belarus,Perak,0,0,0
1/05/2020,Belarus,Perlis,0,0,0
1/05/2020,Belarus,Pulau Pinang,0,0,0
1/05/2020,Belarus,Sabah,0,0,0
1/05/2020,Belarus,Sarawak,0,0,0
1/05/2020,Belarus,Selangor,0,0,0
1/05/2020,Belarus,W.P. Labuan,0,0,0
1/05/2020,Belize,Johor,0,0,0
1/05/2020,Belize,Pulau Pinang,0,0,0
1/05/2020,Belize,Sarawak,0,0,0
1/05/2020,Belize,Selangor,0,0,0
1/05/2020,Bermuda,Selangor,0,0,0
1/05/2020,Bolivia,Johor,0,0,0
1/05/2020,Bolivia,Kedah,0,0,0
1/05/2020,Bolivia,Melaka,0,0,0
1/05/2020,Bolivia,Perak,0,0,0
1/05/2020,Bolivia,Perlis,0,0,0
1/05/2020,Bolivia,Pulau Pinang,0,0,0
1/05/2020,Bolivia,Sabah,0,0,0
1/05/2020,Bolivia,Sarawak,0,0,0
1/05/2020,Bolivia,Selangor,0,0,0
1/05/2020,Brazil,Johor,0,0,0
1/05/2020,Brazil,Kedah,0,0,0
1/05/2020,Brazil,Kelantan,0,0,0
1/05/2020,Brazil,Melaka,0,0,0
1/05/2020,Brazil,Pahang,0,0,0
1/05/2020,Brazil,Perak,0,0,0
1/05/2020,Brazil,Perlis,0,0,0
1/05/2020,Brazil,Pulau Pinang,0,0,0
1/05/2020,Brazil,Sabah,0,0,0
1/05/2020,Brazil,Sarawak,0,0,0
1/05/2020,Brazil,Selangor,12,12,0
1/05/2020,Brazil,W.P. Labuan,0,0,0
1/05/2020,Barbados,Johor,0,0,0
1/05/2020,Barbados,Kedah,0,0,0
1/05/2020,Barbados,Perlis,0,0,0
1/05/2020,Barbados,Pulau Pinang,0,0,0
1/05/2020,Barbados,Selangor,0,0,0
1/05/2020,Brunei Darussalam,Johor,0,0,0
1/05/2020,Brunei Darussalam,Kedah,0,0,0
1/05/2020,Brunei Darussalam,Kelantan,0,0,0
1/05/2020,Brunei Darussalam,Melaka,0,0,0
1/05/2020,Brunei Darussalam,Pahang,0,0,0
1/05/2020,Brunei Darussalam,Perak,0,0,0
1/05/2020,Brunei Darussalam,Perlis,0,0,0
1/05/2020,Brunei Darussalam,Pulau Pinang,0,0,0
1/05/2020,Brunei Darussalam,Sabah,0,0,0
1/05/2020,Brunei Darussalam,Sarawak,328,320,8
1/05/2020,Brunei Darussalam,Selangor,1,1,0
1/05/2020,Brunei Darussalam,W.P. Labuan,1,1,0
1/05/2020,Bhutan,Johor,0,0,0
1/05/2020,Bhutan,Kedah,0,0,0
1/05/2020,Bhutan,Perak,0,0,0
1/05/2020,Bhutan,Perlis,0,0,0
1/05/2020,Bhutan,Pulau Pinang,0,0,0
1/05/2020,Bhutan,Sabah,0,0,0
1/05/2020,Bhutan,Sarawak,0,0,0
1/05/2020,Bhutan,Selangor,0,0,0
1/05/2020,Botswana,Johor,0,0,0
1/05/2020,Botswana,Kedah,0,0,0
1/05/2020,Botswana,Perlis,0,0,0
1/05/2020,Botswana,Pulau Pinang,0,0,0
1/05/2020,Botswana,Sabah,0,0,0
1/05/2020,Botswana,Sarawak,0,0,0
1/05/2020,Botswana,Selangor,0,0,0
1/05/2020,Central African Republic,Kedah,0,0,0
1/05/2020,Central African Republic,Selangor,0,0,0
1/05/2020,Canada,Johor,1,1,0
1/05/2020,Canada,Kedah,0,0,0
1/05/2020,Canada,Kelantan,0,0,0
1/05/2020,Canada,Melaka,0,0,0
1/05/2020,Canada,Negeri Sembilan,0,0,0
1/05/2020,Canada,Pahang,0,0,0
1/05/2020,Canada,Perak,0,0,0
1/05/2020,Canada,Perlis,0,0,0
1/05/2020,Canada,Pulau Pinang,0,0,0
1/05/2020,Canada,Sabah,0,0,0
1/05/2020,Canada,Sarawak,0,0,0
1/05/2020,Canada,Selangor,19,17,2
1/05/2020,Canada,Terengganu,0,0,0
1/05/2020,Canada,W.P. Labuan,0,0,0
1/05/2020,Cocos (Keeling) Islands,Selangor,0,0,0
1/05/2020,Switzerland,Johor,0,0,0
1/05/2020,Switzerland,Kedah,0,0,0
1/05/2020,Switzerland,Kelantan,0,0,0
1/05/2020,Switzerland,Melaka,0,0,0
1/05/2020,Switzerland,Negeri Sembilan,0,0,0
1/05/2020,Switzerland,Pahang,0,0,0
1/05/2020,Switzerland,Perak,0,0,0
1/05/2020,Switzerland,Perlis,0,0,0
1/05/2020,Switzerland,Pulau Pinang,0,0,0
1/05/2020,Switzerland,Sabah,0,0,0
1/05/2020,Switzerland,Sarawak,0,0,0
1/05/2020,Switzerland,Selangor,1,1,0
1/05/2020,Switzerland,W.P. Labuan,0,0,0
1/05/2020,Chile,Johor,0,0,0
1/05/2020,Chile,Kedah,0,0,0
1/05/2020,Chile,Kelantan,0,0,0
1/05/2020,Chile,Melaka,0,0,0
1/05/2020,Chile,Pahang,0,0,0
1/05/2020,Chile,Perak,0,0,0
1/05/2020,Chile,Perlis,0,0,0
1/05/2020,Chile,Pulau Pinang,0,0,0
1/05/2020,Chile,Sabah,0,0,0
1/05/2020,Chile,Sarawak,0,0,0
1/05/2020,Chile,Selangor,0,0,0
1/05/2020,China,Johor,2,0,2
1/05/2020,China,Kedah,0,0,0
1/05/2020,China,Kelantan,0,0,0
1/05/2020,China,Melaka,0,0,0
1/05/2020,China,Pahang,0,0,0
1/05/2020,China,Perak,0,0,0
1/05/2020,China,Perlis,0,0,0
1/05/2020,China,Pulau Pinang,0,0,0
1/05/2020,China,Sabah,0,0,0
1/05/2020,China,Sarawak,0,0,0
1/05/2020,China,Selangor,21,11,10
1/05/2020,China,Terengganu,0,0,0
1/05/2020,China,W.P. Labuan,0,0,0
1/05/2020,Côte d'Ivoire,Johor,0,0,0
1/05/2020,Côte d'Ivoire,Kedah,0,0,0
1/05/2020,Côte d'Ivoire,Pulau Pinang,0,0,0
1/05/2020,Côte d'Ivoire,Sabah,0,0,0
1/05/2020,Côte d'Ivoire,Sarawak,0,0,0
1/05/2020,Côte d'Ivoire,Selangor,0,0,0
1/05/2020,Cameroon,Johor,0,0,0
1/05/2020,Cameroon,Kedah,0,0,0
1/05/2020,Cameroon,Pulau Pinang,0,0,0
1/05/2020,Cameroon,Sabah,0,0,0
1/05/2020,Cameroon,Sarawak,0,0,0
1/05/2020,Cameroon,Selangor,0,0,0
1/05/2020,Congo,Johor,0,0,0
1/05/2020,Congo,Pulau Pinang,0,0,0
1/05/2020,Congo,Sarawak,0,0,0
1/05/2020,Congo,Selangor,0,0,0
1/05/2020,Congo,Johor,0,0,0
1/05/2020,Congo,Kedah,0,0,0
1/05/2020,Congo,Selangor,0,0,0
1/05/2020,Cook Islands,Selangor,0,0,0
1/05/2020,Colombia,Johor,0,0,0
1/05/2020,Colombia,Kedah,0,0,0
1/05/2020,Colombia,Perak,0,0,0
1/05/2020,Colombia,Pulau Pinang,0,0,0
1/05/2020,Colombia,Sabah,0,0,0
1/05/2020,Colombia,Sarawak,0,0,0
1/05/2020,Colombia,Selangor,0,0,0
1/05/2020,Colombia,W.P. Labuan,0,0,0
1/05/2020,Comoros,Johor,0,0,0
1/05/2020,Comoros,Kedah,0,0,0
1/05/2020,Comoros,Selangor,0,0,0
1/05/2020,Cabo Verde,Johor,0,0,0
1/05/2020,Cabo Verde,Kedah,0,0,0
1/05/2020,Cabo Verde,Pulau Pinang,0,0,0
1/05/2020,Cabo Verde,Sabah,0,0,0
1/05/2020,Cabo Verde,Selangor,0,0,0
1/05/2020,Costa Rica,Johor,0,0,0
1/05/2020,Costa Rica,Kedah,0,0,0
1/05/2020,Costa Rica,Perak,0,0,0
1/05/2020,Costa Rica,Perlis,0,0,0
1/05/2020,Costa Rica,Pulau Pinang,0,0,0
1/05/2020,Costa Rica,Sabah,0,0,0
1/05/2020,Costa Rica,Sarawak,0,0,0
1/05/2020,Costa Rica,Selangor,0,0,0
1/05/2020,Cuba,Johor,0,0,0
1/05/2020,Cuba,Kedah,0,0,0
1/05/2020,Cuba,Perlis,0,0,0
1/05/2020,Cuba,Pulau Pinang,0,0,0
1/05/2020,Cuba,Sabah,0,0,0
1/05/2020,Cuba,Sarawak,0,0,0
1/05/2020,Cuba,Selangor,0,0,0
1/05/2020,Cyprus,Johor,0,0,0
1/05/2020,Cyprus,Kedah,0,0,0
1/05/2020,Cyprus,Perak,0,0,0
1/05/2020,Cyprus,Perlis,0,0,0
1/05/2020,Cyprus,Pulau Pinang,0,0,0
1/05/2020,Cyprus,Sabah,0,0,0
1/05/2020,Cyprus,Sarawak,0,0,0
1/05/2020,Cyprus,Selangor,0,0,0
1/05/2020,Czechia,Johor,0,0,0
1/05/2020,Czechia,Kedah,0,0,0
1/05/2020,Czechia,Kelantan,0,0,0
1/05/2020,Czechia,Melaka,0,0,0
1/05/2020,Czechia,Negeri Sembilan,0,0,0
1/05/2020,Czechia,Perak,0,0,0
1/05/2020,Czechia,Perlis,0,0,0
1/05/2020,Czechia,Pulau Pinang,0,0,0
1/05/2020,Czechia,Sabah,0,0,0
1/05/2020,Czechia,Sarawak,0,0,0
1/05/2020,Czechia,Selangor,1,1,0
1/05/2020,Czechia,W.P. Labuan,0,0,0
1/05/2020,Germany,Johor,0,0,0
1/05/2020,Germany,Kedah,0,0,0
1/05/2020,Germany,Kelantan,0,0,0
1/05/2020,Germany,Melaka,0,0,0
1/05/2020,Germany,Negeri Sembilan,0,0,0
1/05/2020,Germany,Pahang,0,0,0
1/05/2020,Germany,Perak,0,0,0
1/05/2020,Germany,Perlis,0,0,0
1/05/2020,Germany,Pulau Pinang,0,0,0
1/05/2020,Germany,Sabah,0,0,0
1/05/2020,Germany,Sarawak,0,0,0
1/05/2020,Germany,Selangor,4,2,2
1/05/2020,Germany,Terengganu,0,0,0
1/05/2020,Germany,W.P. Labuan,0,0,0
1/05/2020,Djibouti,Johor,0,0,0
1/05/2020,Djibouti,Selangor,0,0,0
1/05/2020,Dominica,Johor,0,0,0
1/05/2020,Dominica,Kedah,0,0,0
1/05/2020,Dominica,Pulau Pinang,0,0,0
1/05/2020,Dominica,Sabah,0,0,0
1/05/2020,Dominica,Sarawak,0,0,0
1/05/2020,Dominica,Selangor,0,0,0
1/05/2020,Dominica,W.P. Labuan,0,0,0
1/05/2020,Denmark,Johor,0,0,0
1/05/2020,Denmark,Kedah,0,0,0
1/05/2020,Denmark,Kelantan,0,0,0
1/05/2020,Denmark,Melaka,0,0,0
1/05/2020,Denmark,Negeri Sembilan,0,0,0
1/05/2020,Denmark,Pahang,0,0,0
1/05/2020,Denmark,Perak,0,0,0
1/05/2020,Denmark,Perlis,0,0,0
1/05/2020,Denmark,Pulau Pinang,0,0,0
1/05/2020,Denmark,Sabah,0,0,0
1/05/2020,Denmark,Sarawak,0,0,0
1/05/2020,Denmark,Selangor,0,0,0
1/05/2020,Denmark,W.P. Labuan,0,0,0
1/05/2020,Dominican Republic,Johor,0,0,0
1/05/2020,Dominican Republic,Kedah,0,0,0
1/05/2020,Dominican Republic,Perak,0,0,0
1/05/2020,Dominican Republic,Perlis,0,0,0
1/05/2020,Dominican Republic,Pulau Pinang,0,0,0
1/05/2020,Dominican Republic,Sabah,0,0,0
1/05/2020,Dominican Republic,Sarawak,0,0,0
1/05/2020,Dominican Republic,Selangor,0,0,0
1/05/2020,Algeria,Johor,0,0,0
1/05/2020,Algeria,Kedah,0,0,0
1/05/2020,Algeria,Kelantan,0,0,0
1/05/2020,Algeria,Melaka,0,0,0
1/05/2020,Algeria,Perak,0,0,0
1/05/2020,Algeria,Perlis,0,0,0
1/05/2020,Algeria,Pulau Pinang,0,0,0
1/05/2020,Algeria,Sabah,0,0,0
1/05/2020,Algeria,Sarawak,0,0,0
1/05/2020,Algeria,Selangor,0,0,0
1/05/2020,Algeria,W.P. Labuan,0,0,0
1/05/2020,Ecuador,Johor,0,0,0
1/05/2020,Ecuador,Kedah,0,0,0
1/05/2020,Ecuador,Perak,0,0,0
1/05/2020,Ecuador,Perlis,0,0,0
1/05/2020,Ecuador,Pulau Pinang,0,0,0
1/05/2020,Ecuador,Sabah,0,0,0
1/05/2020,Ecuador,Sarawak,0,0,0
1/05/2020,Ecuador,Selangor,0,0,0
1/05/2020,Egypt,Johor,0,0,0
1/05/2020,Egypt,Kedah,0,0,0
1/05/2020,Egypt,Kelantan,0,0,0
1/05/2020,Egypt,Melaka,0,0,0
1/05/2020,Egypt,Pahang,0,0,0
1/05/2020,Egypt,Perak,0,0,0
1/05/2020,Egypt,Perlis,0,0,0
1/05/2020,Egypt,Pulau Pinang,0,0,0
1/05/2020,Egypt,Sabah,0,0,0
1/05/2020,Egypt,Sarawak,0,0,0
1/05/2020,Egypt,Selangor,13,11,2
1/05/2020,Egypt,Terengganu,0,0,0
1/05/2020,Egypt,W.P. Labuan,0,0,0
1/05/2020,Eritrea,Johor,0,0,0
1/05/2020,Eritrea,Pulau Pinang,0,0,0
1/05/2020,Eritrea,Sabah,0,0,0
1/05/2020,Eritrea,Selangor,0,0,0
1/05/2020,Spain,Johor,0,0,0
1/05/2020,Spain,Kedah,0,0,0
1/05/2020,Spain,Kelantan,0,0,0
1/05/2020,Spain,Melaka,0,0,0
1/05/2020,Spain,Negeri Sembilan,0,0,0
1/05/2020,Spain,Pahang,0,0,0
1/05/2020,Spain,Perak,0,0,0
1/05/2020,Spain,Perlis,0,0,0
1/05/2020,Spain,Pulau Pinang,0,0,0
1/05/2020,Spain,Sabah,0,0,0
1/05/2020,Spain,Sarawak,0,0,0
1/05/2020,Spain,Selangor,0,0,0
1/05/2020,Spain,W.P. Labuan,0,0,0
1/05/2020,Estonia,Johor,0,0,0
1/05/2020,Estonia,Kedah,0,0,0
1/05/2020,Estonia,Kelantan,0,0,0
1/05/2020,Estonia,Pahang,0,0,0
1/05/2020,Estonia,Perak,0,0,0
1/05/2020,Estonia,Perlis,0,0,0
1/05/2020,Estonia,Pulau Pinang,0,0,0
1/05/2020,Estonia,Sabah,0,0,0
1/05/2020,Estonia,Sarawak,0,0,0
1/05/2020,Estonia,Selangor,0,0,0
1/05/2020,Estonia,W.P. Labuan,0,0,0
1/05/2020,Ethiopia,Johor,0,0,0
1/05/2020,Ethiopia,Kedah,0,0,0
1/05/2020,Ethiopia,Pulau Pinang,0,0,0
1/05/2020,Ethiopia,Sarawak,0,0,0
1/05/2020,Ethiopia,Selangor,0,0,0
1/05/2020,Finland,Johor,0,0,0
1/05/2020,Finland,Kedah,0,0,0
1/05/2020,Finland,Kelantan,0,0,0
1/05/2020,Finland,Melaka,0,0,0
1/05/2020,Finland,Negeri Sembilan,0,0,0
1/05/2020,Finland,Pahang,0,0,0
1/05/2020,Finland,Perak,0,0,0
1/05/2020,Finland,Perlis,0,0,0
1/05/2020,Finland,Pulau Pinang,0,0,0
1/05/2020,Finland,Sabah,0,0,0
1/05/2020,Finland,Sarawak,0,0,0
1/05/2020,Finland,Selangor,2,1,1
1/05/2020,Finland,W.P. Labuan,0,0,0
1/05/2020,Fiji,Johor,0,0,0
1/05/2020,Fiji,Kedah,0,0,0
1/05/2020,Fiji,Kelantan,0,0,0
1/05/2020,Fiji,Perak,0,0,0
1/05/2020,Fiji,Perlis,0,0,0
1/05/2020,Fiji,Pulau Pinang,0,0,0
1/05/2020,Fiji,Sabah,0,0,0
1/05/2020,Fiji,Sarawak,0,0,0
1/05/2020,Fiji,Selangor,0,0,0
1/05/2020,France,Johor,0,0,0
1/05/2020,France,Kedah,0,0,0
1/05/2020,France,Kelantan,0,0,0
1/05/2020,France,Melaka,0,0,0
1/05/2020,France,Negeri Sembilan,0,0,0
1/05/2020,France,Pahang,0,0,0
1/05/2020,France,Perak,0,0,0
1/05/2020,France,Perlis,0,0,0
1/05/2020,France,Pulau Pinang,0,0,0
1/05/2020,France,Sabah,0,0,0
1/05/2020,France,Sarawak,0,0,0
1/05/2020,France,Selangor,7,7,0
1/05/2020,France,Terengganu,0,0,0
1/05/2020,France,W.P. Labuan,0,0,0
1/05/2020,"Micronesia, Federated States of",Johor,0,0,0
1/05/2020,"Micronesia, Federated States of",Pulau Pinang,0,0,0
1/05/2020,"Micronesia, Federated States of",Selangor,0,0,0
1/05/2020,Gabon,Johor,0,0,0
1/05/2020,Gabon,Pulau Pinang,0,0,0
1/05/2020,Gabon,Sarawak,0,0,0
1/05/2020,Gabon,Selangor,0,0,0
1/05/2020,United Kingdom of Great Britain and Northern Ireland,Johor,3,3,0
1/05/2020,United Kingdom of Great Britain and Northern Ireland,Kedah,2,1,1
1/05/2020,United Kingdom of Great Britain and Northern Ireland,Kelantan,0,0,0
1/05/2020,United Kingdom of Great Britain and Northern Ireland,Melaka,0,0,0
1/05/2020,United Kingdom of Great Britain and Northern Ireland,Negeri Sembilan,0,0,0
1/05/2020,United Kingdom of Great Britain and Northern Ireland,Pahang,0,0,0
1/05/2020,United Kingdom of Great Britain and Northern Ireland,Perak,0,0,0
1/05/2020,United Kingdom of Great Britain and Northern Ireland,Perlis,0,0,0
1/05/2020,United Kingdom of Great Britain and Northern Ireland,Pulau Pinang,0,0,0
1/05/2020,United Kingdom of Great Britain and Northern Ireland,Sabah,0,0,0
1/05/2020,United Kingdom of Great Britain and Northern Ireland,Sarawak,0,0,0
1/05/2020,United Kingdom of Great Britain and Northern Ireland,Selangor,54,52,2
1/05/2020,United Kingdom of Great Britain and Northern Ireland,Terengganu,0,0,0
1/05/2020,United Kingdom of Great Britain and Northern Ireland,W.P. Labuan,0,0,0
1/05/2020,Georgia,Johor,0,0,0
1/05/2020,Georgia,Kedah,0,0,0
1/05/2020,Georgia,Melaka,0,0,0
1/05/2020,Georgia,Perak,0,0,0
1/05/2020,Georgia,Perlis,0,0,0
1/05/2020,Georgia,Pulau Pinang,0,0,0
1/05/2020,Georgia,Sabah,0,0,0
1/05/2020,Georgia,Sarawak,0,0,0
1/05/2020,Georgia,Selangor,0,0,0
1/05/2020,Ghana,Johor,0,0,0
1/05/2020,Ghana,Kedah,0,0,0
1/05/2020,Ghana,Kelantan,0,0,0
1/05/2020,Ghana,Pulau Pinang,0,0,0
1/05/2020,Ghana,Sabah,0,0,0
1/05/2020,Ghana,Sarawak,0,0,0
1/05/2020,Ghana,Selangor,0,0,0
1/05/2020,Gibraltar,Johor,0,0,0
1/05/2020,Gibraltar,Sarawak,0,0,0
1/05/2020,Guinea,Johor,0,0,0
1/05/2020,Guinea,Kedah,0,0,0
1/05/2020,Guinea,Kelantan,0,0,0
1/05/2020,Guinea,Perlis,0,0,0
1/05/2020,Guinea,Pulau Pinang,0,0,0
1/05/2020,Guinea,Sabah,0,0,0
1/05/2020,Guinea,Sarawak,0,0,0
1/05/2020,Guinea,Selangor,0,0,0
1/05/2020,Guadeloupe,Selangor,0,0,0
1/05/2020,Gambia,Johor,0,0,0
1/05/2020,Gambia,Kedah,0,0,0
1/05/2020,Gambia,Kelantan,0,0,0
1/05/2020,Gambia,Pulau Pinang,0,0,0
1/05/2020,Gambia,Sabah,0,0,0
1/05/2020,Gambia,Sarawak,0,0,0
1/05/2020,Gambia,Selangor,0,0,0
1/05/2020,Guinea-Bissau,Johor,0,0,0
1/05/2020,Guinea-Bissau,Selangor,0,0,0
1/05/2020,Equatorial Guinea,Johor,0,0,0
1/05/2020,Equatorial Guinea,Selangor,0,0,0
1/05/2020,Greece,Johor,0,0,0
1/05/2020,Greece,Kedah,0,0,0
1/05/2020,Greece,Kelantan,0,0,0
1/05/2020,Greece,Melaka,0,0,0
1/05/2020,Greece,Negeri Sembilan,0,0,0
1/05/2020,Greece,Pahang,0,0,0
1/05/2020,Greece,Perak,0,0,0
1/05/2020,Greece,Perlis,0,0,0
1/05/2020,Greece,Pulau Pinang,0,0,0
1/05/2020,Greece,Sabah,0,0,0
1/05/2020,Greece,Sarawak,0,0,0
1/05/2020,Greece,Selangor,0,0,0
1/05/2020,Grenada,Johor,0,0,0
1/05/2020,Grenada,Kedah,0,0,0
1/05/2020,Grenada,Pulau Pinang,0,0,0
1/05/2020,Grenada,Sabah,0,0,0
1/05/2020,Grenada,Sarawak,0,0,0
1/05/2020,Grenada,Selangor,0,0,0
1/05/2020,Greenland,Johor,0,0,0
1/05/2020,Greenland,Selangor,0,0,0
1/05/2020,Guatemala,Johor,0,0,0
1/05/2020,Guatemala,Kedah,0,0,0
1/05/2020,Guatemala,Pahang,0,0,0
1/05/2020,Guatemala,Perak,0,0,0
1/05/2020,Guatemala,Pulau Pinang,0,0,0
1/05/2020,Guatemala,Sabah,0,0,0
1/05/2020,Guatemala,Sarawak,0,0,0
1/05/2020,Guatemala,Selangor,0,0,0
1/05/2020,Guatemala,W.P. Labuan,0,0,0
1/05/2020,Guyana,Johor,0,0,0
1/05/2020,Guyana,Kedah,0,0,0
1/05/2020,Guyana,Pulau Pinang,0,0,0
1/05/2020,Guyana,Sarawak,0,0,0
1/05/2020,Guyana,Selangor,0,0,0
1/05/2020,Hong Kong,Johor,0,0,0
1/05/2020,Hong Kong,Kedah,0,0,0
1/05/2020,Hong Kong,Kelantan,0,0,0
1/05/2020,Hong Kong,Pahang,0,0,0
1/05/2020,Hong Kong,Perak,0,0,0
1/05/2020,Hong Kong,Perlis,0,0,0
1/05/2020,Hong Kong,Pulau Pinang,0,0,0
1/05/2020,Hong Kong,Sabah,0,0,0
1/05/2020,Hong Kong,Sarawak,0,0,0
1/05/2020,Hong Kong,Selangor,0,0,0
1/05/2020,Hong Kong,Terengganu,0,0,0
1/05/2020,Heard Island and McDonald Islands,Johor,0,0,0
1/05/2020,Honduras,Johor,0,0,0
1/05/2020,Honduras,Kedah,0,0,0
1/05/2020,Honduras,Perak,0,0,0
1/05/2020,Honduras,Pulau Pinang,0,0,0
1/05/2020,Honduras,Sabah,0,0,0
1/05/2020,Honduras,Sarawak,0,0,0
1/05/2020,Honduras,Selangor,0,0,0
1/05/2020,Croatia,Johor,0,0,0
1/05/2020,Croatia,Kedah,0,0,0
1/05/2020,Croatia,Kelantan,0,0,0
1/05/2020,Croatia,Melaka,0,0,0
1/05/2020,Croatia,Pahang,0,0,0
1/05/2020,Croatia,Perak,0,0,0
1/05/2020,Croatia,Perlis,0,0,0
1/05/2020,Croatia,Pulau Pinang,0,0,0
1/05/2020,Croatia,Sabah,0,0,0
1/05/2020,Croatia,Sarawak,0,0,0
1/05/2020,Croatia,Selangor,8,8,0
1/05/2020,Haiti,Johor,0,0,0
1/05/2020,Haiti,Kedah,0,0,0
1/05/2020,Haiti,Kelantan,0,0,0
1/05/2020,Haiti,Perak,0,0,0
1/05/2020,Haiti,Pulau Pinang,0,0,0
1/05/2020,Haiti,Sabah,0,0,0
1/05/2020,Haiti,Selangor,0,0,0
1/05/2020,Hungary,Johor,0,0,0
1/05/2020,Hungary,Kedah,0,0,0
1/05/2020,Hungary,Kelantan,0,0,0
1/05/2020,Hungary,Pahang,0,0,0
1/05/2020,Hungary,Perak,0,0,0
1/05/2020,Hungary,Perlis,0,0,0
1/05/2020,Hungary,Pulau Pinang,0,0,0
1/05/2020,Hungary,Sabah,0,0,0
1/05/2020,Hungary,Sarawak,0,0,0
1/05/2020,Hungary,Selangor,0,0,0
1/05/2020,Hungary,W.P. Labuan,0,0,0
1/05/2020,Indonesia,Johor,40,37,3
1/05/2020,Indonesia,Kedah,8,8,0
1/05/2020,Indonesia,Kelantan,0,0,0
1/05/2020,Indonesia,Melaka,0,0,0
1/05/2020,Indonesia,Negeri Sembilan,0,0,0
1/05/2020,Indonesia,Pahang,2,2,0
1/05/2020,Indonesia,Perak,0,0,0
1/05/2020,Indonesia,Perlis,0,0,0
1/05/2020,Indonesia,Pulau Pinang,0,0,0
1/05/2020,Indonesia,Sabah,8,1,7
1/05/2020,Indonesia,Sarawak,100,90,10
1/05/2020,Indonesia,Selangor,75,34,41
1/05/2020,Indonesia,Terengganu,0,0,0
1/05/2020,Indonesia,W.P. Labuan,1,1,0
1/05/2020,India,Johor,3,1,2
1/05/2020,India,Kedah,0,0,0
1/05/2020,India,Kelantan,0,0,0
1/05/2020,India,Melaka,0,0,0
1/05/2020,India,Negeri Sembilan,0,0,0
1/05/2020,India,Pahang,0,0,0
1/05/2020,India,Perak,0,0,0
1/05/2020,India,Perlis,0,0,0
1/05/2020,India,Pulau Pinang,0,0,0
1/05/2020,India,Sabah,0,0,0
1/05/2020,India,Sarawak,0,0,0
1/05/2020,India,Selangor,35,20,15
1/05/2020,India,Terengganu,0,0,0
1/05/2020,India,W.P. Labuan,0,0,0
1/05/2020, British Indian Ocean Territory,Pulau Pinang,0,0,0
1/05/2020, British Indian Ocean Territory,Selangor,0,0,0
1/05/2020,Ireland,Johor,0,0,0
1/05/2020,Ireland,Kedah,0,0,0
1/05/2020,Ireland,Kelantan,0,0,0
1/05/2020,Ireland,Negeri Sembilan,0,0,0
1/05/2020,Ireland,Pahang,0,0,0
1/05/2020,Ireland,Perak,0,0,0
1/05/2020,Ireland,Perlis,0,0,0
1/05/2020,Ireland,Pulau Pinang,0,0,0
1/05/2020,Ireland,Sabah,0,0,0
1/05/2020,Ireland,Sarawak,0,0,0
1/05/2020,Ireland,Selangor,6,4,2
1/05/2020,Ireland,Terengganu,0,0,0
1/05/2020,Ireland,W.P. Labuan,0,0,0
1/05/2020,"Iran, Islamic Republic of",Johor,0,0,0
1/05/2020,"Iran, Islamic Republic of",Kedah,0,0,0
1/05/2020,"Iran, Islamic Republic of",Kelantan,0,0,0
1/05/2020,"Iran, Islamic Republic of",Perak,0,0,0
1/05/2020,"Iran, Islamic Republic of",Perlis,0,0,0
1/05/2020,"Iran, Islamic Republic of",Pulau Pinang,0,0,0
1/05/2020,"Iran, Islamic Republic of",Sabah,0,0,0
1/05/2020,"Iran, Islamic Republic of",Sarawak,0,0,0
1/05/2020,"Iran, Islamic Republic of",Selangor,1,1,0
1/05/2020,"Iran, Islamic Republic of",W.P. Labuan,0,0,0
1/05/2020,Iraq,Johor,0,0,0
1/05/2020,Iraq,Kedah,0,0,0
1/05/2020,Iraq,Kelantan,0,0,0
1/05/2020,Iraq,Melaka,0,0,0
1/05/2020,Iraq,Pahang,0,0,0
1/05/2020,Iraq,Perak,0,0,0
1/05/2020,Iraq,Perlis,0,0,0
1/05/2020,Iraq,Pulau Pinang,0,0,0
1/05/2020,Iraq,Sabah,0,0,0
1/05/2020,Iraq,Sarawak,0,0,0
1/05/2020,Iraq,Selangor,0,0,0
1/05/2020,Iceland,Johor,0,0,0
1/05/2020,Iceland,Kedah,0,0,0
1/05/2020,Iceland,Kelantan,0,0,0
1/05/2020,Iceland,Perak,0,0,0
1/05/2020,Iceland,Perlis,0,0,0
1/05/2020,Iceland,Pulau Pinang,0,0,0
1/05/2020,Iceland,Sabah,0,0,0
1/05/2020,Iceland,Sarawak,0,0,0
1/05/2020,Iceland,Selangor,0,0,0
1/05/2020,Iceland,W.P. Labuan,0,0,0
1/05/2020,Israel,Pulau Pinang,0,0,0
1/05/2020,Italy,Johor,0,0,0
1/05/2020,Italy,Kedah,0,0,0
1/05/2020,Italy,Kelantan,0,0,0
1/05/2020,Italy,Melaka,0,0,0
1/05/2020,Italy,Negeri Sembilan,0,0,0
1/05/2020,Italy,Pahang,0,0,0
1/05/2020,Italy,Perak,0,0,0
1/05/2020,Italy,Perlis,0,0,0
1/05/2020,Italy,Pulau Pinang,0,0,0
1/05/2020,Italy,Sabah,0,0,0
1/05/2020,Italy,Sarawak,0,0,0
1/05/2020,Italy,Selangor,0,0,0
1/05/2020,Italy,W.P. Labuan,0,0,0
1/05/2020,Jamaica,Johor,0,0,0
1/05/2020,Jamaica,Kedah,0,0,0
1/05/2020,Jamaica,Perak,0,0,0
1/05/2020,Jamaica,Pulau Pinang,0,0,0
1/05/2020,Jamaica,Sabah,0,0,0
1/05/2020,Jamaica,Sarawak,0,0,0
1/05/2020,Jamaica,Selangor,0,0,0
1/05/2020,Jamaica,W.P. Labuan,0,0,0
1/05/2020,Jordan,Johor,0,0,0
1/05/2020,Jordan,Kedah,0,0,0
1/05/2020,Jordan,Kelantan,0,0,0
1/05/2020,Jordan,Melaka,0,0,0
1/05/2020,Jordan,Perlis,0,0,0
1/05/2020,Jordan,Pulau Pinang,0,0,0
1/05/2020,Jordan,Sabah,0,0,0
1/05/2020,Jordan,Sarawak,0,0,0
1/05/2020,Jordan,Selangor,0,0,0
1/05/2020,Jordan,W.P. Labuan,0,0,0
1/05/2020,Japan,Johor,0,0,0
1/05/2020,Japan,Kedah,0,0,0
1/05/2020,Japan,Kelantan,0,0,0
1/05/2020,Japan,Melaka,0,0,0
1/05/2020,Japan,Negeri Sembilan,0,0,0
1/05/2020,Japan,Pahang,0,0,0
1/05/2020,Japan,Perak,0,0,0
1/05/2020,Japan,Perlis,0,0,0
1/05/2020,Japan,Pulau Pinang,0,0,0
1/05/2020,Japan,Sabah,0,0,0
1/05/2020,Japan,Sarawak,0,0,0
1/05/2020,Japan,Selangor,8,6,2
1/05/2020,Japan,W.P. Labuan,0,0,0
1/05/2020,Kazakhstan,Johor,0,0,0
1/05/2020,Kazakhstan,Kedah,0,0,0
1/05/2020,Kazakhstan,Kelantan,0,0,0
1/05/2020,Kazakhstan,Melaka,0,0,0
1/05/2020,Kazakhstan,Perak,0,0,0
1/05/2020,Kazakhstan,Perlis,0,0,0
1/05/2020,Kazakhstan,Pulau Pinang,0,0,0
1/05/2020,Kazakhstan,Sabah,0,0,0
1/05/2020,Kazakhstan,Sarawak,0,0,0
1/05/2020,Kazakhstan,Selangor,0,0,0
1/05/2020,Kazakhstan,W.P. Labuan,0,0,0
1/05/2020,Kenya,Johor,0,0,0
1/05/2020,Kenya,Kedah,0,0,0
1/05/2020,Kenya,Kelantan,0,0,0
1/05/2020,Kenya,Perak,0,0,0
1/05/2020,Kenya,Perlis,0,0,0
1/05/2020,Kenya,Pulau Pinang,0,0,0
1/05/2020,Kenya,Sabah,0,0,0
1/05/2020,Kenya,Sarawak,0,0,0
1/05/2020,Kenya,Selangor,0,0,0
1/05/2020,Kyrgyzstan,Johor,0,0,0
1/05/2020,Kyrgyzstan,Kedah,0,0,0
1/05/2020,Kyrgyzstan,Kelantan,0,0,0
1/05/2020,Kyrgyzstan,Perak,0,0,0
1/05/2020,Kyrgyzstan,Perlis,0,0,0
1/05/2020,Kyrgyzstan,Pulau Pinang,0,0,0
1/05/2020,Kyrgyzstan,Sabah,0,0,0
1/05/2020,Kyrgyzstan,Sarawak,0,0,0
1/05/2020,Kyrgyzstan,Selangor,0,0,0
1/05/2020,Cambodia,Johor,0,0,0
1/05/2020,Cambodia,Kedah,0,0,0
1/05/2020,Cambodia,Kelantan,0,0,0
1/05/2020,Cambodia,Melaka,0,0,0
1/05/2020,Cambodia,Negeri Sembilan,0,0,0
1/05/2020,Cambodia,Pahang,0,0,0
1/05/2020,Cambodia,Perak,0,0,0
1/05/2020,Cambodia,Perlis,0,0,0
1/05/2020,Cambodia,Pulau Pinang,0,0,0
1/05/2020,Cambodia,Sabah,0,0,0
1/05/2020,Cambodia,Sarawak,0,0,0
1/05/2020,Cambodia,Selangor,2,0,2
1/05/2020,Cambodia,W.P. Labuan,0,0,0
1/05/2020,Kiribati,Johor,0,0,0
1/05/2020,Kiribati,Sabah,0,0,0
1/05/2020,Kiribati,Selangor,0,0,0
1/05/2020,Saint Kitts and Nevis,Johor,0,0,0
1/05/2020,Saint Kitts and Nevis,Kedah,0,0,0
1/05/2020,Saint Kitts and Nevis,Perlis,0,0,0
1/05/2020,Saint Kitts and Nevis,Pulau Pinang,0,0,0
1/05/2020,Saint Kitts and Nevis,Sabah,0,0,0
1/05/2020,Saint Kitts and Nevis,Selangor,0,0,0
1/05/2020,Saint Kitts and Nevis,W.P. Labuan,0,0,0
1/05/2020,"Korea, Republic of",Johor,0,0,0
1/05/2020,"Korea, Republic of",Kedah,0,0,0
1/05/2020,"Korea, Republic of",Kelantan,0,0,0
1/05/2020,"Korea, Republic of",Melaka,0,0,0
1/05/2020,"Korea, Republic of",Negeri Sembilan,0,0,0
1/05/2020,"Korea, Republic of",Pahang,0,0,0
1/05/2020,"Korea, Republic of",Perak,0,0,0
1/05/2020,"Korea, Republic of",Perlis,0,0,0
1/05/2020,"Korea, Republic of",Pulau Pinang,0,0,0
1/05/2020,"Korea, Republic of",Sabah,0,0,0
1/05/2020,"Korea, Republic of",Sarawak,0,0,0
1/05/2020,"Korea, Republic of",Selangor,2,1,1
1/05/2020,"Korea, Republic of",Terengganu,0,0,0
1/05/2020,"Korea, Republic of",W.P. Labuan,0,0,0
1/05/2020,Kuwait,Johor,0,0,0
1/05/2020,Kuwait,Kedah,0,0,0
1/05/2020,Kuwait,Kelantan,0,0,0
1/05/2020,Kuwait,Perak,0,0,0
1/05/2020,Kuwait,Perlis,0,0,0
1/05/2020,Kuwait,Pulau Pinang,0,0,0
1/05/2020,Kuwait,Sabah,0,0,0
1/05/2020,Kuwait,Sarawak,0,0,0
1/05/2020,Kuwait,Selangor,0,0,0
1/05/2020,Kuwait,W.P. Labuan,0,0,0
1/05/2020, Lao People's Democratic Republic,Johor,1,0,1
1/05/2020, Lao People's Democratic Republic,Kedah,0,0,0
1/05/2020, Lao People's Democratic Republic,Kelantan,0,0,0
1/05/2020, Lao People's Democratic Republic,Melaka,0,0,0
1/05/2020, Lao People's Democratic Republic,Perak,0,0,0
1/05/2020, Lao People's Democratic Republic,Perlis,0,0,0
1/05/2020, Lao People's Democratic Republic,Pulau Pinang,0,0,0
1/05/2020, Lao People's Democratic Republic,Sabah,0,0,0
1/05/2020, Lao People's Democratic Republic,Sarawak,0,0,0
1/05/2020, Lao People's Democratic Republic,Selangor,3,0,3
1/05/2020, Lao People's Democratic Republic,W.P. Labuan,0,0,0
1/05/2020,Lebanon,Johor,0,0,0
1/05/2020,Lebanon,Kedah,0,0,0
1/05/2020,Lebanon,Kelantan,0,0,0
1/05/2020,Lebanon,Pahang,0,0,0
1/05/2020,Lebanon,Perak,0,0,0
1/05/2020,Lebanon,Perlis,0,0,0
1/05/2020,Lebanon,Pulau Pinang,0,0,0
1/05/2020,Lebanon,Sabah,0,0,0
1/05/2020,Lebanon,Sarawak,0,0,0
1/05/2020,Lebanon,Selangor,1,1,0
1/05/2020,Lebanon,W.P. Labuan,0,0,0
1/05/2020,Liberia,Johor,0,0,0
1/05/2020,Liberia,Kedah,0,0,0
1/05/2020,Liberia,Sabah,0,0,0
1/05/2020,Liberia,Sarawak,0,0,0
1/05/2020,Liberia,Selangor,0,0,0
1/05/2020,Libya,Johor,0,0,0
1/05/2020,Libya,Kedah,0,0,0
1/05/2020,Libya,Perlis,0,0,0
1/05/2020,Libya,Pulau Pinang,0,0,0
1/05/2020,Libya,Sabah,0,0,0
1/05/2020,Libya,Sarawak,0,0,0
1/05/2020,Libya,Selangor,0,0,0
1/05/2020,Saint Lucia,Johor,0,0,0
1/05/2020,Saint Lucia,Kedah,0,0,0
1/05/2020,Saint Lucia,Pulau Pinang,0,0,0
1/05/2020,Saint Lucia,Sarawak,0,0,0
1/05/2020,Saint Lucia,Selangor,0,0,0
1/05/2020,Liechtenstein,Johor,0,0,0
1/05/2020,Liechtenstein,Kedah,0,0,0
1/05/2020,Liechtenstein,Perlis,0,0,0
1/05/2020,Liechtenstein,Pulau Pinang,0,0,0
1/05/2020,Liechtenstein,Sabah,0,0,0
1/05/2020,Liechtenstein,Sarawak,0,0,0
1/05/2020,Liechtenstein,Selangor,0,0,0
1/05/2020,LKA,Johor,0,0,0
1/05/2020,LKA,Kedah,0,0,0
1/05/2020,LKA,Kelantan,0,0,0
1/05/2020,LKA,Melaka,0,0,0
1/05/2020,LKA,Pahang,0,0,0
1/05/2020,LKA,Perak,0,0,0
1/05/2020,LKA,Perlis,0,0,0
1/05/2020,LKA,Pulau Pinang,0,0,0
1/05/2020,LKA,Sabah,0,0,0
1/05/2020,LKA,Sarawak,0,0,0
1/05/2020,LKA,Selangor,1,1,0
1/05/2020,LKA,W.P. Labuan,0,0,0
1/05/2020,Lesotho,Johor,0,0,0
1/05/2020,Lesotho,Kedah,0,0,0
1/05/2020,Lesotho,Pulau Pinang,0,0,0
1/05/2020,Lesotho,Sarawak,0,0,0
1/05/2020,Lesotho,Selangor,0,0,0
1/05/2020,Lithuania,Johor,2,2,0
1/05/2020,Lithuania,Kedah,0,0,0
1/05/2020,Lithuania,Kelantan,0,0,0
1/05/2020,Lithuania,Pahang,0,0,0
1/05/2020,Lithuania,Perak,0,0,0
1/05/2020,Lithuania,Perlis,0,0,0
1/05/2020,Lithuania,Pulau Pinang,0,0,0
1/05/2020,Lithuania,Sabah,0,0,0
1/05/2020,Lithuania,Sarawak,0,0,0
1/05/2020,Lithuania,Selangor,1,1,0
1/05/2020,Lithuania,W.P. Labuan,0,0,0
1/05/2020,Luxembourg,Johor,0,0,0
1/05/2020,Luxembourg,Kedah,0,0,0
1/05/2020,Luxembourg,Kelantan,0,0,0
1/05/2020,Luxembourg,Perak,0,0,0
1/05/2020,Luxembourg,Perlis,0,0,0
1/05/2020,Luxembourg,Pulau Pinang,0,0,0
1/05/2020,Luxembourg,Sabah,0,0,0
1/05/2020,Luxembourg,Sarawak,0,0,0
1/05/2020,Luxembourg,Selangor,0,0,0
1/05/2020,Latvia,Johor,2,2,0
1/05/2020,Latvia,Kedah,0,0,0
1/05/2020,Latvia,Kelantan,0,0,0
1/05/2020,Latvia,Pahang,0,0,0
1/05/2020,Latvia,Perak,0,0,0
1/05/2020,Latvia,Perlis,0,0,0
1/05/2020,Latvia,Pulau Pinang,0,0,0
1/05/2020,Latvia,Sabah,0,0,0
1/05/2020,Latvia,Sarawak,0,0,0
1/05/2020,Latvia,Selangor,1,1,0
1/05/2020,Latvia,W.P. Labuan,0,0,0
1/05/2020,Macao,Johor,0,0,0
1/05/2020,Macao,Pahang,0,0,0
1/05/2020,Macao,Perak,0,0,0
1/05/2020,Macao,Selangor,0,0,0
1/05/2020,Macao,W.P. Labuan,0,0,0
1/05/2020,Morocco,Johor,0,0,0
1/05/2020,Morocco,Kedah,0,0,0
1/05/2020,Morocco,Kelantan,0,0,0
1/05/2020,Morocco,Melaka,0,0,0
1/05/2020,Morocco,Pahang,0,0,0
1/05/2020,Morocco,Perak,0,0,0
1/05/2020,Morocco,Perlis,0,0,0
1/05/2020,Morocco,Pulau Pinang,0,0,0
1/05/2020,Morocco,Sabah,0,0,0
1/05/2020,Morocco,Sarawak,0,0,0
1/05/2020,Morocco,Selangor,0,0,0
1/05/2020,Morocco,W.P. Labuan,0,0,0
1/05/2020,Monaco,Johor,0,0,0
1/05/2020,Monaco,Kedah,0,0,0
1/05/2020,Monaco,Sabah,0,0,0
1/05/2020,Monaco,Selangor,0,0,0
1/05/2020,"Moldova, Republic of",Johor,0,0,0
1/05/2020,"Moldova, Republic of",Kedah,0,0,0
1/05/2020,"Moldova, Republic of",Kelantan,0,0,0
1/05/2020,"Moldova, Republic of",Negeri Sembilan,0,0,0
1/05/2020,"Moldova, Republic of",Perlis,0,0,0
1/05/2020,"Moldova, Republic of",Pulau Pinang,0,0,0
1/05/2020,"Moldova, Republic of",Sabah,0,0,0
1/05/2020,"Moldova, Republic of",Sarawak,0,0,0
1/05/2020,"Moldova, Republic of",Selangor,0,0,0
1/05/2020,Madagascar,Johor,0,0,0
1/05/2020,Madagascar,Kedah,0,0,0
1/05/2020,Madagascar,Perak,0,0,0
1/05/2020,Madagascar,Perlis,0,0,0
1/05/2020,Madagascar,Pulau Pinang,0,0,0
1/05/2020,Madagascar,Sabah,0,0,0
1/05/2020,Madagascar,Sarawak,0,0,0
1/05/2020,Madagascar,Selangor,0,0,0
1/05/2020,Maldives,Johor,0,0,0
1/05/2020,Maldives,Kedah,0,0,0
1/05/2020,Maldives,Kelantan,0,0,0
1/05/2020,Maldives,Perak,0,0,0
1/05/2020,Maldives,Perlis,0,0,0
1/05/2020,Maldives,Pulau Pinang,0,0,0
1/05/2020,Maldives,Sabah,0,0,0
1/05/2020,Maldives,Sarawak,0,0,0
1/05/2020,Maldives,Selangor,0,0,0
1/05/2020,Mexico,Johor,0,0,0
1/05/2020,Mexico,Kedah,0,0,0
1/05/2020,Mexico,Kelantan,0,0,0
1/05/2020,Mexico,Pahang,0,0,0
1/05/2020,Mexico,Perak,0,0,0
1/05/2020,Mexico,Perlis,0,0,0
1/05/2020,Mexico,Pulau Pinang,0,0,0
1/05/2020,Mexico,Sabah,0,0,0
1/05/2020,Mexico,Sarawak,0,0,0
1/05/2020,Mexico,Selangor,0,0,0
1/05/2020,Mexico,W.P. Labuan,0,0,0
1/05/2020,Marshall Islands,Johor,0,0,0
1/05/2020,Marshall Islands,Kedah,0,0,0
1/05/2020,Marshall Islands,Perak,0,0,0
1/05/2020,Marshall Islands,Pulau Pinang,0,0,0
1/05/2020,Marshall Islands,Sabah,0,0,0
1/05/2020,Marshall Islands,Selangor,0,0,0
1/05/2020,North Macedonia,Johor,0,0,0
1/05/2020,North Macedonia,Kedah,0,0,0
1/05/2020,North Macedonia,Perak,0,0,0
1/05/2020,North Macedonia,Pulau Pinang,0,0,0
1/05/2020,North Macedonia,Sabah,0,0,0
1/05/2020,North Macedonia,Sarawak,0,0,0
1/05/2020,North Macedonia,Selangor,0,0,0
1/05/2020,Mali,Johor,0,0,0
1/05/2020,Mali,Sabah,0,0,0
1/05/2020,Mali,Selangor,0,0,0
1/05/2020,Malta,Johor,0,0,0
1/05/2020,Malta,Kedah,0,0,0
1/05/2020,Malta,Kelantan,0,0,0
1/05/2020,Malta,Perak,0,0,0
1/05/2020,Malta,Perlis,0,0,0
1/05/2020,Malta,Pulau Pinang,0,0,0
1/05/2020,Malta,Sabah,0,0,0
1/05/2020,Malta,Sarawak,0,0,0
1/05/2020,Malta,Selangor,0,0,0
1/05/2020,Malta,W.P. Labuan,0,0,0
1/05/2020,Myanmar,Johor,2,2,0
1/05/2020,Myanmar,Kedah,0,0,0
1/05/2020,Myanmar,Kelantan,0,0,0
1/05/2020,Myanmar,Negeri Sembilan,0,0,0
1/05/2020,Myanmar,Pahang,0,0,0
1/05/2020,Myanmar,Perak,0,0,0
1/05/2020,Myanmar,Perlis,0,0,0
1/05/2020,Myanmar,Pulau Pinang,0,0,0
1/05/2020,Myanmar,Sabah,0,0,0
1/05/2020,Myanmar,Sarawak,0,0,0
1/05/2020,Myanmar,Selangor,8,4,4
1/05/2020,Myanmar,Terengganu,0,0,0
1/05/2020,Myanmar,W.P. Labuan,0,0,0
1/05/2020,Montenegro,Johor,0,0,0
1/05/2020,Montenegro,Kedah,0,0,0
1/05/2020,Montenegro,Pulau Pinang,0,0,0
1/05/2020,Montenegro,Sabah,0,0,0
1/05/2020,Montenegro,Sarawak,0,0,0
1/05/2020,Montenegro,Selangor,0,0,0
1/05/2020,Mongolia,Johor,0,0,0
1/05/2020,Mongolia,Kedah,0,0,0
1/05/2020,Mongolia,Kelantan,0,0,0
1/05/2020,Mongolia,Perak,0,0,0
1/05/2020,Mongolia,Perlis,0,0,0
1/05/2020,Mongolia,Pulau Pinang,0,0,0
1/05/2020,Mongolia,Sabah,0,0,0
1/05/2020,Mongolia,Sarawak,0,0,0
1/05/2020,Mongolia,Selangor,0,0,0
1/05/2020,Northern Mariana Islands,Selangor,0,0,0
1/05/2020,Mozambique,Johor,0,0,0
1/05/2020,Mozambique,Kedah,0,0,0
1/05/2020,Mozambique,Perak,0,0,0
1/05/2020,Mozambique,Pulau Pinang,0,0,0
1/05/2020,Mozambique,Sabah,0,0,0
1/05/2020,Mozambique,Sarawak,0,0,0
1/05/2020,Mozambique,Selangor,0,0,0
1/05/2020,Mauritania,Johor,0,0,0
1/05/2020,Mauritania,Kedah,0,0,0
1/05/2020,Mauritania,Pulau Pinang,0,0,0
1/05/2020,Mauritania,Sabah,0,0,0
1/05/2020,Mauritania,Sarawak,0,0,0
1/05/2020,Mauritania,Selangor,0,0,0
1/05/2020,Mauritius,Johor,0,0,0
1/05/2020,Mauritius,Kedah,0,0,0
1/05/2020,Mauritius,Kelantan,0,0,0
1/05/2020,Mauritius,Pahang,0,0,0
1/05/2020,Mauritius,Perak,0,0,0
1/05/2020,Mauritius,Perlis,0,0,0
1/05/2020,Mauritius,Pulau Pinang,0,0,0
1/05/2020,Mauritius,Sabah,0,0,0
1/05/2020,Mauritius,Sarawak,0,0,0
1/05/2020,Mauritius,Selangor,0,0,0
1/05/2020,Malawi,Johor,0,0,0
1/05/2020,Malawi,Pulau Pinang,0,0,0
1/05/2020,Malawi,Sabah,0,0,0
1/05/2020,Malawi,Sarawak,0,0,0
1/05/2020,Malawi,Selangor,0,0,0
1/05/2020,Mayotte,Selangor,0,0,0
1/05/2020,Namibia,Johor,0,0,0
1/05/2020,Namibia,Kedah,0,0,0
1/05/2020,Namibia,Perak,0,0,0
1/05/2020,Namibia,Perlis,0,0,0
1/05/2020,Namibia,Pulau Pinang,0,0,0
1/05/2020,Namibia,Sabah,0,0,0
1/05/2020,Namibia,Sarawak,0,0,0
1/05/2020,Namibia,Selangor,0,0,0
1/05/2020,New Caledonia,Selangor,0,0,0
1/05/2020,Niger,Johor,0,0,0
1/05/2020,Niger,Sabah,0,0,0
1/05/2020,Niger,Selangor,0,0,0
1/05/2020,Nigeria,Johor,0,0,0
1/05/2020,Nigeria,Kedah,0,0,0
1/05/2020,Nigeria,Perlis,0,0,0
1/05/2020,Nigeria,Pulau Pinang,0,0,0
1/05/2020,Nigeria,Sabah,0,0,0
1/05/2020,Nigeria,Sarawak,0,0,0
1/05/2020,Nigeria,Selangor,1,1,0
1/05/2020,Nicaragua,Johor,0,0,0
1/05/2020,Nicaragua,Kedah,0,0,0
1/05/2020,Nicaragua,Pulau Pinang,0,0,0
1/05/2020,Nicaragua,Sabah,0,0,0
1/05/2020,Nicaragua,Selangor,0,0,0
1/05/2020,Netherlands,Johor,4,4,0
1/05/2020,Netherlands,Kedah,0,0,0
1/05/2020,Netherlands,Kelantan,0,0,0
1/05/2020,Netherlands,Melaka,0,0,0
1/05/2020,Netherlands,Negeri Sembilan,0,0,0
1/05/2020,Netherlands,Pahang,0,0,0
1/05/2020,Netherlands,Perak,0,0,0
1/05/2020,Netherlands,Perlis,0,0,0
1/05/2020,Netherlands,Pulau Pinang,0,0,0
1/05/2020,Netherlands,Sabah,0,0,0
1/05/2020,Netherlands,Sarawak,0,0,0
1/05/2020,Netherlands,Selangor,12,8,4
1/05/2020,Netherlands,Terengganu,0,0,0
1/05/2020,Netherlands,W.P. Labuan,0,0,0
1/05/2020,Norway,Johor,0,0,0
1/05/2020,Norway,Kedah,0,0,0
1/05/2020,Norway,Kelantan,0,0,0
1/05/2020,Norway,Melaka,0,0,0
1/05/2020,Norway,Pahang,0,0,0
1/05/2020,Norway,Perak,0,0,0
1/05/2020,Norway,Perlis,0,0,0
1/05/2020,Norway,Pulau Pinang,0,0,0
1/05/2020,Norway,Sabah,0,0,0
1/05/2020,Norway,Sarawak,0,0,0
1/05/2020,Norway,Selangor,2,2,0
1/05/2020,Norway,W.P. Labuan,0,0,0
1/05/2020,Nepal,Johor,0,0,0
1/05/2020,Nepal,Kedah,0,0,0
1/05/2020,Nepal,Pahang,0,0,0
1/05/2020,Nepal,Perak,0,0,0
1/05/2020,Nepal,Perlis,0,0,0
1/05/2020,Nepal,Pulau Pinang,0,0,0
1/05/2020,Nepal,Sabah,0,0,0
1/05/2020,Nepal,Sarawak,0,0,0
1/05/2020,Nepal,Selangor,0,0,0
1/05/2020,Nepal,W.P. Labuan,0,0,0
1/05/2020,Nauru,Johor,0,0,0
1/05/2020,Nauru,Pulau Pinang,0,0,0
1/05/2020,Nauru,Selangor,0,0,0
1/05/2020,New Zealand,Johor,0,0,0
1/05/2020,New Zealand,Kedah,2,1,1
1/05/2020,New Zealand,Kelantan,0,0,0
1/05/2020,New Zealand,Melaka,0,0,0
1/05/2020,New Zealand,Negeri Sembilan,0,0,0
1/05/2020,New Zealand,Pahang,0,0,0
1/05/2020,New Zealand,Perak,0,0,0
1/05/2020,New Zealand,Perlis,0,0,0
1/05/2020,New Zealand,Pulau Pinang,0,0,0
1/05/2020,New Zealand,Sabah,0,0,0
1/05/2020,New Zealand,Sarawak,0,0,0
1/05/2020,New Zealand,Selangor,5,5,0
1/05/2020,New Zealand,Terengganu,0,0,0
1/05/2020,New Zealand,W.P. Labuan,0,0,0
1/05/2020,Oman,Johor,0,0,0
1/05/2020,Oman,Kedah,0,0,0
1/05/2020,Oman,Kelantan,0,0,0
1/05/2020,Oman,Melaka,0,0,0
1/05/2020,Oman,Perak,0,0,0
1/05/2020,Oman,Perlis,0,0,0
1/05/2020,Oman,Pulau Pinang,0,0,0
1/05/2020,Oman,Sabah,0,0,0
1/05/2020,Oman,Sarawak,0,0,0
1/05/2020,Oman,Selangor,0,0,0
1/05/2020,Pakistan,Johor,0,0,0
1/05/2020,Pakistan,Kedah,0,0,0
1/05/2020,Pakistan,Kelantan,0,0,0
1/05/2020,Pakistan,Melaka,0,0,0
1/05/2020,Pakistan,Negeri Sembilan,0,0,0
1/05/2020,Pakistan,Pahang,0,0,0
1/05/2020,Pakistan,Perak,0,0,0
1/05/2020,Pakistan,Perlis,0,0,0
1/05/2020,Pakistan,Pulau Pinang,0,0,0
1/05/2020,Pakistan,Sabah,0,0,0
1/05/2020,Pakistan,Sarawak,0,0,0
1/05/2020,Pakistan,Selangor,35,31,4
1/05/2020,Pakistan,W.P. Labuan,0,0,0
1/05/2020,Panama,Johor,0,0,0
1/05/2020,Panama,Kedah,0,0,0
1/05/2020,Panama,Perak,0,0,0
1/05/2020,Panama,Perlis,0,0,0
1/05/2020,Panama,Pulau Pinang,0,0,0
1/05/2020,Panama,Sabah,0,0,0
1/05/2020,Panama,Sarawak,0,0,0
1/05/2020,Panama,Selangor,0,0,0
1/05/2020,Peru,Johor,0,0,0
1/05/2020,Peru,Kedah,0,0,0
1/05/2020,Peru,Kelantan,0,0,0
1/05/2020,Peru,Pahang,0,0,0
1/05/2020,Peru,Perak,0,0,0
1/05/2020,Peru,Perlis,0,0,0
1/05/2020,Peru,Pulau Pinang,0,0,0
1/05/2020,Peru,Sabah,0,0,0
1/05/2020,Peru,Sarawak,0,0,0
1/05/2020,Peru,Selangor,0,0,0
1/05/2020,Peru,W.P. Labuan,0,0,0
1/05/2020,Philippines,Johor,3,0,3
1/05/2020,Philippines,Kedah,0,0,0
1/05/2020,Philippines,Kelantan,0,0,0
1/05/2020,Philippines,Melaka,0,0,0
1/05/2020,Philippines,Negeri Sembilan,0,0,0
1/05/2020,Philippines,Pahang,0,0,0
1/05/2020,Philippines,Perak,0,0,0
1/05/2020,Philippines,Perlis,0,0,0
1/05/2020,Philippines,Pulau Pinang,0,0,0
1/05/2020,Philippines,Sabah,1,0,1
1/05/2020,Philippines,Sarawak,14,14,0
1/05/2020,Philippines,Selangor,9,4,5
1/05/2020,Philippines,Terengganu,0,0,0
1/05/2020,Philippines,W.P. Labuan,0,0,0
1/05/2020,Palau,Johor,0,0,0
1/05/2020,Palau,Pulau Pinang,0,0,0
1/05/2020,Palau,Selangor,0,0,0
1/05/2020,Papua New Guinea,Johor,0,0,0
1/05/2020,Papua New Guinea,Kedah,0,0,0
1/05/2020,Papua New Guinea,Kelantan,0,0,0
1/05/2020,Papua New Guinea,Perak,0,0,0
1/05/2020,Papua New Guinea,Pulau Pinang,0,0,0
1/05/2020,Papua New Guinea,Sabah,0,0,0
1/05/2020,Papua New Guinea,Sarawak,0,0,0
1/05/2020,Papua New Guinea,Selangor,0,0,0
1/05/2020,Poland,Johor,6,6,0
1/05/2020,Poland,Kedah,0,0,0
1/05/2020,Poland,Kelantan,0,0,0
1/05/2020,Poland,Melaka,0,0,0
1/05/2020,Poland,Negeri Sembilan,0,0,0
1/05/2020,Poland,Pahang,0,0,0
1/05/2020,Poland,Perak,0,0,0
1/05/2020,Poland,Perlis,0,0,0
1/05/2020,Poland,Pulau Pinang,0,0,0
1/05/2020,Poland,Sabah,0,0,0
1/05/2020,Poland,Sarawak,0,0,0
1/05/2020,Poland,Selangor,6,6,0
1/05/2020,Poland,Terengganu,0,0,0
1/05/2020,Poland,W.P. Labuan,0,0,0
1/05/2020,"North Korea, Democratic People's Republic of",Selangor,0,0,0
1/05/2020,Portugal,Johor,0,0,0
1/05/2020,Portugal,Kedah,0,0,0
1/05/2020,Portugal,Kelantan,0,0,0
1/05/2020,Portugal,Melaka,0,0,0
1/05/2020,Portugal,Pahang,0,0,0
1/05/2020,Portugal,Perak,0,0,0
1/05/2020,Portugal,Perlis,0,0,0
1/05/2020,Portugal,Pulau Pinang,0,0,0
1/05/2020,Portugal,Sabah,0,0,0
1/05/2020,Portugal,Sarawak,0,0,0
1/05/2020,Portugal,Selangor,1,1,0
1/05/2020,Portugal,W.P. Labuan,0,0,0
1/05/2020,Paraguay,Johor,0,0,0
1/05/2020,Paraguay,Kedah,0,0,0
1/05/2020,Paraguay,Perak,0,0,0
1/05/2020,Paraguay,Perlis,0,0,0
1/05/2020,Paraguay,Pulau Pinang,0,0,0
1/05/2020,Paraguay,Sabah,0,0,0
1/05/2020,Paraguay,Sarawak,0,0,0
1/05/2020,Paraguay,Selangor,0,0,0
1/05/2020,"Palestine, State of",Johor,0,0,0
1/05/2020,"Palestine, State of",Kedah,0,0,0
1/05/2020,"Palestine, State of",Kelantan,0,0,0
1/05/2020,"Palestine, State of",Melaka,0,0,0
1/05/2020,"Palestine, State of",Perak,0,0,0
1/05/2020,"Palestine, State of",Perlis,0,0,0
1/05/2020,"Palestine, State of",Pulau Pinang,0,0,0
1/05/2020,"Palestine, State of",Sabah,0,0,0
1/05/2020,"Palestine, State of",Sarawak,0,0,0
1/05/2020,"Palestine, State of",Selangor,2,1,1
1/05/2020,Qatar,Johor,0,0,0
1/05/2020,Qatar,Kedah,0,0,0
1/05/2020,Qatar,Perlis,0,0,0
1/05/2020,Qatar,Pulau Pinang,0,0,0
1/05/2020,Qatar,Sabah,0,0,0
1/05/2020,Qatar,Sarawak,0,0,0
1/05/2020,Qatar,Selangor,0,0,0
1/05/2020,Réunion,Johor,0,0,0
1/05/2020,Réunion,Sarawak,0,0,0
1/05/2020,Romania,Johor,2,2,0
1/05/2020,Romania,Kedah,0,0,0
1/05/2020,Romania,Kelantan,0,0,0
1/05/2020,Romania,Negeri Sembilan,0,0,0
1/05/2020,Romania,Pahang,0,0,0
1/05/2020,Romania,Perak,0,0,0
1/05/2020,Romania,Perlis,0,0,0
1/05/2020,Romania,Pulau Pinang,0,0,0
1/05/2020,Romania,Sabah,0,0,0
1/05/2020,Romania,Sarawak,0,0,0
1/05/2020,Romania,Selangor,0,0,0
1/05/2020,Romania,W.P. Labuan,0,0,0
1/05/2020,Russian Federation (Russia),Johor,0,0,0
1/05/2020,Russian Federation (Russia),Kedah,0,0,0
1/05/2020,Russian Federation (Russia),Kelantan,0,0,0
1/05/2020,Russian Federation (Russia),Melaka,0,0,0
1/05/2020,Russian Federation (Russia),Negeri Sembilan,0,0,0
1/05/2020,Russian Federation (Russia),Pahang,0,0,0
1/05/2020,Russian Federation (Russia),Perak,0,0,0
1/05/2020,Russian Federation (Russia),Perlis,0,0,0
1/05/2020,Russian Federation (Russia),Pulau Pinang,0,0,0
1/05/2020,Russian Federation (Russia),Sabah,0,0,0
1/05/2020,Russian Federation (Russia),Sarawak,0,0,0
1/05/2020,Russian Federation (Russia),Selangor,6,4,2
1/05/2020,Russian Federation (Russia),W.P. Labuan,0,0,0
1/05/2020,Rwanda,Johor,0,0,0
1/05/2020,Rwanda,Kedah,0,0,0
1/05/2020,Rwanda,Pulau Pinang,0,0,0
1/05/2020,Rwanda,Selangor,0,0,0
1/05/2020,Saudi Arabia,Johor,0,0,0
1/05/2020,Saudi Arabia,Kedah,0,0,0
1/05/2020,Saudi Arabia,Kelantan,0,0,0
1/05/2020,Saudi Arabia,Melaka,0,0,0
1/05/2020,Saudi Arabia,Perak,0,0,0
1/05/2020,Saudi Arabia,Perlis,0,0,0
1/05/2020,Saudi Arabia,Pulau Pinang,0,0,0
1/05/2020,Saudi Arabia,Sabah,0,0,0
1/05/2020,Saudi Arabia,Sarawak,0,0,0
1/05/2020,Saudi Arabia,Selangor,0,0,0
1/05/2020,Saudi Arabia,W.P. Labuan,0,0,0
1/05/2020,Sudan,Johor,0,0,0
1/05/2020,Sudan,Kedah,0,0,0
1/05/2020,Sudan,Kelantan,0,0,0
1/05/2020,Sudan,Perlis,0,0,0
1/05/2020,Sudan,Pulau Pinang,0,0,0
1/05/2020,Sudan,Sabah,0,0,0
1/05/2020,Sudan,Sarawak,0,0,0
1/05/2020,Sudan,Selangor,0,0,0
1/05/2020,Sudan,W.P. Labuan,0,0,0
1/05/2020,Senegal,Johor,0,0,0
1/05/2020,Senegal,Kedah,0,0,0
1/05/2020,Senegal,Kelantan,0,0,0
1/05/2020,Senegal,Perak,0,0,0
1/05/2020,Senegal,Perlis,0,0,0
1/05/2020,Senegal,Pulau Pinang,0,0,0
1/05/2020,Senegal,Sabah,0,0,0
1/05/2020,Senegal,Sarawak,0,0,0
1/05/2020,Senegal,Selangor,0,0,0
1/05/2020,Singapore,Johor,56,53,3
1/05/2020,Singapore,Kedah,0,0,0
1/05/2020,Singapore,Kelantan,0,0,0
1/05/2020,Singapore,Melaka,0,0,0
1/05/2020,Singapore,Negeri Sembilan,0,0,0
1/05/2020,Singapore,Pahang,0,0,0
1/05/2020,Singapore,Perak,0,0,0
1/05/2020,Singapore,Perlis,0,0,0
1/05/2020,Singapore,Pulau Pinang,0,0,0
1/05/2020,Singapore,Sabah,0,0,0
1/05/2020,Singapore,Sarawak,3,0,3
1/05/2020,Singapore,Selangor,21,10,11
1/05/2020,Singapore,Terengganu,0,0,0
1/05/2020,Singapore,W.P. Labuan,0,0,0
1/05/2020,South Georgia and the South Sandwich Islands,Johor,0,0,0
1/05/2020,South Georgia and the South Sandwich Islands,Sabah,0,0,0
1/05/2020,South Georgia and the South Sandwich Islands,Selangor,0,0,0
1/05/2020,Saint Helena,Sarawak,0,0,0
1/05/2020,Solomon Islands,Johor,0,0,0
1/05/2020,Solomon Islands,Perlis,0,0,0
1/05/2020,Solomon Islands,Pulau Pinang,0,0,0
1/05/2020,Solomon Islands,Sabah,0,0,0
1/05/2020,Solomon Islands,Sarawak,0,0,0
1/05/2020,Solomon Islands,Selangor,0,0,0
1/05/2020,Solomon Islands,W.P. Labuan,0,0,0
1/05/2020,Sierra Leone,Johor,0,0,0
1/05/2020,Sierra Leone,Kedah,0,0,0
1/05/2020,Sierra Leone,Perak,0,0,0
1/05/2020,Sierra Leone,Pulau Pinang,0,0,0
1/05/2020,Sierra Leone,Sabah,0,0,0
1/05/2020,Sierra Leone,Selangor,0,0,0
1/05/2020,El Salvador,Johor,0,0,0
1/05/2020,El Salvador,Kedah,0,0,0
1/05/2020,El Salvador,Perak,0,0,0
1/05/2020,El Salvador,Perlis,0,0,0
1/05/2020,El Salvador,Pulau Pinang,0,0,0
1/05/2020,El Salvador,Sabah,0,0,0
1/05/2020,El Salvador,Selangor,0,0,0
1/05/2020,El Salvador,W.P. Labuan,0,0,0
1/05/2020,San Marino,Johor,0,0,0
1/05/2020,San Marino,Selangor,0,0,0
1/05/2020,Somalia,Johor,0,0,0
1/05/2020,Somalia,Kedah,0,0,0
1/05/2020,Somalia,Kelantan,0,0,0
1/05/2020,Somalia,Perlis,0,0,0
1/05/2020,Somalia,Sabah,0,0,0
1/05/2020,Somalia,Sarawak,0,0,0
1/05/2020,Somalia,Selangor,0,0,0
1/05/2020,Serbia,Johor,0,0,0
1/05/2020,Serbia,Kedah,0,0,0
1/05/2020,Serbia,Kelantan,0,0,0
1/05/2020,Serbia,Pahang,0,0,0
1/05/2020,Serbia,Perak,0,0,0
1/05/2020,Serbia,Perlis,0,0,0
1/05/2020,Serbia,Pulau Pinang,0,0,0
1/05/2020,Serbia,Sabah,0,0,0
1/05/2020,Serbia,Sarawak,0,0,0
1/05/2020,Serbia,Selangor,0,0,0
1/05/2020,South Sudan,Johor,0,0,0
1/05/2020,South Sudan,Kedah,0,0,0
1/05/2020,South Sudan,Sarawak,0,0,0
1/05/2020,South Sudan,Selangor,0,0,0
1/05/2020,South Sudan,W.P. Labuan,0,0,0
1/05/2020,Sao Tome and Principe,Selangor,0,0,0
1/05/2020,Suriname,Johor,0,0,0
1/05/2020,Suriname,Kedah,0,0,0
1/05/2020,Suriname,Kelantan,0,0,0
1/05/2020,Suriname,Perak,0,0,0
1/05/2020,Suriname,Perlis,0,0,0
1/05/2020,Suriname,Pulau Pinang,0,0,0
1/05/2020,Suriname,Sabah,0,0,0
1/05/2020,Suriname,Sarawak,0,0,0
1/05/2020,Suriname,Selangor,0,0,0
1/05/2020,Slovakia,Johor,0,0,0
1/05/2020,Slovakia,Kedah,0,0,0
1/05/2020,Slovakia,Kelantan,0,0,0
1/05/2020,Slovakia,Negeri Sembilan,0,0,0
1/05/2020,Slovakia,Pahang,0,0,0
1/05/2020,Slovakia,Perak,0,0,0
1/05/2020,Slovakia,Perlis,0,0,0
1/05/2020,Slovakia,Pulau Pinang,0,0,0
1/05/2020,Slovakia,Sabah,0,0,0
1/05/2020,Slovakia,Sarawak,0,0,0
1/05/2020,Slovakia,Selangor,0,0,0
1/05/2020,Slovakia,W.P. Labuan,0,0,0
1/05/2020,Slovenia,Johor,0,0,0
1/05/2020,Slovenia,Kedah,0,0,0
1/05/2020,Slovenia,Kelantan,0,0,0
1/05/2020,Slovenia,Perak,0,0,0
1/05/2020,Slovenia,Perlis,0,0,0
1/05/2020,Slovenia,Pulau Pinang,0,0,0
1/05/2020,Slovenia,Sabah,0,0,0
1/05/2020,Slovenia,Sarawak,0,0,0
1/05/2020,Slovenia,Selangor,0,0,0
1/05/2020,Slovenia,W.P. Labuan,0,0,0
1/05/2020,Sweden,Johor,0,0,0
1/05/2020,Sweden,Kedah,0,0,0
1/05/2020,Sweden,Kelantan,0,0,0
1/05/2020,Sweden,Melaka,0,0,0
1/05/2020,Sweden,Negeri Sembilan,0,0,0
1/05/2020,Sweden,Pahang,0,0,0
1/05/2020,Sweden,Perak,0,0,0
1/05/2020,Sweden,Perlis,0,0,0
1/05/2020,Sweden,Pulau Pinang,0,0,0
1/05/2020,Sweden,Sabah,0,0,0
1/05/2020,Sweden,Sarawak,0,0,0
1/05/2020,Sweden,Selangor,1,1,0
1/05/2020,Sweden,W.P. Labuan,0,0,0
1/05/2020,Eswatini,Johor,0,0,0
1/05/2020,Eswatini,Kedah,0,0,0
1/05/2020,Eswatini,Pulau Pinang,0,0,0
1/05/2020,Eswatini,Sabah,0,0,0
1/05/2020,Eswatini,Selangor,0,0,0
1/05/2020,Seychelles,Johor,0,0,0
1/05/2020,Seychelles,Kedah,0,0,0
1/05/2020,Seychelles,Pulau Pinang,0,0,0
1/05/2020,Seychelles,Sabah,0,0,0
1/05/2020,Seychelles,Sarawak,0,0,0
1/05/2020,Seychelles,Selangor,0,0,0
1/05/2020,Syrian Arab Republic,Johor,0,0,0
1/05/2020,Syrian Arab Republic,Kedah,0,0,0
1/05/2020,Syrian Arab Republic,Kelantan,0,0,0
1/05/2020,Syrian Arab Republic,Pahang,0,0,0
1/05/2020,Syrian Arab Republic,Perlis,0,0,0
1/05/2020,Syrian Arab Republic,Pulau Pinang,0,0,0
1/05/2020,Syrian Arab Republic,Sabah,0,0,0
1/05/2020,Syrian Arab Republic,Sarawak,0,0,0
1/05/2020,Syrian Arab Republic,Selangor,0,0,0
1/05/2020,Syrian Arab Republic,W.P. Labuan,0,0,0
1/05/2020,Turks and Caicos Islands,Perlis,0,0,0
1/05/2020,TCD,Johor,0,0,0
1/05/2020,TCD,Kedah,0,0,0
1/05/2020,TCD,Perlis,0,0,0
1/05/2020,TCD,Selangor,0,0,0
1/05/2020,Togo,Johor,0,0,0
1/05/2020,Togo,Perak,0,0,0
1/05/2020,Togo,Pulau Pinang,0,0,0
1/05/2020,Togo,Selangor,0,0,0
1/05/2020,Thailand,Johor,88,88,0
1/05/2020,Thailand,Kedah,12912,12099,813
1/05/2020,Thailand,Kelantan,18,6,12
1/05/2020,Thailand,Melaka,0,0,0
1/05/2020,Thailand,Negeri Sembilan,0,0,0
1/05/2020,Thailand,Pahang,0,0,0
1/05/2020,Thailand,Perak,0,0,0
1/05/2020,Thailand,Perlis,24,3,21
1/05/2020,Thailand,Pulau Pinang,0,0,0
1/05/2020,Thailand,Sabah,0,0,0
1/05/2020,Thailand,Sarawak,6,6,0
1/05/2020,Thailand,Selangor,89,75,14
1/05/2020,Thailand,Terengganu,0,0,0
1/05/2020,Thailand,W.P. Labuan,0,0,0
1/05/2020,Tajikistan,Johor,0,0,0
1/05/2020,Tajikistan,Kedah,0,0,0
1/05/2020,Tajikistan,Perlis,0,0,0
1/05/2020,Tajikistan,Pulau Pinang,0,0,0
1/05/2020,Tajikistan,Sabah,0,0,0
1/05/2020,Tajikistan,Selangor,0,0,0
1/05/2020,Tokelau,Selangor,0,0,0
1/05/2020,Turkmenistan,Johor,0,0,0
1/05/2020,Turkmenistan,Kedah,0,0,0
1/05/2020,Turkmenistan,Kelantan,0,0,0
1/05/2020,Turkmenistan,Perlis,0,0,0
1/05/2020,Turkmenistan,Pulau Pinang,0,0,0
1/05/2020,Turkmenistan,Sabah,0,0,0
1/05/2020,Turkmenistan,Sarawak,0,0,0
1/05/2020,Turkmenistan,Selangor,0,0,0
1/05/2020,Timor-Leste,Johor,0,0,0
1/05/2020,Timor-Leste,Kedah,0,0,0
1/05/2020,Timor-Leste,Perlis,0,0,0
1/05/2020,Timor-Leste,Pulau Pinang,0,0,0
1/05/2020,Timor-Leste,Sabah,0,0,0
1/05/2020,Timor-Leste,Sarawak,0,0,0
1/05/2020,Timor-Leste,Selangor,1,1,0
1/05/2020,Tonga,Johor,0,0,0
1/05/2020,Tonga,Pulau Pinang,0,0,0
1/05/2020,Tonga,Sarawak,0,0,0
1/05/2020,Tonga,Selangor,0,0,0
1/05/2020,Trinidad and Tobago,Johor,0,0,0
1/05/2020,Trinidad and Tobago,Kedah,0,0,0
1/05/2020,Trinidad and Tobago,Pahang,0,0,0
1/05/2020,Trinidad and Tobago,Pulau Pinang,0,0,0
1/05/2020,Trinidad and Tobago,Sabah,0,0,0
1/05/2020,Trinidad and Tobago,Sarawak,0,0,0
1/05/2020,Trinidad and Tobago,Selangor,0,0,0
1/05/2020,Tunisia,Johor,0,0,0
1/05/2020,Tunisia,Kedah,0,0,0
1/05/2020,Tunisia,Kelantan,0,0,0
1/05/2020,Tunisia,Melaka,0,0,0
1/05/2020,Tunisia,Perak,0,0,0
1/05/2020,Tunisia,Perlis,0,0,0
1/05/2020,Tunisia,Pulau Pinang,0,0,0
1/05/2020,Tunisia,Sabah,0,0,0
1/05/2020,Tunisia,Sarawak,0,0,0
1/05/2020,Tunisia,Selangor,0,0,0
1/05/2020,Tunisia,W.P. Labuan,0,0,0
1/05/2020,Türkiye,Johor,0,0,0
1/05/2020,Türkiye,Kedah,0,0,0
1/05/2020,Türkiye,Kelantan,0,0,0
1/05/2020,Türkiye,Melaka,0,0,0
1/05/2020,Türkiye,Negeri Sembilan,0,0,0
1/05/2020,Türkiye,Pahang,0,0,0
1/05/2020,Türkiye,Perak,0,0,0
1/05/2020,Türkiye,Perlis,0,0,0
1/05/2020,Türkiye,Pulau Pinang,0,0,0
1/05/2020,Türkiye,Sabah,0,0,0
1/05/2020,Türkiye,Sarawak,3,2,1
1/05/2020,Türkiye,Selangor,8,7,1
1/05/2020,Türkiye,W.P. Labuan,0,0,0
1/05/2020,Tuvalu,Selangor,0,0,0
1/05/2020,"Taiwan, Province of China",Johor,0,0,0
1/05/2020,"Taiwan, Province of China",Kedah,0,0,0
1/05/2020,"Taiwan, Province of China",Kelantan,0,0,0
1/05/2020,"Taiwan, Province of China",Melaka,0,0,0
1/05/2020,"Taiwan, Province of China",Negeri Sembilan,0,0,0
1/05/2020,"Taiwan, Province of China",Pahang,0,0,0
1/05/2020,"Taiwan, Province of China",Perak,0,0,0
1/05/2020,"Taiwan, Province of China",Perlis,0,0,0
1/05/2020,"Taiwan, Province of China",Pulau Pinang,0,0,0
1/05/2020,"Taiwan, Province of China",Sabah,0,0,0
1/05/2020,"Taiwan, Province of China",Sarawak,0,0,0
1/05/2020,"Taiwan, Province of China",Selangor,2,0,2
1/05/2020,"Taiwan, Province of China",W.P. Labuan,0,0,0
1/05/2020,"Tanzania, United Republic of",Johor,0,0,0
1/05/2020,"Tanzania, United Republic of",Kedah,0,0,0
1/05/2020,"Tanzania, United Republic of",Perak,0,0,0
1/05/2020,"Tanzania, United Republic of",Perlis,0,0,0
1/05/2020,"Tanzania, United Republic of",Pulau Pinang,0,0,0
1/05/2020,"Tanzania, United Republic of",Sabah,0,0,0
1/05/2020,"Tanzania, United Republic of",Sarawak,0,0,0
1/05/2020,"Tanzania, United Republic of",Selangor,0,0,0
1/05/2020,Uganda,Johor,0,0,0
1/05/2020,Uganda,Kedah,0,0,0
1/05/2020,Uganda,Perak,0,0,0
1/05/2020,Uganda,Perlis,0,0,0
1/05/2020,Uganda,Pulau Pinang,0,0,0
1/05/2020,Uganda,Sabah,0,0,0
1/05/2020,Uganda,Sarawak,0,0,0
1/05/2020,Uganda,Selangor,0,0,0
1/05/2020,Ukraine,Johor,2,2,0
1/05/2020,Ukraine,Kedah,0,0,0
1/05/2020,Ukraine,Kelantan,0,0,0
1/05/2020,Ukraine,Melaka,0,0,0
1/05/2020,Ukraine,Negeri Sembilan,0,0,0
1/05/2020,Ukraine,Pahang,0,0,0
1/05/2020,Ukraine,Perak,0,0,0
1/05/2020,Ukraine,Perlis,0,0,0
1/05/2020,Ukraine,Pulau Pinang,0,0,0
1/05/2020,Ukraine,Sabah,10,10,0
1/05/2020,Ukraine,Sarawak,0,0,0
1/05/2020,Ukraine,Selangor,0,0,0
1/05/2020,Ukraine,W.P. Labuan,0,0,0
1/05/2020,Uruguay,Johor,0,0,0
1/05/2020,Uruguay,Kedah,0,0,0
1/05/2020,Uruguay,Kelantan,0,0,0
1/05/2020,Uruguay,Perak,0,0,0
1/05/2020,Uruguay,Perlis,0,0,0
1/05/2020,Uruguay,Pulau Pinang,0,0,0
1/05/2020,Uruguay,Sabah,0,0,0
1/05/2020,Uruguay,Sarawak,0,0,0
1/05/2020,Uruguay,Selangor,0,0,0
1/05/2020,Uruguay,W.P. Labuan,0,0,0
1/05/2020,United States of America,Johor,0,0,0
1/05/2020,United States of America,Kedah,0,0,0
1/05/2020,United States of America,Kelantan,0,0,0
1/05/2020,United States of America,Melaka,0,0,0
1/05/2020,United States of America,Negeri Sembilan,0,0,0
1/05/2020,United States of America,Pahang,0,0,0
1/05/2020,United States of America,Perak,0,0,0
1/05/2020,United States of America,Perlis,0,0,0
1/05/2020,United States of America,Pulau Pinang,1,1,0
1/05/2020,United States of America,Sabah,0,0,0
1/05/2020,United States of America,Sarawak,0,0,0
1/05/2020,United States of America,Selangor,22,18,4
1/05/2020,United States of America,Terengganu,0,0,0
1/05/2020,United States of America,W.P. Labuan,0,0,0
1/05/2020,Uzbekistan,Johor,0,0,0
1/05/2020,Uzbekistan,Kedah,0,0,0
1/05/2020,Uzbekistan,Kelantan,0,0,0
1/05/2020,Uzbekistan,Perak,0,0,0
1/05/2020,Uzbekistan,Perlis,0,0,0
1/05/2020,Uzbekistan,Pulau Pinang,0,0,0
1/05/2020,Uzbekistan,Sabah,0,0,0
1/05/2020,Uzbekistan,Sarawak,0,0,0
1/05/2020,Uzbekistan,Selangor,0,0,0
1/05/2020,Holy See,Johor,0,0,0
1/05/2020,Holy See,Sarawak,0,0,0
1/05/2020,Holy See,Selangor,0,0,0
1/05/2020,Saint Vincent and the Grenadines,Johor,0,0,0
1/05/2020,Saint Vincent and the Grenadines,Kedah,0,0,0
1/05/2020,Saint Vincent and the Grenadines,Pulau Pinang,0,0,0
1/05/2020,Saint Vincent and the Grenadines,Sarawak,0,0,0
1/05/2020,Saint Vincent and the Grenadines,Selangor,0,0,0
1/05/2020,"Venezuela, Bolivarian Republic of",Johor,0,0,0
1/05/2020,"Venezuela, Bolivarian Republic of",Kedah,0,0,0
1/05/2020,"Venezuela, Bolivarian Republic of",Kelantan,0,0,0
1/05/2020,"Venezuela, Bolivarian Republic of",Melaka,0,0,0
1/05/2020,"Venezuela, Bolivarian Republic of",Perak,0,0,0
1/05/2020,"Venezuela, Bolivarian Republic of",Perlis,0,0,0
1/05/2020,"Venezuela, Bolivarian Republic of",Pulau Pinang,0,0,0
1/05/2020,"Venezuela, Bolivarian Republic of",Sabah,0,0,0
1/05/2020,"Venezuela, Bolivarian Republic of",Sarawak,0,0,0
1/05/2020,"Venezuela, Bolivarian Republic of",Selangor,0,0,0
1/05/2020,"Venezuela, Bolivarian Republic of",W.P. Labuan,0,0,0
1/05/2020,Viet Nam,Johor,4,3,1
1/05/2020,Viet Nam,Kedah,0,0,0
1/05/2020,Viet Nam,Kelantan,0,0,0
1/05/2020,Viet Nam,Melaka,0,0,0
1/05/2020,Viet Nam,Negeri Sembilan,0,0,0
1/05/2020,Viet Nam,Pahang,0,0,0
1/05/2020,Viet Nam,Perak,0,0,0
1/05/2020,Viet Nam,Perlis,0,0,0
1/05/2020,Viet Nam,Pulau Pinang,0,0,0
1/05/2020,Viet Nam,Sabah,0,0,0
1/05/2020,Viet Nam,Sarawak,0,0,0
1/05/2020,Viet Nam,Selangor,46,0,46
1/05/2020,Viet Nam,Terengganu,0,0,0
1/05/2020,Viet Nam,W.P. Labuan,0,0,0
1/05/2020,Vanuatu,Johor,0,0,0
1/05/2020,Vanuatu,Kedah,0,0,0
1/05/2020,Vanuatu,Pulau Pinang,0,0,0
1/05/2020,Vanuatu,Sabah,0,0,0
1/05/2020,Vanuatu,Sarawak,0,0,0
1/05/2020,Vanuatu,Selangor,0,0,0
1/05/2020, Samoa,Johor,0,0,0
1/05/2020, Samoa,Sarawak,0,0,0
1/05/2020, Samoa,Selangor,0,0,0
1/05/2020,Yemen,Johor,0,0,0
1/05/2020,Yemen,Kedah,0,0,0
1/05/2020,Yemen,Kelantan,0,0,0
1/05/2020,Yemen,Melaka,0,0,0
1/05/2020,Yemen,Pahang,0,0,0
1/05/2020,Yemen,Perak,0,0,0
1/05/2020,Yemen,Perlis,0,0,0
1/05/2020,Yemen,Pulau Pinang,0,0,0
1/05/2020,Yemen,Sabah,0,0,0
1/05/2020,Yemen,Sarawak,0,0,0
1/05/2020,Yemen,Selangor,1,0,1
1/05/2020,Yemen,W.P. Labuan,0,0,0
1/05/2020,South Africa,Johor,0,0,0
1/05/2020,South Africa,Kedah,0,0,0
1/05/2020,South Africa,Kelantan,0,0,0
1/05/2020,South Africa,Melaka,0,0,0
1/05/2020,South Africa,Pahang,0,0,0
1/05/2020,South Africa,Perak,0,0,0
1/05/2020,South Africa,Perlis,0,0,0
1/05/2020,South Africa,Pulau Pinang,0,0,0
1/05/2020,South Africa,Sabah,0,0,0
1/05/2020,South Africa,Sarawak,0,0,0
1/05/2020,South Africa,Selangor,1,1,0
1/05/2020,South Africa,Terengganu,0,0,0
1/05/2020,South Africa,W.P. Labuan,0,0,0
1/05/2020,ZAR,Selangor,0,0,0
1/05/2020,Zambia,Johor,0,0,0
1/05/2020,Zambia,Kedah,0,0,0
1/05/2020,Zambia,Perak,0,0,0
1/05/2020,Zambia,Perlis,0,0,0
1/05/2020,Zambia,Pulau Pinang,0,0,0
1/05/2020,Zambia,Sabah,0,0,0
1/05/2020,Zambia,Sarawak,0,0,0
1/05/2020,Zambia,Selangor,0,0,0
1/05/2020,Zimbabwe,Johor,0,0,0
1/05/2020,Zimbabwe,Kedah,0,0,0
1/05/2020,Zimbabwe,Kelantan,0,0,0
1/05/2020,Zimbabwe,Perak,0,0,0
1/05/2020,Zimbabwe,Perlis,0,0,0
1/05/2020,Zimbabwe,Pulau Pinang,0,0,0
1/05/2020,Zimbabwe,Sabah,0,0,0
1/05/2020,Zimbabwe,Sarawak,0,0,0
1/05/2020,Zimbabwe,Selangor,0,0,0
1/06/2020,Aruba,Kedah,0,0,0
1/06/2020,Aruba,Pulau Pinang,0,0,0
1/06/2020,Afghanistan,Johor,0,0,0
1/06/2020,Afghanistan,Kedah,0,0,0
1/06/2020,Afghanistan,Perlis,0,0,0
1/06/2020,Afghanistan,Pulau Pinang,0,0,0
1/06/2020,Afghanistan,Sarawak,0,0,0
1/06/2020,Afghanistan,Selangor,1,1,0
1/06/2020,Angola,Johor,0,0,0
1/06/2020,Angola,Kedah,0,0,0
1/06/2020,Angola,Sabah,0,0,0
1/06/2020,Angola,Selangor,0,0,0
1/06/2020,Anguilla,Selangor,0,0,0
1/06/2020,Albania,Johor,0,0,0
1/06/2020,Albania,Kedah,0,0,0
1/06/2020,Albania,Perak,0,0,0
1/06/2020,Albania,Perlis,0,0,0
1/06/2020,Albania,Pulau Pinang,0,0,0
1/06/2020,Albania,Sabah,0,0,0
1/06/2020,Albania,Sarawak,0,0,0
1/06/2020,Albania,Selangor,0,0,0
1/06/2020,Andorra,Johor,0,0,0
1/06/2020,Andorra,Kedah,0,0,0
1/06/2020,Andorra,Perlis,0,0,0
1/06/2020,Andorra,Pulau Pinang,0,0,0
1/06/2020,Andorra,Selangor,0,0,0
1/06/2020,Antigua and Barbuda,Selangor,0,0,0
1/06/2020,United Arab Emirates,Johor,0,0,0
1/06/2020,United Arab Emirates,Kedah,0,0,0
1/06/2020,United Arab Emirates,Kelantan,0,0,0
1/06/2020,United Arab Emirates,Perak,0,0,0
1/06/2020,United Arab Emirates,Perlis,0,0,0
1/06/2020,United Arab Emirates,Pulau Pinang,0,0,0
1/06/2020,United Arab Emirates,Sabah,0,0,0
1/06/2020,United Arab Emirates,Sarawak,0,0,0
1/06/2020,United Arab Emirates,Selangor,2,2,0
1/06/2020,Argentina,Johor,0,0,0
1/06/2020,Argentina,Kedah,0,0,0
1/06/2020,Argentina,Kelantan,0,0,0
1/06/2020,Argentina,Melaka,0,0,0
1/06/2020,Argentina,Perak,0,0,0
1/06/2020,Argentina,Perlis,0,0,0
1/06/2020,Argentina,Pulau Pinang,0,0,0
1/06/2020,Argentina,Sabah,0,0,0
1/06/2020,Argentina,Sarawak,0,0,0
1/06/2020,Argentina,Selangor,0,0,0
1/06/2020,Argentina,W.P. Labuan,0,0,0
1/06/2020,Armenia,Johor,0,0,0
1/06/2020,Armenia,Kedah,0,0,0
1/06/2020,Armenia,Kelantan,0,0,0
1/06/2020,Armenia,Perak,0,0,0
1/06/2020,Armenia,Perlis,0,0,0
1/06/2020,Armenia,Pulau Pinang,0,0,0
1/06/2020,Armenia,Sabah,0,0,0
1/06/2020,Armenia,Sarawak,0,0,0
1/06/2020,Armenia,Selangor,0,0,0
1/06/2020,Antarctica,Selangor,0,0,0
1/06/2020,Antigua and Barbuda,Johor,0,0,0
1/06/2020,Antigua and Barbuda,Kedah,0,0,0
1/06/2020,Antigua and Barbuda,Pulau Pinang,0,0,0
1/06/2020,Antigua and Barbuda,Sarawak,0,0,0
1/06/2020,Antigua and Barbuda,Selangor,0,0,0
1/06/2020,Australia,Johor,4,4,0
1/06/2020,Australia,Kedah,0,0,0
1/06/2020,Australia,Kelantan,0,0,0
1/06/2020,Australia,Melaka,0,0,0
1/06/2020,Australia,Negeri Sembilan,0,0,0
1/06/2020,Australia,Pahang,0,0,0
1/06/2020,Australia,Perak,0,0,0
1/06/2020,Australia,Perlis,0,0,0
1/06/2020,Australia,Pulau Pinang,0,0,0
1/06/2020,Australia,Sabah,0,0,0
1/06/2020,Australia,Sarawak,1,1,0
1/06/2020,Australia,Selangor,36,21,15
1/06/2020,Australia,Terengganu,0,0,0
1/06/2020,Australia,W.P. Labuan,0,0,0
1/06/2020,Austria,Johor,0,0,0
1/06/2020,Austria,Kedah,0,0,0
1/06/2020,Austria,Kelantan,0,0,0
1/06/2020,Austria,Melaka,0,0,0
1/06/2020,Austria,Negeri Sembilan,0,0,0
1/06/2020,Austria,Pahang,0,0,0
1/06/2020,Austria,Perak,0,0,0
1/06/2020,Austria,Perlis,0,0,0
1/06/2020,Austria,Pulau Pinang,0,0,0
1/06/2020,Austria,Sabah,0,0,0
1/06/2020,Austria,Sarawak,0,0,0
1/06/2020,Austria,Selangor,0,0,0
1/06/2020,Austria,Terengganu,0,0,0
1/06/2020,Austria,W.P. Labuan,0,0,0
1/06/2020,Azerbaijan,Johor,0,0,0
1/06/2020,Azerbaijan,Kedah,0,0,0
1/06/2020,Azerbaijan,Kelantan,0,0,0
1/06/2020,Azerbaijan,Melaka,0,0,0
1/06/2020,Azerbaijan,Perlis,0,0,0
1/06/2020,Azerbaijan,Pulau Pinang,0,0,0
1/06/2020,Azerbaijan,Sabah,0,0,0
1/06/2020,Azerbaijan,Sarawak,0,0,0
1/06/2020,Azerbaijan,Selangor,0,0,0
1/06/2020,Azerbaijan,W.P. Labuan,0,0,0
1/06/2020,Burundi,Pulau Pinang,0,0,0
1/06/2020,Burundi,Sarawak,0,0,0
1/06/2020,Burundi,Selangor,0,0,0
1/06/2020,Belgium,Johor,0,0,0
1/06/2020,Belgium,Kedah,0,0,0
1/06/2020,Belgium,Kelantan,0,0,0
1/06/2020,Belgium,Melaka,0,0,0
1/06/2020,Belgium,Negeri Sembilan,0,0,0
1/06/2020,Belgium,Pahang,0,0,0
1/06/2020,Belgium,Perak,0,0,0
1/06/2020,Belgium,Perlis,0,0,0
1/06/2020,Belgium,Pulau Pinang,0,0,0
1/06/2020,Belgium,Sabah,0,0,0
1/06/2020,Belgium,Sarawak,0,0,0
1/06/2020,Belgium,Selangor,0,0,0
1/06/2020,Belgium,W.P. Labuan,0,0,0
1/06/2020,Benin,Johor,0,0,0
1/06/2020,Benin,Kedah,0,0,0
1/06/2020,Benin,Perak,0,0,0
1/06/2020,Benin,Pulau Pinang,0,0,0
1/06/2020,Benin,Sabah,0,0,0
1/06/2020,Benin,Sarawak,0,0,0
1/06/2020,Benin,Selangor,0,0,0
1/06/2020,Burkina Faso,Perak,0,0,0
1/06/2020,Burkina Faso,Pulau Pinang,0,0,0
1/06/2020,Burkina Faso,Selangor,0,0,0
1/06/2020,Bangladesh,Johor,0,0,0
1/06/2020,Bangladesh,Kedah,0,0,0
1/06/2020,Bangladesh,Kelantan,0,0,0
1/06/2020,Bangladesh,Melaka,0,0,0
1/06/2020,Bangladesh,Negeri Sembilan,0,0,0
1/06/2020,Bangladesh,Pahang,0,0,0
1/06/2020,Bangladesh,Perak,0,0,0
1/06/2020,Bangladesh,Perlis,0,0,0
1/06/2020,Bangladesh,Pulau Pinang,0,0,0
1/06/2020,Bangladesh,Sabah,0,0,0
1/06/2020,Bangladesh,Sarawak,0,0,0
1/06/2020,Bangladesh,Selangor,39,32,7
1/06/2020,Bangladesh,W.P. Labuan,0,0,0
1/06/2020,Bulgaria,Johor,0,0,0
1/06/2020,Bulgaria,Kedah,0,0,0
1/06/2020,Bulgaria,Kelantan,0,0,0
1/06/2020,Bulgaria,Pahang,0,0,0
1/06/2020,Bulgaria,Perak,0,0,0
1/06/2020,Bulgaria,Perlis,0,0,0
1/06/2020,Bulgaria,Pulau Pinang,0,0,0
1/06/2020,Bulgaria,Sabah,0,0,0
1/06/2020,Bulgaria,Sarawak,0,0,0
1/06/2020,Bulgaria,Selangor,0,0,0
1/06/2020,Bulgaria,W.P. Labuan,0,0,0
1/06/2020,Bahrain,Johor,0,0,0
1/06/2020,Bahrain,Kedah,0,0,0
1/06/2020,Bahrain,Kelantan,0,0,0
1/06/2020,Bahrain,Perlis,0,0,0
1/06/2020,Bahrain,Pulau Pinang,0,0,0
1/06/2020,Bahrain,Sabah,0,0,0
1/06/2020,Bahrain,Sarawak,0,0,0
1/06/2020,Bahrain,Selangor,0,0,0
1/06/2020,Bahamas,Johor,0,0,0
1/06/2020,Bahamas,Kedah,0,0,0
1/06/2020,Bahamas,Perak,0,0,0
1/06/2020,Bahamas,Sabah,0,0,0
1/06/2020,Bahamas,Sarawak,0,0,0
1/06/2020,Bahamas,Selangor,0,0,0
1/06/2020,Bosnia and Herzegovina,Johor,0,0,0
1/06/2020,Bosnia and Herzegovina,Kedah,0,0,0
1/06/2020,Bosnia and Herzegovina,Perlis,0,0,0
1/06/2020,Bosnia and Herzegovina,Pulau Pinang,0,0,0
1/06/2020,Bosnia and Herzegovina,Sabah,0,0,0
1/06/2020,Bosnia and Herzegovina,Sarawak,0,0,0
1/06/2020,Bosnia and Herzegovina,Selangor,0,0,0
1/06/2020,Belarus,Johor,0,0,0
1/06/2020,Belarus,Kedah,0,0,0
1/06/2020,Belarus,Kelantan,0,0,0
1/06/2020,Belarus,Pahang,0,0,0
1/06/2020,Belarus,Perak,0,0,0
1/06/2020,Belarus,Perlis,0,0,0
1/06/2020,Belarus,Pulau Pinang,0,0,0
1/06/2020,Belarus,Sabah,0,0,0
1/06/2020,Belarus,Sarawak,0,0,0
1/06/2020,Belarus,Selangor,0,0,0
1/06/2020,Belarus,W.P. Labuan,0,0,0
1/06/2020,Belize,Johor,0,0,0
1/06/2020,Belize,Pulau Pinang,0,0,0
1/06/2020,Belize,Sarawak,0,0,0
1/06/2020,Belize,Selangor,0,0,0
1/06/2020,Bermuda,Selangor,0,0,0
1/06/2020,Bolivia,Johor,0,0,0
1/06/2020,Bolivia,Kedah,0,0,0
1/06/2020,Bolivia,Melaka,0,0,0
1/06/2020,Bolivia,Perak,0,0,0
1/06/2020,Bolivia,Perlis,0,0,0
1/06/2020,Bolivia,Pulau Pinang,0,0,0
1/06/2020,Bolivia,Sabah,0,0,0
1/06/2020,Bolivia,Sarawak,0,0,0
1/06/2020,Bolivia,Selangor,0,0,0
1/06/2020,Brazil,Johor,0,0,0
1/06/2020,Brazil,Kedah,0,0,0
1/06/2020,Brazil,Kelantan,0,0,0
1/06/2020,Brazil,Melaka,0,0,0
1/06/2020,Brazil,Pahang,0,0,0
1/06/2020,Brazil,Perak,0,0,0
1/06/2020,Brazil,Perlis,0,0,0
1/06/2020,Brazil,Pulau Pinang,0,0,0
1/06/2020,Brazil,Sabah,0,0,0
1/06/2020,Brazil,Sarawak,0,0,0
1/06/2020,Brazil,Selangor,2,2,0
1/06/2020,Brazil,W.P. Labuan,0,0,0
1/06/2020,Barbados,Johor,0,0,0
1/06/2020,Barbados,Kedah,0,0,0
1/06/2020,Barbados,Perlis,0,0,0
1/06/2020,Barbados,Pulau Pinang,0,0,0
1/06/2020,Barbados,Selangor,0,0,0
1/06/2020,Brunei Darussalam,Johor,0,0,0
1/06/2020,Brunei Darussalam,Kedah,0,0,0
1/06/2020,Brunei Darussalam,Kelantan,0,0,0
1/06/2020,Brunei Darussalam,Melaka,0,0,0
1/06/2020,Brunei Darussalam,Pahang,0,0,0
1/06/2020,Brunei Darussalam,Perak,0,0,0
1/06/2020,Brunei Darussalam,Perlis,0,0,0
1/06/2020,Brunei Darussalam,Pulau Pinang,0,0,0
1/06/2020,Brunei Darussalam,Sabah,0,0,0
1/06/2020,Brunei Darussalam,Sarawak,428,411,17
1/06/2020,Brunei Darussalam,Selangor,37,34,3
1/06/2020,Brunei Darussalam,W.P. Labuan,0,0,0
1/06/2020,Bhutan,Johor,0,0,0
1/06/2020,Bhutan,Kedah,0,0,0
1/06/2020,Bhutan,Perak,0,0,0
1/06/2020,Bhutan,Perlis,0,0,0
1/06/2020,Bhutan,Pulau Pinang,0,0,0
1/06/2020,Bhutan,Sabah,0,0,0
1/06/2020,Bhutan,Sarawak,0,0,0
1/06/2020,Bhutan,Selangor,0,0,0
1/06/2020,Botswana,Johor,0,0,0
1/06/2020,Botswana,Kedah,0,0,0
1/06/2020,Botswana,Perlis,0,0,0
1/06/2020,Botswana,Pulau Pinang,0,0,0
1/06/2020,Botswana,Sabah,0,0,0
1/06/2020,Botswana,Sarawak,0,0,0
1/06/2020,Botswana,Selangor,0,0,0
1/06/2020,Central African Republic,Kedah,0,0,0
1/06/2020,Central African Republic,Selangor,0,0,0
1/06/2020,Canada,Johor,0,0,0
1/06/2020,Canada,Kedah,0,0,0
1/06/2020,Canada,Kelantan,0,0,0
1/06/2020,Canada,Melaka,0,0,0
1/06/2020,Canada,Negeri Sembilan,0,0,0
1/06/2020,Canada,Pahang,0,0,0
1/06/2020,Canada,Perak,0,0,0
1/06/2020,Canada,Perlis,0,0,0
1/06/2020,Canada,Pulau Pinang,0,0,0
1/06/2020,Canada,Sabah,0,0,0
1/06/2020,Canada,Sarawak,1,1,0
1/06/2020,Canada,Selangor,14,12,2
1/06/2020,Canada,Terengganu,0,0,0
1/06/2020,Canada,W.P. Labuan,0,0,0
1/06/2020,Cocos (Keeling) Islands,Selangor,0,0,0
1/06/2020,Switzerland,Johor,1,1,0
1/06/2020,Switzerland,Kedah,0,0,0
1/06/2020,Switzerland,Kelantan,0,0,0
1/06/2020,Switzerland,Melaka,0,0,0
1/06/2020,Switzerland,Negeri Sembilan,0,0,0
1/06/2020,Switzerland,Pahang,0,0,0
1/06/2020,Switzerland,Perak,0,0,0
1/06/2020,Switzerland,Perlis,0,0,0
1/06/2020,Switzerland,Pulau Pinang,0,0,0
1/06/2020,Switzerland,Sabah,0,0,0
1/06/2020,Switzerland,Sarawak,0,0,0
1/06/2020,Switzerland,Selangor,2,2,0
1/06/2020,Switzerland,W.P. Labuan,0,0,0
1/06/2020,Chile,Johor,0,0,0
1/06/2020,Chile,Kedah,0,0,0
1/06/2020,Chile,Kelantan,0,0,0
1/06/2020,Chile,Melaka,0,0,0
1/06/2020,Chile,Pahang,0,0,0
1/06/2020,Chile,Perak,0,0,0
1/06/2020,Chile,Perlis,0,0,0
1/06/2020,Chile,Pulau Pinang,0,0,0
1/06/2020,Chile,Sabah,0,0,0
1/06/2020,Chile,Sarawak,0,0,0
1/06/2020,Chile,Selangor,0,0,0
1/06/2020,China,Johor,0,0,0
1/06/2020,China,Kedah,0,0,0
1/06/2020,China,Kelantan,0,0,0
1/06/2020,China,Melaka,0,0,0
1/06/2020,China,Pahang,0,0,0
1/06/2020,China,Perak,0,0,0
1/06/2020,China,Perlis,0,0,0
1/06/2020,China,Pulau Pinang,0,0,0
1/06/2020,China,Sabah,0,0,0
1/06/2020,China,Sarawak,2,0,2
1/06/2020,China,Selangor,194,135,59
1/06/2020,China,Terengganu,0,0,0
1/06/2020,China,W.P. Labuan,0,0,0
1/06/2020,Côte d'Ivoire,Johor,0,0,0
1/06/2020,Côte d'Ivoire,Kedah,0,0,0
1/06/2020,Côte d'Ivoire,Pulau Pinang,0,0,0
1/06/2020,Côte d'Ivoire,Sabah,0,0,0
1/06/2020,Côte d'Ivoire,Sarawak,0,0,0
1/06/2020,Côte d'Ivoire,Selangor,0,0,0
1/06/2020,Cameroon,Johor,0,0,0
1/06/2020,Cameroon,Kedah,0,0,0
1/06/2020,Cameroon,Pulau Pinang,0,0,0
1/06/2020,Cameroon,Sabah,0,0,0
1/06/2020,Cameroon,Sarawak,0,0,0
1/06/2020,Cameroon,Selangor,0,0,0
1/06/2020,Congo,Johor,0,0,0
1/06/2020,Congo,Pulau Pinang,0,0,0
1/06/2020,Congo,Sarawak,0,0,0
1/06/2020,Congo,Selangor,0,0,0
1/06/2020,Congo,Johor,0,0,0
1/06/2020,Congo,Kedah,0,0,0
1/06/2020,Congo,Selangor,0,0,0
1/06/2020,Cook Islands,Selangor,0,0,0
1/06/2020,Colombia,Johor,0,0,0
1/06/2020,Colombia,Kedah,0,0,0
1/06/2020,Colombia,Perak,0,0,0
1/06/2020,Colombia,Pulau Pinang,0,0,0
1/06/2020,Colombia,Sabah,0,0,0
1/06/2020,Colombia,Sarawak,0,0,0
1/06/2020,Colombia,Selangor,0,0,0
1/06/2020,Colombia,W.P. Labuan,0,0,0
1/06/2020,Comoros,Johor,0,0,0
1/06/2020,Comoros,Kedah,0,0,0
1/06/2020,Comoros,Selangor,0,0,0
1/06/2020,Cabo Verde,Johor,0,0,0
1/06/2020,Cabo Verde,Kedah,0,0,0
1/06/2020,Cabo Verde,Pulau Pinang,0,0,0
1/06/2020,Cabo Verde,Sabah,0,0,0
1/06/2020,Cabo Verde,Selangor,0,0,0
1/06/2020,Costa Rica,Johor,0,0,0
1/06/2020,Costa Rica,Kedah,0,0,0
1/06/2020,Costa Rica,Perak,0,0,0
1/06/2020,Costa Rica,Perlis,0,0,0
1/06/2020,Costa Rica,Pulau Pinang,0,0,0
1/06/2020,Costa Rica,Sabah,0,0,0
1/06/2020,Costa Rica,Sarawak,0,0,0
1/06/2020,Costa Rica,Selangor,0,0,0
1/06/2020,Cuba,Johor,0,0,0
1/06/2020,Cuba,Kedah,0,0,0
1/06/2020,Cuba,Perlis,0,0,0
1/06/2020,Cuba,Pulau Pinang,0,0,0
1/06/2020,Cuba,Sabah,0,0,0
1/06/2020,Cuba,Sarawak,0,0,0
1/06/2020,Cuba,Selangor,0,0,0
1/06/2020,Cyprus,Johor,0,0,0
1/06/2020,Cyprus,Kedah,0,0,0
1/06/2020,Cyprus,Perak,0,0,0
1/06/2020,Cyprus,Perlis,0,0,0
1/06/2020,Cyprus,Pulau Pinang,0,0,0
1/06/2020,Cyprus,Sabah,0,0,0
1/06/2020,Cyprus,Sarawak,0,0,0
1/06/2020,Cyprus,Selangor,0,0,0
1/06/2020,Czechia,Johor,0,0,0
1/06/2020,Czechia,Kedah,0,0,0
1/06/2020,Czechia,Kelantan,0,0,0
1/06/2020,Czechia,Melaka,0,0,0
1/06/2020,Czechia,Negeri Sembilan,0,0,0
1/06/2020,Czechia,Perak,0,0,0
1/06/2020,Czechia,Perlis,0,0,0
1/06/2020,Czechia,Pulau Pinang,0,0,0
1/06/2020,Czechia,Sabah,0,0,0
1/06/2020,Czechia,Sarawak,0,0,0
1/06/2020,Czechia,Selangor,1,1,0
1/06/2020,Czechia,W.P. Labuan,0,0,0
1/06/2020,Germany,Johor,0,0,0
1/06/2020,Germany,Kedah,0,0,0
1/06/2020,Germany,Kelantan,0,0,0
1/06/2020,Germany,Melaka,0,0,0
1/06/2020,Germany,Negeri Sembilan,0,0,0
1/06/2020,Germany,Pahang,0,0,0
1/06/2020,Germany,Perak,0,0,0
1/06/2020,Germany,Perlis,0,0,0
1/06/2020,Germany,Pulau Pinang,0,0,0
1/06/2020,Germany,Sabah,0,0,0
1/06/2020,Germany,Sarawak,1,1,0
1/06/2020,Germany,Selangor,18,15,3
1/06/2020,Germany,Terengganu,0,0,0
1/06/2020,Germany,W.P. Labuan,0,0,0
1/06/2020,Djibouti,Johor,0,0,0
1/06/2020,Djibouti,Selangor,0,0,0
1/06/2020,Dominica,Johor,0,0,0
1/06/2020,Dominica,Kedah,0,0,0
1/06/2020,Dominica,Pulau Pinang,0,0,0
1/06/2020,Dominica,Sabah,0,0,0
1/06/2020,Dominica,Sarawak,0,0,0
1/06/2020,Dominica,Selangor,1,1,0
1/06/2020,Dominica,W.P. Labuan,0,0,0
1/06/2020,Denmark,Johor,0,0,0
1/06/2020,Denmark,Kedah,0,0,0
1/06/2020,Denmark,Kelantan,0,0,0
1/06/2020,Denmark,Melaka,0,0,0
1/06/2020,Denmark,Negeri Sembilan,0,0,0
1/06/2020,Denmark,Pahang,0,0,0
1/06/2020,Denmark,Perak,0,0,0
1/06/2020,Denmark,Perlis,0,0,0
1/06/2020,Denmark,Pulau Pinang,0,0,0
1/06/2020,Denmark,Sabah,0,0,0
1/06/2020,Denmark,Sarawak,0,0,0
1/06/2020,Denmark,Selangor,2,2,0
1/06/2020,Denmark,W.P. Labuan,0,0,0
1/06/2020,Dominican Republic,Johor,0,0,0
1/06/2020,Dominican Republic,Kedah,0,0,0
1/06/2020,Dominican Republic,Perak,0,0,0
1/06/2020,Dominican Republic,Perlis,0,0,0
1/06/2020,Dominican Republic,Pulau Pinang,0,0,0
1/06/2020,Dominican Republic,Sabah,0,0,0
1/06/2020,Dominican Republic,Sarawak,0,0,0
1/06/2020,Dominican Republic,Selangor,0,0,0
1/06/2020,Algeria,Johor,0,0,0
1/06/2020,Algeria,Kedah,0,0,0
1/06/2020,Algeria,Kelantan,0,0,0
1/06/2020,Algeria,Melaka,0,0,0
1/06/2020,Algeria,Perak,0,0,0
1/06/2020,Algeria,Perlis,0,0,0
1/06/2020,Algeria,Pulau Pinang,0,0,0
1/06/2020,Algeria,Sabah,0,0,0
1/06/2020,Algeria,Sarawak,0,0,0
1/06/2020,Algeria,Selangor,1,1,0
1/06/2020,Algeria,W.P. Labuan,0,0,0
1/06/2020,Ecuador,Johor,0,0,0
1/06/2020,Ecuador,Kedah,0,0,0
1/06/2020,Ecuador,Perak,0,0,0
1/06/2020,Ecuador,Perlis,0,0,0
1/06/2020,Ecuador,Pulau Pinang,0,0,0
1/06/2020,Ecuador,Sabah,0,0,0
1/06/2020,Ecuador,Sarawak,0,0,0
1/06/2020,Ecuador,Selangor,1,0,1
1/06/2020,Egypt,Johor,0,0,0
1/06/2020,Egypt,Kedah,0,0,0
1/06/2020,Egypt,Kelantan,0,0,0
1/06/2020,Egypt,Melaka,0,0,0
1/06/2020,Egypt,Pahang,0,0,0
1/06/2020,Egypt,Perak,0,0,0
1/06/2020,Egypt,Perlis,0,0,0
1/06/2020,Egypt,Pulau Pinang,0,0,0
1/06/2020,Egypt,Sabah,0,0,0
1/06/2020,Egypt,Sarawak,0,0,0
1/06/2020,Egypt,Selangor,3,3,0
1/06/2020,Egypt,Terengganu,0,0,0
1/06/2020,Egypt,W.P. Labuan,0,0,0
1/06/2020,Eritrea,Johor,0,0,0
1/06/2020,Eritrea,Pulau Pinang,0,0,0
1/06/2020,Eritrea,Sabah,0,0,0
1/06/2020,Eritrea,Selangor,0,0,0
1/06/2020,Spain,Johor,0,0,0
1/06/2020,Spain,Kedah,0,0,0
1/06/2020,Spain,Kelantan,0,0,0
1/06/2020,Spain,Melaka,0,0,0
1/06/2020,Spain,Negeri Sembilan,0,0,0
1/06/2020,Spain,Pahang,0,0,0
1/06/2020,Spain,Perak,0,0,0
1/06/2020,Spain,Perlis,0,0,0
1/06/2020,Spain,Pulau Pinang,0,0,0
1/06/2020,Spain,Sabah,0,0,0
1/06/2020,Spain,Sarawak,0,0,0
1/06/2020,Spain,Selangor,3,1,2
1/06/2020,Spain,W.P. Labuan,0,0,0
1/06/2020,Estonia,Johor,0,0,0
1/06/2020,Estonia,Kedah,0,0,0
1/06/2020,Estonia,Kelantan,0,0,0
1/06/2020,Estonia,Pahang,0,0,0
1/06/2020,Estonia,Perak,0,0,0
1/06/2020,Estonia,Perlis,0,0,0
1/06/2020,Estonia,Pulau Pinang,0,0,0
1/06/2020,Estonia,Sabah,0,0,0
1/06/2020,Estonia,Sarawak,0,0,0
1/06/2020,Estonia,Selangor,0,0,0
1/06/2020,Estonia,W.P. Labuan,0,0,0
1/06/2020,Ethiopia,Johor,0,0,0
1/06/2020,Ethiopia,Kedah,0,0,0
1/06/2020,Ethiopia,Pulau Pinang,0,0,0
1/06/2020,Ethiopia,Sarawak,0,0,0
1/06/2020,Ethiopia,Selangor,0,0,0
1/06/2020,Finland,Johor,0,0,0
1/06/2020,Finland,Kedah,0,0,0
1/06/2020,Finland,Kelantan,0,0,0
1/06/2020,Finland,Melaka,0,0,0
1/06/2020,Finland,Negeri Sembilan,0,0,0
1/06/2020,Finland,Pahang,0,0,0
1/06/2020,Finland,Perak,0,0,0
1/06/2020,Finland,Perlis,0,0,0
1/06/2020,Finland,Pulau Pinang,0,0,0
1/06/2020,Finland,Sabah,0,0,0
1/06/2020,Finland,Sarawak,0,0,0
1/06/2020,Finland,Selangor,0,0,0
1/06/2020,Finland,W.P. Labuan,0,0,0
1/06/2020,Fiji,Johor,0,0,0
1/06/2020,Fiji,Kedah,0,0,0
1/06/2020,Fiji,Kelantan,0,0,0
1/06/2020,Fiji,Perak,0,0,0
1/06/2020,Fiji,Perlis,0,0,0
1/06/2020,Fiji,Pulau Pinang,0,0,0
1/06/2020,Fiji,Sabah,0,0,0
1/06/2020,Fiji,Sarawak,0,0,0
1/06/2020,Fiji,Selangor,0,0,0
1/06/2020,France,Johor,3,2,1
1/06/2020,France,Kedah,0,0,0
1/06/2020,France,Kelantan,0,0,0
1/06/2020,France,Melaka,0,0,0
1/06/2020,France,Negeri Sembilan,0,0,0
1/06/2020,France,Pahang,0,0,0
1/06/2020,France,Perak,0,0,0
1/06/2020,France,Perlis,0,0,0
1/06/2020,France,Pulau Pinang,1,1,0
1/06/2020,France,Sabah,0,0,0
1/06/2020,France,Sarawak,0,0,0
1/06/2020,France,Selangor,22,18,4
1/06/2020,France,Terengganu,0,0,0
1/06/2020,France,W.P. Labuan,0,0,0
1/06/2020,"Micronesia, Federated States of",Johor,0,0,0
1/06/2020,"Micronesia, Federated States of",Pulau Pinang,0,0,0
1/06/2020,"Micronesia, Federated States of",Selangor,0,0,0
1/06/2020,Gabon,Johor,0,0,0
1/06/2020,Gabon,Pulau Pinang,0,0,0
1/06/2020,Gabon,Sarawak,0,0,0
1/06/2020,Gabon,Selangor,0,0,0
1/06/2020,United Kingdom of Great Britain and Northern Ireland,Johor,4,4,0
1/06/2020,United Kingdom of Great Britain and Northern Ireland,Kedah,0,0,0
1/06/2020,United Kingdom of Great Britain and Northern Ireland,Kelantan,0,0,0
1/06/2020,United Kingdom of Great Britain and Northern Ireland,Melaka,0,0,0
1/06/2020,United Kingdom of Great Britain and Northern Ireland,Negeri Sembilan,0,0,0
1/06/2020,United Kingdom of Great Britain and Northern Ireland,Pahang,0,0,0
1/06/2020,United Kingdom of Great Britain and Northern Ireland,Perak,0,0,0
1/06/2020,United Kingdom of Great Britain and Northern Ireland,Perlis,0,0,0
1/06/2020,United Kingdom of Great Britain and Northern Ireland,Pulau Pinang,0,0,0
1/06/2020,United Kingdom of Great Britain and Northern Ireland,Sabah,0,0,0
1/06/2020,United Kingdom of Great Britain and Northern Ireland,Sarawak,3,3,0
1/06/2020,United Kingdom of Great Britain and Northern Ireland,Selangor,94,78,16
1/06/2020,United Kingdom of Great Britain and Northern Ireland,Terengganu,0,0,0
1/06/2020,United Kingdom of Great Britain and Northern Ireland,W.P. Labuan,0,0,0
1/06/2020,Georgia,Johor,0,0,0
1/06/2020,Georgia,Kedah,0,0,0
1/06/2020,Georgia,Melaka,0,0,0
1/06/2020,Georgia,Perak,0,0,0
1/06/2020,Georgia,Perlis,0,0,0
1/06/2020,Georgia,Pulau Pinang,0,0,0
1/06/2020,Georgia,Sabah,0,0,0
1/06/2020,Georgia,Sarawak,0,0,0
1/06/2020,Georgia,Selangor,1,1,0
1/06/2020,Ghana,Johor,0,0,0
1/06/2020,Ghana,Kedah,0,0,0
1/06/2020,Ghana,Kelantan,0,0,0
1/06/2020,Ghana,Pulau Pinang,0,0,0
1/06/2020,Ghana,Sabah,0,0,0
1/06/2020,Ghana,Sarawak,0,0,0
1/06/2020,Ghana,Selangor,0,0,0
1/06/2020,Gibraltar,Johor,0,0,0
1/06/2020,Gibraltar,Sarawak,0,0,0
1/06/2020,Guinea,Johor,0,0,0
1/06/2020,Guinea,Kedah,0,0,0
1/06/2020,Guinea,Kelantan,0,0,0
1/06/2020,Guinea,Perlis,0,0,0
1/06/2020,Guinea,Pulau Pinang,0,0,0
1/06/2020,Guinea,Sabah,0,0,0
1/06/2020,Guinea,Sarawak,0,0,0
1/06/2020,Guinea,Selangor,0,0,0
1/06/2020,Guadeloupe,Selangor,0,0,0
1/06/2020,Gambia,Johor,0,0,0
1/06/2020,Gambia,Kedah,0,0,0
1/06/2020,Gambia,Kelantan,0,0,0
1/06/2020,Gambia,Pulau Pinang,0,0,0
1/06/2020,Gambia,Sabah,0,0,0
1/06/2020,Gambia,Sarawak,0,0,0
1/06/2020,Gambia,Selangor,0,0,0
1/06/2020,Guinea-Bissau,Johor,0,0,0
1/06/2020,Guinea-Bissau,Selangor,0,0,0
1/06/2020,Equatorial Guinea,Johor,0,0,0
1/06/2020,Equatorial Guinea,Selangor,0,0,0
1/06/2020,Greece,Johor,0,0,0
1/06/2020,Greece,Kedah,0,0,0
1/06/2020,Greece,Kelantan,0,0,0
1/06/2020,Greece,Melaka,0,0,0
1/06/2020,Greece,Negeri Sembilan,0,0,0
1/06/2020,Greece,Pahang,0,0,0
1/06/2020,Greece,Perak,0,0,0
1/06/2020,Greece,Perlis,0,0,0
1/06/2020,Greece,Pulau Pinang,0,0,0
1/06/2020,Greece,Sabah,0,0,0
1/06/2020,Greece,Sarawak,0,0,0
1/06/2020,Greece,Selangor,2,1,1
1/06/2020,Grenada,Johor,0,0,0
1/06/2020,Grenada,Kedah,0,0,0
1/06/2020,Grenada,Pulau Pinang,0,0,0
1/06/2020,Grenada,Sabah,0,0,0
1/06/2020,Grenada,Sarawak,0,0,0
1/06/2020,Grenada,Selangor,0,0,0
1/06/2020,Greenland,Johor,0,0,0
1/06/2020,Greenland,Selangor,0,0,0
1/06/2020,Guatemala,Johor,0,0,0
1/06/2020,Guatemala,Kedah,0,0,0
1/06/2020,Guatemala,Pahang,0,0,0
1/06/2020,Guatemala,Perak,0,0,0
1/06/2020,Guatemala,Pulau Pinang,0,0,0
1/06/2020,Guatemala,Sabah,0,0,0
1/06/2020,Guatemala,Sarawak,0,0,0
1/06/2020,Guatemala,Selangor,0,0,0
1/06/2020,Guatemala,W.P. Labuan,0,0,0
1/06/2020,Guyana,Johor,0,0,0
1/06/2020,Guyana,Kedah,0,0,0
1/06/2020,Guyana,Pulau Pinang,0,0,0
1/06/2020,Guyana,Sarawak,0,0,0
1/06/2020,Guyana,Selangor,0,0,0
1/06/2020,Hong Kong,Johor,0,0,0
1/06/2020,Hong Kong,Kedah,0,0,0
1/06/2020,Hong Kong,Kelantan,0,0,0
1/06/2020,Hong Kong,Pahang,0,0,0
1/06/2020,Hong Kong,Perak,0,0,0
1/06/2020,Hong Kong,Perlis,0,0,0
1/06/2020,Hong Kong,Pulau Pinang,0,0,0
1/06/2020,Hong Kong,Sabah,0,0,0
1/06/2020,Hong Kong,Sarawak,0,0,0
1/06/2020,Hong Kong,Selangor,0,0,0
1/06/2020,Hong Kong,Terengganu,0,0,0
1/06/2020,Heard Island and McDonald Islands,Johor,0,0,0
1/06/2020,Honduras,Johor,0,0,0
1/06/2020,Honduras,Kedah,0,0,0
1/06/2020,Honduras,Perak,0,0,0
1/06/2020,Honduras,Pulau Pinang,0,0,0
1/06/2020,Honduras,Sabah,0,0,0
1/06/2020,Honduras,Sarawak,0,0,0
1/06/2020,Honduras,Selangor,0,0,0
1/06/2020,Croatia,Johor,0,0,0
1/06/2020,Croatia,Kedah,0,0,0
1/06/2020,Croatia,Kelantan,0,0,0
1/06/2020,Croatia,Melaka,0,0,0
1/06/2020,Croatia,Pahang,0,0,0
1/06/2020,Croatia,Perak,0,0,0
1/06/2020,Croatia,Perlis,0,0,0
1/06/2020,Croatia,Pulau Pinang,0,0,0
1/06/2020,Croatia,Sabah,0,0,0
1/06/2020,Croatia,Sarawak,0,0,0
1/06/2020,Croatia,Selangor,1,1,0
1/06/2020,Haiti,Johor,0,0,0
1/06/2020,Haiti,Kedah,0,0,0
1/06/2020,Haiti,Kelantan,0,0,0
1/06/2020,Haiti,Perak,0,0,0
1/06/2020,Haiti,Pulau Pinang,0,0,0
1/06/2020,Haiti,Sabah,0,0,0
1/06/2020,Haiti,Selangor,0,0,0
1/06/2020,Hungary,Johor,0,0,0
1/06/2020,Hungary,Kedah,0,0,0
1/06/2020,Hungary,Kelantan,0,0,0
1/06/2020,Hungary,Pahang,0,0,0
1/06/2020,Hungary,Perak,0,0,0
1/06/2020,Hungary,Perlis,0,0,0
1/06/2020,Hungary,Pulau Pinang,0,0,0
1/06/2020,Hungary,Sabah,0,0,0
1/06/2020,Hungary,Sarawak,0,0,0
1/06/2020,Hungary,Selangor,1,0,1
1/06/2020,Hungary,W.P. Labuan,0,0,0
1/06/2020,Indonesia,Johor,84,62,22
1/06/2020,Indonesia,Kedah,7,7,0
1/06/2020,Indonesia,Kelantan,6,0,6
1/06/2020,Indonesia,Melaka,0,0,0
1/06/2020,Indonesia,Negeri Sembilan,0,0,0
1/06/2020,Indonesia,Pahang,0,0,0
1/06/2020,Indonesia,Perak,0,0,0
1/06/2020,Indonesia,Perlis,0,0,0
1/06/2020,Indonesia,Pulau Pinang,14,0,14
1/06/2020,Indonesia,Sabah,28,5,23
1/06/2020,Indonesia,Sarawak,444,423,21
1/06/2020,Indonesia,Selangor,144,53,91
1/06/2020,Indonesia,Terengganu,1,1,0
1/06/2020,Indonesia,W.P. Labuan,0,0,0
1/06/2020,India,Johor,3,3,0
1/06/2020,India,Kedah,0,0,0
1/06/2020,India,Kelantan,0,0,0
1/06/2020,India,Melaka,0,0,0
1/06/2020,India,Negeri Sembilan,0,0,0
1/06/2020,India,Pahang,0,0,0
1/06/2020,India,Perak,0,0,0
1/06/2020,India,Perlis,0,0,0
1/06/2020,India,Pulau Pinang,0,0,0
1/06/2020,India,Sabah,0,0,0
1/06/2020,India,Sarawak,0,0,0
1/06/2020,India,Selangor,70,40,30
1/06/2020,India,Terengganu,0,0,0
1/06/2020,India,W.P. Labuan,0,0,0
1/06/2020, British Indian Ocean Territory,Pulau Pinang,0,0,0
1/06/2020, British Indian Ocean Territory,Selangor,0,0,0
1/06/2020,Ireland,Johor,1,1,0
1/06/2020,Ireland,Kedah,0,0,0
1/06/2020,Ireland,Kelantan,0,0,0
1/06/2020,Ireland,Negeri Sembilan,0,0,0
1/06/2020,Ireland,Pahang,0,0,0
1/06/2020,Ireland,Perak,0,0,0
1/06/2020,Ireland,Perlis,0,0,0
1/06/2020,Ireland,Pulau Pinang,0,0,0
1/06/2020,Ireland,Sabah,0,0,0
1/06/2020,Ireland,Sarawak,0,0,0
1/06/2020,Ireland,Selangor,3,2,1
1/06/2020,Ireland,Terengganu,0,0,0
1/06/2020,Ireland,W.P. Labuan,0,0,0
1/06/2020,"Iran, Islamic Republic of",Johor,0,0,0
1/06/2020,"Iran, Islamic Republic of",Kedah,0,0,0
1/06/2020,"Iran, Islamic Republic of",Kelantan,0,0,0
1/06/2020,"Iran, Islamic Republic of",Perak,0,0,0
1/06/2020,"Iran, Islamic Republic of",Perlis,0,0,0
1/06/2020,"Iran, Islamic Republic of",Pulau Pinang,0,0,0
1/06/2020,"Iran, Islamic Republic of",Sabah,0,0,0
1/06/2020,"Iran, Islamic Republic of",Sarawak,0,0,0
1/06/2020,"Iran, Islamic Republic of",Selangor,5,4,1
1/06/2020,"Iran, Islamic Republic of",W.P. Labuan,0,0,0
1/06/2020,Iraq,Johor,0,0,0
1/06/2020,Iraq,Kedah,0,0,0
1/06/2020,Iraq,Kelantan,0,0,0
1/06/2020,Iraq,Melaka,0,0,0
1/06/2020,Iraq,Pahang,0,0,0
1/06/2020,Iraq,Perak,0,0,0
1/06/2020,Iraq,Perlis,0,0,0
1/06/2020,Iraq,Pulau Pinang,0,0,0
1/06/2020,Iraq,Sabah,0,0,0
1/06/2020,Iraq,Sarawak,0,0,0
1/06/2020,Iraq,Selangor,11,6,5
1/06/2020,Iceland,Johor,0,0,0
1/06/2020,Iceland,Kedah,0,0,0
1/06/2020,Iceland,Kelantan,0,0,0
1/06/2020,Iceland,Perak,0,0,0
1/06/2020,Iceland,Perlis,0,0,0
1/06/2020,Iceland,Pulau Pinang,0,0,0
1/06/2020,Iceland,Sabah,0,0,0
1/06/2020,Iceland,Sarawak,0,0,0
1/06/2020,Iceland,Selangor,0,0,0
1/06/2020,Iceland,W.P. Labuan,0,0,0
1/06/2020,Israel,Pulau Pinang,0,0,0
1/06/2020,Italy,Johor,0,0,0
1/06/2020,Italy,Kedah,0,0,0
1/06/2020,Italy,Kelantan,0,0,0
1/06/2020,Italy,Melaka,0,0,0
1/06/2020,Italy,Negeri Sembilan,0,0,0
1/06/2020,Italy,Pahang,0,0,0
1/06/2020,Italy,Perak,0,0,0
1/06/2020,Italy,Perlis,0,0,0
1/06/2020,Italy,Pulau Pinang,0,0,0
1/06/2020,Italy,Sabah,0,0,0
1/06/2020,Italy,Sarawak,0,0,0
1/06/2020,Italy,Selangor,4,2,2
1/06/2020,Italy,W.P. Labuan,0,0,0
1/06/2020,Jamaica,Johor,0,0,0
1/06/2020,Jamaica,Kedah,0,0,0
1/06/2020,Jamaica,Perak,0,0,0
1/06/2020,Jamaica,Pulau Pinang,0,0,0
1/06/2020,Jamaica,Sabah,0,0,0
1/06/2020,Jamaica,Sarawak,0,0,0
1/06/2020,Jamaica,Selangor,0,0,0
1/06/2020,Jamaica,W.P. Labuan,0,0,0
1/06/2020,Jordan,Johor,0,0,0
1/06/2020,Jordan,Kedah,0,0,0
1/06/2020,Jordan,Kelantan,0,0,0
1/06/2020,Jordan,Melaka,0,0,0
1/06/2020,Jordan,Perlis,0,0,0
1/06/2020,Jordan,Pulau Pinang,0,0,0
1/06/2020,Jordan,Sabah,0,0,0
1/06/2020,Jordan,Sarawak,0,0,0
1/06/2020,Jordan,Selangor,2,1,1
1/06/2020,Jordan,W.P. Labuan,0,0,0
1/06/2020,Japan,Johor,0,0,0
1/06/2020,Japan,Kedah,0,0,0
1/06/2020,Japan,Kelantan,0,0,0
1/06/2020,Japan,Melaka,0,0,0
1/06/2020,Japan,Negeri Sembilan,0,0,0
1/06/2020,Japan,Pahang,0,0,0
1/06/2020,Japan,Perak,0,0,0
1/06/2020,Japan,Perlis,0,0,0
1/06/2020,Japan,Pulau Pinang,0,0,0
1/06/2020,Japan,Sabah,0,0,0
1/06/2020,Japan,Sarawak,0,0,0
1/06/2020,Japan,Selangor,47,30,17
1/06/2020,Japan,W.P. Labuan,0,0,0
1/06/2020,Kazakhstan,Johor,0,0,0
1/06/2020,Kazakhstan,Kedah,0,0,0
1/06/2020,Kazakhstan,Kelantan,0,0,0
1/06/2020,Kazakhstan,Melaka,0,0,0
1/06/2020,Kazakhstan,Perak,0,0,0
1/06/2020,Kazakhstan,Perlis,0,0,0
1/06/2020,Kazakhstan,Pulau Pinang,0,0,0
1/06/2020,Kazakhstan,Sabah,0,0,0
1/06/2020,Kazakhstan,Sarawak,0,0,0
1/06/2020,Kazakhstan,Selangor,1,0,1
1/06/2020,Kazakhstan,W.P. Labuan,0,0,0
1/06/2020,Kenya,Johor,0,0,0
1/06/2020,Kenya,Kedah,0,0,0
1/06/2020,Kenya,Kelantan,0,0,0
1/06/2020,Kenya,Perak,0,0,0
1/06/2020,Kenya,Perlis,0,0,0
1/06/2020,Kenya,Pulau Pinang,0,0,0
1/06/2020,Kenya,Sabah,0,0,0
1/06/2020,Kenya,Sarawak,0,0,0
1/06/2020,Kenya,Selangor,0,0,0
1/06/2020,Kyrgyzstan,Johor,0,0,0
1/06/2020,Kyrgyzstan,Kedah,0,0,0
1/06/2020,Kyrgyzstan,Kelantan,0,0,0
1/06/2020,Kyrgyzstan,Perak,0,0,0
1/06/2020,Kyrgyzstan,Perlis,0,0,0
1/06/2020,Kyrgyzstan,Pulau Pinang,0,0,0
1/06/2020,Kyrgyzstan,Sabah,0,0,0
1/06/2020,Kyrgyzstan,Sarawak,0,0,0
1/06/2020,Kyrgyzstan,Selangor,0,0,0
1/06/2020,Cambodia,Johor,0,0,0
1/06/2020,Cambodia,Kedah,0,0,0
1/06/2020,Cambodia,Kelantan,0,0,0
1/06/2020,Cambodia,Melaka,0,0,0
1/06/2020,Cambodia,Negeri Sembilan,0,0,0
1/06/2020,Cambodia,Pahang,0,0,0
1/06/2020,Cambodia,Perak,0,0,0
1/06/2020,Cambodia,Perlis,0,0,0
1/06/2020,Cambodia,Pulau Pinang,0,0,0
1/06/2020,Cambodia,Sabah,0,0,0
1/06/2020,Cambodia,Sarawak,0,0,0
1/06/2020,Cambodia,Selangor,14,6,8
1/06/2020,Cambodia,W.P. Labuan,0,0,0
1/06/2020,Kiribati,Johor,0,0,0
1/06/2020,Kiribati,Sabah,0,0,0
1/06/2020,Kiribati,Selangor,0,0,0
1/06/2020,Saint Kitts and Nevis,Johor,0,0,0
1/06/2020,Saint Kitts and Nevis,Kedah,0,0,0
1/06/2020,Saint Kitts and Nevis,Perlis,0,0,0
1/06/2020,Saint Kitts and Nevis,Pulau Pinang,0,0,0
1/06/2020,Saint Kitts and Nevis,Sabah,0,0,0
1/06/2020,Saint Kitts and Nevis,Selangor,0,0,0
1/06/2020,Saint Kitts and Nevis,W.P. Labuan,0,0,0
1/06/2020,"Korea, Republic of",Johor,0,0,0
1/06/2020,"Korea, Republic of",Kedah,0,0,0
1/06/2020,"Korea, Republic of",Kelantan,0,0,0
1/06/2020,"Korea, Republic of",Melaka,0,0,0
1/06/2020,"Korea, Republic of",Negeri Sembilan,0,0,0
1/06/2020,"Korea, Republic of",Pahang,0,0,0
1/06/2020,"Korea, Republic of",Perak,0,0,0
1/06/2020,"Korea, Republic of",Perlis,0,0,0
1/06/2020,"Korea, Republic of",Pulau Pinang,0,0,0
1/06/2020,"Korea, Republic of",Sabah,0,0,0
1/06/2020,"Korea, Republic of",Sarawak,0,0,0
1/06/2020,"Korea, Republic of",Selangor,45,35,10
1/06/2020,"Korea, Republic of",Terengganu,0,0,0
1/06/2020,"Korea, Republic of",W.P. Labuan,0,0,0
1/06/2020,Kuwait,Johor,0,0,0
1/06/2020,Kuwait,Kedah,0,0,0
1/06/2020,Kuwait,Kelantan,0,0,0
1/06/2020,Kuwait,Perak,0,0,0
1/06/2020,Kuwait,Perlis,0,0,0
1/06/2020,Kuwait,Pulau Pinang,0,0,0
1/06/2020,Kuwait,Sabah,0,0,0
1/06/2020,Kuwait,Sarawak,0,0,0
1/06/2020,Kuwait,Selangor,0,0,0
1/06/2020,Kuwait,W.P. Labuan,0,0,0
1/06/2020, Lao People's Democratic Republic,Johor,0,0,0
1/06/2020, Lao People's Democratic Republic,Kedah,0,0,0
1/06/2020, Lao People's Democratic Republic,Kelantan,0,0,0
1/06/2020, Lao People's Democratic Republic,Melaka,0,0,0
1/06/2020, Lao People's Democratic Republic,Perak,0,0,0
1/06/2020, Lao People's Democratic Republic,Perlis,0,0,0
1/06/2020, Lao People's Democratic Republic,Pulau Pinang,0,0,0
1/06/2020, Lao People's Democratic Republic,Sabah,0,0,0
1/06/2020, Lao People's Democratic Republic,Sarawak,0,0,0
1/06/2020, Lao People's Democratic Republic,Selangor,0,0,0
1/06/2020, Lao People's Democratic Republic,W.P. Labuan,0,0,0
1/06/2020,Lebanon,Johor,0,0,0
1/06/2020,Lebanon,Kedah,0,0,0
1/06/2020,Lebanon,Kelantan,0,0,0
1/06/2020,Lebanon,Pahang,0,0,0
1/06/2020,Lebanon,Perak,0,0,0
1/06/2020,Lebanon,Perlis,0,0,0
1/06/2020,Lebanon,Pulau Pinang,0,0,0
1/06/2020,Lebanon,Sabah,0,0,0
1/06/2020,Lebanon,Sarawak,0,0,0
1/06/2020,Lebanon,Selangor,0,0,0
1/06/2020,Lebanon,W.P. Labuan,0,0,0
1/06/2020,Liberia,Johor,0,0,0
1/06/2020,Liberia,Kedah,0,0,0
1/06/2020,Liberia,Sabah,0,0,0
1/06/2020,Liberia,Sarawak,0,0,0
1/06/2020,Liberia,Selangor,0,0,0
1/06/2020,Libya,Johor,0,0,0
1/06/2020,Libya,Kedah,0,0,0
1/06/2020,Libya,Perlis,0,0,0
1/06/2020,Libya,Pulau Pinang,0,0,0
1/06/2020,Libya,Sabah,0,0,0
1/06/2020,Libya,Sarawak,0,0,0
1/06/2020,Libya,Selangor,0,0,0
1/06/2020,Saint Lucia,Johor,0,0,0
1/06/2020,Saint Lucia,Kedah,0,0,0
1/06/2020,Saint Lucia,Pulau Pinang,0,0,0
1/06/2020,Saint Lucia,Sarawak,0,0,0
1/06/2020,Saint Lucia,Selangor,0,0,0
1/06/2020,Liechtenstein,Johor,0,0,0
1/06/2020,Liechtenstein,Kedah,0,0,0
1/06/2020,Liechtenstein,Perlis,0,0,0
1/06/2020,Liechtenstein,Pulau Pinang,0,0,0
1/06/2020,Liechtenstein,Sabah,0,0,0
1/06/2020,Liechtenstein,Sarawak,0,0,0
1/06/2020,Liechtenstein,Selangor,0,0,0
1/06/2020,LKA,Johor,0,0,0
1/06/2020,LKA,Kedah,0,0,0
1/06/2020,LKA,Kelantan,0,0,0
1/06/2020,LKA,Melaka,0,0,0
1/06/2020,LKA,Pahang,0,0,0
1/06/2020,LKA,Perak,0,0,0
1/06/2020,LKA,Perlis,0,0,0
1/06/2020,LKA,Pulau Pinang,0,0,0
1/06/2020,LKA,Sabah,0,0,0
1/06/2020,LKA,Sarawak,0,0,0
1/06/2020,LKA,Selangor,9,6,3
1/06/2020,LKA,W.P. Labuan,0,0,0
1/06/2020,Lesotho,Johor,0,0,0
1/06/2020,Lesotho,Kedah,0,0,0
1/06/2020,Lesotho,Pulau Pinang,0,0,0
1/06/2020,Lesotho,Sarawak,0,0,0
1/06/2020,Lesotho,Selangor,0,0,0
1/06/2020,Lithuania,Johor,1,1,0
1/06/2020,Lithuania,Kedah,0,0,0
1/06/2020,Lithuania,Kelantan,0,0,0
1/06/2020,Lithuania,Pahang,0,0,0
1/06/2020,Lithuania,Perak,0,0,0
1/06/2020,Lithuania,Perlis,0,0,0
1/06/2020,Lithuania,Pulau Pinang,0,0,0
1/06/2020,Lithuania,Sabah,0,0,0
1/06/2020,Lithuania,Sarawak,0,0,0
1/06/2020,Lithuania,Selangor,0,0,0
1/06/2020,Lithuania,W.P. Labuan,0,0,0
1/06/2020,Luxembourg,Johor,0,0,0
1/06/2020,Luxembourg,Kedah,0,0,0
1/06/2020,Luxembourg,Kelantan,0,0,0
1/06/2020,Luxembourg,Perak,0,0,0
1/06/2020,Luxembourg,Perlis,0,0,0
1/06/2020,Luxembourg,Pulau Pinang,0,0,0
1/06/2020,Luxembourg,Sabah,0,0,0
1/06/2020,Luxembourg,Sarawak,0,0,0
1/06/2020,Luxembourg,Selangor,0,0,0
1/06/2020,Latvia,Johor,1,1,0
1/06/2020,Latvia,Kedah,0,0,0
1/06/2020,Latvia,Kelantan,0,0,0
1/06/2020,Latvia,Pahang,0,0,0
1/06/2020,Latvia,Perak,0,0,0
1/06/2020,Latvia,Perlis,0,0,0
1/06/2020,Latvia,Pulau Pinang,0,0,0
1/06/2020,Latvia,Sabah,0,0,0
1/06/2020,Latvia,Sarawak,0,0,0
1/06/2020,Latvia,Selangor,0,0,0
1/06/2020,Latvia,W.P. Labuan,0,0,0
1/06/2020,Macao,Johor,0,0,0
1/06/2020,Macao,Pahang,0,0,0
1/06/2020,Macao,Perak,0,0,0
1/06/2020,Macao,Selangor,0,0,0
1/06/2020,Macao,W.P. Labuan,0,0,0
1/06/2020,Morocco,Johor,0,0,0
1/06/2020,Morocco,Kedah,0,0,0
1/06/2020,Morocco,Kelantan,0,0,0
1/06/2020,Morocco,Melaka,0,0,0
1/06/2020,Morocco,Pahang,0,0,0
1/06/2020,Morocco,Perak,0,0,0
1/06/2020,Morocco,Perlis,0,0,0
1/06/2020,Morocco,Pulau Pinang,0,0,0
1/06/2020,Morocco,Sabah,0,0,0
1/06/2020,Morocco,Sarawak,0,0,0
1/06/2020,Morocco,Selangor,5,0,5
1/06/2020,Morocco,W.P. Labuan,0,0,0
1/06/2020,Monaco,Johor,0,0,0
1/06/2020,Monaco,Kedah,0,0,0
1/06/2020,Monaco,Sabah,0,0,0
1/06/2020,Monaco,Selangor,0,0,0
1/06/2020,"Moldova, Republic of",Johor,0,0,0
1/06/2020,"Moldova, Republic of",Kedah,0,0,0
1/06/2020,"Moldova, Republic of",Kelantan,0,0,0
1/06/2020,"Moldova, Republic of",Negeri Sembilan,0,0,0
1/06/2020,"Moldova, Republic of",Perlis,0,0,0
1/06/2020,"Moldova, Republic of",Pulau Pinang,0,0,0
1/06/2020,"Moldova, Republic of",Sabah,0,0,0
1/06/2020,"Moldova, Republic of",Sarawak,0,0,0
1/06/2020,"Moldova, Republic of",Selangor,0,0,0
1/06/2020,Madagascar,Johor,0,0,0
1/06/2020,Madagascar,Kedah,0,0,0
1/06/2020,Madagascar,Perak,0,0,0
1/06/2020,Madagascar,Perlis,0,0,0
1/06/2020,Madagascar,Pulau Pinang,0,0,0
1/06/2020,Madagascar,Sabah,0,0,0
1/06/2020,Madagascar,Sarawak,0,0,0
1/06/2020,Madagascar,Selangor,0,0,0
1/06/2020,Maldives,Johor,0,0,0
1/06/2020,Maldives,Kedah,0,0,0
1/06/2020,Maldives,Kelantan,0,0,0
1/06/2020,Maldives,Perak,0,0,0
1/06/2020,Maldives,Perlis,0,0,0
1/06/2020,Maldives,Pulau Pinang,0,0,0
1/06/2020,Maldives,Sabah,0,0,0
1/06/2020,Maldives,Sarawak,0,0,0
1/06/2020,Maldives,Selangor,3,2,1
1/06/2020,Mexico,Johor,0,0,0
1/06/2020,Mexico,Kedah,0,0,0
1/06/2020,Mexico,Kelantan,0,0,0
1/06/2020,Mexico,Pahang,0,0,0
1/06/2020,Mexico,Perak,0,0,0
1/06/2020,Mexico,Perlis,0,0,0
1/06/2020,Mexico,Pulau Pinang,0,0,0
1/06/2020,Mexico,Sabah,0,0,0
1/06/2020,Mexico,Sarawak,0,0,0
1/06/2020,Mexico,Selangor,1,1,0
1/06/2020,Mexico,W.P. Labuan,0,0,0
1/06/2020,Marshall Islands,Johor,0,0,0
1/06/2020,Marshall Islands,Kedah,0,0,0
1/06/2020,Marshall Islands,Perak,0,0,0
1/06/2020,Marshall Islands,Pulau Pinang,0,0,0
1/06/2020,Marshall Islands,Sabah,0,0,0
1/06/2020,Marshall Islands,Selangor,0,0,0
1/06/2020,North Macedonia,Johor,0,0,0
1/06/2020,North Macedonia,Kedah,0,0,0
1/06/2020,North Macedonia,Perak,0,0,0
1/06/2020,North Macedonia,Pulau Pinang,0,0,0
1/06/2020,North Macedonia,Sabah,0,0,0
1/06/2020,North Macedonia,Sarawak,0,0,0
1/06/2020,North Macedonia,Selangor,1,1,0
1/06/2020,Mali,Johor,0,0,0
1/06/2020,Mali,Sabah,0,0,0
1/06/2020,Mali,Selangor,0,0,0
1/06/2020,Malta,Johor,0,0,0
1/06/2020,Malta,Kedah,0,0,0
1/06/2020,Malta,Kelantan,0,0,0
1/06/2020,Malta,Perak,0,0,0
1/06/2020,Malta,Perlis,0,0,0
1/06/2020,Malta,Pulau Pinang,0,0,0
1/06/2020,Malta,Sabah,0,0,0
1/06/2020,Malta,Sarawak,0,0,0
1/06/2020,Malta,Selangor,0,0,0
1/06/2020,Malta,W.P. Labuan,0,0,0
1/06/2020,Myanmar,Johor,13,12,1
1/06/2020,Myanmar,Kedah,0,0,0
1/06/2020,Myanmar,Kelantan,0,0,0
1/06/2020,Myanmar,Negeri Sembilan,0,0,0
1/06/2020,Myanmar,Pahang,0,0,0
1/06/2020,Myanmar,Perak,0,0,0
1/06/2020,Myanmar,Perlis,0,0,0
1/06/2020,Myanmar,Pulau Pinang,0,0,0
1/06/2020,Myanmar,Sabah,0,0,0
1/06/2020,Myanmar,Sarawak,0,0,0
1/06/2020,Myanmar,Selangor,24,5,19
1/06/2020,Myanmar,Terengganu,0,0,0
1/06/2020,Myanmar,W.P. Labuan,0,0,0
1/06/2020,Montenegro,Johor,0,0,0
1/06/2020,Montenegro,Kedah,0,0,0
1/06/2020,Montenegro,Pulau Pinang,0,0,0
1/06/2020,Montenegro,Sabah,0,0,0
1/06/2020,Montenegro,Sarawak,0,0,0
1/06/2020,Montenegro,Selangor,1,0,1
1/06/2020,Mongolia,Johor,0,0,0
1/06/2020,Mongolia,Kedah,0,0,0
1/06/2020,Mongolia,Kelantan,0,0,0
1/06/2020,Mongolia,Perak,0,0,0
1/06/2020,Mongolia,Perlis,0,0,0
1/06/2020,Mongolia,Pulau Pinang,0,0,0
1/06/2020,Mongolia,Sabah,0,0,0
1/06/2020,Mongolia,Sarawak,0,0,0
1/06/2020,Mongolia,Selangor,0,0,0
1/06/2020,Northern Mariana Islands,Selangor,0,0,0
1/06/2020,Mozambique,Johor,0,0,0
1/06/2020,Mozambique,Kedah,0,0,0
1/06/2020,Mozambique,Perak,0,0,0
1/06/2020,Mozambique,Pulau Pinang,0,0,0
1/06/2020,Mozambique,Sabah,0,0,0
1/06/2020,Mozambique,Sarawak,0,0,0
1/06/2020,Mozambique,Selangor,0,0,0
1/06/2020,Mauritania,Johor,0,0,0
1/06/2020,Mauritania,Kedah,0,0,0
1/06/2020,Mauritania,Pulau Pinang,0,0,0
1/06/2020,Mauritania,Sabah,0,0,0
1/06/2020,Mauritania,Sarawak,0,0,0
1/06/2020,Mauritania,Selangor,0,0,0
1/06/2020,Mauritius,Johor,0,0,0
1/06/2020,Mauritius,Kedah,0,0,0
1/06/2020,Mauritius,Kelantan,0,0,0
1/06/2020,Mauritius,Pahang,0,0,0
1/06/2020,Mauritius,Perak,0,0,0
1/06/2020,Mauritius,Perlis,0,0,0
1/06/2020,Mauritius,Pulau Pinang,0,0,0
1/06/2020,Mauritius,Sabah,0,0,0
1/06/2020,Mauritius,Sarawak,0,0,0
1/06/2020,Mauritius,Selangor,0,0,0
1/06/2020,Malawi,Johor,0,0,0
1/06/2020,Malawi,Pulau Pinang,0,0,0
1/06/2020,Malawi,Sabah,0,0,0
1/06/2020,Malawi,Sarawak,0,0,0
1/06/2020,Malawi,Selangor,0,0,0
1/06/2020,Mayotte,Selangor,0,0,0
1/06/2020,Namibia,Johor,0,0,0
1/06/2020,Namibia,Kedah,0,0,0
1/06/2020,Namibia,Perak,0,0,0
1/06/2020,Namibia,Perlis,0,0,0
1/06/2020,Namibia,Pulau Pinang,0,0,0
1/06/2020,Namibia,Sabah,0,0,0
1/06/2020,Namibia,Sarawak,0,0,0
1/06/2020,Namibia,Selangor,0,0,0
1/06/2020,New Caledonia,Selangor,0,0,0
1/06/2020,Niger,Johor,0,0,0
1/06/2020,Niger,Sabah,0,0,0
1/06/2020,Niger,Selangor,0,0,0
1/06/2020,Nigeria,Johor,0,0,0
1/06/2020,Nigeria,Kedah,0,0,0
1/06/2020,Nigeria,Perlis,0,0,0
1/06/2020,Nigeria,Pulau Pinang,0,0,0
1/06/2020,Nigeria,Sabah,0,0,0
1/06/2020,Nigeria,Sarawak,0,0,0
1/06/2020,Nigeria,Selangor,4,4,0
1/06/2020,Nicaragua,Johor,0,0,0
1/06/2020,Nicaragua,Kedah,0,0,0
1/06/2020,Nicaragua,Pulau Pinang,0,0,0
1/06/2020,Nicaragua,Sabah,0,0,0
1/06/2020,Nicaragua,Selangor,0,0,0
1/06/2020,Netherlands,Johor,0,0,0
1/06/2020,Netherlands,Kedah,0,0,0
1/06/2020,Netherlands,Kelantan,0,0,0
1/06/2020,Netherlands,Melaka,0,0,0
1/06/2020,Netherlands,Negeri Sembilan,0,0,0
1/06/2020,Netherlands,Pahang,0,0,0
1/06/2020,Netherlands,Perak,0,0,0
1/06/2020,Netherlands,Perlis,0,0,0
1/06/2020,Netherlands,Pulau Pinang,0,0,0
1/06/2020,Netherlands,Sabah,0,0,0
1/06/2020,Netherlands,Sarawak,0,0,0
1/06/2020,Netherlands,Selangor,15,12,3
1/06/2020,Netherlands,Terengganu,0,0,0
1/06/2020,Netherlands,W.P. Labuan,0,0,0
1/06/2020,Norway,Johor,2,2,0
1/06/2020,Norway,Kedah,0,0,0
1/06/2020,Norway,Kelantan,0,0,0
1/06/2020,Norway,Melaka,0,0,0
1/06/2020,Norway,Pahang,0,0,0
1/06/2020,Norway,Perak,0,0,0
1/06/2020,Norway,Perlis,0,0,0
1/06/2020,Norway,Pulau Pinang,0,0,0
1/06/2020,Norway,Sabah,0,0,0
1/06/2020,Norway,Sarawak,0,0,0
1/06/2020,Norway,Selangor,3,3,0
1/06/2020,Norway,W.P. Labuan,0,0,0
1/06/2020,Nepal,Johor,1,1,0
1/06/2020,Nepal,Kedah,0,0,0
1/06/2020,Nepal,Pahang,0,0,0
1/06/2020,Nepal,Perak,0,0,0
1/06/2020,Nepal,Perlis,0,0,0
1/06/2020,Nepal,Pulau Pinang,0,0,0
1/06/2020,Nepal,Sabah,0,0,0
1/06/2020,Nepal,Sarawak,0,0,0
1/06/2020,Nepal,Selangor,3,3,0
1/06/2020,Nepal,W.P. Labuan,0,0,0
1/06/2020,Nauru,Johor,0,0,0
1/06/2020,Nauru,Pulau Pinang,0,0,0
1/06/2020,Nauru,Selangor,0,0,0
1/06/2020,New Zealand,Johor,2,2,0
1/06/2020,New Zealand,Kedah,2,2,0
1/06/2020,New Zealand,Kelantan,0,0,0
1/06/2020,New Zealand,Melaka,0,0,0
1/06/2020,New Zealand,Negeri Sembilan,0,0,0
1/06/2020,New Zealand,Pahang,0,0,0
1/06/2020,New Zealand,Perak,0,0,0
1/06/2020,New Zealand,Perlis,0,0,0
1/06/2020,New Zealand,Pulau Pinang,0,0,0
1/06/2020,New Zealand,Sabah,0,0,0
1/06/2020,New Zealand,Sarawak,0,0,0
1/06/2020,New Zealand,Selangor,8,4,4
1/06/2020,New Zealand,Terengganu,0,0,0
1/06/2020,New Zealand,W.P. Labuan,0,0,0
1/06/2020,Oman,Johor,0,0,0
1/06/2020,Oman,Kedah,0,0,0
1/06/2020,Oman,Kelantan,0,0,0
1/06/2020,Oman,Melaka,0,0,0
1/06/2020,Oman,Perak,0,0,0
1/06/2020,Oman,Perlis,0,0,0
1/06/2020,Oman,Pulau Pinang,0,0,0
1/06/2020,Oman,Sabah,0,0,0
1/06/2020,Oman,Sarawak,0,0,0
1/06/2020,Oman,Selangor,0,0,0
1/06/2020,Pakistan,Johor,0,0,0
1/06/2020,Pakistan,Kedah,0,0,0
1/06/2020,Pakistan,Kelantan,0,0,0
1/06/2020,Pakistan,Melaka,0,0,0
1/06/2020,Pakistan,Negeri Sembilan,0,0,0
1/06/2020,Pakistan,Pahang,0,0,0
1/06/2020,Pakistan,Perak,0,0,0
1/06/2020,Pakistan,Perlis,0,0,0
1/06/2020,Pakistan,Pulau Pinang,0,0,0
1/06/2020,Pakistan,Sabah,0,0,0
1/06/2020,Pakistan,Sarawak,0,0,0
1/06/2020,Pakistan,Selangor,128,111,17
1/06/2020,Pakistan,W.P. Labuan,0,0,0
1/06/2020,Panama,Johor,0,0,0
1/06/2020,Panama,Kedah,0,0,0
1/06/2020,Panama,Perak,0,0,0
1/06/2020,Panama,Perlis,0,0,0
1/06/2020,Panama,Pulau Pinang,0,0,0
1/06/2020,Panama,Sabah,0,0,0
1/06/2020,Panama,Sarawak,0,0,0
1/06/2020,Panama,Selangor,0,0,0
1/06/2020,Peru,Johor,0,0,0
1/06/2020,Peru,Kedah,0,0,0
1/06/2020,Peru,Kelantan,0,0,0
1/06/2020,Peru,Pahang,0,0,0
1/06/2020,Peru,Perak,0,0,0
1/06/2020,Peru,Perlis,0,0,0
1/06/2020,Peru,Pulau Pinang,0,0,0
1/06/2020,Peru,Sabah,0,0,0
1/06/2020,Peru,Sarawak,0,0,0
1/06/2020,Peru,Selangor,0,0,0
1/06/2020,Peru,W.P. Labuan,0,0,0
1/06/2020,Philippines,Johor,0,0,0
1/06/2020,Philippines,Kedah,1,0,1
1/06/2020,Philippines,Kelantan,0,0,0
1/06/2020,Philippines,Melaka,0,0,0
1/06/2020,Philippines,Negeri Sembilan,0,0,0
1/06/2020,Philippines,Pahang,0,0,0
1/06/2020,Philippines,Perak,0,0,0
1/06/2020,Philippines,Perlis,0,0,0
1/06/2020,Philippines,Pulau Pinang,0,0,0
1/06/2020,Philippines,Sabah,5,1,4
1/06/2020,Philippines,Sarawak,51,47,4
1/06/2020,Philippines,Selangor,20,3,17
1/06/2020,Philippines,Terengganu,0,0,0
1/06/2020,Philippines,W.P. Labuan,5,5,0
1/06/2020,Palau,Johor,0,0,0
1/06/2020,Palau,Pulau Pinang,0,0,0
1/06/2020,Palau,Selangor,0,0,0
1/06/2020,Papua New Guinea,Johor,0,0,0
1/06/2020,Papua New Guinea,Kedah,0,0,0
1/06/2020,Papua New Guinea,Kelantan,0,0,0
1/06/2020,Papua New Guinea,Perak,0,0,0
1/06/2020,Papua New Guinea,Pulau Pinang,0,0,0
1/06/2020,Papua New Guinea,Sabah,0,0,0
1/06/2020,Papua New Guinea,Sarawak,0,0,0
1/06/2020,Papua New Guinea,Selangor,0,0,0
1/06/2020,Poland,Johor,4,4,0
1/06/2020,Poland,Kedah,0,0,0
1/06/2020,Poland,Kelantan,0,0,0
1/06/2020,Poland,Melaka,0,0,0
1/06/2020,Poland,Negeri Sembilan,0,0,0
1/06/2020,Poland,Pahang,0,0,0
1/06/2020,Poland,Perak,0,0,0
1/06/2020,Poland,Perlis,0,0,0
1/06/2020,Poland,Pulau Pinang,0,0,0
1/06/2020,Poland,Sabah,0,0,0
1/06/2020,Poland,Sarawak,0,0,0
1/06/2020,Poland,Selangor,1,1,0
1/06/2020,Poland,Terengganu,0,0,0
1/06/2020,Poland,W.P. Labuan,0,0,0
1/06/2020,"North Korea, Democratic People's Republic of",Selangor,0,0,0
1/06/2020,Portugal,Johor,0,0,0
1/06/2020,Portugal,Kedah,0,0,0
1/06/2020,Portugal,Kelantan,0,0,0
1/06/2020,Portugal,Melaka,0,0,0
1/06/2020,Portugal,Pahang,0,0,0
1/06/2020,Portugal,Perak,0,0,0
1/06/2020,Portugal,Perlis,0,0,0
1/06/2020,Portugal,Pulau Pinang,0,0,0
1/06/2020,Portugal,Sabah,0,0,0
1/06/2020,Portugal,Sarawak,0,0,0
1/06/2020,Portugal,Selangor,1,1,0
1/06/2020,Portugal,W.P. Labuan,0,0,0
1/06/2020,Paraguay,Johor,0,0,0
1/06/2020,Paraguay,Kedah,0,0,0
1/06/2020,Paraguay,Perak,0,0,0
1/06/2020,Paraguay,Perlis,0,0,0
1/06/2020,Paraguay,Pulau Pinang,0,0,0
1/06/2020,Paraguay,Sabah,0,0,0
1/06/2020,Paraguay,Sarawak,0,0,0
1/06/2020,Paraguay,Selangor,0,0,0
1/06/2020,"Palestine, State of",Johor,0,0,0
1/06/2020,"Palestine, State of",Kedah,0,0,0
1/06/2020,"Palestine, State of",Kelantan,0,0,0
1/06/2020,"Palestine, State of",Melaka,0,0,0
1/06/2020,"Palestine, State of",Perak,0,0,0
1/06/2020,"Palestine, State of",Perlis,0,0,0
1/06/2020,"Palestine, State of",Pulau Pinang,0,0,0
1/06/2020,"Palestine, State of",Sabah,0,0,0
1/06/2020,"Palestine, State of",Sarawak,0,0,0
1/06/2020,"Palestine, State of",Selangor,1,1,0
1/06/2020,Qatar,Johor,0,0,0
1/06/2020,Qatar,Kedah,0,0,0
1/06/2020,Qatar,Perlis,0,0,0
1/06/2020,Qatar,Pulau Pinang,0,0,0
1/06/2020,Qatar,Sabah,0,0,0
1/06/2020,Qatar,Sarawak,0,0,0
1/06/2020,Qatar,Selangor,0,0,0
1/06/2020,Réunion,Johor,0,0,0
1/06/2020,Réunion,Sarawak,0,0,0
1/06/2020,Romania,Johor,2,2,0
1/06/2020,Romania,Kedah,0,0,0
1/06/2020,Romania,Kelantan,0,0,0
1/06/2020,Romania,Negeri Sembilan,0,0,0
1/06/2020,Romania,Pahang,0,0,0
1/06/2020,Romania,Perak,0,0,0
1/06/2020,Romania,Perlis,0,0,0
1/06/2020,Romania,Pulau Pinang,0,0,0
1/06/2020,Romania,Sabah,0,0,0
1/06/2020,Romania,Sarawak,0,0,0
1/06/2020,Romania,Selangor,9,8,1
1/06/2020,Romania,W.P. Labuan,0,0,0
1/06/2020,Russian Federation (Russia),Johor,0,0,0
1/06/2020,Russian Federation (Russia),Kedah,0,0,0
1/06/2020,Russian Federation (Russia),Kelantan,0,0,0
1/06/2020,Russian Federation (Russia),Melaka,0,0,0
1/06/2020,Russian Federation (Russia),Negeri Sembilan,0,0,0
1/06/2020,Russian Federation (Russia),Pahang,0,0,0
1/06/2020,Russian Federation (Russia),Perak,0,0,0
1/06/2020,Russian Federation (Russia),Perlis,0,0,0
1/06/2020,Russian Federation (Russia),Pulau Pinang,0,0,0
1/06/2020,Russian Federation (Russia),Sabah,0,0,0
1/06/2020,Russian Federation (Russia),Sarawak,0,0,0
1/06/2020,Russian Federation (Russia),Selangor,17,16,1
1/06/2020,Russian Federation (Russia),W.P. Labuan,0,0,0
1/06/2020,Rwanda,Johor,0,0,0
1/06/2020,Rwanda,Kedah,0,0,0
1/06/2020,Rwanda,Pulau Pinang,0,0,0
1/06/2020,Rwanda,Selangor,0,0,0
1/06/2020,Saudi Arabia,Johor,0,0,0
1/06/2020,Saudi Arabia,Kedah,0,0,0
1/06/2020,Saudi Arabia,Kelantan,0,0,0
1/06/2020,Saudi Arabia,Melaka,0,0,0
1/06/2020,Saudi Arabia,Perak,0,0,0
1/06/2020,Saudi Arabia,Perlis,0,0,0
1/06/2020,Saudi Arabia,Pulau Pinang,0,0,0
1/06/2020,Saudi Arabia,Sabah,0,0,0
1/06/2020,Saudi Arabia,Sarawak,0,0,0
1/06/2020,Saudi Arabia,Selangor,6,3,3
1/06/2020,Saudi Arabia,W.P. Labuan,0,0,0
1/06/2020,Sudan,Johor,0,0,0
1/06/2020,Sudan,Kedah,0,0,0
1/06/2020,Sudan,Kelantan,0,0,0
1/06/2020,Sudan,Perlis,0,0,0
1/06/2020,Sudan,Pulau Pinang,0,0,0
1/06/2020,Sudan,Sabah,0,0,0
1/06/2020,Sudan,Sarawak,0,0,0
1/06/2020,Sudan,Selangor,0,0,0
1/06/2020,Sudan,W.P. Labuan,0,0,0
1/06/2020,Senegal,Johor,0,0,0
1/06/2020,Senegal,Kedah,0,0,0
1/06/2020,Senegal,Kelantan,0,0,0
1/06/2020,Senegal,Perak,0,0,0
1/06/2020,Senegal,Perlis,0,0,0
1/06/2020,Senegal,Pulau Pinang,0,0,0
1/06/2020,Senegal,Sabah,0,0,0
1/06/2020,Senegal,Sarawak,0,0,0
1/06/2020,Senegal,Selangor,0,0,0
1/06/2020,Singapore,Johor,109,94,15
1/06/2020,Singapore,Kedah,0,0,0
1/06/2020,Singapore,Kelantan,0,0,0
1/06/2020,Singapore,Melaka,0,0,0
1/06/2020,Singapore,Negeri Sembilan,0,0,0
1/06/2020,Singapore,Pahang,0,0,0
1/06/2020,Singapore,Perak,3,1,2
1/06/2020,Singapore,Perlis,0,0,0
1/06/2020,Singapore,Pulau Pinang,0,0,0
1/06/2020,Singapore,Sabah,0,0,0
1/06/2020,Singapore,Sarawak,2,2,0
1/06/2020,Singapore,Selangor,36,22,14
1/06/2020,Singapore,Terengganu,0,0,0
1/06/2020,Singapore,W.P. Labuan,0,0,0
1/06/2020,South Georgia and the South Sandwich Islands,Johor,0,0,0
1/06/2020,South Georgia and the South Sandwich Islands,Sabah,0,0,0
1/06/2020,South Georgia and the South Sandwich Islands,Selangor,0,0,0
1/06/2020,Saint Helena,Sarawak,0,0,0
1/06/2020,Solomon Islands,Johor,0,0,0
1/06/2020,Solomon Islands,Perlis,0,0,0
1/06/2020,Solomon Islands,Pulau Pinang,0,0,0
1/06/2020,Solomon Islands,Sabah,0,0,0
1/06/2020,Solomon Islands,Sarawak,0,0,0
1/06/2020,Solomon Islands,Selangor,0,0,0
1/06/2020,Solomon Islands,W.P. Labuan,0,0,0
1/06/2020,Sierra Leone,Johor,0,0,0
1/06/2020,Sierra Leone,Kedah,0,0,0
1/06/2020,Sierra Leone,Perak,0,0,0
1/06/2020,Sierra Leone,Pulau Pinang,0,0,0
1/06/2020,Sierra Leone,Sabah,0,0,0
1/06/2020,Sierra Leone,Selangor,0,0,0
1/06/2020,El Salvador,Johor,0,0,0
1/06/2020,El Salvador,Kedah,0,0,0
1/06/2020,El Salvador,Perak,0,0,0
1/06/2020,El Salvador,Perlis,0,0,0
1/06/2020,El Salvador,Pulau Pinang,0,0,0
1/06/2020,El Salvador,Sabah,0,0,0
1/06/2020,El Salvador,Selangor,0,0,0
1/06/2020,El Salvador,W.P. Labuan,0,0,0
1/06/2020,San Marino,Johor,0,0,0
1/06/2020,San Marino,Selangor,0,0,0
1/06/2020,Somalia,Johor,0,0,0
1/06/2020,Somalia,Kedah,0,0,0
1/06/2020,Somalia,Kelantan,0,0,0
1/06/2020,Somalia,Perlis,0,0,0
1/06/2020,Somalia,Sabah,0,0,0
1/06/2020,Somalia,Sarawak,0,0,0
1/06/2020,Somalia,Selangor,0,0,0
1/06/2020,Serbia,Johor,0,0,0
1/06/2020,Serbia,Kedah,0,0,0
1/06/2020,Serbia,Kelantan,0,0,0
1/06/2020,Serbia,Pahang,0,0,0
1/06/2020,Serbia,Perak,0,0,0
1/06/2020,Serbia,Perlis,0,0,0
1/06/2020,Serbia,Pulau Pinang,0,0,0
1/06/2020,Serbia,Sabah,0,0,0
1/06/2020,Serbia,Sarawak,0,0,0
1/06/2020,Serbia,Selangor,0,0,0
1/06/2020,South Sudan,Johor,0,0,0
1/06/2020,South Sudan,Kedah,0,0,0
1/06/2020,South Sudan,Sarawak,0,0,0
1/06/2020,South Sudan,Selangor,0,0,0
1/06/2020,South Sudan,W.P. Labuan,0,0,0
1/06/2020,Sao Tome and Principe,Selangor,0,0,0
1/06/2020,Suriname,Johor,0,0,0
1/06/2020,Suriname,Kedah,0,0,0
1/06/2020,Suriname,Kelantan,0,0,0
1/06/2020,Suriname,Perak,0,0,0
1/06/2020,Suriname,Perlis,0,0,0
1/06/2020,Suriname,Pulau Pinang,0,0,0
1/06/2020,Suriname,Sabah,0,0,0
1/06/2020,Suriname,Sarawak,0,0,0
1/06/2020,Suriname,Selangor,0,0,0
1/06/2020,Slovakia,Johor,0,0,0
1/06/2020,Slovakia,Kedah,0,0,0
1/06/2020,Slovakia,Kelantan,0,0,0
1/06/2020,Slovakia,Negeri Sembilan,0,0,0
1/06/2020,Slovakia,Pahang,0,0,0
1/06/2020,Slovakia,Perak,0,0,0
1/06/2020,Slovakia,Perlis,0,0,0
1/06/2020,Slovakia,Pulau Pinang,0,0,0
1/06/2020,Slovakia,Sabah,0,0,0
1/06/2020,Slovakia,Sarawak,0,0,0
1/06/2020,Slovakia,Selangor,0,0,0
1/06/2020,Slovakia,W.P. Labuan,0,0,0
1/06/2020,Slovenia,Johor,0,0,0
1/06/2020,Slovenia,Kedah,0,0,0
1/06/2020,Slovenia,Kelantan,0,0,0
1/06/2020,Slovenia,Perak,0,0,0
1/06/2020,Slovenia,Perlis,0,0,0
1/06/2020,Slovenia,Pulau Pinang,0,0,0
1/06/2020,Slovenia,Sabah,0,0,0
1/06/2020,Slovenia,Sarawak,0,0,0
1/06/2020,Slovenia,Selangor,0,0,0
1/06/2020,Slovenia,W.P. Labuan,0,0,0
1/06/2020,Sweden,Johor,0,0,0
1/06/2020,Sweden,Kedah,0,0,0
1/06/2020,Sweden,Kelantan,0,0,0
1/06/2020,Sweden,Melaka,0,0,0
1/06/2020,Sweden,Negeri Sembilan,0,0,0
1/06/2020,Sweden,Pahang,0,0,0
1/06/2020,Sweden,Perak,0,0,0
1/06/2020,Sweden,Perlis,0,0,0
1/06/2020,Sweden,Pulau Pinang,0,0,0
1/06/2020,Sweden,Sabah,0,0,0
1/06/2020,Sweden,Sarawak,0,0,0
1/06/2020,Sweden,Selangor,0,0,0
1/06/2020,Sweden,W.P. Labuan,0,0,0
1/06/2020,Eswatini,Johor,0,0,0
1/06/2020,Eswatini,Kedah,0,0,0
1/06/2020,Eswatini,Pulau Pinang,0,0,0
1/06/2020,Eswatini,Sabah,0,0,0
1/06/2020,Eswatini,Selangor,0,0,0
1/06/2020,Seychelles,Johor,0,0,0
1/06/2020,Seychelles,Kedah,0,0,0
1/06/2020,Seychelles,Pulau Pinang,0,0,0
1/06/2020,Seychelles,Sabah,0,0,0
1/06/2020,Seychelles,Sarawak,0,0,0
1/06/2020,Seychelles,Selangor,0,0,0
1/06/2020,Syrian Arab Republic,Johor,0,0,0
1/06/2020,Syrian Arab Republic,Kedah,0,0,0
1/06/2020,Syrian Arab Republic,Kelantan,0,0,0
1/06/2020,Syrian Arab Republic,Pahang,0,0,0
1/06/2020,Syrian Arab Republic,Perlis,0,0,0
1/06/2020,Syrian Arab Republic,Pulau Pinang,0,0,0
1/06/2020,Syrian Arab Republic,Sabah,0,0,0
1/06/2020,Syrian Arab Republic,Sarawak,0,0,0
1/06/2020,Syrian Arab Republic,Selangor,0,0,0
1/06/2020,Syrian Arab Republic,W.P. Labuan,0,0,0
1/06/2020,Turks and Caicos Islands,Perlis,0,0,0
1/06/2020,TCD,Johor,0,0,0
1/06/2020,TCD,Kedah,0,0,0
1/06/2020,TCD,Perlis,0,0,0
1/06/2020,TCD,Selangor,0,0,0
1/06/2020,Togo,Johor,0,0,0
1/06/2020,Togo,Perak,0,0,0
1/06/2020,Togo,Pulau Pinang,0,0,0
1/06/2020,Togo,Selangor,0,0,0
1/06/2020,Thailand,Johor,135,134,1
1/06/2020,Thailand,Kedah,11733,10992,741
1/06/2020,Thailand,Kelantan,15,3,12
1/06/2020,Thailand,Melaka,0,0,0
1/06/2020,Thailand,Negeri Sembilan,0,0,0
1/06/2020,Thailand,Pahang,0,0,0
1/06/2020,Thailand,Perak,2,1,1
1/06/2020,Thailand,Perlis,3,0,3
1/06/2020,Thailand,Pulau Pinang,0,0,0
1/06/2020,Thailand,Sabah,0,0,0
1/06/2020,Thailand,Sarawak,13,13,0
1/06/2020,Thailand,Selangor,3,0,3
1/06/2020,Thailand,Terengganu,0,0,0
1/06/2020,Thailand,W.P. Labuan,0,0,0
1/06/2020,Tajikistan,Johor,0,0,0
1/06/2020,Tajikistan,Kedah,0,0,0
1/06/2020,Tajikistan,Perlis,0,0,0
1/06/2020,Tajikistan,Pulau Pinang,0,0,0
1/06/2020,Tajikistan,Sabah,0,0,0
1/06/2020,Tajikistan,Selangor,1,1,0
1/06/2020,Tokelau,Selangor,0,0,0
1/06/2020,Turkmenistan,Johor,0,0,0
1/06/2020,Turkmenistan,Kedah,0,0,0
1/06/2020,Turkmenistan,Kelantan,0,0,0
1/06/2020,Turkmenistan,Perlis,0,0,0
1/06/2020,Turkmenistan,Pulau Pinang,0,0,0
1/06/2020,Turkmenistan,Sabah,0,0,0
1/06/2020,Turkmenistan,Sarawak,0,0,0
1/06/2020,Turkmenistan,Selangor,0,0,0
1/06/2020,Timor-Leste,Johor,0,0,0
1/06/2020,Timor-Leste,Kedah,0,0,0
1/06/2020,Timor-Leste,Perlis,0,0,0
1/06/2020,Timor-Leste,Pulau Pinang,0,0,0
1/06/2020,Timor-Leste,Sabah,0,0,0
1/06/2020,Timor-Leste,Sarawak,0,0,0
1/06/2020,Timor-Leste,Selangor,0,0,0
1/06/2020,Tonga,Johor,0,0,0
1/06/2020,Tonga,Pulau Pinang,0,0,0
1/06/2020,Tonga,Sarawak,0,0,0
1/06/2020,Tonga,Selangor,0,0,0
1/06/2020,Trinidad and Tobago,Johor,0,0,0
1/06/2020,Trinidad and Tobago,Kedah,0,0,0
1/06/2020,Trinidad and Tobago,Pahang,0,0,0
1/06/2020,Trinidad and Tobago,Pulau Pinang,0,0,0
1/06/2020,Trinidad and Tobago,Sabah,0,0,0
1/06/2020,Trinidad and Tobago,Sarawak,0,0,0
1/06/2020,Trinidad and Tobago,Selangor,0,0,0
1/06/2020,Tunisia,Johor,0,0,0
1/06/2020,Tunisia,Kedah,0,0,0
1/06/2020,Tunisia,Kelantan,0,0,0
1/06/2020,Tunisia,Melaka,0,0,0
1/06/2020,Tunisia,Perak,0,0,0
1/06/2020,Tunisia,Perlis,0,0,0
1/06/2020,Tunisia,Pulau Pinang,0,0,0
1/06/2020,Tunisia,Sabah,0,0,0
1/06/2020,Tunisia,Sarawak,0,0,0
1/06/2020,Tunisia,Selangor,0,0,0
1/06/2020,Tunisia,W.P. Labuan,0,0,0
1/06/2020,Türkiye,Johor,0,0,0
1/06/2020,Türkiye,Kedah,0,0,0
1/06/2020,Türkiye,Kelantan,0,0,0
1/06/2020,Türkiye,Melaka,0,0,0
1/06/2020,Türkiye,Negeri Sembilan,0,0,0
1/06/2020,Türkiye,Pahang,0,0,0
1/06/2020,Türkiye,Perak,0,0,0
1/06/2020,Türkiye,Perlis,0,0,0
1/06/2020,Türkiye,Pulau Pinang,0,0,0
1/06/2020,Türkiye,Sabah,0,0,0
1/06/2020,Türkiye,Sarawak,0,0,0
1/06/2020,Türkiye,Selangor,8,5,3
1/06/2020,Türkiye,W.P. Labuan,0,0,0
1/06/2020,Tuvalu,Selangor,0,0,0
1/06/2020,"Taiwan, Province of China",Johor,1,1,0
1/06/2020,"Taiwan, Province of China",Kedah,0,0,0
1/06/2020,"Taiwan, Province of China",Kelantan,0,0,0
1/06/2020,"Taiwan, Province of China",Melaka,0,0,0
1/06/2020,"Taiwan, Province of China",Negeri Sembilan,0,0,0
1/06/2020,"Taiwan, Province of China",Pahang,0,0,0
1/06/2020,"Taiwan, Province of China",Perak,0,0,0
1/06/2020,"Taiwan, Province of China",Perlis,0,0,0
1/06/2020,"Taiwan, Province of China",Pulau Pinang,0,0,0
1/06/2020,"Taiwan, Province of China",Sabah,0,0,0
1/06/2020,"Taiwan, Province of China",Sarawak,0,0,0
1/06/2020,"Taiwan, Province of China",Selangor,11,6,5
1/06/2020,"Taiwan, Province of China",W.P. Labuan,0,0,0
1/06/2020,"Tanzania, United Republic of",Johor,0,0,0
1/06/2020,"Tanzania, United Republic of",Kedah,0,0,0
1/06/2020,"Tanzania, United Republic of",Perak,0,0,0
1/06/2020,"Tanzania, United Republic of",Perlis,0,0,0
1/06/2020,"Tanzania, United Republic of",Pulau Pinang,0,0,0
1/06/2020,"Tanzania, United Republic of",Sabah,0,0,0
1/06/2020,"Tanzania, United Republic of",Sarawak,0,0,0
1/06/2020,"Tanzania, United Republic of",Selangor,0,0,0
1/06/2020,Uganda,Johor,0,0,0
1/06/2020,Uganda,Kedah,0,0,0
1/06/2020,Uganda,Perak,0,0,0
1/06/2020,Uganda,Perlis,0,0,0
1/06/2020,Uganda,Pulau Pinang,0,0,0
1/06/2020,Uganda,Sabah,0,0,0
1/06/2020,Uganda,Sarawak,0,0,0
1/06/2020,Uganda,Selangor,0,0,0
1/06/2020,Ukraine,Johor,2,2,0
1/06/2020,Ukraine,Kedah,0,0,0
1/06/2020,Ukraine,Kelantan,0,0,0
1/06/2020,Ukraine,Melaka,0,0,0
1/06/2020,Ukraine,Negeri Sembilan,0,0,0
1/06/2020,Ukraine,Pahang,0,0,0
1/06/2020,Ukraine,Perak,0,0,0
1/06/2020,Ukraine,Perlis,0,0,0
1/06/2020,Ukraine,Pulau Pinang,0,0,0
1/06/2020,Ukraine,Sabah,0,0,0
1/06/2020,Ukraine,Sarawak,0,0,0
1/06/2020,Ukraine,Selangor,10,9,1
1/06/2020,Ukraine,W.P. Labuan,0,0,0
1/06/2020,Uruguay,Johor,0,0,0
1/06/2020,Uruguay,Kedah,0,0,0
1/06/2020,Uruguay,Kelantan,0,0,0
1/06/2020,Uruguay,Perak,0,0,0
1/06/2020,Uruguay,Perlis,0,0,0
1/06/2020,Uruguay,Pulau Pinang,0,0,0
1/06/2020,Uruguay,Sabah,0,0,0
1/06/2020,Uruguay,Sarawak,0,0,0
1/06/2020,Uruguay,Selangor,0,0,0
1/06/2020,Uruguay,W.P. Labuan,0,0,0
1/06/2020,United States of America,Johor,13,11,2
1/06/2020,United States of America,Kedah,0,0,0
1/06/2020,United States of America,Kelantan,0,0,0
1/06/2020,United States of America,Melaka,0,0,0
1/06/2020,United States of America,Negeri Sembilan,0,0,0
1/06/2020,United States of America,Pahang,0,0,0
1/06/2020,United States of America,Perak,0,0,0
1/06/2020,United States of America,Perlis,0,0,0
1/06/2020,United States of America,Pulau Pinang,3,3,0
1/06/2020,United States of America,Sabah,0,0,0
1/06/2020,United States of America,Sarawak,0,0,0
1/06/2020,United States of America,Selangor,34,25,9
1/06/2020,United States of America,Terengganu,0,0,0
1/06/2020,United States of America,W.P. Labuan,0,0,0
1/06/2020,Uzbekistan,Johor,0,0,0
1/06/2020,Uzbekistan,Kedah,0,0,0
1/06/2020,Uzbekistan,Kelantan,0,0,0
1/06/2020,Uzbekistan,Perak,0,0,0
1/06/2020,Uzbekistan,Perlis,0,0,0
1/06/2020,Uzbekistan,Pulau Pinang,0,0,0
1/06/2020,Uzbekistan,Sabah,0,0,0
1/06/2020,Uzbekistan,Sarawak,0,0,0
1/06/2020,Uzbekistan,Selangor,0,0,0
1/06/2020,Holy See,Johor,0,0,0
1/06/2020,Holy See,Sarawak,0,0,0
1/06/2020,Holy See,Selangor,0,0,0
1/06/2020,Saint Vincent and the Grenadines,Johor,0,0,0
1/06/2020,Saint Vincent and the Grenadines,Kedah,0,0,0
1/06/2020,Saint Vincent and the Grenadines,Pulau Pinang,0,0,0
1/06/2020,Saint Vincent and the Grenadines,Sarawak,0,0,0
1/06/2020,Saint Vincent and the Grenadines,Selangor,0,0,0
1/06/2020,"Venezuela, Bolivarian Republic of",Johor,0,0,0
1/06/2020,"Venezuela, Bolivarian Republic of",Kedah,0,0,0
1/06/2020,"Venezuela, Bolivarian Republic of",Kelantan,0,0,0
1/06/2020,"Venezuela, Bolivarian Republic of",Melaka,0,0,0
1/06/2020,"Venezuela, Bolivarian Republic of",Perak,0,0,0
1/06/2020,"Venezuela, Bolivarian Republic of",Perlis,0,0,0
1/06/2020,"Venezuela, Bolivarian Republic of",Pulau Pinang,0,0,0
1/06/2020,"Venezuela, Bolivarian Republic of",Sabah,0,0,0
1/06/2020,"Venezuela, Bolivarian Republic of",Sarawak,0,0,0
1/06/2020,"Venezuela, Bolivarian Republic of",Selangor,2,1,1
1/06/2020,"Venezuela, Bolivarian Republic of",W.P. Labuan,0,0,0
1/06/2020,Viet Nam,Johor,1,0,1
1/06/2020,Viet Nam,Kedah,0,0,0
1/06/2020,Viet Nam,Kelantan,0,0,0
1/06/2020,Viet Nam,Melaka,0,0,0
1/06/2020,Viet Nam,Negeri Sembilan,0,0,0
1/06/2020,Viet Nam,Pahang,0,0,0
1/06/2020,Viet Nam,Perak,0,0,0
1/06/2020,Viet Nam,Perlis,0,0,0
1/06/2020,Viet Nam,Pulau Pinang,0,0,0
1/06/2020,Viet Nam,Sabah,0,0,0
1/06/2020,Viet Nam,Sarawak,0,0,0
1/06/2020,Viet Nam,Selangor,31,30,1
1/06/2020,Viet Nam,Terengganu,0,0,0
1/06/2020,Viet Nam,W.P. Labuan,0,0,0
1/06/2020,Vanuatu,Johor,0,0,0
1/06/2020,Vanuatu,Kedah,0,0,0
1/06/2020,Vanuatu,Pulau Pinang,0,0,0
1/06/2020,Vanuatu,Sabah,0,0,0
1/06/2020,Vanuatu,Sarawak,0,0,0
1/06/2020,Vanuatu,Selangor,0,0,0
1/06/2020, Samoa,Johor,0,0,0
1/06/2020, Samoa,Sarawak,0,0,0
1/06/2020, Samoa,Selangor,0,0,0
1/06/2020,Yemen,Johor,0,0,0
1/06/2020,Yemen,Kedah,0,0,0
1/06/2020,Yemen,Kelantan,0,0,0
1/06/2020,Yemen,Melaka,0,0,0
1/06/2020,Yemen,Pahang,0,0,0
1/06/2020,Yemen,Perak,0,0,0
1/06/2020,Yemen,Perlis,0,0,0
1/06/2020,Yemen,Pulau Pinang,0,0,0
1/06/2020,Yemen,Sabah,0,0,0
1/06/2020,Yemen,Sarawak,0,0,0
1/06/2020,Yemen,Selangor,0,0,0
1/06/2020,Yemen,W.P. Labuan,0,0,0
1/06/2020,South Africa,Johor,0,0,0
1/06/2020,South Africa,Kedah,0,0,0
1/06/2020,South Africa,Kelantan,0,0,0
1/06/2020,South Africa,Melaka,0,0,0
1/06/2020,South Africa,Pahang,0,0,0
1/06/2020,South Africa,Perak,0,0,0
1/06/2020,South Africa,Perlis,0,0,0
1/06/2020,South Africa,Pulau Pinang,0,0,0
1/06/2020,South Africa,Sabah,0,0,0
1/06/2020,South Africa,Sarawak,0,0,0
1/06/2020,South Africa,Selangor,14,6,8
1/06/2020,South Africa,Terengganu,0,0,0
1/06/2020,South Africa,W.P. Labuan,0,0,0
1/06/2020,ZAR,Selangor,0,0,0
1/06/2020,Zambia,Johor,0,0,0
1/06/2020,Zambia,Kedah,0,0,0
1/06/2020,Zambia,Perak,0,0,0
1/06/2020,Zambia,Perlis,0,0,0
1/06/2020,Zambia,Pulau Pinang,0,0,0
1/06/2020,Zambia,Sabah,0,0,0
1/06/2020,Zambia,Sarawak,0,0,0
1/06/2020,Zambia,Selangor,0,0,0
1/06/2020,Zimbabwe,Johor,0,0,0
1/06/2020,Zimbabwe,Kedah,0,0,0
1/06/2020,Zimbabwe,Kelantan,0,0,0
1/06/2020,Zimbabwe,Perak,0,0,0
1/06/2020,Zimbabwe,Perlis,0,0,0
1/06/2020,Zimbabwe,Pulau Pinang,0,0,0
1/06/2020,Zimbabwe,Sabah,0,0,0
1/06/2020,Zimbabwe,Sarawak,0,0,0
1/06/2020,Zimbabwe,Selangor,0,0,0
1/07/2020,Aruba,Kedah,0,0,0
1/07/2020,Aruba,Pulau Pinang,0,0,0
1/07/2020,Afghanistan,Johor,0,0,0
1/07/2020,Afghanistan,Kedah,0,0,0
1/07/2020,Afghanistan,Perlis,0,0,0
1/07/2020,Afghanistan,Pulau Pinang,0,0,0
1/07/2020,Afghanistan,Sarawak,0,0,0
1/07/2020,Afghanistan,Selangor,6,3,3
1/07/2020,Angola,Johor,0,0,0
1/07/2020,Angola,Kedah,0,0,0
1/07/2020,Angola,Sabah,0,0,0
1/07/2020,Angola,Selangor,0,0,0
1/07/2020,Anguilla,Selangor,0,0,0
1/07/2020,Albania,Johor,0,0,0
1/07/2020,Albania,Kedah,0,0,0
1/07/2020,Albania,Perak,0,0,0
1/07/2020,Albania,Perlis,0,0,0
1/07/2020,Albania,Pulau Pinang,0,0,0
1/07/2020,Albania,Sabah,0,0,0
1/07/2020,Albania,Sarawak,0,0,0
1/07/2020,Albania,Selangor,0,0,0
1/07/2020,Andorra,Johor,0,0,0
1/07/2020,Andorra,Kedah,0,0,0
1/07/2020,Andorra,Perlis,0,0,0
1/07/2020,Andorra,Pulau Pinang,0,0,0
1/07/2020,Andorra,Selangor,0,0,0
1/07/2020,Antigua and Barbuda,Selangor,0,0,0
1/07/2020,United Arab Emirates,Johor,0,0,0
1/07/2020,United Arab Emirates,Kedah,0,0,0
1/07/2020,United Arab Emirates,Kelantan,0,0,0
1/07/2020,United Arab Emirates,Perak,0,0,0
1/07/2020,United Arab Emirates,Perlis,0,0,0
1/07/2020,United Arab Emirates,Pulau Pinang,0,0,0
1/07/2020,United Arab Emirates,Sabah,0,0,0
1/07/2020,United Arab Emirates,Sarawak,0,0,0
1/07/2020,United Arab Emirates,Selangor,5,1,4
1/07/2020,Argentina,Johor,0,0,0
1/07/2020,Argentina,Kedah,0,0,0
1/07/2020,Argentina,Kelantan,0,0,0
1/07/2020,Argentina,Melaka,0,0,0
1/07/2020,Argentina,Perak,0,0,0
1/07/2020,Argentina,Perlis,0,0,0
1/07/2020,Argentina,Pulau Pinang,0,0,0
1/07/2020,Argentina,Sabah,0,0,0
1/07/2020,Argentina,Sarawak,0,0,0
1/07/2020,Argentina,Selangor,4,2,2
1/07/2020,Argentina,W.P. Labuan,0,0,0
1/07/2020,Armenia,Johor,0,0,0
1/07/2020,Armenia,Kedah,0,0,0
1/07/2020,Armenia,Kelantan,0,0,0
1/07/2020,Armenia,Perak,0,0,0
1/07/2020,Armenia,Perlis,0,0,0
1/07/2020,Armenia,Pulau Pinang,0,0,0
1/07/2020,Armenia,Sabah,0,0,0
1/07/2020,Armenia,Sarawak,0,0,0
1/07/2020,Armenia,Selangor,0,0,0
1/07/2020,Antarctica,Selangor,0,0,0
1/07/2020,Antigua and Barbuda,Johor,0,0,0
1/07/2020,Antigua and Barbuda,Kedah,0,0,0
1/07/2020,Antigua and Barbuda,Pulau Pinang,0,0,0
1/07/2020,Antigua and Barbuda,Sarawak,0,0,0
1/07/2020,Antigua and Barbuda,Selangor,0,0,0
1/07/2020,Australia,Johor,5,5,0
1/07/2020,Australia,Kedah,1,1,0
1/07/2020,Australia,Kelantan,0,0,0
1/07/2020,Australia,Melaka,0,0,0
1/07/2020,Australia,Negeri Sembilan,0,0,0
1/07/2020,Australia,Pahang,0,0,0
1/07/2020,Australia,Perak,0,0,0
1/07/2020,Australia,Perlis,0,0,0
1/07/2020,Australia,Pulau Pinang,0,0,0
1/07/2020,Australia,Sabah,0,0,0
1/07/2020,Australia,Sarawak,3,3,0
1/07/2020,Australia,Selangor,162,111,51
1/07/2020,Australia,Terengganu,0,0,0
1/07/2020,Australia,W.P. Labuan,1,1,0
1/07/2020,Austria,Johor,0,0,0
1/07/2020,Austria,Kedah,0,0,0
1/07/2020,Austria,Kelantan,0,0,0
1/07/2020,Austria,Melaka,0,0,0
1/07/2020,Austria,Negeri Sembilan,0,0,0
1/07/2020,Austria,Pahang,0,0,0
1/07/2020,Austria,Perak,0,0,0
1/07/2020,Austria,Perlis,0,0,0
1/07/2020,Austria,Pulau Pinang,0,0,0
1/07/2020,Austria,Sabah,0,0,0
1/07/2020,Austria,Sarawak,0,0,0
1/07/2020,Austria,Selangor,13,9,4
1/07/2020,Austria,Terengganu,0,0,0
1/07/2020,Austria,W.P. Labuan,0,0,0
1/07/2020,Azerbaijan,Johor,0,0,0
1/07/2020,Azerbaijan,Kedah,0,0,0
1/07/2020,Azerbaijan,Kelantan,0,0,0
1/07/2020,Azerbaijan,Melaka,0,0,0
1/07/2020,Azerbaijan,Perlis,0,0,0
1/07/2020,Azerbaijan,Pulau Pinang,0,0,0
1/07/2020,Azerbaijan,Sabah,0,0,0
1/07/2020,Azerbaijan,Sarawak,0,0,0
1/07/2020,Azerbaijan,Selangor,1,1,0
1/07/2020,Azerbaijan,W.P. Labuan,0,0,0
1/07/2020,Burundi,Pulau Pinang,0,0,0
1/07/2020,Burundi,Sarawak,0,0,0
1/07/2020,Burundi,Selangor,0,0,0
1/07/2020,Belgium,Johor,0,0,0
1/07/2020,Belgium,Kedah,0,0,0
1/07/2020,Belgium,Kelantan,0,0,0
1/07/2020,Belgium,Melaka,0,0,0
1/07/2020,Belgium,Negeri Sembilan,0,0,0
1/07/2020,Belgium,Pahang,0,0,0
1/07/2020,Belgium,Perak,0,0,0
1/07/2020,Belgium,Perlis,0,0,0
1/07/2020,Belgium,Pulau Pinang,0,0,0
1/07/2020,Belgium,Sabah,0,0,0
1/07/2020,Belgium,Sarawak,0,0,0
1/07/2020,Belgium,Selangor,12,10,2
1/07/2020,Belgium,W.P. Labuan,0,0,0
1/07/2020,Benin,Johor,0,0,0
1/07/2020,Benin,Kedah,0,0,0
1/07/2020,Benin,Perak,0,0,0
1/07/2020,Benin,Pulau Pinang,0,0,0
1/07/2020,Benin,Sabah,0,0,0
1/07/2020,Benin,Sarawak,0,0,0
1/07/2020,Benin,Selangor,0,0,0
1/07/2020,Burkina Faso,Perak,0,0,0
1/07/2020,Burkina Faso,Pulau Pinang,0,0,0
1/07/2020,Burkina Faso,Selangor,0,0,0
1/07/2020,Bangladesh,Johor,2,2,0
1/07/2020,Bangladesh,Kedah,0,0,0
1/07/2020,Bangladesh,Kelantan,0,0,0
1/07/2020,Bangladesh,Melaka,0,0,0
1/07/2020,Bangladesh,Negeri Sembilan,0,0,0
1/07/2020,Bangladesh,Pahang,0,0,0
1/07/2020,Bangladesh,Perak,0,0,0
1/07/2020,Bangladesh,Perlis,0,0,0
1/07/2020,Bangladesh,Pulau Pinang,0,0,0
1/07/2020,Bangladesh,Sabah,0,0,0
1/07/2020,Bangladesh,Sarawak,0,0,0
1/07/2020,Bangladesh,Selangor,106,70,36
1/07/2020,Bangladesh,W.P. Labuan,0,0,0
1/07/2020,Bulgaria,Johor,1,1,0
1/07/2020,Bulgaria,Kedah,0,0,0
1/07/2020,Bulgaria,Kelantan,0,0,0
1/07/2020,Bulgaria,Pahang,0,0,0
1/07/2020,Bulgaria,Perak,0,0,0
1/07/2020,Bulgaria,Perlis,0,0,0
1/07/2020,Bulgaria,Pulau Pinang,0,0,0
1/07/2020,Bulgaria,Sabah,0,0,0
1/07/2020,Bulgaria,Sarawak,0,0,0
1/07/2020,Bulgaria,Selangor,24,24,0
1/07/2020,Bulgaria,W.P. Labuan,0,0,0
1/07/2020,Bahrain,Johor,0,0,0
1/07/2020,Bahrain,Kedah,0,0,0
1/07/2020,Bahrain,Kelantan,0,0,0
1/07/2020,Bahrain,Perlis,0,0,0
1/07/2020,Bahrain,Pulau Pinang,0,0,0
1/07/2020,Bahrain,Sabah,0,0,0
1/07/2020,Bahrain,Sarawak,0,0,0
1/07/2020,Bahrain,Selangor,0,0,0
1/07/2020,Bahamas,Johor,0,0,0
1/07/2020,Bahamas,Kedah,0,0,0
1/07/2020,Bahamas,Perak,0,0,0
1/07/2020,Bahamas,Sabah,0,0,0
1/07/2020,Bahamas,Sarawak,0,0,0
1/07/2020,Bahamas,Selangor,0,0,0
1/07/2020,Bosnia and Herzegovina,Johor,0,0,0
1/07/2020,Bosnia and Herzegovina,Kedah,0,0,0
1/07/2020,Bosnia and Herzegovina,Perlis,0,0,0
1/07/2020,Bosnia and Herzegovina,Pulau Pinang,0,0,0
1/07/2020,Bosnia and Herzegovina,Sabah,0,0,0
1/07/2020,Bosnia and Herzegovina,Sarawak,0,0,0
1/07/2020,Bosnia and Herzegovina,Selangor,1,1,0
1/07/2020,Belarus,Johor,0,0,0
1/07/2020,Belarus,Kedah,0,0,0
1/07/2020,Belarus,Kelantan,0,0,0
1/07/2020,Belarus,Pahang,0,0,0
1/07/2020,Belarus,Perak,0,0,0
1/07/2020,Belarus,Perlis,0,0,0
1/07/2020,Belarus,Pulau Pinang,0,0,0
1/07/2020,Belarus,Sabah,0,0,0
1/07/2020,Belarus,Sarawak,0,0,0
1/07/2020,Belarus,Selangor,1,1,0
1/07/2020,Belarus,W.P. Labuan,0,0,0
1/07/2020,Belize,Johor,0,0,0
1/07/2020,Belize,Pulau Pinang,0,0,0
1/07/2020,Belize,Sarawak,0,0,0
1/07/2020,Belize,Selangor,0,0,0
1/07/2020,Bermuda,Selangor,0,0,0
1/07/2020,Bolivia,Johor,0,0,0
1/07/2020,Bolivia,Kedah,0,0,0
1/07/2020,Bolivia,Melaka,0,0,0
1/07/2020,Bolivia,Perak,0,0,0
1/07/2020,Bolivia,Perlis,0,0,0
1/07/2020,Bolivia,Pulau Pinang,0,0,0
1/07/2020,Bolivia,Sabah,0,0,0
1/07/2020,Bolivia,Sarawak,0,0,0
1/07/2020,Bolivia,Selangor,0,0,0
1/07/2020,Brazil,Johor,0,0,0
1/07/2020,Brazil,Kedah,0,0,0
1/07/2020,Brazil,Kelantan,0,0,0
1/07/2020,Brazil,Melaka,0,0,0
1/07/2020,Brazil,Pahang,0,0,0
1/07/2020,Brazil,Perak,0,0,0
1/07/2020,Brazil,Perlis,0,0,0
1/07/2020,Brazil,Pulau Pinang,0,0,0
1/07/2020,Brazil,Sabah,0,0,0
1/07/2020,Brazil,Sarawak,0,0,0
1/07/2020,Brazil,Selangor,16,13,3
1/07/2020,Brazil,W.P. Labuan,0,0,0
1/07/2020,Barbados,Johor,0,0,0
1/07/2020,Barbados,Kedah,0,0,0
1/07/2020,Barbados,Perlis,0,0,0
1/07/2020,Barbados,Pulau Pinang,0,0,0
1/07/2020,Barbados,Selangor,1,0,1
1/07/2020,Brunei Darussalam,Johor,0,0,0
1/07/2020,Brunei Darussalam,Kedah,0,0,0
1/07/2020,Brunei Darussalam,Kelantan,0,0,0
1/07/2020,Brunei Darussalam,Melaka,0,0,0
1/07/2020,Brunei Darussalam,Pahang,0,0,0
1/07/2020,Brunei Darussalam,Perak,0,0,0
1/07/2020,Brunei Darussalam,Perlis,0,0,0
1/07/2020,Brunei Darussalam,Pulau Pinang,0,0,0
1/07/2020,Brunei Darussalam,Sabah,0,0,0
1/07/2020,Brunei Darussalam,Sarawak,339,315,24
1/07/2020,Brunei Darussalam,Selangor,10,1,9
1/07/2020,Brunei Darussalam,W.P. Labuan,1,0,1
1/07/2020,Bhutan,Johor,0,0,0
1/07/2020,Bhutan,Kedah,0,0,0
1/07/2020,Bhutan,Perak,0,0,0
1/07/2020,Bhutan,Perlis,0,0,0
1/07/2020,Bhutan,Pulau Pinang,0,0,0
1/07/2020,Bhutan,Sabah,0,0,0
1/07/2020,Bhutan,Sarawak,0,0,0
1/07/2020,Bhutan,Selangor,0,0,0
1/07/2020,Botswana,Johor,0,0,0
1/07/2020,Botswana,Kedah,0,0,0
1/07/2020,Botswana,Perlis,0,0,0
1/07/2020,Botswana,Pulau Pinang,0,0,0
1/07/2020,Botswana,Sabah,0,0,0
1/07/2020,Botswana,Sarawak,0,0,0
1/07/2020,Botswana,Selangor,0,0,0
1/07/2020,Central African Republic,Kedah,0,0,0
1/07/2020,Central African Republic,Selangor,0,0,0
1/07/2020,Canada,Johor,0,0,0
1/07/2020,Canada,Kedah,0,0,0
1/07/2020,Canada,Kelantan,0,0,0
1/07/2020,Canada,Melaka,0,0,0
1/07/2020,Canada,Negeri Sembilan,0,0,0
1/07/2020,Canada,Pahang,0,0,0
1/07/2020,Canada,Perak,0,0,0
1/07/2020,Canada,Perlis,0,0,0
1/07/2020,Canada,Pulau Pinang,0,0,0
1/07/2020,Canada,Sabah,0,0,0
1/07/2020,Canada,Sarawak,0,0,0
1/07/2020,Canada,Selangor,37,27,10
1/07/2020,Canada,Terengganu,0,0,0
1/07/2020,Canada,W.P. Labuan,0,0,0
1/07/2020,Cocos (Keeling) Islands,Selangor,0,0,0
1/07/2020,Switzerland,Johor,0,0,0
1/07/2020,Switzerland,Kedah,0,0,0
1/07/2020,Switzerland,Kelantan,0,0,0
1/07/2020,Switzerland,Melaka,0,0,0
1/07/2020,Switzerland,Negeri Sembilan,0,0,0
1/07/2020,Switzerland,Pahang,0,0,0
1/07/2020,Switzerland,Perak,0,0,0
1/07/2020,Switzerland,Perlis,0,0,0
1/07/2020,Switzerland,Pulau Pinang,0,0,0
1/07/2020,Switzerland,Sabah,0,0,0
1/07/2020,Switzerland,Sarawak,0,0,0
1/07/2020,Switzerland,Selangor,18,14,4
1/07/2020,Switzerland,W.P. Labuan,0,0,0
1/07/2020,Chile,Johor,0,0,0
1/07/2020,Chile,Kedah,0,0,0
1/07/2020,Chile,Kelantan,0,0,0
1/07/2020,Chile,Melaka,0,0,0
1/07/2020,Chile,Pahang,0,0,0
1/07/2020,Chile,Perak,0,0,0
1/07/2020,Chile,Perlis,0,0,0
1/07/2020,Chile,Pulau Pinang,0,0,0
1/07/2020,Chile,Sabah,0,0,0
1/07/2020,Chile,Sarawak,0,0,0
1/07/2020,Chile,Selangor,0,0,0
1/07/2020,China,Johor,11,3,8
1/07/2020,China,Kedah,0,0,0
1/07/2020,China,Kelantan,0,0,0
1/07/2020,China,Melaka,0,0,0
1/07/2020,China,Pahang,0,0,0
1/07/2020,China,Perak,0,0,0
1/07/2020,China,Perlis,0,0,0
1/07/2020,China,Pulau Pinang,0,0,0
1/07/2020,China,Sabah,2,1,1
1/07/2020,China,Sarawak,5,0,5
1/07/2020,China,Selangor,485,326,159
1/07/2020,China,Terengganu,0,0,0
1/07/2020,China,W.P. Labuan,2,0,2
1/07/2020,Côte d'Ivoire,Johor,0,0,0
1/07/2020,Côte d'Ivoire,Kedah,0,0,0
1/07/2020,Côte d'Ivoire,Pulau Pinang,0,0,0
1/07/2020,Côte d'Ivoire,Sabah,0,0,0
1/07/2020,Côte d'Ivoire,Sarawak,0,0,0
1/07/2020,Côte d'Ivoire,Selangor,0,0,0
1/07/2020,Cameroon,Johor,0,0,0
1/07/2020,Cameroon,Kedah,0,0,0
1/07/2020,Cameroon,Pulau Pinang,0,0,0
1/07/2020,Cameroon,Sabah,0,0,0
1/07/2020,Cameroon,Sarawak,0,0,0
1/07/2020,Cameroon,Selangor,0,0,0
1/07/2020,Congo,Johor,0,0,0
1/07/2020,Congo,Pulau Pinang,0,0,0
1/07/2020,Congo,Sarawak,0,0,0
1/07/2020,Congo,Selangor,0,0,0
1/07/2020,Congo,Johor,0,0,0
1/07/2020,Congo,Kedah,0,0,0
1/07/2020,Congo,Selangor,0,0,0
1/07/2020,Cook Islands,Selangor,0,0,0
1/07/2020,Colombia,Johor,0,0,0
1/07/2020,Colombia,Kedah,0,0,0
1/07/2020,Colombia,Perak,0,0,0
1/07/2020,Colombia,Pulau Pinang,0,0,0
1/07/2020,Colombia,Sabah,0,0,0
1/07/2020,Colombia,Sarawak,0,0,0
1/07/2020,Colombia,Selangor,3,1,2
1/07/2020,Colombia,W.P. Labuan,0,0,0
1/07/2020,Comoros,Johor,0,0,0
1/07/2020,Comoros,Kedah,0,0,0
1/07/2020,Comoros,Selangor,0,0,0
1/07/2020,Cabo Verde,Johor,0,0,0
1/07/2020,Cabo Verde,Kedah,0,0,0
1/07/2020,Cabo Verde,Pulau Pinang,0,0,0
1/07/2020,Cabo Verde,Sabah,0,0,0
1/07/2020,Cabo Verde,Selangor,0,0,0
1/07/2020,Costa Rica,Johor,0,0,0
1/07/2020,Costa Rica,Kedah,0,0,0
1/07/2020,Costa Rica,Perak,0,0,0
1/07/2020,Costa Rica,Perlis,0,0,0
1/07/2020,Costa Rica,Pulau Pinang,0,0,0
1/07/2020,Costa Rica,Sabah,0,0,0
1/07/2020,Costa Rica,Sarawak,0,0,0
1/07/2020,Costa Rica,Selangor,0,0,0
1/07/2020,Cuba,Johor,0,0,0
1/07/2020,Cuba,Kedah,0,0,0
1/07/2020,Cuba,Perlis,0,0,0
1/07/2020,Cuba,Pulau Pinang,0,0,0
1/07/2020,Cuba,Sabah,0,0,0
1/07/2020,Cuba,Sarawak,0,0,0
1/07/2020,Cuba,Selangor,0,0,0
1/07/2020,Cyprus,Johor,0,0,0
1/07/2020,Cyprus,Kedah,0,0,0
1/07/2020,Cyprus,Perak,0,0,0
1/07/2020,Cyprus,Perlis,0,0,0
1/07/2020,Cyprus,Pulau Pinang,0,0,0
1/07/2020,Cyprus,Sabah,0,0,0
1/07/2020,Cyprus,Sarawak,0,0,0
1/07/2020,Cyprus,Selangor,2,2,0
1/07/2020,Czechia,Johor,0,0,0
1/07/2020,Czechia,Kedah,0,0,0
1/07/2020,Czechia,Kelantan,0,0,0
1/07/2020,Czechia,Melaka,0,0,0
1/07/2020,Czechia,Negeri Sembilan,0,0,0
1/07/2020,Czechia,Perak,0,0,0
1/07/2020,Czechia,Perlis,0,0,0
1/07/2020,Czechia,Pulau Pinang,0,0,0
1/07/2020,Czechia,Sabah,0,0,0
1/07/2020,Czechia,Sarawak,0,0,0
1/07/2020,Czechia,Selangor,7,5,2
1/07/2020,Czechia,W.P. Labuan,0,0,0
1/07/2020,Germany,Johor,0,0,0
1/07/2020,Germany,Kedah,0,0,0
1/07/2020,Germany,Kelantan,0,0,0
1/07/2020,Germany,Melaka,0,0,0
1/07/2020,Germany,Negeri Sembilan,0,0,0
1/07/2020,Germany,Pahang,0,0,0
1/07/2020,Germany,Perak,0,0,0
1/07/2020,Germany,Perlis,0,0,0
1/07/2020,Germany,Pulau Pinang,0,0,0
1/07/2020,Germany,Sabah,2,0,2
1/07/2020,Germany,Sarawak,0,0,0
1/07/2020,Germany,Selangor,115,75,40
1/07/2020,Germany,Terengganu,0,0,0
1/07/2020,Germany,W.P. Labuan,0,0,0
1/07/2020,Djibouti,Johor,0,0,0
1/07/2020,Djibouti,Selangor,0,0,0
1/07/2020,Dominica,Johor,0,0,0
1/07/2020,Dominica,Kedah,0,0,0
1/07/2020,Dominica,Pulau Pinang,0,0,0
1/07/2020,Dominica,Sabah,0,0,0
1/07/2020,Dominica,Sarawak,0,0,0
1/07/2020,Dominica,Selangor,0,0,0
1/07/2020,Dominica,W.P. Labuan,0,0,0
1/07/2020,Denmark,Johor,0,0,0
1/07/2020,Denmark,Kedah,0,0,0
1/07/2020,Denmark,Kelantan,0,0,0
1/07/2020,Denmark,Melaka,0,0,0
1/07/2020,Denmark,Negeri Sembilan,0,0,0
1/07/2020,Denmark,Pahang,0,0,0
1/07/2020,Denmark,Perak,0,0,0
1/07/2020,Denmark,Perlis,0,0,0
1/07/2020,Denmark,Pulau Pinang,0,0,0
1/07/2020,Denmark,Sabah,0,0,0
1/07/2020,Denmark,Sarawak,0,0,0
1/07/2020,Denmark,Selangor,35,30,5
1/07/2020,Denmark,W.P. Labuan,0,0,0
1/07/2020,Dominican Republic,Johor,0,0,0
1/07/2020,Dominican Republic,Kedah,0,0,0
1/07/2020,Dominican Republic,Perak,0,0,0
1/07/2020,Dominican Republic,Perlis,0,0,0
1/07/2020,Dominican Republic,Pulau Pinang,0,0,0
1/07/2020,Dominican Republic,Sabah,0,0,0
1/07/2020,Dominican Republic,Sarawak,0,0,0
1/07/2020,Dominican Republic,Selangor,1,1,0
1/07/2020,Algeria,Johor,0,0,0
1/07/2020,Algeria,Kedah,0,0,0
1/07/2020,Algeria,Kelantan,0,0,0
1/07/2020,Algeria,Melaka,0,0,0
1/07/2020,Algeria,Perak,0,0,0
1/07/2020,Algeria,Perlis,0,0,0
1/07/2020,Algeria,Pulau Pinang,0,0,0
1/07/2020,Algeria,Sabah,0,0,0
1/07/2020,Algeria,Sarawak,0,0,0
1/07/2020,Algeria,Selangor,4,2,2
1/07/2020,Algeria,W.P. Labuan,0,0,0
1/07/2020,Ecuador,Johor,0,0,0
1/07/2020,Ecuador,Kedah,0,0,0
1/07/2020,Ecuador,Perak,0,0,0
1/07/2020,Ecuador,Perlis,0,0,0
1/07/2020,Ecuador,Pulau Pinang,0,0,0
1/07/2020,Ecuador,Sabah,0,0,0
1/07/2020,Ecuador,Sarawak,0,0,0
1/07/2020,Ecuador,Selangor,1,0,1
1/07/2020,Egypt,Johor,0,0,0
1/07/2020,Egypt,Kedah,0,0,0
1/07/2020,Egypt,Kelantan,0,0,0
1/07/2020,Egypt,Melaka,0,0,0
1/07/2020,Egypt,Pahang,0,0,0
1/07/2020,Egypt,Perak,0,0,0
1/07/2020,Egypt,Perlis,0,0,0
1/07/2020,Egypt,Pulau Pinang,0,0,0
1/07/2020,Egypt,Sabah,0,0,0
1/07/2020,Egypt,Sarawak,0,0,0
1/07/2020,Egypt,Selangor,27,18,9
1/07/2020,Egypt,Terengganu,0,0,0
1/07/2020,Egypt,W.P. Labuan,0,0,0
1/07/2020,Eritrea,Johor,0,0,0
1/07/2020,Eritrea,Pulau Pinang,0,0,0
1/07/2020,Eritrea,Sabah,0,0,0
1/07/2020,Eritrea,Selangor,0,0,0
1/07/2020,Spain,Johor,0,0,0
1/07/2020,Spain,Kedah,0,0,0
1/07/2020,Spain,Kelantan,0,0,0
1/07/2020,Spain,Melaka,0,0,0
1/07/2020,Spain,Negeri Sembilan,0,0,0
1/07/2020,Spain,Pahang,0,0,0
1/07/2020,Spain,Perak,0,0,0
1/07/2020,Spain,Perlis,0,0,0
1/07/2020,Spain,Pulau Pinang,0,0,0
1/07/2020,Spain,Sabah,0,0,0
1/07/2020,Spain,Sarawak,0,0,0
1/07/2020,Spain,Selangor,22,18,4
1/07/2020,Spain,W.P. Labuan,0,0,0
1/07/2020,Estonia,Johor,0,0,0
1/07/2020,Estonia,Kedah,0,0,0
1/07/2020,Estonia,Kelantan,0,0,0
1/07/2020,Estonia,Pahang,0,0,0
1/07/2020,Estonia,Perak,0,0,0
1/07/2020,Estonia,Perlis,0,0,0
1/07/2020,Estonia,Pulau Pinang,1,1,0
1/07/2020,Estonia,Sabah,0,0,0
1/07/2020,Estonia,Sarawak,0,0,0
1/07/2020,Estonia,Selangor,5,5,0
1/07/2020,Estonia,W.P. Labuan,0,0,0
1/07/2020,Ethiopia,Johor,0,0,0
1/07/2020,Ethiopia,Kedah,0,0,0
1/07/2020,Ethiopia,Pulau Pinang,0,0,0
1/07/2020,Ethiopia,Sarawak,0,0,0
1/07/2020,Ethiopia,Selangor,3,3,0
1/07/2020,Finland,Johor,0,0,0
1/07/2020,Finland,Kedah,0,0,0
1/07/2020,Finland,Kelantan,0,0,0
1/07/2020,Finland,Melaka,0,0,0
1/07/2020,Finland,Negeri Sembilan,0,0,0
1/07/2020,Finland,Pahang,0,0,0
1/07/2020,Finland,Perak,0,0,0
1/07/2020,Finland,Perlis,0,0,0
1/07/2020,Finland,Pulau Pinang,0,0,0
1/07/2020,Finland,Sabah,0,0,0
1/07/2020,Finland,Sarawak,0,0,0
1/07/2020,Finland,Selangor,8,6,2
1/07/2020,Finland,W.P. Labuan,0,0,0
1/07/2020,Fiji,Johor,0,0,0
1/07/2020,Fiji,Kedah,0,0,0
1/07/2020,Fiji,Kelantan,0,0,0
1/07/2020,Fiji,Perak,0,0,0
1/07/2020,Fiji,Perlis,0,0,0
1/07/2020,Fiji,Pulau Pinang,0,0,0
1/07/2020,Fiji,Sabah,0,0,0
1/07/2020,Fiji,Sarawak,0,0,0
1/07/2020,Fiji,Selangor,0,0,0
1/07/2020,France,Johor,1,1,0
1/07/2020,France,Kedah,1,1,0
1/07/2020,France,Kelantan,0,0,0
1/07/2020,France,Melaka,0,0,0
1/07/2020,France,Negeri Sembilan,0,0,0
1/07/2020,France,Pahang,0,0,0
1/07/2020,France,Perak,0,0,0
1/07/2020,France,Perlis,0,0,0
1/07/2020,France,Pulau Pinang,0,0,0
1/07/2020,France,Sabah,0,0,0
1/07/2020,France,Sarawak,0,0,0
1/07/2020,France,Selangor,62,40,22
1/07/2020,France,Terengganu,0,0,0
1/07/2020,France,W.P. Labuan,0,0,0
1/07/2020,"Micronesia, Federated States of",Johor,0,0,0
1/07/2020,"Micronesia, Federated States of",Pulau Pinang,0,0,0
1/07/2020,"Micronesia, Federated States of",Selangor,0,0,0
1/07/2020,Gabon,Johor,0,0,0
1/07/2020,Gabon,Pulau Pinang,0,0,0
1/07/2020,Gabon,Sarawak,0,0,0
1/07/2020,Gabon,Selangor,0,0,0
1/07/2020,United Kingdom of Great Britain and Northern Ireland,Johor,1,1,0
1/07/2020,United Kingdom of Great Britain and Northern Ireland,Kedah,0,0,0
1/07/2020,United Kingdom of Great Britain and Northern Ireland,Kelantan,0,0,0
1/07/2020,United Kingdom of Great Britain and Northern Ireland,Melaka,0,0,0
1/07/2020,United Kingdom of Great Britain and Northern Ireland,Negeri Sembilan,0,0,0
1/07/2020,United Kingdom of Great Britain and Northern Ireland,Pahang,0,0,0
1/07/2020,United Kingdom of Great Britain and Northern Ireland,Perak,0,0,0
1/07/2020,United Kingdom of Great Britain and Northern Ireland,Perlis,0,0,0
1/07/2020,United Kingdom of Great Britain and Northern Ireland,Pulau Pinang,1,1,0
1/07/2020,United Kingdom of Great Britain and Northern Ireland,Sabah,2,2,0
1/07/2020,United Kingdom of Great Britain and Northern Ireland,Sarawak,2,2,0
1/07/2020,United Kingdom of Great Britain and Northern Ireland,Selangor,265,197,68
1/07/2020,United Kingdom of Great Britain and Northern Ireland,Terengganu,0,0,0
1/07/2020,United Kingdom of Great Britain and Northern Ireland,W.P. Labuan,0,0,0
1/07/2020,Georgia,Johor,0,0,0
1/07/2020,Georgia,Kedah,0,0,0
1/07/2020,Georgia,Melaka,0,0,0
1/07/2020,Georgia,Perak,0,0,0
1/07/2020,Georgia,Perlis,0,0,0
1/07/2020,Georgia,Pulau Pinang,0,0,0
1/07/2020,Georgia,Sabah,0,0,0
1/07/2020,Georgia,Sarawak,0,0,0
1/07/2020,Georgia,Selangor,30,30,0
1/07/2020,Ghana,Johor,0,0,0
1/07/2020,Ghana,Kedah,0,0,0
1/07/2020,Ghana,Kelantan,0,0,0
1/07/2020,Ghana,Pulau Pinang,0,0,0
1/07/2020,Ghana,Sabah,0,0,0
1/07/2020,Ghana,Sarawak,0,0,0
1/07/2020,Ghana,Selangor,0,0,0
1/07/2020,Gibraltar,Johor,0,0,0
1/07/2020,Gibraltar,Sarawak,0,0,0
1/07/2020,Guinea,Johor,0,0,0
1/07/2020,Guinea,Kedah,0,0,0
1/07/2020,Guinea,Kelantan,0,0,0
1/07/2020,Guinea,Perlis,0,0,0
1/07/2020,Guinea,Pulau Pinang,0,0,0
1/07/2020,Guinea,Sabah,0,0,0
1/07/2020,Guinea,Sarawak,0,0,0
1/07/2020,Guinea,Selangor,0,0,0
1/07/2020,Guadeloupe,Selangor,0,0,0
1/07/2020,Gambia,Johor,0,0,0
1/07/2020,Gambia,Kedah,0,0,0
1/07/2020,Gambia,Kelantan,0,0,0
1/07/2020,Gambia,Pulau Pinang,0,0,0
1/07/2020,Gambia,Sabah,0,0,0
1/07/2020,Gambia,Sarawak,0,0,0
1/07/2020,Gambia,Selangor,1,0,1
1/07/2020,Guinea-Bissau,Johor,0,0,0
1/07/2020,Guinea-Bissau,Selangor,0,0,0
1/07/2020,Equatorial Guinea,Johor,0,0,0
1/07/2020,Equatorial Guinea,Selangor,0,0,0
1/07/2020,Greece,Johor,4,4,0
1/07/2020,Greece,Kedah,0,0,0
1/07/2020,Greece,Kelantan,0,0,0
1/07/2020,Greece,Melaka,0,0,0
1/07/2020,Greece,Negeri Sembilan,0,0,0
1/07/2020,Greece,Pahang,0,0,0
1/07/2020,Greece,Perak,0,0,0
1/07/2020,Greece,Perlis,0,0,0
1/07/2020,Greece,Pulau Pinang,0,0,0
1/07/2020,Greece,Sabah,0,0,0
1/07/2020,Greece,Sarawak,0,0,0
1/07/2020,Greece,Selangor,31,28,3
1/07/2020,Grenada,Johor,0,0,0
1/07/2020,Grenada,Kedah,0,0,0
1/07/2020,Grenada,Pulau Pinang,0,0,0
1/07/2020,Grenada,Sabah,0,0,0
1/07/2020,Grenada,Sarawak,0,0,0
1/07/2020,Grenada,Selangor,0,0,0
1/07/2020,Greenland,Johor,0,0,0
1/07/2020,Greenland,Selangor,0,0,0
1/07/2020,Guatemala,Johor,0,0,0
1/07/2020,Guatemala,Kedah,0,0,0
1/07/2020,Guatemala,Pahang,0,0,0
1/07/2020,Guatemala,Perak,0,0,0
1/07/2020,Guatemala,Pulau Pinang,0,0,0
1/07/2020,Guatemala,Sabah,0,0,0
1/07/2020,Guatemala,Sarawak,0,0,0
1/07/2020,Guatemala,Selangor,0,0,0
1/07/2020,Guatemala,W.P. Labuan,0,0,0
1/07/2020,Guyana,Johor,0,0,0
1/07/2020,Guyana,Kedah,0,0,0
1/07/2020,Guyana,Pulau Pinang,0,0,0
1/07/2020,Guyana,Sarawak,0,0,0
1/07/2020,Guyana,Selangor,0,0,0
1/07/2020,Hong Kong,Johor,0,0,0
1/07/2020,Hong Kong,Kedah,0,0,0
1/07/2020,Hong Kong,Kelantan,0,0,0
1/07/2020,Hong Kong,Pahang,0,0,0
1/07/2020,Hong Kong,Perak,0,0,0
1/07/2020,Hong Kong,Perlis,0,0,0
1/07/2020,Hong Kong,Pulau Pinang,0,0,0
1/07/2020,Hong Kong,Sabah,0,0,0
1/07/2020,Hong Kong,Sarawak,7,6,1
1/07/2020,Hong Kong,Selangor,0,0,0
1/07/2020,Hong Kong,Terengganu,0,0,0
1/07/2020,Heard Island and McDonald Islands,Johor,0,0,0
1/07/2020,Honduras,Johor,0,0,0
1/07/2020,Honduras,Kedah,0,0,0
1/07/2020,Honduras,Perak,0,0,0
1/07/2020,Honduras,Pulau Pinang,0,0,0
1/07/2020,Honduras,Sabah,0,0,0
1/07/2020,Honduras,Sarawak,0,0,0
1/07/2020,Honduras,Selangor,2,2,0
1/07/2020,Croatia,Johor,7,7,0
1/07/2020,Croatia,Kedah,0,0,0
1/07/2020,Croatia,Kelantan,0,0,0
1/07/2020,Croatia,Melaka,0,0,0
1/07/2020,Croatia,Pahang,0,0,0
1/07/2020,Croatia,Perak,0,0,0
1/07/2020,Croatia,Perlis,0,0,0
1/07/2020,Croatia,Pulau Pinang,0,0,0
1/07/2020,Croatia,Sabah,0,0,0
1/07/2020,Croatia,Sarawak,0,0,0
1/07/2020,Croatia,Selangor,37,37,0
1/07/2020,Haiti,Johor,0,0,0
1/07/2020,Haiti,Kedah,0,0,0
1/07/2020,Haiti,Kelantan,0,0,0
1/07/2020,Haiti,Perak,0,0,0
1/07/2020,Haiti,Pulau Pinang,0,0,0
1/07/2020,Haiti,Sabah,0,0,0
1/07/2020,Haiti,Selangor,0,0,0
1/07/2020,Hungary,Johor,1,1,0
1/07/2020,Hungary,Kedah,0,0,0
1/07/2020,Hungary,Kelantan,0,0,0
1/07/2020,Hungary,Pahang,0,0,0
1/07/2020,Hungary,Perak,0,0,0
1/07/2020,Hungary,Perlis,0,0,0
1/07/2020,Hungary,Pulau Pinang,0,0,0
1/07/2020,Hungary,Sabah,0,0,0
1/07/2020,Hungary,Sarawak,0,0,0
1/07/2020,Hungary,Selangor,6,2,4
1/07/2020,Hungary,W.P. Labuan,0,0,0
1/07/2020,Indonesia,Johor,214,163,51
1/07/2020,Indonesia,Kedah,8,7,1
1/07/2020,Indonesia,Kelantan,0,0,0
1/07/2020,Indonesia,Melaka,0,0,0
1/07/2020,Indonesia,Negeri Sembilan,0,0,0
1/07/2020,Indonesia,Pahang,0,0,0
1/07/2020,Indonesia,Perak,0,0,0
1/07/2020,Indonesia,Perlis,1,1,0
1/07/2020,Indonesia,Pulau Pinang,14,2,12
1/07/2020,Indonesia,Sabah,56,20,36
1/07/2020,Indonesia,Sarawak,733,687,46
1/07/2020,Indonesia,Selangor,716,478,238
1/07/2020,Indonesia,Terengganu,0,0,0
1/07/2020,Indonesia,W.P. Labuan,0,0,0
1/07/2020,India,Johor,71,71,0
1/07/2020,India,Kedah,0,0,0
1/07/2020,India,Kelantan,0,0,0
1/07/2020,India,Melaka,0,0,0
1/07/2020,India,Negeri Sembilan,0,0,0
1/07/2020,India,Pahang,0,0,0
1/07/2020,India,Perak,0,0,0
1/07/2020,India,Perlis,0,0,0
1/07/2020,India,Pulau Pinang,0,0,0
1/07/2020,India,Sabah,0,0,0
1/07/2020,India,Sarawak,1,0,1
1/07/2020,India,Selangor,699,485,214
1/07/2020,India,Terengganu,0,0,0
1/07/2020,India,W.P. Labuan,0,0,0
1/07/2020, British Indian Ocean Territory,Pulau Pinang,0,0,0
1/07/2020, British Indian Ocean Territory,Selangor,0,0,0
1/07/2020,Ireland,Johor,2,2,0
1/07/2020,Ireland,Kedah,0,0,0
1/07/2020,Ireland,Kelantan,0,0,0
1/07/2020,Ireland,Negeri Sembilan,0,0,0
1/07/2020,Ireland,Pahang,0,0,0
1/07/2020,Ireland,Perak,0,0,0
1/07/2020,Ireland,Perlis,0,0,0
1/07/2020,Ireland,Pulau Pinang,0,0,0
1/07/2020,Ireland,Sabah,0,0,0
1/07/2020,Ireland,Sarawak,0,0,0
1/07/2020,Ireland,Selangor,14,9,5
1/07/2020,Ireland,Terengganu,0,0,0
1/07/2020,Ireland,W.P. Labuan,0,0,0
1/07/2020,"Iran, Islamic Republic of",Johor,0,0,0
1/07/2020,"Iran, Islamic Republic of",Kedah,0,0,0
1/07/2020,"Iran, Islamic Republic of",Kelantan,0,0,0
1/07/2020,"Iran, Islamic Republic of",Perak,0,0,0
1/07/2020,"Iran, Islamic Republic of",Perlis,0,0,0
1/07/2020,"Iran, Islamic Republic of",Pulau Pinang,0,0,0
1/07/2020,"Iran, Islamic Republic of",Sabah,0,0,0
1/07/2020,"Iran, Islamic Republic of",Sarawak,0,0,0
1/07/2020,"Iran, Islamic Republic of",Selangor,28,14,14
1/07/2020,"Iran, Islamic Republic of",W.P. Labuan,0,0,0
1/07/2020,Iraq,Johor,0,0,0
1/07/2020,Iraq,Kedah,0,0,0
1/07/2020,Iraq,Kelantan,0,0,0
1/07/2020,Iraq,Melaka,0,0,0
1/07/2020,Iraq,Pahang,0,0,0
1/07/2020,Iraq,Perak,0,0,0
1/07/2020,Iraq,Perlis,0,0,0
1/07/2020,Iraq,Pulau Pinang,0,0,0
1/07/2020,Iraq,Sabah,0,0,0
1/07/2020,Iraq,Sarawak,0,0,0
1/07/2020,Iraq,Selangor,7,6,1
1/07/2020,Iceland,Johor,0,0,0
1/07/2020,Iceland,Kedah,0,0,0
1/07/2020,Iceland,Kelantan,0,0,0
1/07/2020,Iceland,Perak,0,0,0
1/07/2020,Iceland,Perlis,0,0,0
1/07/2020,Iceland,Pulau Pinang,0,0,0
1/07/2020,Iceland,Sabah,0,0,0
1/07/2020,Iceland,Sarawak,0,0,0
1/07/2020,Iceland,Selangor,5,5,0
1/07/2020,Iceland,W.P. Labuan,0,0,0
1/07/2020,Israel,Pulau Pinang,0,0,0
1/07/2020,Italy,Johor,3,3,0
1/07/2020,Italy,Kedah,0,0,0
1/07/2020,Italy,Kelantan,0,0,0
1/07/2020,Italy,Melaka,0,0,0
1/07/2020,Italy,Negeri Sembilan,0,0,0
1/07/2020,Italy,Pahang,0,0,0
1/07/2020,Italy,Perak,0,0,0
1/07/2020,Italy,Perlis,0,0,0
1/07/2020,Italy,Pulau Pinang,0,0,0
1/07/2020,Italy,Sabah,0,0,0
1/07/2020,Italy,Sarawak,0,0,0
1/07/2020,Italy,Selangor,29,22,7
1/07/2020,Italy,W.P. Labuan,0,0,0
1/07/2020,Jamaica,Johor,0,0,0
1/07/2020,Jamaica,Kedah,0,0,0
1/07/2020,Jamaica,Perak,0,0,0
1/07/2020,Jamaica,Pulau Pinang,0,0,0
1/07/2020,Jamaica,Sabah,0,0,0
1/07/2020,Jamaica,Sarawak,0,0,0
1/07/2020,Jamaica,Selangor,0,0,0
1/07/2020,Jamaica,W.P. Labuan,0,0,0
1/07/2020,Jordan,Johor,0,0,0
1/07/2020,Jordan,Kedah,0,0,0
1/07/2020,Jordan,Kelantan,0,0,0
1/07/2020,Jordan,Melaka,0,0,0
1/07/2020,Jordan,Perlis,0,0,0
1/07/2020,Jordan,Pulau Pinang,0,0,0
1/07/2020,Jordan,Sabah,0,0,0
1/07/2020,Jordan,Sarawak,0,0,0
1/07/2020,Jordan,Selangor,0,0,0
1/07/2020,Jordan,W.P. Labuan,0,0,0
1/07/2020,Japan,Johor,0,0,0
1/07/2020,Japan,Kedah,0,0,0
1/07/2020,Japan,Kelantan,0,0,0
1/07/2020,Japan,Melaka,0,0,0
1/07/2020,Japan,Negeri Sembilan,0,0,0
1/07/2020,Japan,Pahang,0,0,0
1/07/2020,Japan,Perak,0,0,0
1/07/2020,Japan,Perlis,0,0,0
1/07/2020,Japan,Pulau Pinang,1,1,0
1/07/2020,Japan,Sabah,1,0,1
1/07/2020,Japan,Sarawak,1,1,0
1/07/2020,Japan,Selangor,439,307,132
1/07/2020,Japan,W.P. Labuan,0,0,0
1/07/2020,Kazakhstan,Johor,0,0,0
1/07/2020,Kazakhstan,Kedah,0,0,0
1/07/2020,Kazakhstan,Kelantan,0,0,0
1/07/2020,Kazakhstan,Melaka,0,0,0
1/07/2020,Kazakhstan,Perak,0,0,0
1/07/2020,Kazakhstan,Perlis,0,0,0
1/07/2020,Kazakhstan,Pulau Pinang,0,0,0
1/07/2020,Kazakhstan,Sabah,0,0,0
1/07/2020,Kazakhstan,Sarawak,0,0,0
1/07/2020,Kazakhstan,Selangor,17,10,7
1/07/2020,Kazakhstan,W.P. Labuan,0,0,0
1/07/2020,Kenya,Johor,0,0,0
1/07/2020,Kenya,Kedah,0,0,0
1/07/2020,Kenya,Kelantan,0,0,0
1/07/2020,Kenya,Perak,0,0,0
1/07/2020,Kenya,Perlis,0,0,0
1/07/2020,Kenya,Pulau Pinang,0,0,0
1/07/2020,Kenya,Sabah,0,0,0
1/07/2020,Kenya,Sarawak,0,0,0
1/07/2020,Kenya,Selangor,1,0,1
1/07/2020,Kyrgyzstan,Johor,0,0,0
1/07/2020,Kyrgyzstan,Kedah,0,0,0
1/07/2020,Kyrgyzstan,Kelantan,0,0,0
1/07/2020,Kyrgyzstan,Perak,0,0,0
1/07/2020,Kyrgyzstan,Perlis,0,0,0
1/07/2020,Kyrgyzstan,Pulau Pinang,0,0,0
1/07/2020,Kyrgyzstan,Sabah,0,0,0
1/07/2020,Kyrgyzstan,Sarawak,0,0,0
1/07/2020,Kyrgyzstan,Selangor,4,4,0
1/07/2020,Cambodia,Johor,0,0,0
1/07/2020,Cambodia,Kedah,0,0,0
1/07/2020,Cambodia,Kelantan,0,0,0
1/07/2020,Cambodia,Melaka,0,0,0
1/07/2020,Cambodia,Negeri Sembilan,0,0,0
1/07/2020,Cambodia,Pahang,0,0,0
1/07/2020,Cambodia,Perak,0,0,0
1/07/2020,Cambodia,Perlis,0,0,0
1/07/2020,Cambodia,Pulau Pinang,0,0,0
1/07/2020,Cambodia,Sabah,0,0,0
1/07/2020,Cambodia,Sarawak,0,0,0
1/07/2020,Cambodia,Selangor,15,2,13
1/07/2020,Cambodia,W.P. Labuan,0,0,0
1/07/2020,Kiribati,Johor,0,0,0
1/07/2020,Kiribati,Sabah,0,0,0
1/07/2020,Kiribati,Selangor,0,0,0
1/07/2020,Saint Kitts and Nevis,Johor,0,0,0
1/07/2020,Saint Kitts and Nevis,Kedah,0,0,0
1/07/2020,Saint Kitts and Nevis,Perlis,0,0,0
1/07/2020,Saint Kitts and Nevis,Pulau Pinang,0,0,0
1/07/2020,Saint Kitts and Nevis,Sabah,0,0,0
1/07/2020,Saint Kitts and Nevis,Selangor,0,0,0
1/07/2020,Saint Kitts and Nevis,W.P. Labuan,0,0,0
1/07/2020,"Korea, Republic of",Johor,1,0,1
1/07/2020,"Korea, Republic of",Kedah,0,0,0
1/07/2020,"Korea, Republic of",Kelantan,0,0,0
1/07/2020,"Korea, Republic of",Melaka,0,0,0
1/07/2020,"Korea, Republic of",Negeri Sembilan,0,0,0
1/07/2020,"Korea, Republic of",Pahang,0,0,0
1/07/2020,"Korea, Republic of",Perak,0,0,0
1/07/2020,"Korea, Republic of",Perlis,0,0,0
1/07/2020,"Korea, Republic of",Pulau Pinang,2,2,0
1/07/2020,"Korea, Republic of",Sabah,1,0,1
1/07/2020,"Korea, Republic of",Sarawak,3,0,3
1/07/2020,"Korea, Republic of",Selangor,228,153,75
1/07/2020,"Korea, Republic of",Terengganu,0,0,0
1/07/2020,"Korea, Republic of",W.P. Labuan,0,0,0
1/07/2020,Kuwait,Johor,0,0,0
1/07/2020,Kuwait,Kedah,0,0,0
1/07/2020,Kuwait,Kelantan,0,0,0
1/07/2020,Kuwait,Perak,0,0,0
1/07/2020,Kuwait,Perlis,0,0,0
1/07/2020,Kuwait,Pulau Pinang,0,0,0
1/07/2020,Kuwait,Sabah,0,0,0
1/07/2020,Kuwait,Sarawak,0,0,0
1/07/2020,Kuwait,Selangor,0,0,0
1/07/2020,Kuwait,W.P. Labuan,0,0,0
1/07/2020, Lao People's Democratic Republic,Johor,0,0,0
1/07/2020, Lao People's Democratic Republic,Kedah,1,0,1
1/07/2020, Lao People's Democratic Republic,Kelantan,0,0,0
1/07/2020, Lao People's Democratic Republic,Melaka,0,0,0
1/07/2020, Lao People's Democratic Republic,Perak,0,0,0
1/07/2020, Lao People's Democratic Republic,Perlis,0,0,0
1/07/2020, Lao People's Democratic Republic,Pulau Pinang,0,0,0
1/07/2020, Lao People's Democratic Republic,Sabah,0,0,0
1/07/2020, Lao People's Democratic Republic,Sarawak,0,0,0
1/07/2020, Lao People's Democratic Republic,Selangor,8,0,8
1/07/2020, Lao People's Democratic Republic,W.P. Labuan,0,0,0
1/07/2020,Lebanon,Johor,2,2,0
1/07/2020,Lebanon,Kedah,0,0,0
1/07/2020,Lebanon,Kelantan,0,0,0
1/07/2020,Lebanon,Pahang,0,0,0
1/07/2020,Lebanon,Perak,0,0,0
1/07/2020,Lebanon,Perlis,0,0,0
1/07/2020,Lebanon,Pulau Pinang,0,0,0
1/07/2020,Lebanon,Sabah,0,0,0
1/07/2020,Lebanon,Sarawak,0,0,0
1/07/2020,Lebanon,Selangor,1,1,0
1/07/2020,Lebanon,W.P. Labuan,0,0,0
1/07/2020,Liberia,Johor,0,0,0
1/07/2020,Liberia,Kedah,0,0,0
1/07/2020,Liberia,Sabah,0,0,0
1/07/2020,Liberia,Sarawak,0,0,0
1/07/2020,Liberia,Selangor,1,1,0
1/07/2020,Libya,Johor,0,0,0
1/07/2020,Libya,Kedah,0,0,0
1/07/2020,Libya,Perlis,0,0,0
1/07/2020,Libya,Pulau Pinang,0,0,0
1/07/2020,Libya,Sabah,0,0,0
1/07/2020,Libya,Sarawak,0,0,0
1/07/2020,Libya,Selangor,1,1,0
1/07/2020,Saint Lucia,Johor,0,0,0
1/07/2020,Saint Lucia,Kedah,0,0,0
1/07/2020,Saint Lucia,Pulau Pinang,0,0,0
1/07/2020,Saint Lucia,Sarawak,0,0,0
1/07/2020,Saint Lucia,Selangor,0,0,0
1/07/2020,Liechtenstein,Johor,0,0,0
1/07/2020,Liechtenstein,Kedah,0,0,0
1/07/2020,Liechtenstein,Perlis,0,0,0
1/07/2020,Liechtenstein,Pulau Pinang,0,0,0
1/07/2020,Liechtenstein,Sabah,0,0,0
1/07/2020,Liechtenstein,Sarawak,0,0,0
1/07/2020,Liechtenstein,Selangor,0,0,0
1/07/2020,LKA,Johor,3,3,0
1/07/2020,LKA,Kedah,0,0,0
1/07/2020,LKA,Kelantan,0,0,0
1/07/2020,LKA,Melaka,0,0,0
1/07/2020,LKA,Pahang,0,0,0
1/07/2020,LKA,Perak,0,0,0
1/07/2020,LKA,Perlis,0,0,0
1/07/2020,LKA,Pulau Pinang,0,0,0
1/07/2020,LKA,Sabah,1,0,1
1/07/2020,LKA,Sarawak,0,0,0
1/07/2020,LKA,Selangor,7,5,2
1/07/2020,LKA,W.P. Labuan,0,0,0
1/07/2020,Lesotho,Johor,0,0,0
1/07/2020,Lesotho,Kedah,0,0,0
1/07/2020,Lesotho,Pulau Pinang,0,0,0
1/07/2020,Lesotho,Sarawak,0,0,0
1/07/2020,Lesotho,Selangor,0,0,0
1/07/2020,Lithuania,Johor,0,0,0
1/07/2020,Lithuania,Kedah,0,0,0
1/07/2020,Lithuania,Kelantan,0,0,0
1/07/2020,Lithuania,Pahang,0,0,0
1/07/2020,Lithuania,Perak,0,0,0
1/07/2020,Lithuania,Perlis,0,0,0
1/07/2020,Lithuania,Pulau Pinang,0,0,0
1/07/2020,Lithuania,Sabah,0,0,0
1/07/2020,Lithuania,Sarawak,0,0,0
1/07/2020,Lithuania,Selangor,4,4,0
1/07/2020,Lithuania,W.P. Labuan,0,0,0
1/07/2020,Luxembourg,Johor,0,0,0
1/07/2020,Luxembourg,Kedah,0,0,0
1/07/2020,Luxembourg,Kelantan,0,0,0
1/07/2020,Luxembourg,Perak,0,0,0
1/07/2020,Luxembourg,Perlis,0,0,0
1/07/2020,Luxembourg,Pulau Pinang,0,0,0
1/07/2020,Luxembourg,Sabah,0,0,0
1/07/2020,Luxembourg,Sarawak,0,0,0
1/07/2020,Luxembourg,Selangor,0,0,0
1/07/2020,Latvia,Johor,0,0,0
1/07/2020,Latvia,Kedah,0,0,0
1/07/2020,Latvia,Kelantan,0,0,0
1/07/2020,Latvia,Pahang,0,0,0
1/07/2020,Latvia,Perak,0,0,0
1/07/2020,Latvia,Perlis,0,0,0
1/07/2020,Latvia,Pulau Pinang,0,0,0
1/07/2020,Latvia,Sabah,0,0,0
1/07/2020,Latvia,Sarawak,0,0,0
1/07/2020,Latvia,Selangor,7,7,0
1/07/2020,Latvia,W.P. Labuan,0,0,0
1/07/2020,Macao,Johor,0,0,0
1/07/2020,Macao,Pahang,0,0,0
1/07/2020,Macao,Perak,0,0,0
1/07/2020,Macao,Selangor,0,0,0
1/07/2020,Macao,W.P. Labuan,0,0,0
1/07/2020,Morocco,Johor,0,0,0
1/07/2020,Morocco,Kedah,0,0,0
1/07/2020,Morocco,Kelantan,0,0,0
1/07/2020,Morocco,Melaka,0,0,0
1/07/2020,Morocco,Pahang,0,0,0
1/07/2020,Morocco,Perak,0,0,0
1/07/2020,Morocco,Perlis,0,0,0
1/07/2020,Morocco,Pulau Pinang,0,0,0
1/07/2020,Morocco,Sabah,0,0,0
1/07/2020,Morocco,Sarawak,1,1,0
1/07/2020,Morocco,Selangor,4,2,2
1/07/2020,Morocco,W.P. Labuan,0,0,0
1/07/2020,Monaco,Johor,0,0,0
1/07/2020,Monaco,Kedah,0,0,0
1/07/2020,Monaco,Sabah,0,0,0
1/07/2020,Monaco,Selangor,0,0,0
1/07/2020,"Moldova, Republic of",Johor,0,0,0
1/07/2020,"Moldova, Republic of",Kedah,0,0,0
1/07/2020,"Moldova, Republic of",Kelantan,0,0,0
1/07/2020,"Moldova, Republic of",Negeri Sembilan,0,0,0
1/07/2020,"Moldova, Republic of",Perlis,0,0,0
1/07/2020,"Moldova, Republic of",Pulau Pinang,0,0,0
1/07/2020,"Moldova, Republic of",Sabah,0,0,0
1/07/2020,"Moldova, Republic of",Sarawak,0,0,0
1/07/2020,"Moldova, Republic of",Selangor,2,2,0
1/07/2020,Madagascar,Johor,0,0,0
1/07/2020,Madagascar,Kedah,0,0,0
1/07/2020,Madagascar,Perak,0,0,0
1/07/2020,Madagascar,Perlis,0,0,0
1/07/2020,Madagascar,Pulau Pinang,0,0,0
1/07/2020,Madagascar,Sabah,0,0,0
1/07/2020,Madagascar,Sarawak,0,0,0
1/07/2020,Madagascar,Selangor,3,1,2
1/07/2020,Maldives,Johor,0,0,0
1/07/2020,Maldives,Kedah,0,0,0
1/07/2020,Maldives,Kelantan,0,0,0
1/07/2020,Maldives,Perak,0,0,0
1/07/2020,Maldives,Perlis,0,0,0
1/07/2020,Maldives,Pulau Pinang,0,0,0
1/07/2020,Maldives,Sabah,0,0,0
1/07/2020,Maldives,Sarawak,0,0,0
1/07/2020,Maldives,Selangor,1,0,1
1/07/2020,Mexico,Johor,0,0,0
1/07/2020,Mexico,Kedah,0,0,0
1/07/2020,Mexico,Kelantan,0,0,0
1/07/2020,Mexico,Pahang,0,0,0
1/07/2020,Mexico,Perak,0,0,0
1/07/2020,Mexico,Perlis,0,0,0
1/07/2020,Mexico,Pulau Pinang,0,0,0
1/07/2020,Mexico,Sabah,0,0,0
1/07/2020,Mexico,Sarawak,0,0,0
1/07/2020,Mexico,Selangor,10,9,1
1/07/2020,Mexico,W.P. Labuan,0,0,0
1/07/2020,Marshall Islands,Johor,0,0,0
1/07/2020,Marshall Islands,Kedah,0,0,0
1/07/2020,Marshall Islands,Perak,0,0,0
1/07/2020,Marshall Islands,Pulau Pinang,0,0,0
1/07/2020,Marshall Islands,Sabah,0,0,0
1/07/2020,Marshall Islands,Selangor,0,0,0
1/07/2020,North Macedonia,Johor,0,0,0
1/07/2020,North Macedonia,Kedah,0,0,0
1/07/2020,North Macedonia,Perak,0,0,0
1/07/2020,North Macedonia,Pulau Pinang,0,0,0
1/07/2020,North Macedonia,Sabah,0,0,0
1/07/2020,North Macedonia,Sarawak,0,0,0
1/07/2020,North Macedonia,Selangor,0,0,0
1/07/2020,Mali,Johor,0,0,0
1/07/2020,Mali,Sabah,0,0,0
1/07/2020,Mali,Selangor,0,0,0
1/07/2020,Malta,Johor,0,0,0
1/07/2020,Malta,Kedah,0,0,0
1/07/2020,Malta,Kelantan,0,0,0
1/07/2020,Malta,Perak,0,0,0
1/07/2020,Malta,Perlis,0,0,0
1/07/2020,Malta,Pulau Pinang,0,0,0
1/07/2020,Malta,Sabah,0,0,0
1/07/2020,Malta,Sarawak,0,0,0
1/07/2020,Malta,Selangor,0,0,0
1/07/2020,Malta,W.P. Labuan,0,0,0
1/07/2020,Myanmar,Johor,0,0,0
1/07/2020,Myanmar,Kedah,0,0,0
1/07/2020,Myanmar,Kelantan,0,0,0
1/07/2020,Myanmar,Negeri Sembilan,0,0,0
1/07/2020,Myanmar,Pahang,0,0,0
1/07/2020,Myanmar,Perak,0,0,0
1/07/2020,Myanmar,Perlis,0,0,0
1/07/2020,Myanmar,Pulau Pinang,0,0,0
1/07/2020,Myanmar,Sabah,0,0,0
1/07/2020,Myanmar,Sarawak,0,0,0
1/07/2020,Myanmar,Selangor,13,4,9
1/07/2020,Myanmar,Terengganu,0,0,0
1/07/2020,Myanmar,W.P. Labuan,0,0,0
1/07/2020,Montenegro,Johor,4,4,0
1/07/2020,Montenegro,Kedah,0,0,0
1/07/2020,Montenegro,Pulau Pinang,0,0,0
1/07/2020,Montenegro,Sabah,0,0,0
1/07/2020,Montenegro,Sarawak,0,0,0
1/07/2020,Montenegro,Selangor,6,6,0
1/07/2020,Mongolia,Johor,0,0,0
1/07/2020,Mongolia,Kedah,0,0,0
1/07/2020,Mongolia,Kelantan,0,0,0
1/07/2020,Mongolia,Perak,0,0,0
1/07/2020,Mongolia,Perlis,0,0,0
1/07/2020,Mongolia,Pulau Pinang,0,0,0
1/07/2020,Mongolia,Sabah,0,0,0
1/07/2020,Mongolia,Sarawak,0,0,0
1/07/2020,Mongolia,Selangor,0,0,0
1/07/2020,Northern Mariana Islands,Selangor,0,0,0
1/07/2020,Mozambique,Johor,0,0,0
1/07/2020,Mozambique,Kedah,0,0,0
1/07/2020,Mozambique,Perak,0,0,0
1/07/2020,Mozambique,Pulau Pinang,0,0,0
1/07/2020,Mozambique,Sabah,0,0,0
1/07/2020,Mozambique,Sarawak,0,0,0
1/07/2020,Mozambique,Selangor,0,0,0
1/07/2020,Mauritania,Johor,0,0,0
1/07/2020,Mauritania,Kedah,0,0,0
1/07/2020,Mauritania,Pulau Pinang,0,0,0
1/07/2020,Mauritania,Sabah,0,0,0
1/07/2020,Mauritania,Sarawak,0,0,0
1/07/2020,Mauritania,Selangor,0,0,0
1/07/2020,Mauritius,Johor,0,0,0
1/07/2020,Mauritius,Kedah,0,0,0
1/07/2020,Mauritius,Kelantan,0,0,0
1/07/2020,Mauritius,Pahang,0,0,0
1/07/2020,Mauritius,Perak,0,0,0
1/07/2020,Mauritius,Perlis,0,0,0
1/07/2020,Mauritius,Pulau Pinang,0,0,0
1/07/2020,Mauritius,Sabah,0,0,0
1/07/2020,Mauritius,Sarawak,0,0,0
1/07/2020,Mauritius,Selangor,1,1,0
1/07/2020,Malawi,Johor,0,0,0
1/07/2020,Malawi,Pulau Pinang,0,0,0
1/07/2020,Malawi,Sabah,0,0,0
1/07/2020,Malawi,Sarawak,0,0,0
1/07/2020,Malawi,Selangor,0,0,0
1/07/2020,Mayotte,Selangor,0,0,0
1/07/2020,Namibia,Johor,0,0,0
1/07/2020,Namibia,Kedah,0,0,0
1/07/2020,Namibia,Perak,0,0,0
1/07/2020,Namibia,Perlis,0,0,0
1/07/2020,Namibia,Pulau Pinang,0,0,0
1/07/2020,Namibia,Sabah,0,0,0
1/07/2020,Namibia,Sarawak,0,0,0
1/07/2020,Namibia,Selangor,0,0,0
1/07/2020,New Caledonia,Selangor,0,0,0
1/07/2020,Niger,Johor,0,0,0
1/07/2020,Niger,Sabah,0,0,0
1/07/2020,Niger,Selangor,0,0,0
1/07/2020,Nigeria,Johor,0,0,0
1/07/2020,Nigeria,Kedah,0,0,0
1/07/2020,Nigeria,Perlis,0,0,0
1/07/2020,Nigeria,Pulau Pinang,0,0,0
1/07/2020,Nigeria,Sabah,0,0,0
1/07/2020,Nigeria,Sarawak,1,1,0
1/07/2020,Nigeria,Selangor,18,14,4
1/07/2020,Nicaragua,Johor,0,0,0
1/07/2020,Nicaragua,Kedah,0,0,0
1/07/2020,Nicaragua,Pulau Pinang,0,0,0
1/07/2020,Nicaragua,Sabah,0,0,0
1/07/2020,Nicaragua,Selangor,0,0,0
1/07/2020,Netherlands,Johor,0,0,0
1/07/2020,Netherlands,Kedah,0,0,0
1/07/2020,Netherlands,Kelantan,0,0,0
1/07/2020,Netherlands,Melaka,0,0,0
1/07/2020,Netherlands,Negeri Sembilan,0,0,0
1/07/2020,Netherlands,Pahang,0,0,0
1/07/2020,Netherlands,Perak,0,0,0
1/07/2020,Netherlands,Perlis,0,0,0
1/07/2020,Netherlands,Pulau Pinang,0,0,0
1/07/2020,Netherlands,Sabah,0,0,0
1/07/2020,Netherlands,Sarawak,0,0,0
1/07/2020,Netherlands,Selangor,63,49,14
1/07/2020,Netherlands,Terengganu,0,0,0
1/07/2020,Netherlands,W.P. Labuan,0,0,0
1/07/2020,Norway,Johor,0,0,0
1/07/2020,Norway,Kedah,0,0,0
1/07/2020,Norway,Kelantan,0,0,0
1/07/2020,Norway,Melaka,0,0,0
1/07/2020,Norway,Pahang,0,0,0
1/07/2020,Norway,Perak,0,0,0
1/07/2020,Norway,Perlis,0,0,0
1/07/2020,Norway,Pulau Pinang,0,0,0
1/07/2020,Norway,Sabah,0,0,0
1/07/2020,Norway,Sarawak,0,0,0
1/07/2020,Norway,Selangor,15,12,3
1/07/2020,Norway,W.P. Labuan,0,0,0
1/07/2020,Nepal,Johor,0,0,0
1/07/2020,Nepal,Kedah,0,0,0
1/07/2020,Nepal,Pahang,0,0,0
1/07/2020,Nepal,Perak,0,0,0
1/07/2020,Nepal,Perlis,0,0,0
1/07/2020,Nepal,Pulau Pinang,0,0,0
1/07/2020,Nepal,Sabah,0,0,0
1/07/2020,Nepal,Sarawak,0,0,0
1/07/2020,Nepal,Selangor,8,8,0
1/07/2020,Nepal,W.P. Labuan,0,0,0
1/07/2020,Nauru,Johor,0,0,0
1/07/2020,Nauru,Pulau Pinang,0,0,0
1/07/2020,Nauru,Selangor,0,0,0
1/07/2020,New Zealand,Johor,0,0,0
1/07/2020,New Zealand,Kedah,3,2,1
1/07/2020,New Zealand,Kelantan,0,0,0
1/07/2020,New Zealand,Melaka,0,0,0
1/07/2020,New Zealand,Negeri Sembilan,0,0,0
1/07/2020,New Zealand,Pahang,0,0,0
1/07/2020,New Zealand,Perak,0,0,0
1/07/2020,New Zealand,Perlis,0,0,0
1/07/2020,New Zealand,Pulau Pinang,0,0,0
1/07/2020,New Zealand,Sabah,0,0,0
1/07/2020,New Zealand,Sarawak,0,0,0
1/07/2020,New Zealand,Selangor,30,18,12
1/07/2020,New Zealand,Terengganu,0,0,0
1/07/2020,New Zealand,W.P. Labuan,0,0,0
1/07/2020,Oman,Johor,0,0,0
1/07/2020,Oman,Kedah,0,0,0
1/07/2020,Oman,Kelantan,0,0,0
1/07/2020,Oman,Melaka,0,0,0
1/07/2020,Oman,Perak,0,0,0
1/07/2020,Oman,Perlis,0,0,0
1/07/2020,Oman,Pulau Pinang,0,0,0
1/07/2020,Oman,Sabah,0,0,0
1/07/2020,Oman,Sarawak,0,0,0
1/07/2020,Oman,Selangor,1,1,0
1/07/2020,Pakistan,Johor,3,3,0
1/07/2020,Pakistan,Kedah,0,0,0
1/07/2020,Pakistan,Kelantan,0,0,0
1/07/2020,Pakistan,Melaka,0,0,0
1/07/2020,Pakistan,Negeri Sembilan,0,0,0
1/07/2020,Pakistan,Pahang,0,0,0
1/07/2020,Pakistan,Perak,0,0,0
1/07/2020,Pakistan,Perlis,1,1,0
1/07/2020,Pakistan,Pulau Pinang,0,0,0
1/07/2020,Pakistan,Sabah,1,1,0
1/07/2020,Pakistan,Sarawak,1,1,0
1/07/2020,Pakistan,Selangor,282,228,54
1/07/2020,Pakistan,W.P. Labuan,0,0,0
1/07/2020,Panama,Johor,0,0,0
1/07/2020,Panama,Kedah,0,0,0
1/07/2020,Panama,Perak,0,0,0
1/07/2020,Panama,Perlis,0,0,0
1/07/2020,Panama,Pulau Pinang,0,0,0
1/07/2020,Panama,Sabah,0,0,0
1/07/2020,Panama,Sarawak,0,0,0
1/07/2020,Panama,Selangor,1,1,0
1/07/2020,Peru,Johor,0,0,0
1/07/2020,Peru,Kedah,0,0,0
1/07/2020,Peru,Kelantan,0,0,0
1/07/2020,Peru,Pahang,0,0,0
1/07/2020,Peru,Perak,0,0,0
1/07/2020,Peru,Perlis,0,0,0
1/07/2020,Peru,Pulau Pinang,0,0,0
1/07/2020,Peru,Sabah,0,0,0
1/07/2020,Peru,Sarawak,0,0,0
1/07/2020,Peru,Selangor,3,3,0
1/07/2020,Peru,W.P. Labuan,0,0,0
1/07/2020,Philippines,Johor,69,69,0
1/07/2020,Philippines,Kedah,1,0,1
1/07/2020,Philippines,Kelantan,0,0,0
1/07/2020,Philippines,Melaka,0,0,0
1/07/2020,Philippines,Negeri Sembilan,0,0,0
1/07/2020,Philippines,Pahang,0,0,0
1/07/2020,Philippines,Perak,0,0,0
1/07/2020,Philippines,Perlis,0,0,0
1/07/2020,Philippines,Pulau Pinang,0,0,0
1/07/2020,Philippines,Sabah,24,3,21
1/07/2020,Philippines,Sarawak,73,70,3
1/07/2020,Philippines,Selangor,255,212,43
1/07/2020,Philippines,Terengganu,0,0,0
1/07/2020,Philippines,W.P. Labuan,7,7,0
1/07/2020,Palau,Johor,0,0,0
1/07/2020,Palau,Pulau Pinang,0,0,0
1/07/2020,Palau,Selangor,0,0,0
1/07/2020,Papua New Guinea,Johor,0,0,0
1/07/2020,Papua New Guinea,Kedah,0,0,0
1/07/2020,Papua New Guinea,Kelantan,0,0,0
1/07/2020,Papua New Guinea,Perak,0,0,0
1/07/2020,Papua New Guinea,Pulau Pinang,0,0,0
1/07/2020,Papua New Guinea,Sabah,0,0,0
1/07/2020,Papua New Guinea,Sarawak,0,0,0
1/07/2020,Papua New Guinea,Selangor,0,0,0
1/07/2020,Poland,Johor,1,1,0
1/07/2020,Poland,Kedah,0,0,0
1/07/2020,Poland,Kelantan,0,0,0
1/07/2020,Poland,Melaka,0,0,0
1/07/2020,Poland,Negeri Sembilan,0,0,0
1/07/2020,Poland,Pahang,0,0,0
1/07/2020,Poland,Perak,0,0,0
1/07/2020,Poland,Perlis,0,0,0
1/07/2020,Poland,Pulau Pinang,0,0,0
1/07/2020,Poland,Sabah,0,0,0
1/07/2020,Poland,Sarawak,0,0,0
1/07/2020,Poland,Selangor,18,15,3
1/07/2020,Poland,Terengganu,0,0,0
1/07/2020,Poland,W.P. Labuan,0,0,0
1/07/2020,"North Korea, Democratic People's Republic of",Selangor,0,0,0
1/07/2020,Portugal,Johor,0,0,0
1/07/2020,Portugal,Kedah,0,0,0
1/07/2020,Portugal,Kelantan,0,0,0
1/07/2020,Portugal,Melaka,0,0,0
1/07/2020,Portugal,Pahang,0,0,0
1/07/2020,Portugal,Perak,0,0,0
1/07/2020,Portugal,Perlis,0,0,0
1/07/2020,Portugal,Pulau Pinang,0,0,0
1/07/2020,Portugal,Sabah,0,0,0
1/07/2020,Portugal,Sarawak,0,0,0
1/07/2020,Portugal,Selangor,2,2,0
1/07/2020,Portugal,W.P. Labuan,0,0,0
1/07/2020,Paraguay,Johor,0,0,0
1/07/2020,Paraguay,Kedah,0,0,0
1/07/2020,Paraguay,Perak,0,0,0
1/07/2020,Paraguay,Perlis,0,0,0
1/07/2020,Paraguay,Pulau Pinang,0,0,0
1/07/2020,Paraguay,Sabah,0,0,0
1/07/2020,Paraguay,Sarawak,0,0,0
1/07/2020,Paraguay,Selangor,0,0,0
1/07/2020,"Palestine, State of",Johor,0,0,0
1/07/2020,"Palestine, State of",Kedah,0,0,0
1/07/2020,"Palestine, State of",Kelantan,0,0,0
1/07/2020,"Palestine, State of",Melaka,0,0,0
1/07/2020,"Palestine, State of",Perak,0,0,0
1/07/2020,"Palestine, State of",Perlis,0,0,0
1/07/2020,"Palestine, State of",Pulau Pinang,0,0,0
1/07/2020,"Palestine, State of",Sabah,0,0,0
1/07/2020,"Palestine, State of",Sarawak,0,0,0
1/07/2020,"Palestine, State of",Selangor,0,0,0
1/07/2020,Qatar,Johor,0,0,0
1/07/2020,Qatar,Kedah,0,0,0
1/07/2020,Qatar,Perlis,0,0,0
1/07/2020,Qatar,Pulau Pinang,0,0,0
1/07/2020,Qatar,Sabah,0,0,0
1/07/2020,Qatar,Sarawak,0,0,0
1/07/2020,Qatar,Selangor,0,0,0
1/07/2020,Réunion,Johor,0,0,0
1/07/2020,Réunion,Sarawak,0,0,0
1/07/2020,Romania,Johor,5,5,0
1/07/2020,Romania,Kedah,0,0,0
1/07/2020,Romania,Kelantan,0,0,0
1/07/2020,Romania,Negeri Sembilan,0,0,0
1/07/2020,Romania,Pahang,0,0,0
1/07/2020,Romania,Perak,0,0,0
1/07/2020,Romania,Perlis,0,0,0
1/07/2020,Romania,Pulau Pinang,0,0,0
1/07/2020,Romania,Sabah,0,0,0
1/07/2020,Romania,Sarawak,0,0,0
1/07/2020,Romania,Selangor,25,21,4
1/07/2020,Romania,W.P. Labuan,0,0,0
1/07/2020,Russian Federation (Russia),Johor,50,49,1
1/07/2020,Russian Federation (Russia),Kedah,0,0,0
1/07/2020,Russian Federation (Russia),Kelantan,0,0,0
1/07/2020,Russian Federation (Russia),Melaka,0,0,0
1/07/2020,Russian Federation (Russia),Negeri Sembilan,0,0,0
1/07/2020,Russian Federation (Russia),Pahang,0,0,0
1/07/2020,Russian Federation (Russia),Perak,0,0,0
1/07/2020,Russian Federation (Russia),Perlis,0,0,0
1/07/2020,Russian Federation (Russia),Pulau Pinang,0,0,0
1/07/2020,Russian Federation (Russia),Sabah,0,0,0
1/07/2020,Russian Federation (Russia),Sarawak,2,0,2
1/07/2020,Russian Federation (Russia),Selangor,135,130,5
1/07/2020,Russian Federation (Russia),W.P. Labuan,0,0,0
1/07/2020,Rwanda,Johor,0,0,0
1/07/2020,Rwanda,Kedah,0,0,0
1/07/2020,Rwanda,Pulau Pinang,0,0,0
1/07/2020,Rwanda,Selangor,0,0,0
1/07/2020,Saudi Arabia,Johor,0,0,0
1/07/2020,Saudi Arabia,Kedah,0,0,0
1/07/2020,Saudi Arabia,Kelantan,0,0,0
1/07/2020,Saudi Arabia,Melaka,0,0,0
1/07/2020,Saudi Arabia,Perak,0,0,0
1/07/2020,Saudi Arabia,Perlis,0,0,0
1/07/2020,Saudi Arabia,Pulau Pinang,0,0,0
1/07/2020,Saudi Arabia,Sabah,0,0,0
1/07/2020,Saudi Arabia,Sarawak,0,0,0
1/07/2020,Saudi Arabia,Selangor,12,6,6
1/07/2020,Saudi Arabia,W.P. Labuan,0,0,0
1/07/2020,Sudan,Johor,0,0,0
1/07/2020,Sudan,Kedah,0,0,0
1/07/2020,Sudan,Kelantan,0,0,0
1/07/2020,Sudan,Perlis,0,0,0
1/07/2020,Sudan,Pulau Pinang,0,0,0
1/07/2020,Sudan,Sabah,0,0,0
1/07/2020,Sudan,Sarawak,0,0,0
1/07/2020,Sudan,Selangor,2,2,0
1/07/2020,Sudan,W.P. Labuan,0,0,0
1/07/2020,Senegal,Johor,0,0,0
1/07/2020,Senegal,Kedah,0,0,0
1/07/2020,Senegal,Kelantan,0,0,0
1/07/2020,Senegal,Perak,0,0,0
1/07/2020,Senegal,Perlis,0,0,0
1/07/2020,Senegal,Pulau Pinang,0,0,0
1/07/2020,Senegal,Sabah,0,0,0
1/07/2020,Senegal,Sarawak,0,0,0
1/07/2020,Senegal,Selangor,2,1,1
1/07/2020,Singapore,Johor,226,164,62
1/07/2020,Singapore,Kedah,1,1,0
1/07/2020,Singapore,Kelantan,0,0,0
1/07/2020,Singapore,Melaka,0,0,0
1/07/2020,Singapore,Negeri Sembilan,0,0,0
1/07/2020,Singapore,Pahang,0,0,0
1/07/2020,Singapore,Perak,3,1,2
1/07/2020,Singapore,Perlis,0,0,0
1/07/2020,Singapore,Pulau Pinang,5,3,2
1/07/2020,Singapore,Sabah,2,1,1
1/07/2020,Singapore,Sarawak,6,3,3
1/07/2020,Singapore,Selangor,107,67,40
1/07/2020,Singapore,Terengganu,0,0,0
1/07/2020,Singapore,W.P. Labuan,0,0,0
1/07/2020,South Georgia and the South Sandwich Islands,Johor,0,0,0
1/07/2020,South Georgia and the South Sandwich Islands,Sabah,0,0,0
1/07/2020,South Georgia and the South Sandwich Islands,Selangor,0,0,0
1/07/2020,Saint Helena,Sarawak,0,0,0
1/07/2020,Solomon Islands,Johor,0,0,0
1/07/2020,Solomon Islands,Perlis,0,0,0
1/07/2020,Solomon Islands,Pulau Pinang,0,0,0
1/07/2020,Solomon Islands,Sabah,0,0,0
1/07/2020,Solomon Islands,Sarawak,0,0,0
1/07/2020,Solomon Islands,Selangor,0,0,0
1/07/2020,Solomon Islands,W.P. Labuan,0,0,0
1/07/2020,Sierra Leone,Johor,0,0,0
1/07/2020,Sierra Leone,Kedah,0,0,0
1/07/2020,Sierra Leone,Perak,0,0,0
1/07/2020,Sierra Leone,Pulau Pinang,0,0,0
1/07/2020,Sierra Leone,Sabah,0,0,0
1/07/2020,Sierra Leone,Selangor,0,0,0
1/07/2020,El Salvador,Johor,0,0,0
1/07/2020,El Salvador,Kedah,0,0,0
1/07/2020,El Salvador,Perak,0,0,0
1/07/2020,El Salvador,Perlis,0,0,0
1/07/2020,El Salvador,Pulau Pinang,0,0,0
1/07/2020,El Salvador,Sabah,0,0,0
1/07/2020,El Salvador,Selangor,0,0,0
1/07/2020,El Salvador,W.P. Labuan,0,0,0
1/07/2020,San Marino,Johor,0,0,0
1/07/2020,San Marino,Selangor,0,0,0
1/07/2020,Somalia,Johor,0,0,0
1/07/2020,Somalia,Kedah,0,0,0
1/07/2020,Somalia,Kelantan,0,0,0
1/07/2020,Somalia,Perlis,0,0,0
1/07/2020,Somalia,Sabah,0,0,0
1/07/2020,Somalia,Sarawak,0,0,0
1/07/2020,Somalia,Selangor,0,0,0
1/07/2020,Serbia,Johor,0,0,0
1/07/2020,Serbia,Kedah,0,0,0
1/07/2020,Serbia,Kelantan,0,0,0
1/07/2020,Serbia,Pahang,0,0,0
1/07/2020,Serbia,Perak,0,0,0
1/07/2020,Serbia,Perlis,0,0,0
1/07/2020,Serbia,Pulau Pinang,0,0,0
1/07/2020,Serbia,Sabah,0,0,0
1/07/2020,Serbia,Sarawak,0,0,0
1/07/2020,Serbia,Selangor,1,0,1
1/07/2020,South Sudan,Johor,0,0,0
1/07/2020,South Sudan,Kedah,0,0,0
1/07/2020,South Sudan,Sarawak,0,0,0
1/07/2020,South Sudan,Selangor,0,0,0
1/07/2020,South Sudan,W.P. Labuan,0,0,0
1/07/2020,Sao Tome and Principe,Selangor,0,0,0
1/07/2020,Suriname,Johor,0,0,0
1/07/2020,Suriname,Kedah,0,0,0
1/07/2020,Suriname,Kelantan,0,0,0
1/07/2020,Suriname,Perak,0,0,0
1/07/2020,Suriname,Perlis,0,0,0
1/07/2020,Suriname,Pulau Pinang,0,0,0
1/07/2020,Suriname,Sabah,0,0,0
1/07/2020,Suriname,Sarawak,0,0,0
1/07/2020,Suriname,Selangor,0,0,0
1/07/2020,Slovakia,Johor,0,0,0
1/07/2020,Slovakia,Kedah,0,0,0
1/07/2020,Slovakia,Kelantan,0,0,0
1/07/2020,Slovakia,Negeri Sembilan,0,0,0
1/07/2020,Slovakia,Pahang,0,0,0
1/07/2020,Slovakia,Perak,0,0,0
1/07/2020,Slovakia,Perlis,0,0,0
1/07/2020,Slovakia,Pulau Pinang,0,0,0
1/07/2020,Slovakia,Sabah,0,0,0
1/07/2020,Slovakia,Sarawak,0,0,0
1/07/2020,Slovakia,Selangor,7,7,0
1/07/2020,Slovakia,W.P. Labuan,0,0,0
1/07/2020,Slovenia,Johor,0,0,0
1/07/2020,Slovenia,Kedah,0,0,0
1/07/2020,Slovenia,Kelantan,0,0,0
1/07/2020,Slovenia,Perak,0,0,0
1/07/2020,Slovenia,Perlis,0,0,0
1/07/2020,Slovenia,Pulau Pinang,0,0,0
1/07/2020,Slovenia,Sabah,0,0,0
1/07/2020,Slovenia,Sarawak,0,0,0
1/07/2020,Slovenia,Selangor,2,0,2
1/07/2020,Slovenia,W.P. Labuan,0,0,0
1/07/2020,Sweden,Johor,0,0,0
1/07/2020,Sweden,Kedah,0,0,0
1/07/2020,Sweden,Kelantan,0,0,0
1/07/2020,Sweden,Melaka,0,0,0
1/07/2020,Sweden,Negeri Sembilan,0,0,0
1/07/2020,Sweden,Pahang,0,0,0
1/07/2020,Sweden,Perak,0,0,0
1/07/2020,Sweden,Perlis,0,0,0
1/07/2020,Sweden,Pulau Pinang,0,0,0
1/07/2020,Sweden,Sabah,0,0,0
1/07/2020,Sweden,Sarawak,0,0,0
1/07/2020,Sweden,Selangor,39,30,9
1/07/2020,Sweden,W.P. Labuan,0,0,0
1/07/2020,Eswatini,Johor,0,0,0
1/07/2020,Eswatini,Kedah,0,0,0
1/07/2020,Eswatini,Pulau Pinang,0,0,0
1/07/2020,Eswatini,Sabah,0,0,0
1/07/2020,Eswatini,Selangor,0,0,0
1/07/2020,Seychelles,Johor,0,0,0
1/07/2020,Seychelles,Kedah,0,0,0
1/07/2020,Seychelles,Pulau Pinang,0,0,0
1/07/2020,Seychelles,Sabah,0,0,0
1/07/2020,Seychelles,Sarawak,0,0,0
1/07/2020,Seychelles,Selangor,0,0,0
1/07/2020,Syrian Arab Republic,Johor,0,0,0
1/07/2020,Syrian Arab Republic,Kedah,0,0,0
1/07/2020,Syrian Arab Republic,Kelantan,0,0,0
1/07/2020,Syrian Arab Republic,Pahang,0,0,0
1/07/2020,Syrian Arab Republic,Perlis,0,0,0
1/07/2020,Syrian Arab Republic,Pulau Pinang,0,0,0
1/07/2020,Syrian Arab Republic,Sabah,0,0,0
1/07/2020,Syrian Arab Republic,Sarawak,0,0,0
1/07/2020,Syrian Arab Republic,Selangor,1,1,0
1/07/2020,Syrian Arab Republic,W.P. Labuan,0,0,0
1/07/2020,Turks and Caicos Islands,Perlis,0,0,0
1/07/2020,TCD,Johor,0,0,0
1/07/2020,TCD,Kedah,0,0,0
1/07/2020,TCD,Perlis,0,0,0
1/07/2020,TCD,Selangor,0,0,0
1/07/2020,Togo,Johor,0,0,0
1/07/2020,Togo,Perak,0,0,0
1/07/2020,Togo,Pulau Pinang,0,0,0
1/07/2020,Togo,Selangor,0,0,0
1/07/2020,Thailand,Johor,79,79,0
1/07/2020,Thailand,Kedah,10004,9337,667
1/07/2020,Thailand,Kelantan,9,1,8
1/07/2020,Thailand,Melaka,0,0,0
1/07/2020,Thailand,Negeri Sembilan,0,0,0
1/07/2020,Thailand,Pahang,0,0,0
1/07/2020,Thailand,Perak,7,0,7
1/07/2020,Thailand,Perlis,2562,2509,53
1/07/2020,Thailand,Pulau Pinang,0,0,0
1/07/2020,Thailand,Sabah,0,0,0
1/07/2020,Thailand,Sarawak,15,15,0
1/07/2020,Thailand,Selangor,46,9,37
1/07/2020,Thailand,Terengganu,0,0,0
1/07/2020,Thailand,W.P. Labuan,0,0,0
1/07/2020,Tajikistan,Johor,0,0,0
1/07/2020,Tajikistan,Kedah,0,0,0
1/07/2020,Tajikistan,Perlis,0,0,0
1/07/2020,Tajikistan,Pulau Pinang,0,0,0
1/07/2020,Tajikistan,Sabah,0,0,0
1/07/2020,Tajikistan,Selangor,0,0,0
1/07/2020,Tokelau,Selangor,0,0,0
1/07/2020,Turkmenistan,Johor,0,0,0
1/07/2020,Turkmenistan,Kedah,0,0,0
1/07/2020,Turkmenistan,Kelantan,0,0,0
1/07/2020,Turkmenistan,Perlis,0,0,0
1/07/2020,Turkmenistan,Pulau Pinang,0,0,0
1/07/2020,Turkmenistan,Sabah,0,0,0
1/07/2020,Turkmenistan,Sarawak,0,0,0
1/07/2020,Turkmenistan,Selangor,0,0,0
1/07/2020,Timor-Leste,Johor,0,0,0
1/07/2020,Timor-Leste,Kedah,0,0,0
1/07/2020,Timor-Leste,Perlis,0,0,0
1/07/2020,Timor-Leste,Pulau Pinang,0,0,0
1/07/2020,Timor-Leste,Sabah,0,0,0
1/07/2020,Timor-Leste,Sarawak,0,0,0
1/07/2020,Timor-Leste,Selangor,5,1,4
1/07/2020,Tonga,Johor,0,0,0
1/07/2020,Tonga,Pulau Pinang,0,0,0
1/07/2020,Tonga,Sarawak,0,0,0
1/07/2020,Tonga,Selangor,0,0,0
1/07/2020,Trinidad and Tobago,Johor,0,0,0
1/07/2020,Trinidad and Tobago,Kedah,0,0,0
1/07/2020,Trinidad and Tobago,Pahang,0,0,0
1/07/2020,Trinidad and Tobago,Pulau Pinang,0,0,0
1/07/2020,Trinidad and Tobago,Sabah,0,0,0
1/07/2020,Trinidad and Tobago,Sarawak,0,0,0
1/07/2020,Trinidad and Tobago,Selangor,0,0,0
1/07/2020,Tunisia,Johor,0,0,0
1/07/2020,Tunisia,Kedah,0,0,0
1/07/2020,Tunisia,Kelantan,0,0,0
1/07/2020,Tunisia,Melaka,0,0,0
1/07/2020,Tunisia,Perak,0,0,0
1/07/2020,Tunisia,Perlis,0,0,0
1/07/2020,Tunisia,Pulau Pinang,0,0,0
1/07/2020,Tunisia,Sabah,0,0,0
1/07/2020,Tunisia,Sarawak,0,0,0
1/07/2020,Tunisia,Selangor,2,0,2
1/07/2020,Tunisia,W.P. Labuan,0,0,0
1/07/2020,Türkiye,Johor,2,2,0
1/07/2020,Türkiye,Kedah,0,0,0
1/07/2020,Türkiye,Kelantan,0,0,0
1/07/2020,Türkiye,Melaka,0,0,0
1/07/2020,Türkiye,Negeri Sembilan,0,0,0
1/07/2020,Türkiye,Pahang,0,0,0
1/07/2020,Türkiye,Perak,0,0,0
1/07/2020,Türkiye,Perlis,0,0,0
1/07/2020,Türkiye,Pulau Pinang,0,0,0
1/07/2020,Türkiye,Sabah,1,1,0
1/07/2020,Türkiye,Sarawak,0,0,0
1/07/2020,Türkiye,Selangor,54,32,22
1/07/2020,Türkiye,W.P. Labuan,0,0,0
1/07/2020,Tuvalu,Selangor,0,0,0
1/07/2020,"Taiwan, Province of China",Johor,1,1,0
1/07/2020,"Taiwan, Province of China",Kedah,0,0,0
1/07/2020,"Taiwan, Province of China",Kelantan,0,0,0
1/07/2020,"Taiwan, Province of China",Melaka,0,0,0
1/07/2020,"Taiwan, Province of China",Negeri Sembilan,0,0,0
1/07/2020,"Taiwan, Province of China",Pahang,0,0,0
1/07/2020,"Taiwan, Province of China",Perak,0,0,0
1/07/2020,"Taiwan, Province of China",Perlis,0,0,0
1/07/2020,"Taiwan, Province of China",Pulau Pinang,0,0,0
1/07/2020,"Taiwan, Province of China",Sabah,0,0,0
1/07/2020,"Taiwan, Province of China",Sarawak,0,0,0
1/07/2020,"Taiwan, Province of China",Selangor,70,46,24
1/07/2020,"Taiwan, Province of China",W.P. Labuan,0,0,0
1/07/2020,"Tanzania, United Republic of",Johor,0,0,0
1/07/2020,"Tanzania, United Republic of",Kedah,0,0,0
1/07/2020,"Tanzania, United Republic of",Perak,0,0,0
1/07/2020,"Tanzania, United Republic of",Perlis,0,0,0
1/07/2020,"Tanzania, United Republic of",Pulau Pinang,0,0,0
1/07/2020,"Tanzania, United Republic of",Sabah,0,0,0
1/07/2020,"Tanzania, United Republic of",Sarawak,0,0,0
1/07/2020,"Tanzania, United Republic of",Selangor,0,0,0
1/07/2020,Uganda,Johor,0,0,0
1/07/2020,Uganda,Kedah,0,0,0
1/07/2020,Uganda,Perak,0,0,0
1/07/2020,Uganda,Perlis,0,0,0
1/07/2020,Uganda,Pulau Pinang,0,0,0
1/07/2020,Uganda,Sabah,0,0,0
1/07/2020,Uganda,Sarawak,0,0,0
1/07/2020,Uganda,Selangor,0,0,0
1/07/2020,Ukraine,Johor,40,40,0
1/07/2020,Ukraine,Kedah,0,0,0
1/07/2020,Ukraine,Kelantan,0,0,0
1/07/2020,Ukraine,Melaka,0,0,0
1/07/2020,Ukraine,Negeri Sembilan,0,0,0
1/07/2020,Ukraine,Pahang,0,0,0
1/07/2020,Ukraine,Perak,0,0,0
1/07/2020,Ukraine,Perlis,0,0,0
1/07/2020,Ukraine,Pulau Pinang,0,0,0
1/07/2020,Ukraine,Sabah,0,0,0
1/07/2020,Ukraine,Sarawak,0,0,0
1/07/2020,Ukraine,Selangor,164,164,0
1/07/2020,Ukraine,W.P. Labuan,0,0,0
1/07/2020,Uruguay,Johor,0,0,0
1/07/2020,Uruguay,Kedah,0,0,0
1/07/2020,Uruguay,Kelantan,0,0,0
1/07/2020,Uruguay,Perak,0,0,0
1/07/2020,Uruguay,Perlis,0,0,0
1/07/2020,Uruguay,Pulau Pinang,0,0,0
1/07/2020,Uruguay,Sabah,0,0,0
1/07/2020,Uruguay,Sarawak,0,0,0
1/07/2020,Uruguay,Selangor,0,0,0
1/07/2020,Uruguay,W.P. Labuan,0,0,0
1/07/2020,United States of America,Johor,0,0,0
1/07/2020,United States of America,Kedah,0,0,0
1/07/2020,United States of America,Kelantan,0,0,0
1/07/2020,United States of America,Melaka,0,0,0
1/07/2020,United States of America,Negeri Sembilan,0,0,0
1/07/2020,United States of America,Pahang,0,0,0
1/07/2020,United States of America,Perak,0,0,0
1/07/2020,United States of America,Perlis,0,0,0
1/07/2020,United States of America,Pulau Pinang,0,0,0
1/07/2020,United States of America,Sabah,2,2,0
1/07/2020,United States of America,Sarawak,0,0,0
1/07/2020,United States of America,Selangor,193,134,59
1/07/2020,United States of America,Terengganu,0,0,0
1/07/2020,United States of America,W.P. Labuan,0,0,0
1/07/2020,Uzbekistan,Johor,0,0,0
1/07/2020,Uzbekistan,Kedah,0,0,0
1/07/2020,Uzbekistan,Kelantan,0,0,0
1/07/2020,Uzbekistan,Perak,0,0,0
1/07/2020,Uzbekistan,Perlis,0,0,0
1/07/2020,Uzbekistan,Pulau Pinang,0,0,0
1/07/2020,Uzbekistan,Sabah,0,0,0
1/07/2020,Uzbekistan,Sarawak,0,0,0
1/07/2020,Uzbekistan,Selangor,1,0,1
1/07/2020,Holy See,Johor,0,0,0
1/07/2020,Holy See,Sarawak,0,0,0
1/07/2020,Holy See,Selangor,0,0,0
1/07/2020,Saint Vincent and the Grenadines,Johor,0,0,0
1/07/2020,Saint Vincent and the Grenadines,Kedah,0,0,0
1/07/2020,Saint Vincent and the Grenadines,Pulau Pinang,0,0,0
1/07/2020,Saint Vincent and the Grenadines,Sarawak,0,0,0
1/07/2020,Saint Vincent and the Grenadines,Selangor,0,0,0
1/07/2020,"Venezuela, Bolivarian Republic of",Johor,0,0,0
1/07/2020,"Venezuela, Bolivarian Republic of",Kedah,0,0,0
1/07/2020,"Venezuela, Bolivarian Republic of",Kelantan,0,0,0
1/07/2020,"Venezuela, Bolivarian Republic of",Melaka,0,0,0
1/07/2020,"Venezuela, Bolivarian Republic of",Perak,0,0,0
1/07/2020,"Venezuela, Bolivarian Republic of",Perlis,0,0,0
1/07/2020,"Venezuela, Bolivarian Republic of",Pulau Pinang,0,0,0
1/07/2020,"Venezuela, Bolivarian Republic of",Sabah,0,0,0
1/07/2020,"Venezuela, Bolivarian Republic of",Sarawak,0,0,0
1/07/2020,"Venezuela, Bolivarian Republic of",Selangor,1,1,0
1/07/2020,"Venezuela, Bolivarian Republic of",W.P. Labuan,0,0,0
1/07/2020,Viet Nam,Johor,2,0,2
1/07/2020,Viet Nam,Kedah,0,0,0
1/07/2020,Viet Nam,Kelantan,0,0,0
1/07/2020,Viet Nam,Melaka,0,0,0
1/07/2020,Viet Nam,Negeri Sembilan,0,0,0
1/07/2020,Viet Nam,Pahang,0,0,0
1/07/2020,Viet Nam,Perak,0,0,0
1/07/2020,Viet Nam,Perlis,0,0,0
1/07/2020,Viet Nam,Pulau Pinang,0,0,0
1/07/2020,Viet Nam,Sabah,0,0,0
1/07/2020,Viet Nam,Sarawak,0,0,0
1/07/2020,Viet Nam,Selangor,165,4,161
1/07/2020,Viet Nam,Terengganu,0,0,0
1/07/2020,Viet Nam,W.P. Labuan,0,0,0
1/07/2020,Vanuatu,Johor,0,0,0
1/07/2020,Vanuatu,Kedah,0,0,0
1/07/2020,Vanuatu,Pulau Pinang,0,0,0
1/07/2020,Vanuatu,Sabah,0,0,0
1/07/2020,Vanuatu,Sarawak,0,0,0
1/07/2020,Vanuatu,Selangor,0,0,0
1/07/2020, Samoa,Johor,0,0,0
1/07/2020, Samoa,Sarawak,0,0,0
1/07/2020, Samoa,Selangor,0,0,0
1/07/2020,Yemen,Johor,0,0,0
1/07/2020,Yemen,Kedah,0,0,0
1/07/2020,Yemen,Kelantan,0,0,0
1/07/2020,Yemen,Melaka,0,0,0
1/07/2020,Yemen,Pahang,0,0,0
1/07/2020,Yemen,Perak,0,0,0
1/07/2020,Yemen,Perlis,0,0,0
1/07/2020,Yemen,Pulau Pinang,0,0,0
1/07/2020,Yemen,Sabah,0,0,0
1/07/2020,Yemen,Sarawak,0,0,0
1/07/2020,Yemen,Selangor,8,8,0
1/07/2020,Yemen,W.P. Labuan,0,0,0
1/07/2020,South Africa,Johor,0,0,0
1/07/2020,South Africa,Kedah,0,0,0
1/07/2020,South Africa,Kelantan,0,0,0
1/07/2020,South Africa,Melaka,0,0,0
1/07/2020,South Africa,Pahang,0,0,0
1/07/2020,South Africa,Perak,0,0,0
1/07/2020,South Africa,Perlis,0,0,0
1/07/2020,South Africa,Pulau Pinang,0,0,0
1/07/2020,South Africa,Sabah,0,0,0
1/07/2020,South Africa,Sarawak,0,0,0
1/07/2020,South Africa,Selangor,12,7,5
1/07/2020,South Africa,Terengganu,0,0,0
1/07/2020,South Africa,W.P. Labuan,0,0,0
1/07/2020,ZAR,Selangor,0,0,0
1/07/2020,Zambia,Johor,0,0,0
1/07/2020,Zambia,Kedah,0,0,0
1/07/2020,Zambia,Perak,0,0,0
1/07/2020,Zambia,Perlis,0,0,0
1/07/2020,Zambia,Pulau Pinang,0,0,0
1/07/2020,Zambia,Sabah,0,0,0
1/07/2020,Zambia,Sarawak,0,0,0
1/07/2020,Zambia,Selangor,1,1,0
1/07/2020,Zimbabwe,Johor,0,0,0
1/07/2020,Zimbabwe,Kedah,0,0,0
1/07/2020,Zimbabwe,Kelantan,0,0,0
1/07/2020,Zimbabwe,Perak,0,0,0
1/07/2020,Zimbabwe,Perlis,0,0,0
1/07/2020,Zimbabwe,Pulau Pinang,0,0,0
1/07/2020,Zimbabwe,Sabah,0,0,0
1/07/2020,Zimbabwe,Sarawak,0,0,0
1/07/2020,Zimbabwe,Selangor,1,1,0
1/08/2020,Aruba,Kedah,0,0,0
1/08/2020,Aruba,Pulau Pinang,0,0,0
1/08/2020,Afghanistan,Johor,0,0,0
1/08/2020,Afghanistan,Kedah,0,0,0
1/08/2020,Afghanistan,Perlis,0,0,0
1/08/2020,Afghanistan,Pulau Pinang,0,0,0
1/08/2020,Afghanistan,Sarawak,0,0,0
1/08/2020,Afghanistan,Selangor,2,2,0
1/08/2020,Angola,Johor,0,0,0
1/08/2020,Angola,Kedah,0,0,0
1/08/2020,Angola,Sabah,0,0,0
1/08/2020,Angola,Selangor,0,0,0
1/08/2020,Anguilla,Selangor,0,0,0
1/08/2020,Albania,Johor,0,0,0
1/08/2020,Albania,Kedah,0,0,0
1/08/2020,Albania,Perak,0,0,0
1/08/2020,Albania,Perlis,0,0,0
1/08/2020,Albania,Pulau Pinang,0,0,0
1/08/2020,Albania,Sabah,0,0,0
1/08/2020,Albania,Sarawak,0,0,0
1/08/2020,Albania,Selangor,0,0,0
1/08/2020,Andorra,Johor,0,0,0
1/08/2020,Andorra,Kedah,0,0,0
1/08/2020,Andorra,Perlis,0,0,0
1/08/2020,Andorra,Pulau Pinang,0,0,0
1/08/2020,Andorra,Selangor,0,0,0
1/08/2020,Antigua and Barbuda,Selangor,0,0,0
1/08/2020,United Arab Emirates,Johor,0,0,0
1/08/2020,United Arab Emirates,Kedah,0,0,0
1/08/2020,United Arab Emirates,Kelantan,0,0,0
1/08/2020,United Arab Emirates,Perak,0,0,0
1/08/2020,United Arab Emirates,Perlis,0,0,0
1/08/2020,United Arab Emirates,Pulau Pinang,0,0,0
1/08/2020,United Arab Emirates,Sabah,0,0,0
1/08/2020,United Arab Emirates,Sarawak,0,0,0
1/08/2020,United Arab Emirates,Selangor,8,5,3
1/08/2020,Argentina,Johor,0,0,0
1/08/2020,Argentina,Kedah,0,0,0
1/08/2020,Argentina,Kelantan,0,0,0
1/08/2020,Argentina,Melaka,0,0,0
1/08/2020,Argentina,Perak,0,0,0
1/08/2020,Argentina,Perlis,0,0,0
1/08/2020,Argentina,Pulau Pinang,0,0,0
1/08/2020,Argentina,Sabah,0,0,0
1/08/2020,Argentina,Sarawak,0,0,0
1/08/2020,Argentina,Selangor,2,0,2
1/08/2020,Argentina,W.P. Labuan,0,0,0
1/08/2020,Armenia,Johor,0,0,0
1/08/2020,Armenia,Kedah,0,0,0
1/08/2020,Armenia,Kelantan,0,0,0
1/08/2020,Armenia,Perak,0,0,0
1/08/2020,Armenia,Perlis,0,0,0
1/08/2020,Armenia,Pulau Pinang,0,0,0
1/08/2020,Armenia,Sabah,0,0,0
1/08/2020,Armenia,Sarawak,0,0,0
1/08/2020,Armenia,Selangor,0,0,0
1/08/2020,Antarctica,Selangor,0,0,0
1/08/2020,Antigua and Barbuda,Johor,0,0,0
1/08/2020,Antigua and Barbuda,Kedah,0,0,0
1/08/2020,Antigua and Barbuda,Pulau Pinang,0,0,0
1/08/2020,Antigua and Barbuda,Sarawak,0,0,0
1/08/2020,Antigua and Barbuda,Selangor,0,0,0
1/08/2020,Australia,Johor,6,6,0
1/08/2020,Australia,Kedah,0,0,0
1/08/2020,Australia,Kelantan,0,0,0
1/08/2020,Australia,Melaka,0,0,0
1/08/2020,Australia,Negeri Sembilan,0,0,0
1/08/2020,Australia,Pahang,0,0,0
1/08/2020,Australia,Perak,0,0,0
1/08/2020,Australia,Perlis,0,0,0
1/08/2020,Australia,Pulau Pinang,0,0,0
1/08/2020,Australia,Sabah,2,1,1
1/08/2020,Australia,Sarawak,1,1,0
1/08/2020,Australia,Selangor,116,75,41
1/08/2020,Australia,Terengganu,0,0,0
1/08/2020,Australia,W.P. Labuan,0,0,0
1/08/2020,Austria,Johor,0,0,0
1/08/2020,Austria,Kedah,0,0,0
1/08/2020,Austria,Kelantan,0,0,0
1/08/2020,Austria,Melaka,0,0,0
1/08/2020,Austria,Negeri Sembilan,0,0,0
1/08/2020,Austria,Pahang,0,0,0
1/08/2020,Austria,Perak,0,0,0
1/08/2020,Austria,Perlis,0,0,0
1/08/2020,Austria,Pulau Pinang,0,0,0
1/08/2020,Austria,Sabah,0,0,0
1/08/2020,Austria,Sarawak,0,0,0
1/08/2020,Austria,Selangor,16,10,6
1/08/2020,Austria,Terengganu,0,0,0
1/08/2020,Austria,W.P. Labuan,0,0,0
1/08/2020,Azerbaijan,Johor,0,0,0
1/08/2020,Azerbaijan,Kedah,0,0,0
1/08/2020,Azerbaijan,Kelantan,0,0,0
1/08/2020,Azerbaijan,Melaka,0,0,0
1/08/2020,Azerbaijan,Perlis,0,0,0
1/08/2020,Azerbaijan,Pulau Pinang,0,0,0
1/08/2020,Azerbaijan,Sabah,0,0,0
1/08/2020,Azerbaijan,Sarawak,0,0,0
1/08/2020,Azerbaijan,Selangor,0,0,0
1/08/2020,Azerbaijan,W.P. Labuan,0,0,0
1/08/2020,Burundi,Pulau Pinang,0,0,0
1/08/2020,Burundi,Sarawak,0,0,0
1/08/2020,Burundi,Selangor,0,0,0
1/08/2020,Belgium,Johor,0,0,0
1/08/2020,Belgium,Kedah,0,0,0
1/08/2020,Belgium,Kelantan,0,0,0
1/08/2020,Belgium,Melaka,0,0,0
1/08/2020,Belgium,Negeri Sembilan,0,0,0
1/08/2020,Belgium,Pahang,0,0,0
1/08/2020,Belgium,Perak,0,0,0
1/08/2020,Belgium,Perlis,0,0,0
1/08/2020,Belgium,Pulau Pinang,0,0,0
1/08/2020,Belgium,Sabah,0,0,0
1/08/2020,Belgium,Sarawak,0,0,0
1/08/2020,Belgium,Selangor,9,9,0
1/08/2020,Belgium,W.P. Labuan,0,0,0
1/08/2020,Benin,Johor,0,0,0
1/08/2020,Benin,Kedah,0,0,0
1/08/2020,Benin,Perak,0,0,0
1/08/2020,Benin,Pulau Pinang,0,0,0
1/08/2020,Benin,Sabah,0,0,0
1/08/2020,Benin,Sarawak,0,0,0
1/08/2020,Benin,Selangor,0,0,0
1/08/2020,Burkina Faso,Perak,0,0,0
1/08/2020,Burkina Faso,Pulau Pinang,0,0,0
1/08/2020,Burkina Faso,Selangor,0,0,0
1/08/2020,Bangladesh,Johor,5,5,0
1/08/2020,Bangladesh,Kedah,0,0,0
1/08/2020,Bangladesh,Kelantan,0,0,0
1/08/2020,Bangladesh,Melaka,0,0,0
1/08/2020,Bangladesh,Negeri Sembilan,0,0,0
1/08/2020,Bangladesh,Pahang,0,0,0
1/08/2020,Bangladesh,Perak,0,0,0
1/08/2020,Bangladesh,Perlis,0,0,0
1/08/2020,Bangladesh,Pulau Pinang,0,0,0
1/08/2020,Bangladesh,Sabah,0,0,0
1/08/2020,Bangladesh,Sarawak,1,1,0
1/08/2020,Bangladesh,Selangor,170,131,39
1/08/2020,Bangladesh,W.P. Labuan,0,0,0
1/08/2020,Bulgaria,Johor,0,0,0
1/08/2020,Bulgaria,Kedah,0,0,0
1/08/2020,Bulgaria,Kelantan,0,0,0
1/08/2020,Bulgaria,Pahang,0,0,0
1/08/2020,Bulgaria,Perak,0,0,0
1/08/2020,Bulgaria,Perlis,0,0,0
1/08/2020,Bulgaria,Pulau Pinang,1,1,0
1/08/2020,Bulgaria,Sabah,0,0,0
1/08/2020,Bulgaria,Sarawak,0,0,0
1/08/2020,Bulgaria,Selangor,2,2,0
1/08/2020,Bulgaria,W.P. Labuan,0,0,0
1/08/2020,Bahrain,Johor,0,0,0
1/08/2020,Bahrain,Kedah,0,0,0
1/08/2020,Bahrain,Kelantan,0,0,0
1/08/2020,Bahrain,Perlis,0,0,0
1/08/2020,Bahrain,Pulau Pinang,0,0,0
1/08/2020,Bahrain,Sabah,0,0,0
1/08/2020,Bahrain,Sarawak,0,0,0
1/08/2020,Bahrain,Selangor,1,1,0
1/08/2020,Bahamas,Johor,0,0,0
1/08/2020,Bahamas,Kedah,0,0,0
1/08/2020,Bahamas,Perak,0,0,0
1/08/2020,Bahamas,Sabah,0,0,0
1/08/2020,Bahamas,Sarawak,0,0,0
1/08/2020,Bahamas,Selangor,0,0,0
1/08/2020,Bosnia and Herzegovina,Johor,0,0,0
1/08/2020,Bosnia and Herzegovina,Kedah,0,0,0
1/08/2020,Bosnia and Herzegovina,Perlis,0,0,0
1/08/2020,Bosnia and Herzegovina,Pulau Pinang,0,0,0
1/08/2020,Bosnia and Herzegovina,Sabah,0,0,0
1/08/2020,Bosnia and Herzegovina,Sarawak,0,0,0
1/08/2020,Bosnia and Herzegovina,Selangor,2,1,1
1/08/2020,Belarus,Johor,0,0,0
1/08/2020,Belarus,Kedah,0,0,0
1/08/2020,Belarus,Kelantan,0,0,0
1/08/2020,Belarus,Pahang,0,0,0
1/08/2020,Belarus,Perak,0,0,0
1/08/2020,Belarus,Perlis,0,0,0
1/08/2020,Belarus,Pulau Pinang,0,0,0
1/08/2020,Belarus,Sabah,0,0,0
1/08/2020,Belarus,Sarawak,0,0,0
1/08/2020,Belarus,Selangor,1,1,0
1/08/2020,Belarus,W.P. Labuan,0,0,0
1/08/2020,Belize,Johor,0,0,0
1/08/2020,Belize,Pulau Pinang,0,0,0
1/08/2020,Belize,Sarawak,0,0,0
1/08/2020,Belize,Selangor,0,0,0
1/08/2020,Bermuda,Selangor,0,0,0
1/08/2020,Bolivia,Johor,0,0,0
1/08/2020,Bolivia,Kedah,0,0,0
1/08/2020,Bolivia,Melaka,0,0,0
1/08/2020,Bolivia,Perak,0,0,0
1/08/2020,Bolivia,Perlis,0,0,0
1/08/2020,Bolivia,Pulau Pinang,0,0,0
1/08/2020,Bolivia,Sabah,0,0,0
1/08/2020,Bolivia,Sarawak,0,0,0
1/08/2020,Bolivia,Selangor,0,0,0
1/08/2020,Brazil,Johor,0,0,0
1/08/2020,Brazil,Kedah,0,0,0
1/08/2020,Brazil,Kelantan,0,0,0
1/08/2020,Brazil,Melaka,0,0,0
1/08/2020,Brazil,Pahang,0,0,0
1/08/2020,Brazil,Perak,0,0,0
1/08/2020,Brazil,Perlis,0,0,0
1/08/2020,Brazil,Pulau Pinang,0,0,0
1/08/2020,Brazil,Sabah,0,0,0
1/08/2020,Brazil,Sarawak,0,0,0
1/08/2020,Brazil,Selangor,7,4,3
1/08/2020,Brazil,W.P. Labuan,0,0,0
1/08/2020,Barbados,Johor,0,0,0
1/08/2020,Barbados,Kedah,0,0,0
1/08/2020,Barbados,Perlis,0,0,0
1/08/2020,Barbados,Pulau Pinang,0,0,0
1/08/2020,Barbados,Selangor,0,0,0
1/08/2020,Brunei Darussalam,Johor,0,0,0
1/08/2020,Brunei Darussalam,Kedah,0,0,0
1/08/2020,Brunei Darussalam,Kelantan,0,0,0
1/08/2020,Brunei Darussalam,Melaka,0,0,0
1/08/2020,Brunei Darussalam,Pahang,0,0,0
1/08/2020,Brunei Darussalam,Perak,0,0,0
1/08/2020,Brunei Darussalam,Perlis,0,0,0
1/08/2020,Brunei Darussalam,Pulau Pinang,0,0,0
1/08/2020,Brunei Darussalam,Sabah,0,0,0
1/08/2020,Brunei Darussalam,Sarawak,196,185,11
1/08/2020,Brunei Darussalam,Selangor,22,8,14
1/08/2020,Brunei Darussalam,W.P. Labuan,1,0,1
1/08/2020,Bhutan,Johor,0,0,0
1/08/2020,Bhutan,Kedah,0,0,0
1/08/2020,Bhutan,Perak,0,0,0
1/08/2020,Bhutan,Perlis,0,0,0
1/08/2020,Bhutan,Pulau Pinang,0,0,0
1/08/2020,Bhutan,Sabah,0,0,0
1/08/2020,Bhutan,Sarawak,0,0,0
1/08/2020,Bhutan,Selangor,0,0,0
1/08/2020,Botswana,Johor,0,0,0
1/08/2020,Botswana,Kedah,0,0,0
1/08/2020,Botswana,Perlis,0,0,0
1/08/2020,Botswana,Pulau Pinang,0,0,0
1/08/2020,Botswana,Sabah,0,0,0
1/08/2020,Botswana,Sarawak,0,0,0
1/08/2020,Botswana,Selangor,0,0,0
1/08/2020,Central African Republic,Kedah,0,0,0
1/08/2020,Central African Republic,Selangor,0,0,0
1/08/2020,Canada,Johor,0,0,0
1/08/2020,Canada,Kedah,0,0,0
1/08/2020,Canada,Kelantan,0,0,0
1/08/2020,Canada,Melaka,0,0,0
1/08/2020,Canada,Negeri Sembilan,0,0,0
1/08/2020,Canada,Pahang,0,0,0
1/08/2020,Canada,Perak,0,0,0
1/08/2020,Canada,Perlis,0,0,0
1/08/2020,Canada,Pulau Pinang,0,0,0
1/08/2020,Canada,Sabah,0,0,0
1/08/2020,Canada,Sarawak,1,1,0
1/08/2020,Canada,Selangor,51,28,23
1/08/2020,Canada,Terengganu,0,0,0
1/08/2020,Canada,W.P. Labuan,0,0,0
1/08/2020,Cocos (Keeling) Islands,Selangor,0,0,0
1/08/2020,Switzerland,Johor,0,0,0
1/08/2020,Switzerland,Kedah,0,0,0
1/08/2020,Switzerland,Kelantan,0,0,0
1/08/2020,Switzerland,Melaka,0,0,0
1/08/2020,Switzerland,Negeri Sembilan,0,0,0
1/08/2020,Switzerland,Pahang,0,0,0
1/08/2020,Switzerland,Perak,0,0,0
1/08/2020,Switzerland,Perlis,0,0,0
1/08/2020,Switzerland,Pulau Pinang,1,1,0
1/08/2020,Switzerland,Sabah,0,0,0
1/08/2020,Switzerland,Sarawak,1,1,0
1/08/2020,Switzerland,Selangor,8,6,2
1/08/2020,Switzerland,W.P. Labuan,0,0,0
1/08/2020,Chile,Johor,0,0,0
1/08/2020,Chile,Kedah,0,0,0
1/08/2020,Chile,Kelantan,0,0,0
1/08/2020,Chile,Melaka,0,0,0
1/08/2020,Chile,Pahang,0,0,0
1/08/2020,Chile,Perak,0,0,0
1/08/2020,Chile,Perlis,0,0,0
1/08/2020,Chile,Pulau Pinang,0,0,0
1/08/2020,Chile,Sabah,0,0,0
1/08/2020,Chile,Sarawak,0,0,0
1/08/2020,Chile,Selangor,2,1,1
1/08/2020,China,Johor,26,25,1
1/08/2020,China,Kedah,0,0,0
1/08/2020,China,Kelantan,0,0,0
1/08/2020,China,Melaka,0,0,0
1/08/2020,China,Pahang,0,0,0
1/08/2020,China,Perak,0,0,0
1/08/2020,China,Perlis,0,0,0
1/08/2020,China,Pulau Pinang,0,0,0
1/08/2020,China,Sabah,1,1,0
1/08/2020,China,Sarawak,24,21,3
1/08/2020,China,Selangor,569,389,180
1/08/2020,China,Terengganu,0,0,0
1/08/2020,China,W.P. Labuan,1,0,1
1/08/2020,Côte d'Ivoire,Johor,0,0,0
1/08/2020,Côte d'Ivoire,Kedah,0,0,0
1/08/2020,Côte d'Ivoire,Pulau Pinang,0,0,0
1/08/2020,Côte d'Ivoire,Sabah,0,0,0
1/08/2020,Côte d'Ivoire,Sarawak,0,0,0
1/08/2020,Côte d'Ivoire,Selangor,0,0,0
1/08/2020,Cameroon,Johor,0,0,0
1/08/2020,Cameroon,Kedah,0,0,0
1/08/2020,Cameroon,Pulau Pinang,0,0,0
1/08/2020,Cameroon,Sabah,0,0,0
1/08/2020,Cameroon,Sarawak,0,0,0
1/08/2020,Cameroon,Selangor,1,0,1
1/08/2020,Congo,Johor,0,0,0
1/08/2020,Congo,Pulau Pinang,0,0,0
1/08/2020,Congo,Sarawak,0,0,0
1/08/2020,Congo,Selangor,1,1,0
1/08/2020,Congo,Johor,0,0,0
1/08/2020,Congo,Kedah,0,0,0
1/08/2020,Congo,Selangor,0,0,0
1/08/2020,Cook Islands,Selangor,0,0,0
1/08/2020,Colombia,Johor,0,0,0
1/08/2020,Colombia,Kedah,0,0,0
1/08/2020,Colombia,Perak,0,0,0
1/08/2020,Colombia,Pulau Pinang,0,0,0
1/08/2020,Colombia,Sabah,0,0,0
1/08/2020,Colombia,Sarawak,0,0,0
1/08/2020,Colombia,Selangor,0,0,0
1/08/2020,Colombia,W.P. Labuan,0,0,0
1/08/2020,Comoros,Johor,0,0,0
1/08/2020,Comoros,Kedah,0,0,0
1/08/2020,Comoros,Selangor,0,0,0
1/08/2020,Cabo Verde,Johor,0,0,0
1/08/2020,Cabo Verde,Kedah,0,0,0
1/08/2020,Cabo Verde,Pulau Pinang,0,0,0
1/08/2020,Cabo Verde,Sabah,0,0,0
1/08/2020,Cabo Verde,Selangor,0,0,0
1/08/2020,Costa Rica,Johor,0,0,0
1/08/2020,Costa Rica,Kedah,0,0,0
1/08/2020,Costa Rica,Perak,0,0,0
1/08/2020,Costa Rica,Perlis,0,0,0
1/08/2020,Costa Rica,Pulau Pinang,0,0,0
1/08/2020,Costa Rica,Sabah,0,0,0
1/08/2020,Costa Rica,Sarawak,0,0,0
1/08/2020,Costa Rica,Selangor,3,2,1
1/08/2020,Cuba,Johor,0,0,0
1/08/2020,Cuba,Kedah,0,0,0
1/08/2020,Cuba,Perlis,0,0,0
1/08/2020,Cuba,Pulau Pinang,0,0,0
1/08/2020,Cuba,Sabah,0,0,0
1/08/2020,Cuba,Sarawak,0,0,0
1/08/2020,Cuba,Selangor,0,0,0
1/08/2020,Cyprus,Johor,0,0,0
1/08/2020,Cyprus,Kedah,0,0,0
1/08/2020,Cyprus,Perak,0,0,0
1/08/2020,Cyprus,Perlis,0,0,0
1/08/2020,Cyprus,Pulau Pinang,0,0,0
1/08/2020,Cyprus,Sabah,0,0,0
1/08/2020,Cyprus,Sarawak,0,0,0
1/08/2020,Cyprus,Selangor,0,0,0
1/08/2020,Czechia,Johor,0,0,0
1/08/2020,Czechia,Kedah,0,0,0
1/08/2020,Czechia,Kelantan,0,0,0
1/08/2020,Czechia,Melaka,0,0,0
1/08/2020,Czechia,Negeri Sembilan,0,0,0
1/08/2020,Czechia,Perak,0,0,0
1/08/2020,Czechia,Perlis,0,0,0
1/08/2020,Czechia,Pulau Pinang,0,0,0
1/08/2020,Czechia,Sabah,0,0,0
1/08/2020,Czechia,Sarawak,0,0,0
1/08/2020,Czechia,Selangor,7,6,1
1/08/2020,Czechia,W.P. Labuan,0,0,0
1/08/2020,Germany,Johor,0,0,0
1/08/2020,Germany,Kedah,0,0,0
1/08/2020,Germany,Kelantan,0,0,0
1/08/2020,Germany,Melaka,0,0,0
1/08/2020,Germany,Negeri Sembilan,0,0,0
1/08/2020,Germany,Pahang,0,0,0
1/08/2020,Germany,Perak,0,0,0
1/08/2020,Germany,Perlis,0,0,0
1/08/2020,Germany,Pulau Pinang,0,0,0
1/08/2020,Germany,Sabah,0,0,0
1/08/2020,Germany,Sarawak,0,0,0
1/08/2020,Germany,Selangor,67,49,18
1/08/2020,Germany,Terengganu,0,0,0
1/08/2020,Germany,W.P. Labuan,0,0,0
1/08/2020,Djibouti,Johor,0,0,0
1/08/2020,Djibouti,Selangor,0,0,0
1/08/2020,Dominica,Johor,0,0,0
1/08/2020,Dominica,Kedah,0,0,0
1/08/2020,Dominica,Pulau Pinang,0,0,0
1/08/2020,Dominica,Sabah,0,0,0
1/08/2020,Dominica,Sarawak,0,0,0
1/08/2020,Dominica,Selangor,0,0,0
1/08/2020,Dominica,W.P. Labuan,0,0,0
1/08/2020,Denmark,Johor,0,0,0
1/08/2020,Denmark,Kedah,0,0,0
1/08/2020,Denmark,Kelantan,0,0,0
1/08/2020,Denmark,Melaka,0,0,0
1/08/2020,Denmark,Negeri Sembilan,0,0,0
1/08/2020,Denmark,Pahang,0,0,0
1/08/2020,Denmark,Perak,0,0,0
1/08/2020,Denmark,Perlis,0,0,0
1/08/2020,Denmark,Pulau Pinang,0,0,0
1/08/2020,Denmark,Sabah,0,0,0
1/08/2020,Denmark,Sarawak,0,0,0
1/08/2020,Denmark,Selangor,20,10,10
1/08/2020,Denmark,W.P. Labuan,0,0,0
1/08/2020,Dominican Republic,Johor,0,0,0
1/08/2020,Dominican Republic,Kedah,0,0,0
1/08/2020,Dominican Republic,Perak,0,0,0
1/08/2020,Dominican Republic,Perlis,0,0,0
1/08/2020,Dominican Republic,Pulau Pinang,0,0,0
1/08/2020,Dominican Republic,Sabah,0,0,0
1/08/2020,Dominican Republic,Sarawak,0,0,0
1/08/2020,Dominican Republic,Selangor,0,0,0
1/08/2020,Algeria,Johor,0,0,0
1/08/2020,Algeria,Kedah,0,0,0
1/08/2020,Algeria,Kelantan,0,0,0
1/08/2020,Algeria,Melaka,0,0,0
1/08/2020,Algeria,Perak,0,0,0
1/08/2020,Algeria,Perlis,0,0,0
1/08/2020,Algeria,Pulau Pinang,0,0,0
1/08/2020,Algeria,Sabah,0,0,0
1/08/2020,Algeria,Sarawak,0,0,0
1/08/2020,Algeria,Selangor,5,4,1
1/08/2020,Algeria,W.P. Labuan,0,0,0
1/08/2020,Ecuador,Johor,0,0,0
1/08/2020,Ecuador,Kedah,0,0,0
1/08/2020,Ecuador,Perak,0,0,0
1/08/2020,Ecuador,Perlis,0,0,0
1/08/2020,Ecuador,Pulau Pinang,0,0,0
1/08/2020,Ecuador,Sabah,0,0,0
1/08/2020,Ecuador,Sarawak,0,0,0
1/08/2020,Ecuador,Selangor,0,0,0
1/08/2020,Egypt,Johor,0,0,0
1/08/2020,Egypt,Kedah,0,0,0
1/08/2020,Egypt,Kelantan,0,0,0
1/08/2020,Egypt,Melaka,0,0,0
1/08/2020,Egypt,Pahang,0,0,0
1/08/2020,Egypt,Perak,0,0,0
1/08/2020,Egypt,Perlis,0,0,0
1/08/2020,Egypt,Pulau Pinang,0,0,0
1/08/2020,Egypt,Sabah,1,1,0
1/08/2020,Egypt,Sarawak,0,0,0
1/08/2020,Egypt,Selangor,29,21,8
1/08/2020,Egypt,Terengganu,0,0,0
1/08/2020,Egypt,W.P. Labuan,0,0,0
1/08/2020,Eritrea,Johor,0,0,0
1/08/2020,Eritrea,Pulau Pinang,0,0,0
1/08/2020,Eritrea,Sabah,0,0,0
1/08/2020,Eritrea,Selangor,0,0,0
1/08/2020,Spain,Johor,0,0,0
1/08/2020,Spain,Kedah,0,0,0
1/08/2020,Spain,Kelantan,0,0,0
1/08/2020,Spain,Melaka,0,0,0
1/08/2020,Spain,Negeri Sembilan,0,0,0
1/08/2020,Spain,Pahang,0,0,0
1/08/2020,Spain,Perak,0,0,0
1/08/2020,Spain,Perlis,0,0,0
1/08/2020,Spain,Pulau Pinang,0,0,0
1/08/2020,Spain,Sabah,0,0,0
1/08/2020,Spain,Sarawak,0,0,0
1/08/2020,Spain,Selangor,19,10,9
1/08/2020,Spain,W.P. Labuan,0,0,0
1/08/2020,Estonia,Johor,0,0,0
1/08/2020,Estonia,Kedah,0,0,0
1/08/2020,Estonia,Kelantan,0,0,0
1/08/2020,Estonia,Pahang,0,0,0
1/08/2020,Estonia,Perak,0,0,0
1/08/2020,Estonia,Perlis,0,0,0
1/08/2020,Estonia,Pulau Pinang,0,0,0
1/08/2020,Estonia,Sabah,0,0,0
1/08/2020,Estonia,Sarawak,0,0,0
1/08/2020,Estonia,Selangor,1,1,0
1/08/2020,Estonia,W.P. Labuan,0,0,0
1/08/2020,Ethiopia,Johor,0,0,0
1/08/2020,Ethiopia,Kedah,0,0,0
1/08/2020,Ethiopia,Pulau Pinang,0,0,0
1/08/2020,Ethiopia,Sarawak,0,0,0
1/08/2020,Ethiopia,Selangor,2,1,1
1/08/2020,Finland,Johor,0,0,0
1/08/2020,Finland,Kedah,0,0,0
1/08/2020,Finland,Kelantan,0,0,0
1/08/2020,Finland,Melaka,0,0,0
1/08/2020,Finland,Negeri Sembilan,0,0,0
1/08/2020,Finland,Pahang,0,0,0
1/08/2020,Finland,Perak,0,0,0
1/08/2020,Finland,Perlis,0,0,0
1/08/2020,Finland,Pulau Pinang,0,0,0
1/08/2020,Finland,Sabah,0,0,0
1/08/2020,Finland,Sarawak,0,0,0
1/08/2020,Finland,Selangor,10,5,5
1/08/2020,Finland,W.P. Labuan,0,0,0
1/08/2020,Fiji,Johor,0,0,0
1/08/2020,Fiji,Kedah,0,0,0
1/08/2020,Fiji,Kelantan,0,0,0
1/08/2020,Fiji,Perak,0,0,0
1/08/2020,Fiji,Perlis,0,0,0
1/08/2020,Fiji,Pulau Pinang,0,0,0
1/08/2020,Fiji,Sabah,0,0,0
1/08/2020,Fiji,Sarawak,0,0,0
1/08/2020,Fiji,Selangor,1,1,0
1/08/2020,France,Johor,0,0,0
1/08/2020,France,Kedah,0,0,0
1/08/2020,France,Kelantan,0,0,0
1/08/2020,France,Melaka,0,0,0
1/08/2020,France,Negeri Sembilan,0,0,0
1/08/2020,France,Pahang,0,0,0
1/08/2020,France,Perak,0,0,0
1/08/2020,France,Perlis,0,0,0
1/08/2020,France,Pulau Pinang,0,0,0
1/08/2020,France,Sabah,1,1,0
1/08/2020,France,Sarawak,0,0,0
1/08/2020,France,Selangor,120,72,48
1/08/2020,France,Terengganu,0,0,0
1/08/2020,France,W.P. Labuan,0,0,0
1/08/2020,"Micronesia, Federated States of",Johor,0,0,0
1/08/2020,"Micronesia, Federated States of",Pulau Pinang,0,0,0
1/08/2020,"Micronesia, Federated States of",Selangor,0,0,0
1/08/2020,Gabon,Johor,0,0,0
1/08/2020,Gabon,Pulau Pinang,0,0,0
1/08/2020,Gabon,Sarawak,0,0,0
1/08/2020,Gabon,Selangor,1,1,0
1/08/2020,United Kingdom of Great Britain and Northern Ireland,Johor,6,5,1
1/08/2020,United Kingdom of Great Britain and Northern Ireland,Kedah,0,0,0
1/08/2020,United Kingdom of Great Britain and Northern Ireland,Kelantan,0,0,0
1/08/2020,United Kingdom of Great Britain and Northern Ireland,Melaka,0,0,0
1/08/2020,United Kingdom of Great Britain and Northern Ireland,Negeri Sembilan,0,0,0
1/08/2020,United Kingdom of Great Britain and Northern Ireland,Pahang,0,0,0
1/08/2020,United Kingdom of Great Britain and Northern Ireland,Perak,1,1,0
1/08/2020,United Kingdom of Great Britain and Northern Ireland,Perlis,0,0,0
1/08/2020,United Kingdom of Great Britain and Northern Ireland,Pulau Pinang,0,0,0
1/08/2020,United Kingdom of Great Britain and Northern Ireland,Sabah,3,1,2
1/08/2020,United Kingdom of Great Britain and Northern Ireland,Sarawak,2,0,2
1/08/2020,United Kingdom of Great Britain and Northern Ireland,Selangor,353,217,136
1/08/2020,United Kingdom of Great Britain and Northern Ireland,Terengganu,0,0,0
1/08/2020,United Kingdom of Great Britain and Northern Ireland,W.P. Labuan,0,0,0
1/08/2020,Georgia,Johor,0,0,0
1/08/2020,Georgia,Kedah,0,0,0
1/08/2020,Georgia,Melaka,0,0,0
1/08/2020,Georgia,Perak,0,0,0
1/08/2020,Georgia,Perlis,0,0,0
1/08/2020,Georgia,Pulau Pinang,0,0,0
1/08/2020,Georgia,Sabah,0,0,0
1/08/2020,Georgia,Sarawak,0,0,0
1/08/2020,Georgia,Selangor,3,3,0
1/08/2020,Ghana,Johor,0,0,0
1/08/2020,Ghana,Kedah,0,0,0
1/08/2020,Ghana,Kelantan,0,0,0
1/08/2020,Ghana,Pulau Pinang,0,0,0
1/08/2020,Ghana,Sabah,0,0,0
1/08/2020,Ghana,Sarawak,0,0,0
1/08/2020,Ghana,Selangor,0,0,0
1/08/2020,Gibraltar,Johor,0,0,0
1/08/2020,Gibraltar,Sarawak,0,0,0
1/08/2020,Guinea,Johor,0,0,0
1/08/2020,Guinea,Kedah,0,0,0
1/08/2020,Guinea,Kelantan,0,0,0
1/08/2020,Guinea,Perlis,0,0,0
1/08/2020,Guinea,Pulau Pinang,0,0,0
1/08/2020,Guinea,Sabah,0,0,0
1/08/2020,Guinea,Sarawak,0,0,0
1/08/2020,Guinea,Selangor,0,0,0
1/08/2020,Guadeloupe,Selangor,0,0,0
1/08/2020,Gambia,Johor,0,0,0
1/08/2020,Gambia,Kedah,0,0,0
1/08/2020,Gambia,Kelantan,0,0,0
1/08/2020,Gambia,Pulau Pinang,0,0,0
1/08/2020,Gambia,Sabah,0,0,0
1/08/2020,Gambia,Sarawak,0,0,0
1/08/2020,Gambia,Selangor,0,0,0
1/08/2020,Guinea-Bissau,Johor,0,0,0
1/08/2020,Guinea-Bissau,Selangor,0,0,0
1/08/2020,Equatorial Guinea,Johor,0,0,0
1/08/2020,Equatorial Guinea,Selangor,0,0,0
1/08/2020,Greece,Johor,0,0,0
1/08/2020,Greece,Kedah,0,0,0
1/08/2020,Greece,Kelantan,0,0,0
1/08/2020,Greece,Melaka,0,0,0
1/08/2020,Greece,Negeri Sembilan,0,0,0
1/08/2020,Greece,Pahang,0,0,0
1/08/2020,Greece,Perak,0,0,0
1/08/2020,Greece,Perlis,0,0,0
1/08/2020,Greece,Pulau Pinang,0,0,0
1/08/2020,Greece,Sabah,0,0,0
1/08/2020,Greece,Sarawak,0,0,0
1/08/2020,Greece,Selangor,15,14,1
1/08/2020,Grenada,Johor,0,0,0
1/08/2020,Grenada,Kedah,0,0,0
1/08/2020,Grenada,Pulau Pinang,0,0,0
1/08/2020,Grenada,Sabah,0,0,0
1/08/2020,Grenada,Sarawak,0,0,0
1/08/2020,Grenada,Selangor,0,0,0
1/08/2020,Greenland,Johor,0,0,0
1/08/2020,Greenland,Selangor,0,0,0
1/08/2020,Guatemala,Johor,0,0,0
1/08/2020,Guatemala,Kedah,0,0,0
1/08/2020,Guatemala,Pahang,0,0,0
1/08/2020,Guatemala,Perak,0,0,0
1/08/2020,Guatemala,Pulau Pinang,0,0,0
1/08/2020,Guatemala,Sabah,0,0,0
1/08/2020,Guatemala,Sarawak,0,0,0
1/08/2020,Guatemala,Selangor,0,0,0
1/08/2020,Guatemala,W.P. Labuan,0,0,0
1/08/2020,Guyana,Johor,0,0,0
1/08/2020,Guyana,Kedah,0,0,0
1/08/2020,Guyana,Pulau Pinang,0,0,0
1/08/2020,Guyana,Sarawak,0,0,0
1/08/2020,Guyana,Selangor,0,0,0
1/08/2020,Hong Kong,Johor,0,0,0
1/08/2020,Hong Kong,Kedah,0,0,0
1/08/2020,Hong Kong,Kelantan,0,0,0
1/08/2020,Hong Kong,Pahang,0,0,0
1/08/2020,Hong Kong,Perak,1,0,1
1/08/2020,Hong Kong,Perlis,0,0,0
1/08/2020,Hong Kong,Pulau Pinang,0,0,0
1/08/2020,Hong Kong,Sabah,0,0,0
1/08/2020,Hong Kong,Sarawak,1,1,0
1/08/2020,Hong Kong,Selangor,0,0,0
1/08/2020,Hong Kong,Terengganu,0,0,0
1/08/2020,Heard Island and McDonald Islands,Johor,0,0,0
1/08/2020,Honduras,Johor,0,0,0
1/08/2020,Honduras,Kedah,0,0,0
1/08/2020,Honduras,Perak,0,0,0
1/08/2020,Honduras,Pulau Pinang,0,0,0
1/08/2020,Honduras,Sabah,0,0,0
1/08/2020,Honduras,Sarawak,0,0,0
1/08/2020,Honduras,Selangor,0,0,0
1/08/2020,Croatia,Johor,4,4,0
1/08/2020,Croatia,Kedah,0,0,0
1/08/2020,Croatia,Kelantan,0,0,0
1/08/2020,Croatia,Melaka,0,0,0
1/08/2020,Croatia,Pahang,0,0,0
1/08/2020,Croatia,Perak,0,0,0
1/08/2020,Croatia,Perlis,0,0,0
1/08/2020,Croatia,Pulau Pinang,0,0,0
1/08/2020,Croatia,Sabah,0,0,0
1/08/2020,Croatia,Sarawak,0,0,0
1/08/2020,Croatia,Selangor,20,19,1
1/08/2020,Haiti,Johor,0,0,0
1/08/2020,Haiti,Kedah,0,0,0
1/08/2020,Haiti,Kelantan,0,0,0
1/08/2020,Haiti,Perak,0,0,0
1/08/2020,Haiti,Pulau Pinang,0,0,0
1/08/2020,Haiti,Sabah,0,0,0
1/08/2020,Haiti,Selangor,0,0,0
1/08/2020,Hungary,Johor,0,0,0
1/08/2020,Hungary,Kedah,0,0,0
1/08/2020,Hungary,Kelantan,0,0,0
1/08/2020,Hungary,Pahang,0,0,0
1/08/2020,Hungary,Perak,0,0,0
1/08/2020,Hungary,Perlis,0,0,0
1/08/2020,Hungary,Pulau Pinang,0,0,0
1/08/2020,Hungary,Sabah,0,0,0
1/08/2020,Hungary,Sarawak,0,0,0
1/08/2020,Hungary,Selangor,8,5,3
1/08/2020,Hungary,W.P. Labuan,0,0,0
1/08/2020,Indonesia,Johor,162,139,23
1/08/2020,Indonesia,Kedah,3,3,0
1/08/2020,Indonesia,Kelantan,0,0,0
1/08/2020,Indonesia,Melaka,0,0,0
1/08/2020,Indonesia,Negeri Sembilan,0,0,0
1/08/2020,Indonesia,Pahang,0,0,0
1/08/2020,Indonesia,Perak,0,0,0
1/08/2020,Indonesia,Perlis,5,4,1
1/08/2020,Indonesia,Pulau Pinang,5,2,3
1/08/2020,Indonesia,Sabah,9,3,6
1/08/2020,Indonesia,Sarawak,516,456,60
1/08/2020,Indonesia,Selangor,589,351,238
1/08/2020,Indonesia,Terengganu,0,0,0
1/08/2020,Indonesia,W.P. Labuan,0,0,0
1/08/2020,India,Johor,75,74,1
1/08/2020,India,Kedah,0,0,0
1/08/2020,India,Kelantan,0,0,0
1/08/2020,India,Melaka,0,0,0
1/08/2020,India,Negeri Sembilan,0,0,0
1/08/2020,India,Pahang,0,0,0
1/08/2020,India,Perak,0,0,0
1/08/2020,India,Perlis,0,0,0
1/08/2020,India,Pulau Pinang,0,0,0
1/08/2020,India,Sabah,1,0,1
1/08/2020,India,Sarawak,0,0,0
1/08/2020,India,Selangor,689,427,262
1/08/2020,India,Terengganu,0,0,0
1/08/2020,India,W.P. Labuan,0,0,0
1/08/2020, British Indian Ocean Territory,Pulau Pinang,0,0,0
1/08/2020, British Indian Ocean Territory,Selangor,0,0,0
1/08/2020,Ireland,Johor,0,0,0
1/08/2020,Ireland,Kedah,0,0,0
1/08/2020,Ireland,Kelantan,0,0,0
1/08/2020,Ireland,Negeri Sembilan,0,0,0
1/08/2020,Ireland,Pahang,0,0,0
1/08/2020,Ireland,Perak,0,0,0
1/08/2020,Ireland,Perlis,0,0,0
1/08/2020,Ireland,Pulau Pinang,0,0,0
1/08/2020,Ireland,Sabah,0,0,0
1/08/2020,Ireland,Sarawak,0,0,0
1/08/2020,Ireland,Selangor,22,14,8
1/08/2020,Ireland,Terengganu,0,0,0
1/08/2020,Ireland,W.P. Labuan,0,0,0
1/08/2020,"Iran, Islamic Republic of",Johor,0,0,0
1/08/2020,"Iran, Islamic Republic of",Kedah,0,0,0
1/08/2020,"Iran, Islamic Republic of",Kelantan,0,0,0
1/08/2020,"Iran, Islamic Republic of",Perak,0,0,0
1/08/2020,"Iran, Islamic Republic of",Perlis,0,0,0
1/08/2020,"Iran, Islamic Republic of",Pulau Pinang,0,0,0
1/08/2020,"Iran, Islamic Republic of",Sabah,0,0,0
1/08/2020,"Iran, Islamic Republic of",Sarawak,1,0,1
1/08/2020,"Iran, Islamic Republic of",Selangor,23,10,13
1/08/2020,"Iran, Islamic Republic of",W.P. Labuan,0,0,0
1/08/2020,Iraq,Johor,0,0,0
1/08/2020,Iraq,Kedah,0,0,0
1/08/2020,Iraq,Kelantan,0,0,0
1/08/2020,Iraq,Melaka,0,0,0
1/08/2020,Iraq,Pahang,0,0,0
1/08/2020,Iraq,Perak,0,0,0
1/08/2020,Iraq,Perlis,0,0,0
1/08/2020,Iraq,Pulau Pinang,0,0,0
1/08/2020,Iraq,Sabah,0,0,0
1/08/2020,Iraq,Sarawak,0,0,0
1/08/2020,Iraq,Selangor,10,10,0
1/08/2020,Iceland,Johor,0,0,0
1/08/2020,Iceland,Kedah,0,0,0
1/08/2020,Iceland,Kelantan,0,0,0
1/08/2020,Iceland,Perak,0,0,0
1/08/2020,Iceland,Perlis,0,0,0
1/08/2020,Iceland,Pulau Pinang,0,0,0
1/08/2020,Iceland,Sabah,0,0,0
1/08/2020,Iceland,Sarawak,0,0,0
1/08/2020,Iceland,Selangor,0,0,0
1/08/2020,Iceland,W.P. Labuan,0,0,0
1/08/2020,Israel,Pulau Pinang,0,0,0
1/08/2020,Italy,Johor,0,0,0
1/08/2020,Italy,Kedah,0,0,0
1/08/2020,Italy,Kelantan,0,0,0
1/08/2020,Italy,Melaka,0,0,0
1/08/2020,Italy,Negeri Sembilan,0,0,0
1/08/2020,Italy,Pahang,0,0,0
1/08/2020,Italy,Perak,1,1,0
1/08/2020,Italy,Perlis,0,0,0
1/08/2020,Italy,Pulau Pinang,0,0,0
1/08/2020,Italy,Sabah,0,0,0
1/08/2020,Italy,Sarawak,0,0,0
1/08/2020,Italy,Selangor,17,15,2
1/08/2020,Italy,W.P. Labuan,0,0,0
1/08/2020,Jamaica,Johor,0,0,0
1/08/2020,Jamaica,Kedah,0,0,0
1/08/2020,Jamaica,Perak,0,0,0
1/08/2020,Jamaica,Pulau Pinang,0,0,0
1/08/2020,Jamaica,Sabah,0,0,0
1/08/2020,Jamaica,Sarawak,0,0,0
1/08/2020,Jamaica,Selangor,0,0,0
1/08/2020,Jamaica,W.P. Labuan,0,0,0
1/08/2020,Jordan,Johor,0,0,0
1/08/2020,Jordan,Kedah,0,0,0
1/08/2020,Jordan,Kelantan,0,0,0
1/08/2020,Jordan,Melaka,0,0,0
1/08/2020,Jordan,Perlis,0,0,0
1/08/2020,Jordan,Pulau Pinang,0,0,0
1/08/2020,Jordan,Sabah,1,1,0
1/08/2020,Jordan,Sarawak,0,0,0
1/08/2020,Jordan,Selangor,6,4,2
1/08/2020,Jordan,W.P. Labuan,0,0,0
1/08/2020,Japan,Johor,6,6,0
1/08/2020,Japan,Kedah,1,1,0
1/08/2020,Japan,Kelantan,0,0,0
1/08/2020,Japan,Melaka,0,0,0
1/08/2020,Japan,Negeri Sembilan,0,0,0
1/08/2020,Japan,Pahang,0,0,0
1/08/2020,Japan,Perak,0,0,0
1/08/2020,Japan,Perlis,0,0,0
1/08/2020,Japan,Pulau Pinang,0,0,0
1/08/2020,Japan,Sabah,2,1,1
1/08/2020,Japan,Sarawak,0,0,0
1/08/2020,Japan,Selangor,408,274,134
1/08/2020,Japan,W.P. Labuan,0,0,0
1/08/2020,Kazakhstan,Johor,0,0,0
1/08/2020,Kazakhstan,Kedah,0,0,0
1/08/2020,Kazakhstan,Kelantan,0,0,0
1/08/2020,Kazakhstan,Melaka,0,0,0
1/08/2020,Kazakhstan,Perak,0,0,0
1/08/2020,Kazakhstan,Perlis,0,0,0
1/08/2020,Kazakhstan,Pulau Pinang,0,0,0
1/08/2020,Kazakhstan,Sabah,1,0,1
1/08/2020,Kazakhstan,Sarawak,0,0,0
1/08/2020,Kazakhstan,Selangor,18,10,8
1/08/2020,Kazakhstan,W.P. Labuan,0,0,0
1/08/2020,Kenya,Johor,0,0,0
1/08/2020,Kenya,Kedah,0,0,0
1/08/2020,Kenya,Kelantan,0,0,0
1/08/2020,Kenya,Perak,0,0,0
1/08/2020,Kenya,Perlis,0,0,0
1/08/2020,Kenya,Pulau Pinang,0,0,0
1/08/2020,Kenya,Sabah,0,0,0
1/08/2020,Kenya,Sarawak,0,0,0
1/08/2020,Kenya,Selangor,9,3,6
1/08/2020,Kyrgyzstan,Johor,0,0,0
1/08/2020,Kyrgyzstan,Kedah,0,0,0
1/08/2020,Kyrgyzstan,Kelantan,0,0,0
1/08/2020,Kyrgyzstan,Perak,0,0,0
1/08/2020,Kyrgyzstan,Perlis,0,0,0
1/08/2020,Kyrgyzstan,Pulau Pinang,0,0,0
1/08/2020,Kyrgyzstan,Sabah,0,0,0
1/08/2020,Kyrgyzstan,Sarawak,0,0,0
1/08/2020,Kyrgyzstan,Selangor,1,1,0
1/08/2020,Cambodia,Johor,0,0,0
1/08/2020,Cambodia,Kedah,0,0,0
1/08/2020,Cambodia,Kelantan,0,0,0
1/08/2020,Cambodia,Melaka,0,0,0
1/08/2020,Cambodia,Negeri Sembilan,0,0,0
1/08/2020,Cambodia,Pahang,0,0,0
1/08/2020,Cambodia,Perak,0,0,0
1/08/2020,Cambodia,Perlis,0,0,0
1/08/2020,Cambodia,Pulau Pinang,0,0,0
1/08/2020,Cambodia,Sabah,0,0,0
1/08/2020,Cambodia,Sarawak,0,0,0
1/08/2020,Cambodia,Selangor,1,0,1
1/08/2020,Cambodia,W.P. Labuan,0,0,0
1/08/2020,Kiribati,Johor,0,0,0
1/08/2020,Kiribati,Sabah,0,0,0
1/08/2020,Kiribati,Selangor,0,0,0
1/08/2020,Saint Kitts and Nevis,Johor,0,0,0
1/08/2020,Saint Kitts and Nevis,Kedah,0,0,0
1/08/2020,Saint Kitts and Nevis,Perlis,0,0,0
1/08/2020,Saint Kitts and Nevis,Pulau Pinang,0,0,0
1/08/2020,Saint Kitts and Nevis,Sabah,0,0,0
1/08/2020,Saint Kitts and Nevis,Selangor,0,0,0
1/08/2020,Saint Kitts and Nevis,W.P. Labuan,0,0,0
1/08/2020,"Korea, Republic of",Johor,2,2,0
1/08/2020,"Korea, Republic of",Kedah,0,0,0
1/08/2020,"Korea, Republic of",Kelantan,0,0,0
1/08/2020,"Korea, Republic of",Melaka,0,0,0
1/08/2020,"Korea, Republic of",Negeri Sembilan,0,0,0
1/08/2020,"Korea, Republic of",Pahang,0,0,0
1/08/2020,"Korea, Republic of",Perak,0,0,0
1/08/2020,"Korea, Republic of",Perlis,0,0,0
1/08/2020,"Korea, Republic of",Pulau Pinang,0,0,0
1/08/2020,"Korea, Republic of",Sabah,4,1,3
1/08/2020,"Korea, Republic of",Sarawak,2,2,0
1/08/2020,"Korea, Republic of",Selangor,358,172,186
1/08/2020,"Korea, Republic of",Terengganu,0,0,0
1/08/2020,"Korea, Republic of",W.P. Labuan,0,0,0
1/08/2020,Kuwait,Johor,0,0,0
1/08/2020,Kuwait,Kedah,0,0,0
1/08/2020,Kuwait,Kelantan,0,0,0
1/08/2020,Kuwait,Perak,0,0,0
1/08/2020,Kuwait,Perlis,0,0,0
1/08/2020,Kuwait,Pulau Pinang,0,0,0
1/08/2020,Kuwait,Sabah,0,0,0
1/08/2020,Kuwait,Sarawak,0,0,0
1/08/2020,Kuwait,Selangor,1,1,0
1/08/2020,Kuwait,W.P. Labuan,0,0,0
1/08/2020, Lao People's Democratic Republic,Johor,0,0,0
1/08/2020, Lao People's Democratic Republic,Kedah,0,0,0
1/08/2020, Lao People's Democratic Republic,Kelantan,0,0,0
1/08/2020, Lao People's Democratic Republic,Melaka,0,0,0
1/08/2020, Lao People's Democratic Republic,Perak,0,0,0
1/08/2020, Lao People's Democratic Republic,Perlis,0,0,0
1/08/2020, Lao People's Democratic Republic,Pulau Pinang,1,1,0
1/08/2020, Lao People's Democratic Republic,Sabah,0,0,0
1/08/2020, Lao People's Democratic Republic,Sarawak,0,0,0
1/08/2020, Lao People's Democratic Republic,Selangor,0,0,0
1/08/2020, Lao People's Democratic Republic,W.P. Labuan,0,0,0
1/08/2020,Lebanon,Johor,0,0,0
1/08/2020,Lebanon,Kedah,0,0,0
1/08/2020,Lebanon,Kelantan,0,0,0
1/08/2020,Lebanon,Pahang,0,0,0
1/08/2020,Lebanon,Perak,0,0,0
1/08/2020,Lebanon,Perlis,0,0,0
1/08/2020,Lebanon,Pulau Pinang,0,0,0
1/08/2020,Lebanon,Sabah,0,0,0
1/08/2020,Lebanon,Sarawak,0,0,0
1/08/2020,Lebanon,Selangor,0,0,0
1/08/2020,Lebanon,W.P. Labuan,0,0,0
1/08/2020,Liberia,Johor,0,0,0
1/08/2020,Liberia,Kedah,0,0,0
1/08/2020,Liberia,Sabah,0,0,0
1/08/2020,Liberia,Sarawak,0,0,0
1/08/2020,Liberia,Selangor,0,0,0
1/08/2020,Libya,Johor,0,0,0
1/08/2020,Libya,Kedah,0,0,0
1/08/2020,Libya,Perlis,0,0,0
1/08/2020,Libya,Pulau Pinang,0,0,0
1/08/2020,Libya,Sabah,0,0,0
1/08/2020,Libya,Sarawak,0,0,0
1/08/2020,Libya,Selangor,1,1,0
1/08/2020,Saint Lucia,Johor,0,0,0
1/08/2020,Saint Lucia,Kedah,0,0,0
1/08/2020,Saint Lucia,Pulau Pinang,0,0,0
1/08/2020,Saint Lucia,Sarawak,0,0,0
1/08/2020,Saint Lucia,Selangor,0,0,0
1/08/2020,Liechtenstein,Johor,0,0,0
1/08/2020,Liechtenstein,Kedah,0,0,0
1/08/2020,Liechtenstein,Perlis,0,0,0
1/08/2020,Liechtenstein,Pulau Pinang,0,0,0
1/08/2020,Liechtenstein,Sabah,0,0,0
1/08/2020,Liechtenstein,Sarawak,0,0,0
1/08/2020,Liechtenstein,Selangor,0,0,0
1/08/2020,LKA,Johor,1,1,0
1/08/2020,LKA,Kedah,0,0,0
1/08/2020,LKA,Kelantan,0,0,0
1/08/2020,LKA,Melaka,0,0,0
1/08/2020,LKA,Pahang,0,0,0
1/08/2020,LKA,Perak,0,0,0
1/08/2020,LKA,Perlis,0,0,0
1/08/2020,LKA,Pulau Pinang,0,0,0
1/08/2020,LKA,Sabah,0,0,0
1/08/2020,LKA,Sarawak,0,0,0
1/08/2020,LKA,Selangor,35,27,8
1/08/2020,LKA,W.P. Labuan,0,0,0
1/08/2020,Lesotho,Johor,0,0,0
1/08/2020,Lesotho,Kedah,0,0,0
1/08/2020,Lesotho,Pulau Pinang,0,0,0
1/08/2020,Lesotho,Sarawak,0,0,0
1/08/2020,Lesotho,Selangor,0,0,0
1/08/2020,Lithuania,Johor,0,0,0
1/08/2020,Lithuania,Kedah,0,0,0
1/08/2020,Lithuania,Kelantan,0,0,0
1/08/2020,Lithuania,Pahang,0,0,0
1/08/2020,Lithuania,Perak,0,0,0
1/08/2020,Lithuania,Perlis,0,0,0
1/08/2020,Lithuania,Pulau Pinang,0,0,0
1/08/2020,Lithuania,Sabah,0,0,0
1/08/2020,Lithuania,Sarawak,0,0,0
1/08/2020,Lithuania,Selangor,8,8,0
1/08/2020,Lithuania,W.P. Labuan,0,0,0
1/08/2020,Luxembourg,Johor,0,0,0
1/08/2020,Luxembourg,Kedah,0,0,0
1/08/2020,Luxembourg,Kelantan,0,0,0
1/08/2020,Luxembourg,Perak,0,0,0
1/08/2020,Luxembourg,Perlis,0,0,0
1/08/2020,Luxembourg,Pulau Pinang,0,0,0
1/08/2020,Luxembourg,Sabah,0,0,0
1/08/2020,Luxembourg,Sarawak,0,0,0
1/08/2020,Luxembourg,Selangor,0,0,0
1/08/2020,Latvia,Johor,0,0,0
1/08/2020,Latvia,Kedah,0,0,0
1/08/2020,Latvia,Kelantan,0,0,0
1/08/2020,Latvia,Pahang,0,0,0
1/08/2020,Latvia,Perak,0,0,0
1/08/2020,Latvia,Perlis,0,0,0
1/08/2020,Latvia,Pulau Pinang,0,0,0
1/08/2020,Latvia,Sabah,0,0,0
1/08/2020,Latvia,Sarawak,0,0,0
1/08/2020,Latvia,Selangor,6,6,0
1/08/2020,Latvia,W.P. Labuan,0,0,0
1/08/2020,Macao,Johor,0,0,0
1/08/2020,Macao,Pahang,0,0,0
1/08/2020,Macao,Perak,0,0,0
1/08/2020,Macao,Selangor,0,0,0
1/08/2020,Macao,W.P. Labuan,0,0,0
1/08/2020,Morocco,Johor,0,0,0
1/08/2020,Morocco,Kedah,0,0,0
1/08/2020,Morocco,Kelantan,0,0,0
1/08/2020,Morocco,Melaka,0,0,0
1/08/2020,Morocco,Pahang,0,0,0
1/08/2020,Morocco,Perak,0,0,0
1/08/2020,Morocco,Perlis,0,0,0
1/08/2020,Morocco,Pulau Pinang,0,0,0
1/08/2020,Morocco,Sabah,0,0,0
1/08/2020,Morocco,Sarawak,0,0,0
1/08/2020,Morocco,Selangor,0,0,0
1/08/2020,Morocco,W.P. Labuan,0,0,0
1/08/2020,Monaco,Johor,0,0,0
1/08/2020,Monaco,Kedah,0,0,0
1/08/2020,Monaco,Sabah,0,0,0
1/08/2020,Monaco,Selangor,0,0,0
1/08/2020,"Moldova, Republic of",Johor,0,0,0
1/08/2020,"Moldova, Republic of",Kedah,0,0,0
1/08/2020,"Moldova, Republic of",Kelantan,0,0,0
1/08/2020,"Moldova, Republic of",Negeri Sembilan,0,0,0
1/08/2020,"Moldova, Republic of",Perlis,0,0,0
1/08/2020,"Moldova, Republic of",Pulau Pinang,0,0,0
1/08/2020,"Moldova, Republic of",Sabah,0,0,0
1/08/2020,"Moldova, Republic of",Sarawak,0,0,0
1/08/2020,"Moldova, Republic of",Selangor,0,0,0
1/08/2020,Madagascar,Johor,0,0,0
1/08/2020,Madagascar,Kedah,0,0,0
1/08/2020,Madagascar,Perak,0,0,0
1/08/2020,Madagascar,Perlis,0,0,0
1/08/2020,Madagascar,Pulau Pinang,0,0,0
1/08/2020,Madagascar,Sabah,0,0,0
1/08/2020,Madagascar,Sarawak,0,0,0
1/08/2020,Madagascar,Selangor,0,0,0
1/08/2020,Maldives,Johor,0,0,0
1/08/2020,Maldives,Kedah,0,0,0
1/08/2020,Maldives,Kelantan,0,0,0
1/08/2020,Maldives,Perak,0,0,0
1/08/2020,Maldives,Perlis,0,0,0
1/08/2020,Maldives,Pulau Pinang,0,0,0
1/08/2020,Maldives,Sabah,0,0,0
1/08/2020,Maldives,Sarawak,0,0,0
1/08/2020,Maldives,Selangor,54,22,32
1/08/2020,Mexico,Johor,10,10,0
1/08/2020,Mexico,Kedah,0,0,0
1/08/2020,Mexico,Kelantan,0,0,0
1/08/2020,Mexico,Pahang,0,0,0
1/08/2020,Mexico,Perak,0,0,0
1/08/2020,Mexico,Perlis,0,0,0
1/08/2020,Mexico,Pulau Pinang,0,0,0
1/08/2020,Mexico,Sabah,0,0,0
1/08/2020,Mexico,Sarawak,0,0,0
1/08/2020,Mexico,Selangor,72,6,66
1/08/2020,Mexico,W.P. Labuan,0,0,0
1/08/2020,Marshall Islands,Johor,0,0,0
1/08/2020,Marshall Islands,Kedah,0,0,0
1/08/2020,Marshall Islands,Perak,0,0,0
1/08/2020,Marshall Islands,Pulau Pinang,0,0,0
1/08/2020,Marshall Islands,Sabah,0,0,0
1/08/2020,Marshall Islands,Selangor,0,0,0
1/08/2020,North Macedonia,Johor,0,0,0
1/08/2020,North Macedonia,Kedah,0,0,0
1/08/2020,North Macedonia,Perak,0,0,0
1/08/2020,North Macedonia,Pulau Pinang,0,0,0
1/08/2020,North Macedonia,Sabah,0,0,0
1/08/2020,North Macedonia,Sarawak,0,0,0
1/08/2020,North Macedonia,Selangor,0,0,0
1/08/2020,Mali,Johor,0,0,0
1/08/2020,Mali,Sabah,0,0,0
1/08/2020,Mali,Selangor,0,0,0
1/08/2020,Malta,Johor,0,0,0
1/08/2020,Malta,Kedah,0,0,0
1/08/2020,Malta,Kelantan,0,0,0
1/08/2020,Malta,Perak,0,0,0
1/08/2020,Malta,Perlis,0,0,0
1/08/2020,Malta,Pulau Pinang,0,0,0
1/08/2020,Malta,Sabah,0,0,0
1/08/2020,Malta,Sarawak,0,0,0
1/08/2020,Malta,Selangor,4,4,0
1/08/2020,Malta,W.P. Labuan,0,0,0
1/08/2020,Myanmar,Johor,13,13,0
1/08/2020,Myanmar,Kedah,0,0,0
1/08/2020,Myanmar,Kelantan,0,0,0
1/08/2020,Myanmar,Negeri Sembilan,0,0,0
1/08/2020,Myanmar,Pahang,0,0,0
1/08/2020,Myanmar,Perak,0,0,0
1/08/2020,Myanmar,Perlis,0,0,0
1/08/2020,Myanmar,Pulau Pinang,0,0,0
1/08/2020,Myanmar,Sabah,1,0,1
1/08/2020,Myanmar,Sarawak,0,0,0
1/08/2020,Myanmar,Selangor,82,73,9
1/08/2020,Myanmar,Terengganu,0,0,0
1/08/2020,Myanmar,W.P. Labuan,0,0,0
1/08/2020,Montenegro,Johor,0,0,0
1/08/2020,Montenegro,Kedah,0,0,0
1/08/2020,Montenegro,Pulau Pinang,0,0,0
1/08/2020,Montenegro,Sabah,0,0,0
1/08/2020,Montenegro,Sarawak,0,0,0
1/08/2020,Montenegro,Selangor,1,1,0
1/08/2020,Mongolia,Johor,0,0,0
1/08/2020,Mongolia,Kedah,0,0,0
1/08/2020,Mongolia,Kelantan,0,0,0
1/08/2020,Mongolia,Perak,0,0,0
1/08/2020,Mongolia,Perlis,0,0,0
1/08/2020,Mongolia,Pulau Pinang,0,0,0
1/08/2020,Mongolia,Sabah,0,0,0
1/08/2020,Mongolia,Sarawak,0,0,0
1/08/2020,Mongolia,Selangor,3,0,3
1/08/2020,Northern Mariana Islands,Selangor,0,0,0
1/08/2020,Mozambique,Johor,0,0,0
1/08/2020,Mozambique,Kedah,0,0,0
1/08/2020,Mozambique,Perak,0,0,0
1/08/2020,Mozambique,Pulau Pinang,0,0,0
1/08/2020,Mozambique,Sabah,0,0,0
1/08/2020,Mozambique,Sarawak,0,0,0
1/08/2020,Mozambique,Selangor,0,0,0
1/08/2020,Mauritania,Johor,0,0,0
1/08/2020,Mauritania,Kedah,0,0,0
1/08/2020,Mauritania,Pulau Pinang,0,0,0
1/08/2020,Mauritania,Sabah,0,0,0
1/08/2020,Mauritania,Sarawak,0,0,0
1/08/2020,Mauritania,Selangor,0,0,0
1/08/2020,Mauritius,Johor,0,0,0
1/08/2020,Mauritius,Kedah,0,0,0
1/08/2020,Mauritius,Kelantan,0,0,0
1/08/2020,Mauritius,Pahang,0,0,0
1/08/2020,Mauritius,Perak,0,0,0
1/08/2020,Mauritius,Perlis,0,0,0
1/08/2020,Mauritius,Pulau Pinang,0,0,0
1/08/2020,Mauritius,Sabah,0,0,0
1/08/2020,Mauritius,Sarawak,0,0,0
1/08/2020,Mauritius,Selangor,1,0,1
1/08/2020,Malawi,Johor,0,0,0
1/08/2020,Malawi,Pulau Pinang,0,0,0
1/08/2020,Malawi,Sabah,0,0,0
1/08/2020,Malawi,Sarawak,0,0,0
1/08/2020,Malawi,Selangor,0,0,0
1/08/2020,Mayotte,Selangor,0,0,0
1/08/2020,Namibia,Johor,0,0,0
1/08/2020,Namibia,Kedah,0,0,0
1/08/2020,Namibia,Perak,0,0,0
1/08/2020,Namibia,Perlis,0,0,0
1/08/2020,Namibia,Pulau Pinang,0,0,0
1/08/2020,Namibia,Sabah,0,0,0
1/08/2020,Namibia,Sarawak,0,0,0
1/08/2020,Namibia,Selangor,0,0,0
1/08/2020,New Caledonia,Selangor,0,0,0
1/08/2020,Niger,Johor,0,0,0
1/08/2020,Niger,Sabah,0,0,0
1/08/2020,Niger,Selangor,0,0,0
1/08/2020,Nigeria,Johor,0,0,0
1/08/2020,Nigeria,Kedah,0,0,0
1/08/2020,Nigeria,Perlis,0,0,0
1/08/2020,Nigeria,Pulau Pinang,0,0,0
1/08/2020,Nigeria,Sabah,0,0,0
1/08/2020,Nigeria,Sarawak,0,0,0
1/08/2020,Nigeria,Selangor,10,3,7
1/08/2020,Nicaragua,Johor,0,0,0
1/08/2020,Nicaragua,Kedah,0,0,0
1/08/2020,Nicaragua,Pulau Pinang,0,0,0
1/08/2020,Nicaragua,Sabah,0,0,0
1/08/2020,Nicaragua,Selangor,0,0,0
1/08/2020,Netherlands,Johor,1,1,0
1/08/2020,Netherlands,Kedah,0,0,0
1/08/2020,Netherlands,Kelantan,0,0,0
1/08/2020,Netherlands,Melaka,0,0,0
1/08/2020,Netherlands,Negeri Sembilan,0,0,0
1/08/2020,Netherlands,Pahang,0,0,0
1/08/2020,Netherlands,Perak,0,0,0
1/08/2020,Netherlands,Perlis,0,0,0
1/08/2020,Netherlands,Pulau Pinang,0,0,0
1/08/2020,Netherlands,Sabah,0,0,0
1/08/2020,Netherlands,Sarawak,0,0,0
1/08/2020,Netherlands,Selangor,46,37,9
1/08/2020,Netherlands,Terengganu,0,0,0
1/08/2020,Netherlands,W.P. Labuan,0,0,0
1/08/2020,Norway,Johor,3,3,0
1/08/2020,Norway,Kedah,0,0,0
1/08/2020,Norway,Kelantan,0,0,0
1/08/2020,Norway,Melaka,0,0,0
1/08/2020,Norway,Pahang,0,0,0
1/08/2020,Norway,Perak,0,0,0
1/08/2020,Norway,Perlis,0,0,0
1/08/2020,Norway,Pulau Pinang,0,0,0
1/08/2020,Norway,Sabah,1,0,1
1/08/2020,Norway,Sarawak,0,0,0
1/08/2020,Norway,Selangor,19,17,2
1/08/2020,Norway,W.P. Labuan,0,0,0
1/08/2020,Nepal,Johor,0,0,0
1/08/2020,Nepal,Kedah,0,0,0
1/08/2020,Nepal,Pahang,0,0,0
1/08/2020,Nepal,Perak,0,0,0
1/08/2020,Nepal,Perlis,0,0,0
1/08/2020,Nepal,Pulau Pinang,0,0,0
1/08/2020,Nepal,Sabah,0,0,0
1/08/2020,Nepal,Sarawak,0,0,0
1/08/2020,Nepal,Selangor,7,5,2
1/08/2020,Nepal,W.P. Labuan,0,0,0
1/08/2020,Nauru,Johor,0,0,0
1/08/2020,Nauru,Pulau Pinang,0,0,0
1/08/2020,Nauru,Selangor,0,0,0
1/08/2020,New Zealand,Johor,0,0,0
1/08/2020,New Zealand,Kedah,0,0,0
1/08/2020,New Zealand,Kelantan,0,0,0
1/08/2020,New Zealand,Melaka,0,0,0
1/08/2020,New Zealand,Negeri Sembilan,0,0,0
1/08/2020,New Zealand,Pahang,0,0,0
1/08/2020,New Zealand,Perak,0,0,0
1/08/2020,New Zealand,Perlis,0,0,0
1/08/2020,New Zealand,Pulau Pinang,0,0,0
1/08/2020,New Zealand,Sabah,0,0,0
1/08/2020,New Zealand,Sarawak,0,0,0
1/08/2020,New Zealand,Selangor,117,107,10
1/08/2020,New Zealand,Terengganu,0,0,0
1/08/2020,New Zealand,W.P. Labuan,0,0,0
1/08/2020,Oman,Johor,0,0,0
1/08/2020,Oman,Kedah,0,0,0
1/08/2020,Oman,Kelantan,0,0,0
1/08/2020,Oman,Melaka,0,0,0
1/08/2020,Oman,Perak,0,0,0
1/08/2020,Oman,Perlis,0,0,0
1/08/2020,Oman,Pulau Pinang,0,0,0
1/08/2020,Oman,Sabah,0,0,0
1/08/2020,Oman,Sarawak,0,0,0
1/08/2020,Oman,Selangor,9,5,4
1/08/2020,Pakistan,Johor,0,0,0
1/08/2020,Pakistan,Kedah,0,0,0
1/08/2020,Pakistan,Kelantan,0,0,0
1/08/2020,Pakistan,Melaka,0,0,0
1/08/2020,Pakistan,Negeri Sembilan,0,0,0
1/08/2020,Pakistan,Pahang,0,0,0
1/08/2020,Pakistan,Perak,0,0,0
1/08/2020,Pakistan,Perlis,0,0,0
1/08/2020,Pakistan,Pulau Pinang,0,0,0
1/08/2020,Pakistan,Sabah,1,1,0
1/08/2020,Pakistan,Sarawak,0,0,0
1/08/2020,Pakistan,Selangor,175,150,25
1/08/2020,Pakistan,W.P. Labuan,0,0,0
1/08/2020,Panama,Johor,0,0,0
1/08/2020,Panama,Kedah,0,0,0
1/08/2020,Panama,Perak,0,0,0
1/08/2020,Panama,Perlis,0,0,0
1/08/2020,Panama,Pulau Pinang,0,0,0
1/08/2020,Panama,Sabah,0,0,0
1/08/2020,Panama,Sarawak,0,0,0
1/08/2020,Panama,Selangor,0,0,0
1/08/2020,Peru,Johor,0,0,0
1/08/2020,Peru,Kedah,0,0,0
1/08/2020,Peru,Kelantan,0,0,0
1/08/2020,Peru,Pahang,0,0,0
1/08/2020,Peru,Perak,0,0,0
1/08/2020,Peru,Perlis,0,0,0
1/08/2020,Peru,Pulau Pinang,0,0,0
1/08/2020,Peru,Sabah,0,0,0
1/08/2020,Peru,Sarawak,0,0,0
1/08/2020,Peru,Selangor,5,2,3
1/08/2020,Peru,W.P. Labuan,0,0,0
1/08/2020,Philippines,Johor,69,66,3
1/08/2020,Philippines,Kedah,0,0,0
1/08/2020,Philippines,Kelantan,0,0,0
1/08/2020,Philippines,Melaka,0,0,0
1/08/2020,Philippines,Negeri Sembilan,0,0,0
1/08/2020,Philippines,Pahang,0,0,0
1/08/2020,Philippines,Perak,0,0,0
1/08/2020,Philippines,Perlis,0,0,0
1/08/2020,Philippines,Pulau Pinang,1,0,1
1/08/2020,Philippines,Sabah,3,2,1
1/08/2020,Philippines,Sarawak,39,38,1
1/08/2020,Philippines,Selangor,312,271,41
1/08/2020,Philippines,Terengganu,0,0,0
1/08/2020,Philippines,W.P. Labuan,4,4,0
1/08/2020,Palau,Johor,0,0,0
1/08/2020,Palau,Pulau Pinang,0,0,0
1/08/2020,Palau,Selangor,0,0,0
1/08/2020,Papua New Guinea,Johor,0,0,0
1/08/2020,Papua New Guinea,Kedah,0,0,0
1/08/2020,Papua New Guinea,Kelantan,0,0,0
1/08/2020,Papua New Guinea,Perak,0,0,0
1/08/2020,Papua New Guinea,Pulau Pinang,0,0,0
1/08/2020,Papua New Guinea,Sabah,0,0,0
1/08/2020,Papua New Guinea,Sarawak,0,0,0
1/08/2020,Papua New Guinea,Selangor,0,0,0
1/08/2020,Poland,Johor,0,0,0
1/08/2020,Poland,Kedah,0,0,0
1/08/2020,Poland,Kelantan,0,0,0
1/08/2020,Poland,Melaka,0,0,0
1/08/2020,Poland,Negeri Sembilan,0,0,0
1/08/2020,Poland,Pahang,0,0,0
1/08/2020,Poland,Perak,0,0,0
1/08/2020,Poland,Perlis,0,0,0
1/08/2020,Poland,Pulau Pinang,0,0,0
1/08/2020,Poland,Sabah,0,0,0
1/08/2020,Poland,Sarawak,0,0,0
1/08/2020,Poland,Selangor,23,18,5
1/08/2020,Poland,Terengganu,0,0,0
1/08/2020,Poland,W.P. Labuan,0,0,0
1/08/2020,"North Korea, Democratic People's Republic of",Selangor,0,0,0
1/08/2020,Portugal,Johor,0,0,0
1/08/2020,Portugal,Kedah,0,0,0
1/08/2020,Portugal,Kelantan,0,0,0
1/08/2020,Portugal,Melaka,0,0,0
1/08/2020,Portugal,Pahang,0,0,0
1/08/2020,Portugal,Perak,0,0,0
1/08/2020,Portugal,Perlis,0,0,0
1/08/2020,Portugal,Pulau Pinang,0,0,0
1/08/2020,Portugal,Sabah,0,0,0
1/08/2020,Portugal,Sarawak,0,0,0
1/08/2020,Portugal,Selangor,6,4,2
1/08/2020,Portugal,W.P. Labuan,0,0,0
1/08/2020,Paraguay,Johor,0,0,0
1/08/2020,Paraguay,Kedah,0,0,0
1/08/2020,Paraguay,Perak,0,0,0
1/08/2020,Paraguay,Perlis,0,0,0
1/08/2020,Paraguay,Pulau Pinang,0,0,0
1/08/2020,Paraguay,Sabah,0,0,0
1/08/2020,Paraguay,Sarawak,0,0,0
1/08/2020,Paraguay,Selangor,0,0,0
1/08/2020,"Palestine, State of",Johor,0,0,0
1/08/2020,"Palestine, State of",Kedah,0,0,0
1/08/2020,"Palestine, State of",Kelantan,0,0,0
1/08/2020,"Palestine, State of",Melaka,0,0,0
1/08/2020,"Palestine, State of",Perak,0,0,0
1/08/2020,"Palestine, State of",Perlis,0,0,0
1/08/2020,"Palestine, State of",Pulau Pinang,0,0,0
1/08/2020,"Palestine, State of",Sabah,0,0,0
1/08/2020,"Palestine, State of",Sarawak,0,0,0
1/08/2020,"Palestine, State of",Selangor,6,6,0
1/08/2020,Qatar,Johor,0,0,0
1/08/2020,Qatar,Kedah,0,0,0
1/08/2020,Qatar,Perlis,0,0,0
1/08/2020,Qatar,Pulau Pinang,0,0,0
1/08/2020,Qatar,Sabah,0,0,0
1/08/2020,Qatar,Sarawak,0,0,0
1/08/2020,Qatar,Selangor,1,1,0
1/08/2020,Réunion,Johor,0,0,0
1/08/2020,Réunion,Sarawak,0,0,0
1/08/2020,Romania,Johor,0,0,0
1/08/2020,Romania,Kedah,0,0,0
1/08/2020,Romania,Kelantan,0,0,0
1/08/2020,Romania,Negeri Sembilan,0,0,0
1/08/2020,Romania,Pahang,0,0,0
1/08/2020,Romania,Perak,0,0,0
1/08/2020,Romania,Perlis,0,0,0
1/08/2020,Romania,Pulau Pinang,1,1,0
1/08/2020,Romania,Sabah,0,0,0
1/08/2020,Romania,Sarawak,0,0,0
1/08/2020,Romania,Selangor,16,14,2
1/08/2020,Romania,W.P. Labuan,0,0,0
1/08/2020,Russian Federation (Russia),Johor,6,6,0
1/08/2020,Russian Federation (Russia),Kedah,0,0,0
1/08/2020,Russian Federation (Russia),Kelantan,0,0,0
1/08/2020,Russian Federation (Russia),Melaka,0,0,0
1/08/2020,Russian Federation (Russia),Negeri Sembilan,0,0,0
1/08/2020,Russian Federation (Russia),Pahang,0,0,0
1/08/2020,Russian Federation (Russia),Perak,0,0,0
1/08/2020,Russian Federation (Russia),Perlis,0,0,0
1/08/2020,Russian Federation (Russia),Pulau Pinang,2,2,0
1/08/2020,Russian Federation (Russia),Sabah,3,3,0
1/08/2020,Russian Federation (Russia),Sarawak,1,0,1
1/08/2020,Russian Federation (Russia),Selangor,100,83,17
1/08/2020,Russian Federation (Russia),W.P. Labuan,0,0,0
1/08/2020,Rwanda,Johor,0,0,0
1/08/2020,Rwanda,Kedah,0,0,0
1/08/2020,Rwanda,Pulau Pinang,0,0,0
1/08/2020,Rwanda,Selangor,0,0,0
1/08/2020,Saudi Arabia,Johor,0,0,0
1/08/2020,Saudi Arabia,Kedah,0,0,0
1/08/2020,Saudi Arabia,Kelantan,0,0,0
1/08/2020,Saudi Arabia,Melaka,0,0,0
1/08/2020,Saudi Arabia,Perak,0,0,0
1/08/2020,Saudi Arabia,Perlis,0,0,0
1/08/2020,Saudi Arabia,Pulau Pinang,0,0,0
1/08/2020,Saudi Arabia,Sabah,0,0,0
1/08/2020,Saudi Arabia,Sarawak,0,0,0
1/08/2020,Saudi Arabia,Selangor,9,5,4
1/08/2020,Saudi Arabia,W.P. Labuan,0,0,0
1/08/2020,Sudan,Johor,0,0,0
1/08/2020,Sudan,Kedah,0,0,0
1/08/2020,Sudan,Kelantan,0,0,0
1/08/2020,Sudan,Perlis,0,0,0
1/08/2020,Sudan,Pulau Pinang,0,0,0
1/08/2020,Sudan,Sabah,0,0,0
1/08/2020,Sudan,Sarawak,0,0,0
1/08/2020,Sudan,Selangor,13,11,2
1/08/2020,Sudan,W.P. Labuan,0,0,0
1/08/2020,Senegal,Johor,0,0,0
1/08/2020,Senegal,Kedah,0,0,0
1/08/2020,Senegal,Kelantan,0,0,0
1/08/2020,Senegal,Perak,0,0,0
1/08/2020,Senegal,Perlis,0,0,0
1/08/2020,Senegal,Pulau Pinang,0,0,0
1/08/2020,Senegal,Sabah,0,0,0
1/08/2020,Senegal,Sarawak,0,0,0
1/08/2020,Senegal,Selangor,5,3,2
1/08/2020,Singapore,Johor,328,288,40
1/08/2020,Singapore,Kedah,2,2,0
1/08/2020,Singapore,Kelantan,0,0,0
1/08/2020,Singapore,Melaka,0,0,0
1/08/2020,Singapore,Negeri Sembilan,0,0,0
1/08/2020,Singapore,Pahang,0,0,0
1/08/2020,Singapore,Perak,1,1,0
1/08/2020,Singapore,Perlis,0,0,0
1/08/2020,Singapore,Pulau Pinang,14,8,6
1/08/2020,Singapore,Sabah,0,0,0
1/08/2020,Singapore,Sarawak,8,3,5
1/08/2020,Singapore,Selangor,161,115,46
1/08/2020,Singapore,Terengganu,0,0,0
1/08/2020,Singapore,W.P. Labuan,0,0,0
1/08/2020,South Georgia and the South Sandwich Islands,Johor,0,0,0
1/08/2020,South Georgia and the South Sandwich Islands,Sabah,0,0,0
1/08/2020,South Georgia and the South Sandwich Islands,Selangor,0,0,0
1/08/2020,Saint Helena,Sarawak,0,0,0
1/08/2020,Solomon Islands,Johor,0,0,0
1/08/2020,Solomon Islands,Perlis,0,0,0
1/08/2020,Solomon Islands,Pulau Pinang,0,0,0
1/08/2020,Solomon Islands,Sabah,0,0,0
1/08/2020,Solomon Islands,Sarawak,0,0,0
1/08/2020,Solomon Islands,Selangor,0,0,0
1/08/2020,Solomon Islands,W.P. Labuan,0,0,0
1/08/2020,Sierra Leone,Johor,0,0,0
1/08/2020,Sierra Leone,Kedah,0,0,0
1/08/2020,Sierra Leone,Perak,0,0,0
1/08/2020,Sierra Leone,Pulau Pinang,0,0,0
1/08/2020,Sierra Leone,Sabah,0,0,0
1/08/2020,Sierra Leone,Selangor,0,0,0
1/08/2020,El Salvador,Johor,0,0,0
1/08/2020,El Salvador,Kedah,0,0,0
1/08/2020,El Salvador,Perak,0,0,0
1/08/2020,El Salvador,Perlis,0,0,0
1/08/2020,El Salvador,Pulau Pinang,0,0,0
1/08/2020,El Salvador,Sabah,0,0,0
1/08/2020,El Salvador,Selangor,0,0,0
1/08/2020,El Salvador,W.P. Labuan,0,0,0
1/08/2020,San Marino,Johor,0,0,0
1/08/2020,San Marino,Selangor,0,0,0
1/08/2020,Somalia,Johor,0,0,0
1/08/2020,Somalia,Kedah,0,0,0
1/08/2020,Somalia,Kelantan,0,0,0
1/08/2020,Somalia,Perlis,0,0,0
1/08/2020,Somalia,Sabah,0,0,0
1/08/2020,Somalia,Sarawak,0,0,0
1/08/2020,Somalia,Selangor,2,2,0
1/08/2020,Serbia,Johor,0,0,0
1/08/2020,Serbia,Kedah,0,0,0
1/08/2020,Serbia,Kelantan,0,0,0
1/08/2020,Serbia,Pahang,0,0,0
1/08/2020,Serbia,Perak,0,0,0
1/08/2020,Serbia,Perlis,0,0,0
1/08/2020,Serbia,Pulau Pinang,0,0,0
1/08/2020,Serbia,Sabah,0,0,0
1/08/2020,Serbia,Sarawak,0,0,0
1/08/2020,Serbia,Selangor,3,1,2
1/08/2020,South Sudan,Johor,0,0,0
1/08/2020,South Sudan,Kedah,0,0,0
1/08/2020,South Sudan,Sarawak,0,0,0
1/08/2020,South Sudan,Selangor,0,0,0
1/08/2020,South Sudan,W.P. Labuan,0,0,0
1/08/2020,Sao Tome and Principe,Selangor,0,0,0
1/08/2020,Suriname,Johor,0,0,0
1/08/2020,Suriname,Kedah,0,0,0
1/08/2020,Suriname,Kelantan,0,0,0
1/08/2020,Suriname,Perak,0,0,0
1/08/2020,Suriname,Perlis,0,0,0
1/08/2020,Suriname,Pulau Pinang,0,0,0
1/08/2020,Suriname,Sabah,0,0,0
1/08/2020,Suriname,Sarawak,0,0,0
1/08/2020,Suriname,Selangor,0,0,0
1/08/2020,Slovakia,Johor,0,0,0
1/08/2020,Slovakia,Kedah,0,0,0
1/08/2020,Slovakia,Kelantan,0,0,0
1/08/2020,Slovakia,Negeri Sembilan,0,0,0
1/08/2020,Slovakia,Pahang,0,0,0
1/08/2020,Slovakia,Perak,0,0,0
1/08/2020,Slovakia,Perlis,0,0,0
1/08/2020,Slovakia,Pulau Pinang,0,0,0
1/08/2020,Slovakia,Sabah,0,0,0
1/08/2020,Slovakia,Sarawak,0,0,0
1/08/2020,Slovakia,Selangor,9,6,3
1/08/2020,Slovakia,W.P. Labuan,0,0,0
1/08/2020,Slovenia,Johor,0,0,0
1/08/2020,Slovenia,Kedah,0,0,0
1/08/2020,Slovenia,Kelantan,0,0,0
1/08/2020,Slovenia,Perak,0,0,0
1/08/2020,Slovenia,Perlis,0,0,0
1/08/2020,Slovenia,Pulau Pinang,0,0,0
1/08/2020,Slovenia,Sabah,0,0,0
1/08/2020,Slovenia,Sarawak,0,0,0
1/08/2020,Slovenia,Selangor,1,1,0
1/08/2020,Slovenia,W.P. Labuan,0,0,0
1/08/2020,Sweden,Johor,0,0,0
1/08/2020,Sweden,Kedah,0,0,0
1/08/2020,Sweden,Kelantan,0,0,0
1/08/2020,Sweden,Melaka,0,0,0
1/08/2020,Sweden,Negeri Sembilan,0,0,0
1/08/2020,Sweden,Pahang,0,0,0
1/08/2020,Sweden,Perak,0,0,0
1/08/2020,Sweden,Perlis,0,0,0
1/08/2020,Sweden,Pulau Pinang,0,0,0
1/08/2020,Sweden,Sabah,0,0,0
1/08/2020,Sweden,Sarawak,0,0,0
1/08/2020,Sweden,Selangor,17,13,4
1/08/2020,Sweden,W.P. Labuan,0,0,0
1/08/2020,Eswatini,Johor,0,0,0
1/08/2020,Eswatini,Kedah,0,0,0
1/08/2020,Eswatini,Pulau Pinang,0,0,0
1/08/2020,Eswatini,Sabah,0,0,0
1/08/2020,Eswatini,Selangor,0,0,0
1/08/2020,Seychelles,Johor,0,0,0
1/08/2020,Seychelles,Kedah,0,0,0
1/08/2020,Seychelles,Pulau Pinang,0,0,0
1/08/2020,Seychelles,Sabah,0,0,0
1/08/2020,Seychelles,Sarawak,0,0,0
1/08/2020,Seychelles,Selangor,0,0,0
1/08/2020,Syrian Arab Republic,Johor,0,0,0
1/08/2020,Syrian Arab Republic,Kedah,0,0,0
1/08/2020,Syrian Arab Republic,Kelantan,0,0,0
1/08/2020,Syrian Arab Republic,Pahang,0,0,0
1/08/2020,Syrian Arab Republic,Perlis,0,0,0
1/08/2020,Syrian Arab Republic,Pulau Pinang,0,0,0
1/08/2020,Syrian Arab Republic,Sabah,0,0,0
1/08/2020,Syrian Arab Republic,Sarawak,0,0,0
1/08/2020,Syrian Arab Republic,Selangor,24,23,1
1/08/2020,Syrian Arab Republic,W.P. Labuan,0,0,0
1/08/2020,Turks and Caicos Islands,Perlis,0,0,0
1/08/2020,TCD,Johor,0,0,0
1/08/2020,TCD,Kedah,0,0,0
1/08/2020,TCD,Perlis,0,0,0
1/08/2020,TCD,Selangor,0,0,0
1/08/2020,Togo,Johor,0,0,0
1/08/2020,Togo,Perak,0,0,0
1/08/2020,Togo,Pulau Pinang,0,0,0
1/08/2020,Togo,Selangor,0,0,0
1/08/2020,Thailand,Johor,87,87,0
1/08/2020,Thailand,Kedah,10333,9521,812
1/08/2020,Thailand,Kelantan,3,1,2
1/08/2020,Thailand,Melaka,0,0,0
1/08/2020,Thailand,Negeri Sembilan,0,0,0
1/08/2020,Thailand,Pahang,0,0,0
1/08/2020,Thailand,Perak,0,0,0
1/08/2020,Thailand,Perlis,4315,4191,124
1/08/2020,Thailand,Pulau Pinang,0,0,0
1/08/2020,Thailand,Sabah,1,0,1
1/08/2020,Thailand,Sarawak,13,13,0
1/08/2020,Thailand,Selangor,170,122,48
1/08/2020,Thailand,Terengganu,0,0,0
1/08/2020,Thailand,W.P. Labuan,0,0,0
1/08/2020,Tajikistan,Johor,0,0,0
1/08/2020,Tajikistan,Kedah,0,0,0
1/08/2020,Tajikistan,Perlis,0,0,0
1/08/2020,Tajikistan,Pulau Pinang,0,0,0
1/08/2020,Tajikistan,Sabah,0,0,0
1/08/2020,Tajikistan,Selangor,1,0,1
1/08/2020,Tokelau,Selangor,0,0,0
1/08/2020,Turkmenistan,Johor,0,0,0
1/08/2020,Turkmenistan,Kedah,0,0,0
1/08/2020,Turkmenistan,Kelantan,0,0,0
1/08/2020,Turkmenistan,Perlis,0,0,0
1/08/2020,Turkmenistan,Pulau Pinang,0,0,0
1/08/2020,Turkmenistan,Sabah,0,0,0
1/08/2020,Turkmenistan,Sarawak,0,0,0
1/08/2020,Turkmenistan,Selangor,0,0,0
1/08/2020,Timor-Leste,Johor,0,0,0
1/08/2020,Timor-Leste,Kedah,0,0,0
1/08/2020,Timor-Leste,Perlis,0,0,0
1/08/2020,Timor-Leste,Pulau Pinang,0,0,0
1/08/2020,Timor-Leste,Sabah,0,0,0
1/08/2020,Timor-Leste,Sarawak,0,0,0
1/08/2020,Timor-Leste,Selangor,2,1,1
1/08/2020,Tonga,Johor,0,0,0
1/08/2020,Tonga,Pulau Pinang,0,0,0
1/08/2020,Tonga,Sarawak,0,0,0
1/08/2020,Tonga,Selangor,0,0,0
1/08/2020,Trinidad and Tobago,Johor,0,0,0
1/08/2020,Trinidad and Tobago,Kedah,0,0,0
1/08/2020,Trinidad and Tobago,Pahang,0,0,0
1/08/2020,Trinidad and Tobago,Pulau Pinang,0,0,0
1/08/2020,Trinidad and Tobago,Sabah,0,0,0
1/08/2020,Trinidad and Tobago,Sarawak,0,0,0
1/08/2020,Trinidad and Tobago,Selangor,0,0,0
1/08/2020,Tunisia,Johor,0,0,0
1/08/2020,Tunisia,Kedah,0,0,0
1/08/2020,Tunisia,Kelantan,0,0,0
1/08/2020,Tunisia,Melaka,0,0,0
1/08/2020,Tunisia,Perak,0,0,0
1/08/2020,Tunisia,Perlis,0,0,0
1/08/2020,Tunisia,Pulau Pinang,0,0,0
1/08/2020,Tunisia,Sabah,0,0,0
1/08/2020,Tunisia,Sarawak,0,0,0
1/08/2020,Tunisia,Selangor,5,4,1
1/08/2020,Tunisia,W.P. Labuan,0,0,0
1/08/2020,Türkiye,Johor,0,0,0
1/08/2020,Türkiye,Kedah,0,0,0
1/08/2020,Türkiye,Kelantan,0,0,0
1/08/2020,Türkiye,Melaka,0,0,0
1/08/2020,Türkiye,Negeri Sembilan,0,0,0
1/08/2020,Türkiye,Pahang,0,0,0
1/08/2020,Türkiye,Perak,0,0,0
1/08/2020,Türkiye,Perlis,0,0,0
1/08/2020,Türkiye,Pulau Pinang,0,0,0
1/08/2020,Türkiye,Sabah,0,0,0
1/08/2020,Türkiye,Sarawak,0,0,0
1/08/2020,Türkiye,Selangor,27,16,11
1/08/2020,Türkiye,W.P. Labuan,0,0,0
1/08/2020,Tuvalu,Selangor,0,0,0
1/08/2020,"Taiwan, Province of China",Johor,0,0,0
1/08/2020,"Taiwan, Province of China",Kedah,0,0,0
1/08/2020,"Taiwan, Province of China",Kelantan,0,0,0
1/08/2020,"Taiwan, Province of China",Melaka,0,0,0
1/08/2020,"Taiwan, Province of China",Negeri Sembilan,0,0,0
1/08/2020,"Taiwan, Province of China",Pahang,0,0,0
1/08/2020,"Taiwan, Province of China",Perak,0,0,0
1/08/2020,"Taiwan, Province of China",Perlis,0,0,0
1/08/2020,"Taiwan, Province of China",Pulau Pinang,8,4,4
1/08/2020,"Taiwan, Province of China",Sabah,0,0,0
1/08/2020,"Taiwan, Province of China",Sarawak,0,0,0
1/08/2020,"Taiwan, Province of China",Selangor,68,42,26
1/08/2020,"Taiwan, Province of China",W.P. Labuan,0,0,0
1/08/2020,"Tanzania, United Republic of",Johor,0,0,0
1/08/2020,"Tanzania, United Republic of",Kedah,0,0,0
1/08/2020,"Tanzania, United Republic of",Perak,0,0,0
1/08/2020,"Tanzania, United Republic of",Perlis,0,0,0
1/08/2020,"Tanzania, United Republic of",Pulau Pinang,0,0,0
1/08/2020,"Tanzania, United Republic of",Sabah,0,0,0
1/08/2020,"Tanzania, United Republic of",Sarawak,0,0,0
1/08/2020,"Tanzania, United Republic of",Selangor,1,1,0
1/08/2020,Uganda,Johor,0,0,0
1/08/2020,Uganda,Kedah,0,0,0
1/08/2020,Uganda,Perak,0,0,0
1/08/2020,Uganda,Perlis,0,0,0
1/08/2020,Uganda,Pulau Pinang,0,0,0
1/08/2020,Uganda,Sabah,0,0,0
1/08/2020,Uganda,Sarawak,0,0,0
1/08/2020,Uganda,Selangor,0,0,0
1/08/2020,Ukraine,Johor,18,18,0
1/08/2020,Ukraine,Kedah,0,0,0
1/08/2020,Ukraine,Kelantan,0,0,0
1/08/2020,Ukraine,Melaka,0,0,0
1/08/2020,Ukraine,Negeri Sembilan,0,0,0
1/08/2020,Ukraine,Pahang,0,0,0
1/08/2020,Ukraine,Perak,0,0,0
1/08/2020,Ukraine,Perlis,0,0,0
1/08/2020,Ukraine,Pulau Pinang,2,2,0
1/08/2020,Ukraine,Sabah,0,0,0
1/08/2020,Ukraine,Sarawak,0,0,0
1/08/2020,Ukraine,Selangor,82,81,1
1/08/2020,Ukraine,W.P. Labuan,0,0,0
1/08/2020,Uruguay,Johor,0,0,0
1/08/2020,Uruguay,Kedah,0,0,0
1/08/2020,Uruguay,Kelantan,0,0,0
1/08/2020,Uruguay,Perak,0,0,0
1/08/2020,Uruguay,Perlis,0,0,0
1/08/2020,Uruguay,Pulau Pinang,0,0,0
1/08/2020,Uruguay,Sabah,0,0,0
1/08/2020,Uruguay,Sarawak,0,0,0
1/08/2020,Uruguay,Selangor,0,0,0
1/08/2020,Uruguay,W.P. Labuan,0,0,0
1/08/2020,United States of America,Johor,0,0,0
1/08/2020,United States of America,Kedah,0,0,0
1/08/2020,United States of America,Kelantan,0,0,0
1/08/2020,United States of America,Melaka,0,0,0
1/08/2020,United States of America,Negeri Sembilan,0,0,0
1/08/2020,United States of America,Pahang,0,0,0
1/08/2020,United States of America,Perak,0,0,0
1/08/2020,United States of America,Perlis,0,0,0
1/08/2020,United States of America,Pulau Pinang,0,0,0
1/08/2020,United States of America,Sabah,0,0,0
1/08/2020,United States of America,Sarawak,0,0,0
1/08/2020,United States of America,Selangor,139,87,52
1/08/2020,United States of America,Terengganu,0,0,0
1/08/2020,United States of America,W.P. Labuan,0,0,0
1/08/2020,Uzbekistan,Johor,0,0,0
1/08/2020,Uzbekistan,Kedah,0,0,0
1/08/2020,Uzbekistan,Kelantan,0,0,0
1/08/2020,Uzbekistan,Perak,0,0,0
1/08/2020,Uzbekistan,Perlis,0,0,0
1/08/2020,Uzbekistan,Pulau Pinang,0,0,0
1/08/2020,Uzbekistan,Sabah,0,0,0
1/08/2020,Uzbekistan,Sarawak,0,0,0
1/08/2020,Uzbekistan,Selangor,3,3,0
1/08/2020,Holy See,Johor,0,0,0
1/08/2020,Holy See,Sarawak,0,0,0
1/08/2020,Holy See,Selangor,0,0,0
1/08/2020,Saint Vincent and the Grenadines,Johor,0,0,0
1/08/2020,Saint Vincent and the Grenadines,Kedah,0,0,0
1/08/2020,Saint Vincent and the Grenadines,Pulau Pinang,0,0,0
1/08/2020,Saint Vincent and the Grenadines,Sarawak,0,0,0
1/08/2020,Saint Vincent and the Grenadines,Selangor,0,0,0
1/08/2020,"Venezuela, Bolivarian Republic of",Johor,0,0,0
1/08/2020,"Venezuela, Bolivarian Republic of",Kedah,0,0,0
1/08/2020,"Venezuela, Bolivarian Republic of",Kelantan,0,0,0
1/08/2020,"Venezuela, Bolivarian Republic of",Melaka,0,0,0
1/08/2020,"Venezuela, Bolivarian Republic of",Perak,0,0,0
1/08/2020,"Venezuela, Bolivarian Republic of",Perlis,0,0,0
1/08/2020,"Venezuela, Bolivarian Republic of",Pulau Pinang,0,0,0
1/08/2020,"Venezuela, Bolivarian Republic of",Sabah,0,0,0
1/08/2020,"Venezuela, Bolivarian Republic of",Sarawak,0,0,0
1/08/2020,"Venezuela, Bolivarian Republic of",Selangor,0,0,0
1/08/2020,"Venezuela, Bolivarian Republic of",W.P. Labuan,0,0,0
1/08/2020,Viet Nam,Johor,3,0,3
1/08/2020,Viet Nam,Kedah,0,0,0
1/08/2020,Viet Nam,Kelantan,0,0,0
1/08/2020,Viet Nam,Melaka,0,0,0
1/08/2020,Viet Nam,Negeri Sembilan,0,0,0
1/08/2020,Viet Nam,Pahang,0,0,0
1/08/2020,Viet Nam,Perak,0,0,0
1/08/2020,Viet Nam,Perlis,0,0,0
1/08/2020,Viet Nam,Pulau Pinang,0,0,0
1/08/2020,Viet Nam,Sabah,0,0,0
1/08/2020,Viet Nam,Sarawak,0,0,0
1/08/2020,Viet Nam,Selangor,106,47,59
1/08/2020,Viet Nam,Terengganu,0,0,0
1/08/2020,Viet Nam,W.P. Labuan,0,0,0
1/08/2020,Vanuatu,Johor,0,0,0
1/08/2020,Vanuatu,Kedah,0,0,0
1/08/2020,Vanuatu,Pulau Pinang,0,0,0
1/08/2020,Vanuatu,Sabah,0,0,0
1/08/2020,Vanuatu,Sarawak,0,0,0
1/08/2020,Vanuatu,Selangor,0,0,0
1/08/2020, Samoa,Johor,0,0,0
1/08/2020, Samoa,Sarawak,0,0,0
1/08/2020, Samoa,Selangor,0,0,0
1/08/2020,Yemen,Johor,0,0,0
1/08/2020,Yemen,Kedah,0,0,0
1/08/2020,Yemen,Kelantan,0,0,0
1/08/2020,Yemen,Melaka,0,0,0
1/08/2020,Yemen,Pahang,0,0,0
1/08/2020,Yemen,Perak,0,0,0
1/08/2020,Yemen,Perlis,0,0,0
1/08/2020,Yemen,Pulau Pinang,0,0,0
1/08/2020,Yemen,Sabah,1,1,0
1/08/2020,Yemen,Sarawak,0,0,0
1/08/2020,Yemen,Selangor,13,11,2
1/08/2020,Yemen,W.P. Labuan,0,0,0
1/08/2020,South Africa,Johor,0,0,0
1/08/2020,South Africa,Kedah,0,0,0
1/08/2020,South Africa,Kelantan,0,0,0
1/08/2020,South Africa,Melaka,0,0,0
1/08/2020,South Africa,Pahang,0,0,0
1/08/2020,South Africa,Perak,0,0,0
1/08/2020,South Africa,Perlis,0,0,0
1/08/2020,South Africa,Pulau Pinang,0,0,0
1/08/2020,South Africa,Sabah,0,0,0
1/08/2020,South Africa,Sarawak,0,0,0
1/08/2020,South Africa,Selangor,16,11,5
1/08/2020,South Africa,Terengganu,0,0,0
1/08/2020,South Africa,W.P. Labuan,0,0,0
1/08/2020,ZAR,Selangor,0,0,0
1/08/2020,Zambia,Johor,0,0,0
1/08/2020,Zambia,Kedah,0,0,0
1/08/2020,Zambia,Perak,0,0,0
1/08/2020,Zambia,Perlis,0,0,0
1/08/2020,Zambia,Pulau Pinang,0,0,0
1/08/2020,Zambia,Sabah,0,0,0
1/08/2020,Zambia,Sarawak,1,1,0
1/08/2020,Zambia,Selangor,2,1,1
1/08/2020,Zimbabwe,Johor,0,0,0
1/08/2020,Zimbabwe,Kedah,0,0,0
1/08/2020,Zimbabwe,Kelantan,0,0,0
1/08/2020,Zimbabwe,Perak,0,0,0
1/08/2020,Zimbabwe,Perlis,0,0,0
1/08/2020,Zimbabwe,Pulau Pinang,0,0,0
1/08/2020,Zimbabwe,Sabah,0,0,0
1/08/2020,Zimbabwe,Sarawak,0,0,0
1/08/2020,Zimbabwe,Selangor,1,0,1
1/09/2020,Aruba,Kedah,0,0,0
1/09/2020,Aruba,Pulau Pinang,0,0,0
1/09/2020,Afghanistan,Johor,0,0,0
1/09/2020,Afghanistan,Kedah,0,0,0
1/09/2020,Afghanistan,Perlis,0,0,0
1/09/2020,Afghanistan,Pulau Pinang,0,0,0
1/09/2020,Afghanistan,Sarawak,0,0,0
1/09/2020,Afghanistan,Selangor,12,7,5
1/09/2020,Angola,Johor,0,0,0
1/09/2020,Angola,Kedah,0,0,0
1/09/2020,Angola,Sabah,0,0,0
1/09/2020,Angola,Selangor,0,0,0
1/09/2020,Anguilla,Selangor,0,0,0
1/09/2020,Albania,Johor,0,0,0
1/09/2020,Albania,Kedah,0,0,0
1/09/2020,Albania,Perak,0,0,0
1/09/2020,Albania,Perlis,0,0,0
1/09/2020,Albania,Pulau Pinang,0,0,0
1/09/2020,Albania,Sabah,0,0,0
1/09/2020,Albania,Sarawak,0,0,0
1/09/2020,Albania,Selangor,0,0,0
1/09/2020,Andorra,Johor,0,0,0
1/09/2020,Andorra,Kedah,0,0,0
1/09/2020,Andorra,Perlis,0,0,0
1/09/2020,Andorra,Pulau Pinang,0,0,0
1/09/2020,Andorra,Selangor,0,0,0
1/09/2020,Antigua and Barbuda,Selangor,0,0,0
1/09/2020,United Arab Emirates,Johor,0,0,0
1/09/2020,United Arab Emirates,Kedah,0,0,0
1/09/2020,United Arab Emirates,Kelantan,0,0,0
1/09/2020,United Arab Emirates,Perak,0,0,0
1/09/2020,United Arab Emirates,Perlis,0,0,0
1/09/2020,United Arab Emirates,Pulau Pinang,0,0,0
1/09/2020,United Arab Emirates,Sabah,0,0,0
1/09/2020,United Arab Emirates,Sarawak,0,0,0
1/09/2020,United Arab Emirates,Selangor,1,0,1
1/09/2020,Argentina,Johor,1,1,0
1/09/2020,Argentina,Kedah,0,0,0
1/09/2020,Argentina,Kelantan,0,0,0
1/09/2020,Argentina,Melaka,0,0,0
1/09/2020,Argentina,Perak,0,0,0
1/09/2020,Argentina,Perlis,0,0,0
1/09/2020,Argentina,Pulau Pinang,0,0,0
1/09/2020,Argentina,Sabah,0,0,0
1/09/2020,Argentina,Sarawak,0,0,0
1/09/2020,Argentina,Selangor,0,0,0
1/09/2020,Argentina,W.P. Labuan,0,0,0
1/09/2020,Armenia,Johor,0,0,0
1/09/2020,Armenia,Kedah,0,0,0
1/09/2020,Armenia,Kelantan,0,0,0
1/09/2020,Armenia,Perak,0,0,0
1/09/2020,Armenia,Perlis,0,0,0
1/09/2020,Armenia,Pulau Pinang,0,0,0
1/09/2020,Armenia,Sabah,0,0,0
1/09/2020,Armenia,Sarawak,0,0,0
1/09/2020,Armenia,Selangor,0,0,0
1/09/2020,Antarctica,Selangor,0,0,0
1/09/2020,Antigua and Barbuda,Johor,0,0,0
1/09/2020,Antigua and Barbuda,Kedah,0,0,0
1/09/2020,Antigua and Barbuda,Pulau Pinang,0,0,0
1/09/2020,Antigua and Barbuda,Sarawak,0,0,0
1/09/2020,Antigua and Barbuda,Selangor,0,0,0
1/09/2020,Australia,Johor,5,5,0
1/09/2020,Australia,Kedah,0,0,0
1/09/2020,Australia,Kelantan,0,0,0
1/09/2020,Australia,Melaka,0,0,0
1/09/2020,Australia,Negeri Sembilan,0,0,0
1/09/2020,Australia,Pahang,0,0,0
1/09/2020,Australia,Perak,0,0,0
1/09/2020,Australia,Perlis,0,0,0
1/09/2020,Australia,Pulau Pinang,1,1,0
1/09/2020,Australia,Sabah,0,0,0
1/09/2020,Australia,Sarawak,0,0,0
1/09/2020,Australia,Selangor,129,96,33
1/09/2020,Australia,Terengganu,0,0,0
1/09/2020,Australia,W.P. Labuan,0,0,0
1/09/2020,Austria,Johor,0,0,0
1/09/2020,Austria,Kedah,0,0,0
1/09/2020,Austria,Kelantan,0,0,0
1/09/2020,Austria,Melaka,0,0,0
1/09/2020,Austria,Negeri Sembilan,0,0,0
1/09/2020,Austria,Pahang,0,0,0
1/09/2020,Austria,Perak,0,0,0
1/09/2020,Austria,Perlis,0,0,0
1/09/2020,Austria,Pulau Pinang,0,0,0
1/09/2020,Austria,Sabah,0,0,0
1/09/2020,Austria,Sarawak,0,0,0
1/09/2020,Austria,Selangor,11,8,3
1/09/2020,Austria,Terengganu,0,0,0
1/09/2020,Austria,W.P. Labuan,0,0,0
1/09/2020,Azerbaijan,Johor,0,0,0
1/09/2020,Azerbaijan,Kedah,0,0,0
1/09/2020,Azerbaijan,Kelantan,0,0,0
1/09/2020,Azerbaijan,Melaka,0,0,0
1/09/2020,Azerbaijan,Perlis,0,0,0
1/09/2020,Azerbaijan,Pulau Pinang,0,0,0
1/09/2020,Azerbaijan,Sabah,0,0,0
1/09/2020,Azerbaijan,Sarawak,0,0,0
1/09/2020,Azerbaijan,Selangor,2,1,1
1/09/2020,Azerbaijan,W.P. Labuan,0,0,0
1/09/2020,Burundi,Pulau Pinang,0,0,0
1/09/2020,Burundi,Sarawak,0,0,0
1/09/2020,Burundi,Selangor,0,0,0
1/09/2020,Belgium,Johor,1,1,0
1/09/2020,Belgium,Kedah,0,0,0
1/09/2020,Belgium,Kelantan,0,0,0
1/09/2020,Belgium,Melaka,0,0,0
1/09/2020,Belgium,Negeri Sembilan,0,0,0
1/09/2020,Belgium,Pahang,0,0,0
1/09/2020,Belgium,Perak,0,0,0
1/09/2020,Belgium,Perlis,0,0,0
1/09/2020,Belgium,Pulau Pinang,1,1,0
1/09/2020,Belgium,Sabah,0,0,0
1/09/2020,Belgium,Sarawak,0,0,0
1/09/2020,Belgium,Selangor,19,15,4
1/09/2020,Belgium,W.P. Labuan,0,0,0
1/09/2020,Benin,Johor,0,0,0
1/09/2020,Benin,Kedah,0,0,0
1/09/2020,Benin,Perak,0,0,0
1/09/2020,Benin,Pulau Pinang,0,0,0
1/09/2020,Benin,Sabah,0,0,0
1/09/2020,Benin,Sarawak,0,0,0
1/09/2020,Benin,Selangor,0,0,0
1/09/2020,Burkina Faso,Perak,0,0,0
1/09/2020,Burkina Faso,Pulau Pinang,0,0,0
1/09/2020,Burkina Faso,Selangor,0,0,0
1/09/2020,Bangladesh,Johor,6,6,0
1/09/2020,Bangladesh,Kedah,0,0,0
1/09/2020,Bangladesh,Kelantan,0,0,0
1/09/2020,Bangladesh,Melaka,0,0,0
1/09/2020,Bangladesh,Negeri Sembilan,0,0,0
1/09/2020,Bangladesh,Pahang,0,0,0
1/09/2020,Bangladesh,Perak,0,0,0
1/09/2020,Bangladesh,Perlis,0,0,0
1/09/2020,Bangladesh,Pulau Pinang,0,0,0
1/09/2020,Bangladesh,Sabah,0,0,0
1/09/2020,Bangladesh,Sarawak,2,2,0
1/09/2020,Bangladesh,Selangor,143,100,43
1/09/2020,Bangladesh,W.P. Labuan,0,0,0
1/09/2020,Bulgaria,Johor,4,4,0
1/09/2020,Bulgaria,Kedah,0,0,0
1/09/2020,Bulgaria,Kelantan,0,0,0
1/09/2020,Bulgaria,Pahang,0,0,0
1/09/2020,Bulgaria,Perak,0,0,0
1/09/2020,Bulgaria,Perlis,0,0,0
1/09/2020,Bulgaria,Pulau Pinang,0,0,0
1/09/2020,Bulgaria,Sabah,0,0,0
1/09/2020,Bulgaria,Sarawak,1,1,0
1/09/2020,Bulgaria,Selangor,15,14,1
1/09/2020,Bulgaria,W.P. Labuan,0,0,0
1/09/2020,Bahrain,Johor,0,0,0
1/09/2020,Bahrain,Kedah,0,0,0
1/09/2020,Bahrain,Kelantan,0,0,0
1/09/2020,Bahrain,Perlis,0,0,0
1/09/2020,Bahrain,Pulau Pinang,0,0,0
1/09/2020,Bahrain,Sabah,0,0,0
1/09/2020,Bahrain,Sarawak,0,0,0
1/09/2020,Bahrain,Selangor,3,1,2
1/09/2020,Bahamas,Johor,0,0,0
1/09/2020,Bahamas,Kedah,0,0,0
1/09/2020,Bahamas,Perak,0,0,0
1/09/2020,Bahamas,Sabah,0,0,0
1/09/2020,Bahamas,Sarawak,0,0,0
1/09/2020,Bahamas,Selangor,0,0,0
1/09/2020,Bosnia and Herzegovina,Johor,0,0,0
1/09/2020,Bosnia and Herzegovina,Kedah,0,0,0
1/09/2020,Bosnia and Herzegovina,Perlis,0,0,0
1/09/2020,Bosnia and Herzegovina,Pulau Pinang,0,0,0
1/09/2020,Bosnia and Herzegovina,Sabah,0,0,0
1/09/2020,Bosnia and Herzegovina,Sarawak,0,0,0
1/09/2020,Bosnia and Herzegovina,Selangor,1,0,1
1/09/2020,Belarus,Johor,0,0,0
1/09/2020,Belarus,Kedah,0,0,0
1/09/2020,Belarus,Kelantan,0,0,0
1/09/2020,Belarus,Pahang,0,0,0
1/09/2020,Belarus,Perak,0,0,0
1/09/2020,Belarus,Perlis,0,0,0
1/09/2020,Belarus,Pulau Pinang,0,0,0
1/09/2020,Belarus,Sabah,0,0,0
1/09/2020,Belarus,Sarawak,0,0,0
1/09/2020,Belarus,Selangor,0,0,0
1/09/2020,Belarus,W.P. Labuan,0,0,0
1/09/2020,Belize,Johor,0,0,0
1/09/2020,Belize,Pulau Pinang,0,0,0
1/09/2020,Belize,Sarawak,0,0,0
1/09/2020,Belize,Selangor,0,0,0
1/09/2020,Bermuda,Selangor,0,0,0
1/09/2020,Bolivia,Johor,0,0,0
1/09/2020,Bolivia,Kedah,0,0,0
1/09/2020,Bolivia,Melaka,0,0,0
1/09/2020,Bolivia,Perak,0,0,0
1/09/2020,Bolivia,Perlis,0,0,0
1/09/2020,Bolivia,Pulau Pinang,0,0,0
1/09/2020,Bolivia,Sabah,0,0,0
1/09/2020,Bolivia,Sarawak,0,0,0
1/09/2020,Bolivia,Selangor,2,1,1
1/09/2020,Brazil,Johor,0,0,0
1/09/2020,Brazil,Kedah,0,0,0
1/09/2020,Brazil,Kelantan,0,0,0
1/09/2020,Brazil,Melaka,0,0,0
1/09/2020,Brazil,Pahang,0,0,0
1/09/2020,Brazil,Perak,0,0,0
1/09/2020,Brazil,Perlis,0,0,0
1/09/2020,Brazil,Pulau Pinang,0,0,0
1/09/2020,Brazil,Sabah,0,0,0
1/09/2020,Brazil,Sarawak,0,0,0
1/09/2020,Brazil,Selangor,5,5,0
1/09/2020,Brazil,W.P. Labuan,0,0,0
1/09/2020,Barbados,Johor,0,0,0
1/09/2020,Barbados,Kedah,0,0,0
1/09/2020,Barbados,Perlis,0,0,0
1/09/2020,Barbados,Pulau Pinang,0,0,0
1/09/2020,Barbados,Selangor,0,0,0
1/09/2020,Brunei Darussalam,Johor,0,0,0
1/09/2020,Brunei Darussalam,Kedah,0,0,0
1/09/2020,Brunei Darussalam,Kelantan,0,0,0
1/09/2020,Brunei Darussalam,Melaka,0,0,0
1/09/2020,Brunei Darussalam,Pahang,0,0,0
1/09/2020,Brunei Darussalam,Perak,0,0,0
1/09/2020,Brunei Darussalam,Perlis,0,0,0
1/09/2020,Brunei Darussalam,Pulau Pinang,0,0,0
1/09/2020,Brunei Darussalam,Sabah,1,1,0
1/09/2020,Brunei Darussalam,Sarawak,323,315,8
1/09/2020,Brunei Darussalam,Selangor,71,47,24
1/09/2020,Brunei Darussalam,W.P. Labuan,1,1,0
1/09/2020,Bhutan,Johor,0,0,0
1/09/2020,Bhutan,Kedah,0,0,0
1/09/2020,Bhutan,Perak,0,0,0
1/09/2020,Bhutan,Perlis,0,0,0
1/09/2020,Bhutan,Pulau Pinang,0,0,0
1/09/2020,Bhutan,Sabah,0,0,0
1/09/2020,Bhutan,Sarawak,0,0,0
1/09/2020,Bhutan,Selangor,0,0,0
1/09/2020,Botswana,Johor,0,0,0
1/09/2020,Botswana,Kedah,0,0,0
1/09/2020,Botswana,Perlis,0,0,0
1/09/2020,Botswana,Pulau Pinang,0,0,0
1/09/2020,Botswana,Sabah,0,0,0
1/09/2020,Botswana,Sarawak,0,0,0
1/09/2020,Botswana,Selangor,0,0,0
1/09/2020,Central African Republic,Kedah,0,0,0
1/09/2020,Central African Republic,Selangor,0,0,0
1/09/2020,Canada,Johor,0,0,0
1/09/2020,Canada,Kedah,0,0,0
1/09/2020,Canada,Kelantan,0,0,0
1/09/2020,Canada,Melaka,0,0,0
1/09/2020,Canada,Negeri Sembilan,0,0,0
1/09/2020,Canada,Pahang,0,0,0
1/09/2020,Canada,Perak,0,0,0
1/09/2020,Canada,Perlis,0,0,0
1/09/2020,Canada,Pulau Pinang,0,0,0
1/09/2020,Canada,Sabah,0,0,0
1/09/2020,Canada,Sarawak,0,0,0
1/09/2020,Canada,Selangor,70,47,23
1/09/2020,Canada,Terengganu,0,0,0
1/09/2020,Canada,W.P. Labuan,0,0,0
1/09/2020,Cocos (Keeling) Islands,Selangor,0,0,0
1/09/2020,Switzerland,Johor,2,1,1
1/09/2020,Switzerland,Kedah,0,0,0
1/09/2020,Switzerland,Kelantan,0,0,0
1/09/2020,Switzerland,Melaka,0,0,0
1/09/2020,Switzerland,Negeri Sembilan,0,0,0
1/09/2020,Switzerland,Pahang,0,0,0
1/09/2020,Switzerland,Perak,0,0,0
1/09/2020,Switzerland,Perlis,0,0,0
1/09/2020,Switzerland,Pulau Pinang,0,0,0
1/09/2020,Switzerland,Sabah,1,1,0
1/09/2020,Switzerland,Sarawak,0,0,0
1/09/2020,Switzerland,Selangor,14,12,2
1/09/2020,Switzerland,W.P. Labuan,0,0,0
1/09/2020,Chile,Johor,0,0,0
1/09/2020,Chile,Kedah,0,0,0
1/09/2020,Chile,Kelantan,0,0,0
1/09/2020,Chile,Melaka,0,0,0
1/09/2020,Chile,Pahang,0,0,0
1/09/2020,Chile,Perak,0,0,0
1/09/2020,Chile,Perlis,0,0,0
1/09/2020,Chile,Pulau Pinang,0,0,0
1/09/2020,Chile,Sabah,0,0,0
1/09/2020,Chile,Sarawak,0,0,0
1/09/2020,Chile,Selangor,1,0,1
1/09/2020,China,Johor,37,32,5
1/09/2020,China,Kedah,0,0,0
1/09/2020,China,Kelantan,0,0,0
1/09/2020,China,Melaka,0,0,0
1/09/2020,China,Pahang,0,0,0
1/09/2020,China,Perak,0,0,0
1/09/2020,China,Perlis,0,0,0
1/09/2020,China,Pulau Pinang,0,0,0
1/09/2020,China,Sabah,0,0,0
1/09/2020,China,Sarawak,33,19,14
1/09/2020,China,Selangor,793,549,244
1/09/2020,China,Terengganu,0,0,0
1/09/2020,China,W.P. Labuan,1,0,1
1/09/2020,Côte d'Ivoire,Johor,0,0,0
1/09/2020,Côte d'Ivoire,Kedah,0,0,0
1/09/2020,Côte d'Ivoire,Pulau Pinang,0,0,0
1/09/2020,Côte d'Ivoire,Sabah,0,0,0
1/09/2020,Côte d'Ivoire,Sarawak,0,0,0
1/09/2020,Côte d'Ivoire,Selangor,1,1,0
1/09/2020,Cameroon,Johor,0,0,0
1/09/2020,Cameroon,Kedah,0,0,0
1/09/2020,Cameroon,Pulau Pinang,0,0,0
1/09/2020,Cameroon,Sabah,0,0,0
1/09/2020,Cameroon,Sarawak,0,0,0
1/09/2020,Cameroon,Selangor,0,0,0
1/09/2020,Congo,Johor,0,0,0
1/09/2020,Congo,Pulau Pinang,0,0,0
1/09/2020,Congo,Sarawak,0,0,0
1/09/2020,Congo,Selangor,0,0,0
1/09/2020,Congo,Johor,0,0,0
1/09/2020,Congo,Kedah,0,0,0
1/09/2020,Congo,Selangor,0,0,0
1/09/2020,Cook Islands,Selangor,0,0,0
1/09/2020,Colombia,Johor,0,0,0
1/09/2020,Colombia,Kedah,0,0,0
1/09/2020,Colombia,Perak,0,0,0
1/09/2020,Colombia,Pulau Pinang,0,0,0
1/09/2020,Colombia,Sabah,0,0,0
1/09/2020,Colombia,Sarawak,0,0,0
1/09/2020,Colombia,Selangor,0,0,0
1/09/2020,Colombia,W.P. Labuan,0,0,0
1/09/2020,Comoros,Johor,0,0,0
1/09/2020,Comoros,Kedah,0,0,0
1/09/2020,Comoros,Selangor,0,0,0
1/09/2020,Cabo Verde,Johor,0,0,0
1/09/2020,Cabo Verde,Kedah,0,0,0
1/09/2020,Cabo Verde,Pulau Pinang,0,0,0
1/09/2020,Cabo Verde,Sabah,0,0,0
1/09/2020,Cabo Verde,Selangor,0,0,0
1/09/2020,Costa Rica,Johor,0,0,0
1/09/2020,Costa Rica,Kedah,0,0,0
1/09/2020,Costa Rica,Perak,0,0,0
1/09/2020,Costa Rica,Perlis,0,0,0
1/09/2020,Costa Rica,Pulau Pinang,0,0,0
1/09/2020,Costa Rica,Sabah,0,0,0
1/09/2020,Costa Rica,Sarawak,0,0,0
1/09/2020,Costa Rica,Selangor,0,0,0
1/09/2020,Cuba,Johor,0,0,0
1/09/2020,Cuba,Kedah,0,0,0
1/09/2020,Cuba,Perlis,0,0,0
1/09/2020,Cuba,Pulau Pinang,0,0,0
1/09/2020,Cuba,Sabah,0,0,0
1/09/2020,Cuba,Sarawak,0,0,0
1/09/2020,Cuba,Selangor,0,0,0
1/09/2020,Cyprus,Johor,0,0,0
1/09/2020,Cyprus,Kedah,0,0,0
1/09/2020,Cyprus,Perak,0,0,0
1/09/2020,Cyprus,Perlis,0,0,0
1/09/2020,Cyprus,Pulau Pinang,0,0,0
1/09/2020,Cyprus,Sabah,0,0,0
1/09/2020,Cyprus,Sarawak,0,0,0
1/09/2020,Cyprus,Selangor,1,1,0
1/09/2020,Czechia,Johor,0,0,0
1/09/2020,Czechia,Kedah,0,0,0
1/09/2020,Czechia,Kelantan,0,0,0
1/09/2020,Czechia,Melaka,0,0,0
1/09/2020,Czechia,Negeri Sembilan,0,0,0
1/09/2020,Czechia,Perak,0,0,0
1/09/2020,Czechia,Perlis,0,0,0
1/09/2020,Czechia,Pulau Pinang,0,0,0
1/09/2020,Czechia,Sabah,0,0,0
1/09/2020,Czechia,Sarawak,0,0,0
1/09/2020,Czechia,Selangor,24,19,5
1/09/2020,Czechia,W.P. Labuan,0,0,0
1/09/2020,Germany,Johor,2,2,0
1/09/2020,Germany,Kedah,0,0,0
1/09/2020,Germany,Kelantan,0,0,0
1/09/2020,Germany,Melaka,0,0,0
1/09/2020,Germany,Negeri Sembilan,0,0,0
1/09/2020,Germany,Pahang,0,0,0
1/09/2020,Germany,Perak,0,0,0
1/09/2020,Germany,Perlis,0,0,0
1/09/2020,Germany,Pulau Pinang,0,0,0
1/09/2020,Germany,Sabah,0,0,0
1/09/2020,Germany,Sarawak,0,0,0
1/09/2020,Germany,Selangor,71,57,14
1/09/2020,Germany,Terengganu,0,0,0
1/09/2020,Germany,W.P. Labuan,0,0,0
1/09/2020,Djibouti,Johor,0,0,0
1/09/2020,Djibouti,Selangor,0,0,0
1/09/2020,Dominica,Johor,0,0,0
1/09/2020,Dominica,Kedah,0,0,0
1/09/2020,Dominica,Pulau Pinang,0,0,0
1/09/2020,Dominica,Sabah,0,0,0
1/09/2020,Dominica,Sarawak,0,0,0
1/09/2020,Dominica,Selangor,0,0,0
1/09/2020,Dominica,W.P. Labuan,0,0,0
1/09/2020,Denmark,Johor,2,2,0
1/09/2020,Denmark,Kedah,0,0,0
1/09/2020,Denmark,Kelantan,0,0,0
1/09/2020,Denmark,Melaka,0,0,0
1/09/2020,Denmark,Negeri Sembilan,0,0,0
1/09/2020,Denmark,Pahang,0,0,0
1/09/2020,Denmark,Perak,0,0,0
1/09/2020,Denmark,Perlis,0,0,0
1/09/2020,Denmark,Pulau Pinang,0,0,0
1/09/2020,Denmark,Sabah,0,0,0
1/09/2020,Denmark,Sarawak,0,0,0
1/09/2020,Denmark,Selangor,17,13,4
1/09/2020,Denmark,W.P. Labuan,0,0,0
1/09/2020,Dominican Republic,Johor,0,0,0
1/09/2020,Dominican Republic,Kedah,0,0,0
1/09/2020,Dominican Republic,Perak,0,0,0
1/09/2020,Dominican Republic,Perlis,0,0,0
1/09/2020,Dominican Republic,Pulau Pinang,0,0,0
1/09/2020,Dominican Republic,Sabah,0,0,0
1/09/2020,Dominican Republic,Sarawak,0,0,0
1/09/2020,Dominican Republic,Selangor,0,0,0
1/09/2020,Algeria,Johor,0,0,0
1/09/2020,Algeria,Kedah,0,0,0
1/09/2020,Algeria,Kelantan,0,0,0
1/09/2020,Algeria,Melaka,0,0,0
1/09/2020,Algeria,Perak,0,0,0
1/09/2020,Algeria,Perlis,0,0,0
1/09/2020,Algeria,Pulau Pinang,0,0,0
1/09/2020,Algeria,Sabah,0,0,0
1/09/2020,Algeria,Sarawak,0,0,0
1/09/2020,Algeria,Selangor,2,2,0
1/09/2020,Algeria,W.P. Labuan,0,0,0
1/09/2020,Ecuador,Johor,0,0,0
1/09/2020,Ecuador,Kedah,0,0,0
1/09/2020,Ecuador,Perak,0,0,0
1/09/2020,Ecuador,Perlis,0,0,0
1/09/2020,Ecuador,Pulau Pinang,0,0,0
1/09/2020,Ecuador,Sabah,0,0,0
1/09/2020,Ecuador,Sarawak,0,0,0
1/09/2020,Ecuador,Selangor,0,0,0
1/09/2020,Egypt,Johor,0,0,0
1/09/2020,Egypt,Kedah,0,0,0
1/09/2020,Egypt,Kelantan,0,0,0
1/09/2020,Egypt,Melaka,0,0,0
1/09/2020,Egypt,Pahang,0,0,0
1/09/2020,Egypt,Perak,0,0,0
1/09/2020,Egypt,Perlis,0,0,0
1/09/2020,Egypt,Pulau Pinang,0,0,0
1/09/2020,Egypt,Sabah,0,0,0
1/09/2020,Egypt,Sarawak,0,0,0
1/09/2020,Egypt,Selangor,35,28,7
1/09/2020,Egypt,Terengganu,0,0,0
1/09/2020,Egypt,W.P. Labuan,0,0,0
1/09/2020,Eritrea,Johor,0,0,0
1/09/2020,Eritrea,Pulau Pinang,0,0,0
1/09/2020,Eritrea,Sabah,0,0,0
1/09/2020,Eritrea,Selangor,0,0,0
1/09/2020,Spain,Johor,0,0,0
1/09/2020,Spain,Kedah,0,0,0
1/09/2020,Spain,Kelantan,0,0,0
1/09/2020,Spain,Melaka,0,0,0
1/09/2020,Spain,Negeri Sembilan,0,0,0
1/09/2020,Spain,Pahang,0,0,0
1/09/2020,Spain,Perak,0,0,0
1/09/2020,Spain,Perlis,0,0,0
1/09/2020,Spain,Pulau Pinang,0,0,0
1/09/2020,Spain,Sabah,0,0,0
1/09/2020,Spain,Sarawak,0,0,0
1/09/2020,Spain,Selangor,8,5,3
1/09/2020,Spain,W.P. Labuan,0,0,0
1/09/2020,Estonia,Johor,0,0,0
1/09/2020,Estonia,Kedah,0,0,0
1/09/2020,Estonia,Kelantan,0,0,0
1/09/2020,Estonia,Pahang,0,0,0
1/09/2020,Estonia,Perak,0,0,0
1/09/2020,Estonia,Perlis,0,0,0
1/09/2020,Estonia,Pulau Pinang,0,0,0
1/09/2020,Estonia,Sabah,0,0,0
1/09/2020,Estonia,Sarawak,0,0,0
1/09/2020,Estonia,Selangor,0,0,0
1/09/2020,Estonia,W.P. Labuan,0,0,0
1/09/2020,Ethiopia,Johor,0,0,0
1/09/2020,Ethiopia,Kedah,0,0,0
1/09/2020,Ethiopia,Pulau Pinang,0,0,0
1/09/2020,Ethiopia,Sarawak,0,0,0
1/09/2020,Ethiopia,Selangor,1,1,0
1/09/2020,Finland,Johor,0,0,0
1/09/2020,Finland,Kedah,0,0,0
1/09/2020,Finland,Kelantan,0,0,0
1/09/2020,Finland,Melaka,0,0,0
1/09/2020,Finland,Negeri Sembilan,0,0,0
1/09/2020,Finland,Pahang,0,0,0
1/09/2020,Finland,Perak,0,0,0
1/09/2020,Finland,Perlis,0,0,0
1/09/2020,Finland,Pulau Pinang,0,0,0
1/09/2020,Finland,Sabah,0,0,0
1/09/2020,Finland,Sarawak,0,0,0
1/09/2020,Finland,Selangor,8,4,4
1/09/2020,Finland,W.P. Labuan,0,0,0
1/09/2020,Fiji,Johor,0,0,0
1/09/2020,Fiji,Kedah,0,0,0
1/09/2020,Fiji,Kelantan,0,0,0
1/09/2020,Fiji,Perak,0,0,0
1/09/2020,Fiji,Perlis,0,0,0
1/09/2020,Fiji,Pulau Pinang,0,0,0
1/09/2020,Fiji,Sabah,0,0,0
1/09/2020,Fiji,Sarawak,0,0,0
1/09/2020,Fiji,Selangor,0,0,0
1/09/2020,France,Johor,5,5,0
1/09/2020,France,Kedah,0,0,0
1/09/2020,France,Kelantan,0,0,0
1/09/2020,France,Melaka,0,0,0
1/09/2020,France,Negeri Sembilan,0,0,0
1/09/2020,France,Pahang,0,0,0
1/09/2020,France,Perak,0,0,0
1/09/2020,France,Perlis,0,0,0
1/09/2020,France,Pulau Pinang,0,0,0
1/09/2020,France,Sabah,0,0,0
1/09/2020,France,Sarawak,0,0,0
1/09/2020,France,Selangor,82,55,27
1/09/2020,France,Terengganu,0,0,0
1/09/2020,France,W.P. Labuan,0,0,0
1/09/2020,"Micronesia, Federated States of",Johor,0,0,0
1/09/2020,"Micronesia, Federated States of",Pulau Pinang,0,0,0
1/09/2020,"Micronesia, Federated States of",Selangor,0,0,0
1/09/2020,Gabon,Johor,0,0,0
1/09/2020,Gabon,Pulau Pinang,0,0,0
1/09/2020,Gabon,Sarawak,0,0,0
1/09/2020,Gabon,Selangor,0,0,0
1/09/2020,United Kingdom of Great Britain and Northern Ireland,Johor,6,6,0
1/09/2020,United Kingdom of Great Britain and Northern Ireland,Kedah,0,0,0
1/09/2020,United Kingdom of Great Britain and Northern Ireland,Kelantan,0,0,0
1/09/2020,United Kingdom of Great Britain and Northern Ireland,Melaka,0,0,0
1/09/2020,United Kingdom of Great Britain and Northern Ireland,Negeri Sembilan,0,0,0
1/09/2020,United Kingdom of Great Britain and Northern Ireland,Pahang,0,0,0
1/09/2020,United Kingdom of Great Britain and Northern Ireland,Perak,0,0,0
1/09/2020,United Kingdom of Great Britain and Northern Ireland,Perlis,0,0,0
1/09/2020,United Kingdom of Great Britain and Northern Ireland,Pulau Pinang,0,0,0
1/09/2020,United Kingdom of Great Britain and Northern Ireland,Sabah,0,0,0
1/09/2020,United Kingdom of Great Britain and Northern Ireland,Sarawak,2,2,0
1/09/2020,United Kingdom of Great Britain and Northern Ireland,Selangor,238,184,54
1/09/2020,United Kingdom of Great Britain and Northern Ireland,Terengganu,0,0,0
1/09/2020,United Kingdom of Great Britain and Northern Ireland,W.P. Labuan,0,0,0
1/09/2020,Georgia,Johor,0,0,0
1/09/2020,Georgia,Kedah,0,0,0
1/09/2020,Georgia,Melaka,0,0,0
1/09/2020,Georgia,Perak,0,0,0
1/09/2020,Georgia,Perlis,0,0,0
1/09/2020,Georgia,Pulau Pinang,0,0,0
1/09/2020,Georgia,Sabah,0,0,0
1/09/2020,Georgia,Sarawak,0,0,0
1/09/2020,Georgia,Selangor,7,7,0
1/09/2020,Ghana,Johor,0,0,0
1/09/2020,Ghana,Kedah,0,0,0
1/09/2020,Ghana,Kelantan,0,0,0
1/09/2020,Ghana,Pulau Pinang,0,0,0
1/09/2020,Ghana,Sabah,0,0,0
1/09/2020,Ghana,Sarawak,0,0,0
1/09/2020,Ghana,Selangor,5,0,5
1/09/2020,Gibraltar,Johor,0,0,0
1/09/2020,Gibraltar,Sarawak,0,0,0
1/09/2020,Guinea,Johor,0,0,0
1/09/2020,Guinea,Kedah,0,0,0
1/09/2020,Guinea,Kelantan,0,0,0
1/09/2020,Guinea,Perlis,0,0,0
1/09/2020,Guinea,Pulau Pinang,0,0,0
1/09/2020,Guinea,Sabah,0,0,0
1/09/2020,Guinea,Sarawak,0,0,0
1/09/2020,Guinea,Selangor,1,1,0
1/09/2020,Guadeloupe,Selangor,0,0,0
1/09/2020,Gambia,Johor,0,0,0
1/09/2020,Gambia,Kedah,0,0,0
1/09/2020,Gambia,Kelantan,0,0,0
1/09/2020,Gambia,Pulau Pinang,0,0,0
1/09/2020,Gambia,Sabah,0,0,0
1/09/2020,Gambia,Sarawak,0,0,0
1/09/2020,Gambia,Selangor,0,0,0
1/09/2020,Guinea-Bissau,Johor,0,0,0
1/09/2020,Guinea-Bissau,Selangor,0,0,0
1/09/2020,Equatorial Guinea,Johor,0,0,0
1/09/2020,Equatorial Guinea,Selangor,0,0,0
1/09/2020,Greece,Johor,0,0,0
1/09/2020,Greece,Kedah,0,0,0
1/09/2020,Greece,Kelantan,0,0,0
1/09/2020,Greece,Melaka,0,0,0
1/09/2020,Greece,Negeri Sembilan,0,0,0
1/09/2020,Greece,Pahang,0,0,0
1/09/2020,Greece,Perak,0,0,0
1/09/2020,Greece,Perlis,0,0,0
1/09/2020,Greece,Pulau Pinang,0,0,0
1/09/2020,Greece,Sabah,0,0,0
1/09/2020,Greece,Sarawak,0,0,0
1/09/2020,Greece,Selangor,7,6,1
1/09/2020,Grenada,Johor,0,0,0
1/09/2020,Grenada,Kedah,0,0,0
1/09/2020,Grenada,Pulau Pinang,0,0,0
1/09/2020,Grenada,Sabah,0,0,0
1/09/2020,Grenada,Sarawak,0,0,0
1/09/2020,Grenada,Selangor,0,0,0
1/09/2020,Greenland,Johor,0,0,0
1/09/2020,Greenland,Selangor,0,0,0
1/09/2020,Guatemala,Johor,0,0,0
1/09/2020,Guatemala,Kedah,0,0,0
1/09/2020,Guatemala,Pahang,0,0,0
1/09/2020,Guatemala,Perak,0,0,0
1/09/2020,Guatemala,Pulau Pinang,0,0,0
1/09/2020,Guatemala,Sabah,0,0,0
1/09/2020,Guatemala,Sarawak,0,0,0
1/09/2020,Guatemala,Selangor,0,0,0
1/09/2020,Guatemala,W.P. Labuan,0,0,0
1/09/2020,Guyana,Johor,0,0,0
1/09/2020,Guyana,Kedah,0,0,0
1/09/2020,Guyana,Pulau Pinang,0,0,0
1/09/2020,Guyana,Sarawak,0,0,0
1/09/2020,Guyana,Selangor,0,0,0
1/09/2020,Hong Kong,Johor,0,0,0
1/09/2020,Hong Kong,Kedah,0,0,0
1/09/2020,Hong Kong,Kelantan,0,0,0
1/09/2020,Hong Kong,Pahang,0,0,0
1/09/2020,Hong Kong,Perak,0,0,0
1/09/2020,Hong Kong,Perlis,0,0,0
1/09/2020,Hong Kong,Pulau Pinang,0,0,0
1/09/2020,Hong Kong,Sabah,0,0,0
1/09/2020,Hong Kong,Sarawak,0,0,0
1/09/2020,Hong Kong,Selangor,0,0,0
1/09/2020,Hong Kong,Terengganu,0,0,0
1/09/2020,Heard Island and McDonald Islands,Johor,0,0,0
1/09/2020,Honduras,Johor,0,0,0
1/09/2020,Honduras,Kedah,0,0,0
1/09/2020,Honduras,Perak,0,0,0
1/09/2020,Honduras,Pulau Pinang,0,0,0
1/09/2020,Honduras,Sabah,0,0,0
1/09/2020,Honduras,Sarawak,0,0,0
1/09/2020,Honduras,Selangor,0,0,0
1/09/2020,Croatia,Johor,2,2,0
1/09/2020,Croatia,Kedah,0,0,0
1/09/2020,Croatia,Kelantan,0,0,0
1/09/2020,Croatia,Melaka,0,0,0
1/09/2020,Croatia,Pahang,0,0,0
1/09/2020,Croatia,Perak,0,0,0
1/09/2020,Croatia,Perlis,0,0,0
1/09/2020,Croatia,Pulau Pinang,0,0,0
1/09/2020,Croatia,Sabah,0,0,0
1/09/2020,Croatia,Sarawak,0,0,0
1/09/2020,Croatia,Selangor,11,9,2
1/09/2020,Haiti,Johor,0,0,0
1/09/2020,Haiti,Kedah,0,0,0
1/09/2020,Haiti,Kelantan,0,0,0
1/09/2020,Haiti,Perak,0,0,0
1/09/2020,Haiti,Pulau Pinang,0,0,0
1/09/2020,Haiti,Sabah,0,0,0
1/09/2020,Haiti,Selangor,0,0,0
1/09/2020,Hungary,Johor,0,0,0
1/09/2020,Hungary,Kedah,0,0,0
1/09/2020,Hungary,Kelantan,0,0,0
1/09/2020,Hungary,Pahang,0,0,0
1/09/2020,Hungary,Perak,0,0,0
1/09/2020,Hungary,Perlis,0,0,0
1/09/2020,Hungary,Pulau Pinang,0,0,0
1/09/2020,Hungary,Sabah,0,0,0
1/09/2020,Hungary,Sarawak,0,0,0
1/09/2020,Hungary,Selangor,5,3,2
1/09/2020,Hungary,W.P. Labuan,0,0,0
1/09/2020,Indonesia,Johor,276,251,25
1/09/2020,Indonesia,Kedah,4,4,0
1/09/2020,Indonesia,Kelantan,0,0,0
1/09/2020,Indonesia,Melaka,0,0,0
1/09/2020,Indonesia,Negeri Sembilan,0,0,0
1/09/2020,Indonesia,Pahang,0,0,0
1/09/2020,Indonesia,Perak,0,0,0
1/09/2020,Indonesia,Perlis,4,4,0
1/09/2020,Indonesia,Pulau Pinang,3,0,3
1/09/2020,Indonesia,Sabah,11,4,7
1/09/2020,Indonesia,Sarawak,401,347,54
1/09/2020,Indonesia,Selangor,673,496,177
1/09/2020,Indonesia,Terengganu,0,0,0
1/09/2020,Indonesia,W.P. Labuan,0,0,0
1/09/2020,India,Johor,83,82,1
1/09/2020,India,Kedah,0,0,0
1/09/2020,India,Kelantan,0,0,0
1/09/2020,India,Melaka,0,0,0
1/09/2020,India,Negeri Sembilan,0,0,0
1/09/2020,India,Pahang,0,0,0
1/09/2020,India,Perak,0,0,0
1/09/2020,India,Perlis,0,0,0
1/09/2020,India,Pulau Pinang,0,0,0
1/09/2020,India,Sabah,1,1,0
1/09/2020,India,Sarawak,0,0,0
1/09/2020,India,Selangor,472,341,131
1/09/2020,India,Terengganu,0,0,0
1/09/2020,India,W.P. Labuan,0,0,0
1/09/2020, British Indian Ocean Territory,Pulau Pinang,0,0,0
1/09/2020, British Indian Ocean Territory,Selangor,0,0,0
1/09/2020,Ireland,Johor,1,1,0
1/09/2020,Ireland,Kedah,0,0,0
1/09/2020,Ireland,Kelantan,0,0,0
1/09/2020,Ireland,Negeri Sembilan,0,0,0
1/09/2020,Ireland,Pahang,0,0,0
1/09/2020,Ireland,Perak,0,0,0
1/09/2020,Ireland,Perlis,0,0,0
1/09/2020,Ireland,Pulau Pinang,0,0,0
1/09/2020,Ireland,Sabah,0,0,0
1/09/2020,Ireland,Sarawak,0,0,0
1/09/2020,Ireland,Selangor,11,9,2
1/09/2020,Ireland,Terengganu,0,0,0
1/09/2020,Ireland,W.P. Labuan,0,0,0
1/09/2020,"Iran, Islamic Republic of",Johor,0,0,0
1/09/2020,"Iran, Islamic Republic of",Kedah,0,0,0
1/09/2020,"Iran, Islamic Republic of",Kelantan,0,0,0
1/09/2020,"Iran, Islamic Republic of",Perak,0,0,0
1/09/2020,"Iran, Islamic Republic of",Perlis,0,0,0
1/09/2020,"Iran, Islamic Republic of",Pulau Pinang,0,0,0
1/09/2020,"Iran, Islamic Republic of",Sabah,0,0,0
1/09/2020,"Iran, Islamic Republic of",Sarawak,0,0,0
1/09/2020,"Iran, Islamic Republic of",Selangor,19,13,6
1/09/2020,"Iran, Islamic Republic of",W.P. Labuan,0,0,0
1/09/2020,Iraq,Johor,0,0,0
1/09/2020,Iraq,Kedah,0,0,0
1/09/2020,Iraq,Kelantan,0,0,0
1/09/2020,Iraq,Melaka,0,0,0
1/09/2020,Iraq,Pahang,0,0,0
1/09/2020,Iraq,Perak,0,0,0
1/09/2020,Iraq,Perlis,0,0,0
1/09/2020,Iraq,Pulau Pinang,0,0,0
1/09/2020,Iraq,Sabah,0,0,0
1/09/2020,Iraq,Sarawak,0,0,0
1/09/2020,Iraq,Selangor,16,10,6
1/09/2020,Iceland,Johor,0,0,0
1/09/2020,Iceland,Kedah,0,0,0
1/09/2020,Iceland,Kelantan,0,0,0
1/09/2020,Iceland,Perak,0,0,0
1/09/2020,Iceland,Perlis,0,0,0
1/09/2020,Iceland,Pulau Pinang,0,0,0
1/09/2020,Iceland,Sabah,0,0,0
1/09/2020,Iceland,Sarawak,0,0,0
1/09/2020,Iceland,Selangor,1,0,1
1/09/2020,Iceland,W.P. Labuan,0,0,0
1/09/2020,Israel,Pulau Pinang,0,0,0
1/09/2020,Italy,Johor,0,0,0
1/09/2020,Italy,Kedah,0,0,0
1/09/2020,Italy,Kelantan,0,0,0
1/09/2020,Italy,Melaka,0,0,0
1/09/2020,Italy,Negeri Sembilan,0,0,0
1/09/2020,Italy,Pahang,0,0,0
1/09/2020,Italy,Perak,0,0,0
1/09/2020,Italy,Perlis,0,0,0
1/09/2020,Italy,Pulau Pinang,0,0,0
1/09/2020,Italy,Sabah,0,0,0
1/09/2020,Italy,Sarawak,0,0,0
1/09/2020,Italy,Selangor,18,17,1
1/09/2020,Italy,W.P. Labuan,0,0,0
1/09/2020,Jamaica,Johor,0,0,0
1/09/2020,Jamaica,Kedah,0,0,0
1/09/2020,Jamaica,Perak,0,0,0
1/09/2020,Jamaica,Pulau Pinang,0,0,0
1/09/2020,Jamaica,Sabah,0,0,0
1/09/2020,Jamaica,Sarawak,0,0,0
1/09/2020,Jamaica,Selangor,0,0,0
1/09/2020,Jamaica,W.P. Labuan,0,0,0
1/09/2020,Jordan,Johor,0,0,0
1/09/2020,Jordan,Kedah,0,0,0
1/09/2020,Jordan,Kelantan,0,0,0
1/09/2020,Jordan,Melaka,0,0,0
1/09/2020,Jordan,Perlis,0,0,0
1/09/2020,Jordan,Pulau Pinang,0,0,0
1/09/2020,Jordan,Sabah,0,0,0
1/09/2020,Jordan,Sarawak,1,1,0
1/09/2020,Jordan,Selangor,7,5,2
1/09/2020,Jordan,W.P. Labuan,0,0,0
1/09/2020,Japan,Johor,2,2,0
1/09/2020,Japan,Kedah,0,0,0
1/09/2020,Japan,Kelantan,0,0,0
1/09/2020,Japan,Melaka,0,0,0
1/09/2020,Japan,Negeri Sembilan,0,0,0
1/09/2020,Japan,Pahang,0,0,0
1/09/2020,Japan,Perak,0,0,0
1/09/2020,Japan,Perlis,0,0,0
1/09/2020,Japan,Pulau Pinang,1,1,0
1/09/2020,Japan,Sabah,1,0,1
1/09/2020,Japan,Sarawak,1,1,0
1/09/2020,Japan,Selangor,436,290,146
1/09/2020,Japan,W.P. Labuan,0,0,0
1/09/2020,Kazakhstan,Johor,0,0,0
1/09/2020,Kazakhstan,Kedah,0,0,0
1/09/2020,Kazakhstan,Kelantan,0,0,0
1/09/2020,Kazakhstan,Melaka,0,0,0
1/09/2020,Kazakhstan,Perak,0,0,0
1/09/2020,Kazakhstan,Perlis,0,0,0
1/09/2020,Kazakhstan,Pulau Pinang,0,0,0
1/09/2020,Kazakhstan,Sabah,0,0,0
1/09/2020,Kazakhstan,Sarawak,0,0,0
1/09/2020,Kazakhstan,Selangor,9,4,5
1/09/2020,Kazakhstan,W.P. Labuan,0,0,0
1/09/2020,Kenya,Johor,0,0,0
1/09/2020,Kenya,Kedah,0,0,0
1/09/2020,Kenya,Kelantan,0,0,0
1/09/2020,Kenya,Perak,0,0,0
1/09/2020,Kenya,Perlis,0,0,0
1/09/2020,Kenya,Pulau Pinang,0,0,0
1/09/2020,Kenya,Sabah,0,0,0
1/09/2020,Kenya,Sarawak,0,0,0
1/09/2020,Kenya,Selangor,6,2,4
1/09/2020,Kyrgyzstan,Johor,0,0,0
1/09/2020,Kyrgyzstan,Kedah,0,0,0
1/09/2020,Kyrgyzstan,Kelantan,0,0,0
1/09/2020,Kyrgyzstan,Perak,0,0,0
1/09/2020,Kyrgyzstan,Perlis,0,0,0
1/09/2020,Kyrgyzstan,Pulau Pinang,0,0,0
1/09/2020,Kyrgyzstan,Sabah,0,0,0
1/09/2020,Kyrgyzstan,Sarawak,0,0,0
1/09/2020,Kyrgyzstan,Selangor,3,3,0
1/09/2020,Cambodia,Johor,0,0,0
1/09/2020,Cambodia,Kedah,0,0,0
1/09/2020,Cambodia,Kelantan,0,0,0
1/09/2020,Cambodia,Melaka,0,0,0
1/09/2020,Cambodia,Negeri Sembilan,0,0,0
1/09/2020,Cambodia,Pahang,0,0,0
1/09/2020,Cambodia,Perak,0,0,0
1/09/2020,Cambodia,Perlis,0,0,0
1/09/2020,Cambodia,Pulau Pinang,0,0,0
1/09/2020,Cambodia,Sabah,0,0,0
1/09/2020,Cambodia,Sarawak,0,0,0
1/09/2020,Cambodia,Selangor,5,1,4
1/09/2020,Cambodia,W.P. Labuan,0,0,0
1/09/2020,Kiribati,Johor,0,0,0
1/09/2020,Kiribati,Sabah,0,0,0
1/09/2020,Kiribati,Selangor,0,0,0
1/09/2020,Saint Kitts and Nevis,Johor,0,0,0
1/09/2020,Saint Kitts and Nevis,Kedah,0,0,0
1/09/2020,Saint Kitts and Nevis,Perlis,0,0,0
1/09/2020,Saint Kitts and Nevis,Pulau Pinang,0,0,0
1/09/2020,Saint Kitts and Nevis,Sabah,0,0,0
1/09/2020,Saint Kitts and Nevis,Selangor,1,1,0
1/09/2020,Saint Kitts and Nevis,W.P. Labuan,0,0,0
1/09/2020,"Korea, Republic of",Johor,17,17,0
1/09/2020,"Korea, Republic of",Kedah,0,0,0
1/09/2020,"Korea, Republic of",Kelantan,0,0,0
1/09/2020,"Korea, Republic of",Melaka,0,0,0
1/09/2020,"Korea, Republic of",Negeri Sembilan,0,0,0
1/09/2020,"Korea, Republic of",Pahang,0,0,0
1/09/2020,"Korea, Republic of",Perak,0,0,0
1/09/2020,"Korea, Republic of",Perlis,0,0,0
1/09/2020,"Korea, Republic of",Pulau Pinang,0,0,0
1/09/2020,"Korea, Republic of",Sabah,1,0,1
1/09/2020,"Korea, Republic of",Sarawak,3,2,1
1/09/2020,"Korea, Republic of",Selangor,359,195,164
1/09/2020,"Korea, Republic of",Terengganu,0,0,0
1/09/2020,"Korea, Republic of",W.P. Labuan,0,0,0
1/09/2020,Kuwait,Johor,0,0,0
1/09/2020,Kuwait,Kedah,0,0,0
1/09/2020,Kuwait,Kelantan,0,0,0
1/09/2020,Kuwait,Perak,0,0,0
1/09/2020,Kuwait,Perlis,0,0,0
1/09/2020,Kuwait,Pulau Pinang,0,0,0
1/09/2020,Kuwait,Sabah,0,0,0
1/09/2020,Kuwait,Sarawak,0,0,0
1/09/2020,Kuwait,Selangor,2,2,0
1/09/2020,Kuwait,W.P. Labuan,0,0,0
1/09/2020, Lao People's Democratic Republic,Johor,0,0,0
1/09/2020, Lao People's Democratic Republic,Kedah,0,0,0
1/09/2020, Lao People's Democratic Republic,Kelantan,0,0,0
1/09/2020, Lao People's Democratic Republic,Melaka,0,0,0
1/09/2020, Lao People's Democratic Republic,Perak,0,0,0
1/09/2020, Lao People's Democratic Republic,Perlis,0,0,0
1/09/2020, Lao People's Democratic Republic,Pulau Pinang,0,0,0
1/09/2020, Lao People's Democratic Republic,Sabah,0,0,0
1/09/2020, Lao People's Democratic Republic,Sarawak,0,0,0
1/09/2020, Lao People's Democratic Republic,Selangor,1,0,1
1/09/2020, Lao People's Democratic Republic,W.P. Labuan,0,0,0
1/09/2020,Lebanon,Johor,0,0,0
1/09/2020,Lebanon,Kedah,0,0,0
1/09/2020,Lebanon,Kelantan,0,0,0
1/09/2020,Lebanon,Pahang,0,0,0
1/09/2020,Lebanon,Perak,0,0,0
1/09/2020,Lebanon,Perlis,0,0,0
1/09/2020,Lebanon,Pulau Pinang,0,0,0
1/09/2020,Lebanon,Sabah,0,0,0
1/09/2020,Lebanon,Sarawak,0,0,0
1/09/2020,Lebanon,Selangor,5,4,1
1/09/2020,Lebanon,W.P. Labuan,0,0,0
1/09/2020,Liberia,Johor,0,0,0
1/09/2020,Liberia,Kedah,0,0,0
1/09/2020,Liberia,Sabah,0,0,0
1/09/2020,Liberia,Sarawak,0,0,0
1/09/2020,Liberia,Selangor,0,0,0
1/09/2020,Libya,Johor,0,0,0
1/09/2020,Libya,Kedah,0,0,0
1/09/2020,Libya,Perlis,0,0,0
1/09/2020,Libya,Pulau Pinang,0,0,0
1/09/2020,Libya,Sabah,0,0,0
1/09/2020,Libya,Sarawak,0,0,0
1/09/2020,Libya,Selangor,2,1,1
1/09/2020,Saint Lucia,Johor,0,0,0
1/09/2020,Saint Lucia,Kedah,0,0,0
1/09/2020,Saint Lucia,Pulau Pinang,0,0,0
1/09/2020,Saint Lucia,Sarawak,0,0,0
1/09/2020,Saint Lucia,Selangor,0,0,0
1/09/2020,Liechtenstein,Johor,0,0,0
1/09/2020,Liechtenstein,Kedah,0,0,0
1/09/2020,Liechtenstein,Perlis,0,0,0
1/09/2020,Liechtenstein,Pulau Pinang,0,0,0
1/09/2020,Liechtenstein,Sabah,0,0,0
1/09/2020,Liechtenstein,Sarawak,0,0,0
1/09/2020,Liechtenstein,Selangor,0,0,0
1/09/2020,LKA,Johor,4,4,0
1/09/2020,LKA,Kedah,0,0,0
1/09/2020,LKA,Kelantan,0,0,0
1/09/2020,LKA,Melaka,0,0,0
1/09/2020,LKA,Pahang,0,0,0
1/09/2020,LKA,Perak,0,0,0
1/09/2020,LKA,Perlis,0,0,0
1/09/2020,LKA,Pulau Pinang,0,0,0
1/09/2020,LKA,Sabah,0,0,0
1/09/2020,LKA,Sarawak,2,1,1
1/09/2020,LKA,Selangor,35,16,19
1/09/2020,LKA,W.P. Labuan,0,0,0
1/09/2020,Lesotho,Johor,0,0,0
1/09/2020,Lesotho,Kedah,0,0,0
1/09/2020,Lesotho,Pulau Pinang,0,0,0
1/09/2020,Lesotho,Sarawak,0,0,0
1/09/2020,Lesotho,Selangor,0,0,0
1/09/2020,Lithuania,Johor,2,2,0
1/09/2020,Lithuania,Kedah,0,0,0
1/09/2020,Lithuania,Kelantan,0,0,0
1/09/2020,Lithuania,Pahang,0,0,0
1/09/2020,Lithuania,Perak,0,0,0
1/09/2020,Lithuania,Perlis,0,0,0
1/09/2020,Lithuania,Pulau Pinang,0,0,0
1/09/2020,Lithuania,Sabah,0,0,0
1/09/2020,Lithuania,Sarawak,0,0,0
1/09/2020,Lithuania,Selangor,3,3,0
1/09/2020,Lithuania,W.P. Labuan,0,0,0
1/09/2020,Luxembourg,Johor,0,0,0
1/09/2020,Luxembourg,Kedah,0,0,0
1/09/2020,Luxembourg,Kelantan,0,0,0
1/09/2020,Luxembourg,Perak,0,0,0
1/09/2020,Luxembourg,Perlis,0,0,0
1/09/2020,Luxembourg,Pulau Pinang,0,0,0
1/09/2020,Luxembourg,Sabah,0,0,0
1/09/2020,Luxembourg,Sarawak,0,0,0
1/09/2020,Luxembourg,Selangor,1,1,0
1/09/2020,Latvia,Johor,0,0,0
1/09/2020,Latvia,Kedah,0,0,0
1/09/2020,Latvia,Kelantan,0,0,0
1/09/2020,Latvia,Pahang,0,0,0
1/09/2020,Latvia,Perak,0,0,0
1/09/2020,Latvia,Perlis,0,0,0
1/09/2020,Latvia,Pulau Pinang,0,0,0
1/09/2020,Latvia,Sabah,0,0,0
1/09/2020,Latvia,Sarawak,0,0,0
1/09/2020,Latvia,Selangor,5,5,0
1/09/2020,Latvia,W.P. Labuan,0,0,0
1/09/2020,Macao,Johor,0,0,0
1/09/2020,Macao,Pahang,0,0,0
1/09/2020,Macao,Perak,0,0,0
1/09/2020,Macao,Selangor,0,0,0
1/09/2020,Macao,W.P. Labuan,0,0,0
1/09/2020,Morocco,Johor,0,0,0
1/09/2020,Morocco,Kedah,0,0,0
1/09/2020,Morocco,Kelantan,0,0,0
1/09/2020,Morocco,Melaka,0,0,0
1/09/2020,Morocco,Pahang,0,0,0
1/09/2020,Morocco,Perak,0,0,0
1/09/2020,Morocco,Perlis,0,0,0
1/09/2020,Morocco,Pulau Pinang,0,0,0
1/09/2020,Morocco,Sabah,0,0,0
1/09/2020,Morocco,Sarawak,0,0,0
1/09/2020,Morocco,Selangor,5,1,4
1/09/2020,Morocco,W.P. Labuan,0,0,0
1/09/2020,Monaco,Johor,0,0,0
1/09/2020,Monaco,Kedah,0,0,0
1/09/2020,Monaco,Sabah,0,0,0
1/09/2020,Monaco,Selangor,0,0,0
1/09/2020,"Moldova, Republic of",Johor,0,0,0
1/09/2020,"Moldova, Republic of",Kedah,0,0,0
1/09/2020,"Moldova, Republic of",Kelantan,0,0,0
1/09/2020,"Moldova, Republic of",Negeri Sembilan,0,0,0
1/09/2020,"Moldova, Republic of",Perlis,0,0,0
1/09/2020,"Moldova, Republic of",Pulau Pinang,0,0,0
1/09/2020,"Moldova, Republic of",Sabah,0,0,0
1/09/2020,"Moldova, Republic of",Sarawak,0,0,0
1/09/2020,"Moldova, Republic of",Selangor,1,0,1
1/09/2020,Madagascar,Johor,0,0,0
1/09/2020,Madagascar,Kedah,0,0,0
1/09/2020,Madagascar,Perak,0,0,0
1/09/2020,Madagascar,Perlis,0,0,0
1/09/2020,Madagascar,Pulau Pinang,0,0,0
1/09/2020,Madagascar,Sabah,0,0,0
1/09/2020,Madagascar,Sarawak,0,0,0
1/09/2020,Madagascar,Selangor,0,0,0
1/09/2020,Maldives,Johor,0,0,0
1/09/2020,Maldives,Kedah,0,0,0
1/09/2020,Maldives,Kelantan,0,0,0
1/09/2020,Maldives,Perak,0,0,0
1/09/2020,Maldives,Perlis,0,0,0
1/09/2020,Maldives,Pulau Pinang,0,0,0
1/09/2020,Maldives,Sabah,0,0,0
1/09/2020,Maldives,Sarawak,0,0,0
1/09/2020,Maldives,Selangor,50,20,30
1/09/2020,Mexico,Johor,0,0,0
1/09/2020,Mexico,Kedah,0,0,0
1/09/2020,Mexico,Kelantan,0,0,0
1/09/2020,Mexico,Pahang,0,0,0
1/09/2020,Mexico,Perak,0,0,0
1/09/2020,Mexico,Perlis,0,0,0
1/09/2020,Mexico,Pulau Pinang,0,0,0
1/09/2020,Mexico,Sabah,0,0,0
1/09/2020,Mexico,Sarawak,0,0,0
1/09/2020,Mexico,Selangor,4,2,2
1/09/2020,Mexico,W.P. Labuan,0,0,0
1/09/2020,Marshall Islands,Johor,0,0,0
1/09/2020,Marshall Islands,Kedah,0,0,0
1/09/2020,Marshall Islands,Perak,0,0,0
1/09/2020,Marshall Islands,Pulau Pinang,0,0,0
1/09/2020,Marshall Islands,Sabah,0,0,0
1/09/2020,Marshall Islands,Selangor,0,0,0
1/09/2020,North Macedonia,Johor,0,0,0
1/09/2020,North Macedonia,Kedah,0,0,0
1/09/2020,North Macedonia,Perak,0,0,0
1/09/2020,North Macedonia,Pulau Pinang,0,0,0
1/09/2020,North Macedonia,Sabah,0,0,0
1/09/2020,North Macedonia,Sarawak,0,0,0
1/09/2020,North Macedonia,Selangor,0,0,0
1/09/2020,Mali,Johor,0,0,0
1/09/2020,Mali,Sabah,0,0,0
1/09/2020,Mali,Selangor,1,1,0
1/09/2020,Malta,Johor,0,0,0
1/09/2020,Malta,Kedah,0,0,0
1/09/2020,Malta,Kelantan,0,0,0
1/09/2020,Malta,Perak,0,0,0
1/09/2020,Malta,Perlis,0,0,0
1/09/2020,Malta,Pulau Pinang,0,0,0
1/09/2020,Malta,Sabah,0,0,0
1/09/2020,Malta,Sarawak,0,0,0
1/09/2020,Malta,Selangor,0,0,0
1/09/2020,Malta,W.P. Labuan,0,0,0
1/09/2020,Myanmar,Johor,12,12,0
1/09/2020,Myanmar,Kedah,0,0,0
1/09/2020,Myanmar,Kelantan,0,0,0
1/09/2020,Myanmar,Negeri Sembilan,0,0,0
1/09/2020,Myanmar,Pahang,0,0,0
1/09/2020,Myanmar,Perak,0,0,0
1/09/2020,Myanmar,Perlis,0,0,0
1/09/2020,Myanmar,Pulau Pinang,0,0,0
1/09/2020,Myanmar,Sabah,0,0,0
1/09/2020,Myanmar,Sarawak,0,0,0
1/09/2020,Myanmar,Selangor,113,102,11
1/09/2020,Myanmar,Terengganu,0,0,0
1/09/2020,Myanmar,W.P. Labuan,0,0,0
1/09/2020,Montenegro,Johor,0,0,0
1/09/2020,Montenegro,Kedah,0,0,0
1/09/2020,Montenegro,Pulau Pinang,0,0,0
1/09/2020,Montenegro,Sabah,0,0,0
1/09/2020,Montenegro,Sarawak,0,0,0
1/09/2020,Montenegro,Selangor,1,0,1
1/09/2020,Mongolia,Johor,0,0,0
1/09/2020,Mongolia,Kedah,0,0,0
1/09/2020,Mongolia,Kelantan,0,0,0
1/09/2020,Mongolia,Perak,0,0,0
1/09/2020,Mongolia,Perlis,0,0,0
1/09/2020,Mongolia,Pulau Pinang,0,0,0
1/09/2020,Mongolia,Sabah,0,0,0
1/09/2020,Mongolia,Sarawak,0,0,0
1/09/2020,Mongolia,Selangor,0,0,0
1/09/2020,Northern Mariana Islands,Selangor,0,0,0
1/09/2020,Mozambique,Johor,0,0,0
1/09/2020,Mozambique,Kedah,0,0,0
1/09/2020,Mozambique,Perak,0,0,0
1/09/2020,Mozambique,Pulau Pinang,0,0,0
1/09/2020,Mozambique,Sabah,0,0,0
1/09/2020,Mozambique,Sarawak,0,0,0
1/09/2020,Mozambique,Selangor,1,0,1
1/09/2020,Mauritania,Johor,0,0,0
1/09/2020,Mauritania,Kedah,0,0,0
1/09/2020,Mauritania,Pulau Pinang,0,0,0
1/09/2020,Mauritania,Sabah,0,0,0
1/09/2020,Mauritania,Sarawak,0,0,0
1/09/2020,Mauritania,Selangor,1,1,0
1/09/2020,Mauritius,Johor,0,0,0
1/09/2020,Mauritius,Kedah,0,0,0
1/09/2020,Mauritius,Kelantan,0,0,0
1/09/2020,Mauritius,Pahang,0,0,0
1/09/2020,Mauritius,Perak,0,0,0
1/09/2020,Mauritius,Perlis,0,0,0
1/09/2020,Mauritius,Pulau Pinang,0,0,0
1/09/2020,Mauritius,Sabah,0,0,0
1/09/2020,Mauritius,Sarawak,0,0,0
1/09/2020,Mauritius,Selangor,4,2,2
1/09/2020,Malawi,Johor,0,0,0
1/09/2020,Malawi,Pulau Pinang,0,0,0
1/09/2020,Malawi,Sabah,0,0,0
1/09/2020,Malawi,Sarawak,0,0,0
1/09/2020,Malawi,Selangor,0,0,0
1/09/2020,Mayotte,Selangor,0,0,0
1/09/2020,Namibia,Johor,0,0,0
1/09/2020,Namibia,Kedah,0,0,0
1/09/2020,Namibia,Perak,0,0,0
1/09/2020,Namibia,Perlis,0,0,0
1/09/2020,Namibia,Pulau Pinang,0,0,0
1/09/2020,Namibia,Sabah,0,0,0
1/09/2020,Namibia,Sarawak,0,0,0
1/09/2020,Namibia,Selangor,0,0,0
1/09/2020,New Caledonia,Selangor,0,0,0
1/09/2020,Niger,Johor,0,0,0
1/09/2020,Niger,Sabah,0,0,0
1/09/2020,Niger,Selangor,0,0,0
1/09/2020,Nigeria,Johor,0,0,0
1/09/2020,Nigeria,Kedah,0,0,0
1/09/2020,Nigeria,Perlis,0,0,0
1/09/2020,Nigeria,Pulau Pinang,0,0,0
1/09/2020,Nigeria,Sabah,0,0,0
1/09/2020,Nigeria,Sarawak,0,0,0
1/09/2020,Nigeria,Selangor,36,33,3
1/09/2020,Nicaragua,Johor,0,0,0
1/09/2020,Nicaragua,Kedah,0,0,0
1/09/2020,Nicaragua,Pulau Pinang,0,0,0
1/09/2020,Nicaragua,Sabah,0,0,0
1/09/2020,Nicaragua,Selangor,0,0,0
1/09/2020,Netherlands,Johor,3,3,0
1/09/2020,Netherlands,Kedah,0,0,0
1/09/2020,Netherlands,Kelantan,0,0,0
1/09/2020,Netherlands,Melaka,0,0,0
1/09/2020,Netherlands,Negeri Sembilan,0,0,0
1/09/2020,Netherlands,Pahang,0,0,0
1/09/2020,Netherlands,Perak,0,0,0
1/09/2020,Netherlands,Perlis,0,0,0
1/09/2020,Netherlands,Pulau Pinang,0,0,0
1/09/2020,Netherlands,Sabah,0,0,0
1/09/2020,Netherlands,Sarawak,0,0,0
1/09/2020,Netherlands,Selangor,46,38,8
1/09/2020,Netherlands,Terengganu,0,0,0
1/09/2020,Netherlands,W.P. Labuan,0,0,0
1/09/2020,Norway,Johor,0,0,0
1/09/2020,Norway,Kedah,0,0,0
1/09/2020,Norway,Kelantan,0,0,0
1/09/2020,Norway,Melaka,0,0,0
1/09/2020,Norway,Pahang,0,0,0
1/09/2020,Norway,Perak,0,0,0
1/09/2020,Norway,Perlis,0,0,0
1/09/2020,Norway,Pulau Pinang,0,0,0
1/09/2020,Norway,Sabah,0,0,0
1/09/2020,Norway,Sarawak,0,0,0
1/09/2020,Norway,Selangor,8,6,2
1/09/2020,Norway,W.P. Labuan,0,0,0
1/09/2020,Nepal,Johor,0,0,0
1/09/2020,Nepal,Kedah,0,0,0
1/09/2020,Nepal,Pahang,0,0,0
1/09/2020,Nepal,Perak,0,0,0
1/09/2020,Nepal,Perlis,0,0,0
1/09/2020,Nepal,Pulau Pinang,0,0,0
1/09/2020,Nepal,Sabah,0,0,0
1/09/2020,Nepal,Sarawak,0,0,0
1/09/2020,Nepal,Selangor,22,20,2
1/09/2020,Nepal,W.P. Labuan,0,0,0
1/09/2020,Nauru,Johor,0,0,0
1/09/2020,Nauru,Pulau Pinang,0,0,0
1/09/2020,Nauru,Selangor,0,0,0
1/09/2020,New Zealand,Johor,0,0,0
1/09/2020,New Zealand,Kedah,0,0,0
1/09/2020,New Zealand,Kelantan,0,0,0
1/09/2020,New Zealand,Melaka,0,0,0
1/09/2020,New Zealand,Negeri Sembilan,0,0,0
1/09/2020,New Zealand,Pahang,0,0,0
1/09/2020,New Zealand,Perak,0,0,0
1/09/2020,New Zealand,Perlis,0,0,0
1/09/2020,New Zealand,Pulau Pinang,0,0,0
1/09/2020,New Zealand,Sabah,0,0,0
1/09/2020,New Zealand,Sarawak,0,0,0
1/09/2020,New Zealand,Selangor,23,19,4
1/09/2020,New Zealand,Terengganu,0,0,0
1/09/2020,New Zealand,W.P. Labuan,0,0,0
1/09/2020,Oman,Johor,0,0,0
1/09/2020,Oman,Kedah,0,0,0
1/09/2020,Oman,Kelantan,0,0,0
1/09/2020,Oman,Melaka,0,0,0
1/09/2020,Oman,Perak,0,0,0
1/09/2020,Oman,Perlis,0,0,0
1/09/2020,Oman,Pulau Pinang,0,0,0
1/09/2020,Oman,Sabah,0,0,0
1/09/2020,Oman,Sarawak,0,0,0
1/09/2020,Oman,Selangor,21,15,6
1/09/2020,Pakistan,Johor,0,0,0
1/09/2020,Pakistan,Kedah,0,0,0
1/09/2020,Pakistan,Kelantan,0,0,0
1/09/2020,Pakistan,Melaka,0,0,0
1/09/2020,Pakistan,Negeri Sembilan,0,0,0
1/09/2020,Pakistan,Pahang,0,0,0
1/09/2020,Pakistan,Perak,0,0,0
1/09/2020,Pakistan,Perlis,0,0,0
1/09/2020,Pakistan,Pulau Pinang,0,0,0
1/09/2020,Pakistan,Sabah,1,1,0
1/09/2020,Pakistan,Sarawak,0,0,0
1/09/2020,Pakistan,Selangor,80,63,17
1/09/2020,Pakistan,W.P. Labuan,0,0,0
1/09/2020,Panama,Johor,0,0,0
1/09/2020,Panama,Kedah,0,0,0
1/09/2020,Panama,Perak,0,0,0
1/09/2020,Panama,Perlis,0,0,0
1/09/2020,Panama,Pulau Pinang,0,0,0
1/09/2020,Panama,Sabah,0,0,0
1/09/2020,Panama,Sarawak,0,0,0
1/09/2020,Panama,Selangor,0,0,0
1/09/2020,Peru,Johor,0,0,0
1/09/2020,Peru,Kedah,0,0,0
1/09/2020,Peru,Kelantan,0,0,0
1/09/2020,Peru,Pahang,0,0,0
1/09/2020,Peru,Perak,0,0,0
1/09/2020,Peru,Perlis,0,0,0
1/09/2020,Peru,Pulau Pinang,0,0,0
1/09/2020,Peru,Sabah,0,0,0
1/09/2020,Peru,Sarawak,0,0,0
1/09/2020,Peru,Selangor,2,2,0
1/09/2020,Peru,W.P. Labuan,0,0,0
1/09/2020,Philippines,Johor,149,139,10
1/09/2020,Philippines,Kedah,0,0,0
1/09/2020,Philippines,Kelantan,0,0,0
1/09/2020,Philippines,Melaka,0,0,0
1/09/2020,Philippines,Negeri Sembilan,0,0,0
1/09/2020,Philippines,Pahang,0,0,0
1/09/2020,Philippines,Perak,0,0,0
1/09/2020,Philippines,Perlis,0,0,0
1/09/2020,Philippines,Pulau Pinang,0,0,0
1/09/2020,Philippines,Sabah,2,0,2
1/09/2020,Philippines,Sarawak,50,42,8
1/09/2020,Philippines,Selangor,296,260,36
1/09/2020,Philippines,Terengganu,0,0,0
1/09/2020,Philippines,W.P. Labuan,8,7,1
1/09/2020,Palau,Johor,0,0,0
1/09/2020,Palau,Pulau Pinang,0,0,0
1/09/2020,Palau,Selangor,0,0,0
1/09/2020,Papua New Guinea,Johor,0,0,0
1/09/2020,Papua New Guinea,Kedah,0,0,0
1/09/2020,Papua New Guinea,Kelantan,0,0,0
1/09/2020,Papua New Guinea,Perak,0,0,0
1/09/2020,Papua New Guinea,Pulau Pinang,0,0,0
1/09/2020,Papua New Guinea,Sabah,0,0,0
1/09/2020,Papua New Guinea,Sarawak,0,0,0
1/09/2020,Papua New Guinea,Selangor,0,0,0
1/09/2020,Poland,Johor,4,4,0
1/09/2020,Poland,Kedah,0,0,0
1/09/2020,Poland,Kelantan,0,0,0
1/09/2020,Poland,Melaka,0,0,0
1/09/2020,Poland,Negeri Sembilan,0,0,0
1/09/2020,Poland,Pahang,0,0,0
1/09/2020,Poland,Perak,0,0,0
1/09/2020,Poland,Perlis,0,0,0
1/09/2020,Poland,Pulau Pinang,0,0,0
1/09/2020,Poland,Sabah,0,0,0
1/09/2020,Poland,Sarawak,0,0,0
1/09/2020,Poland,Selangor,19,16,3
1/09/2020,Poland,Terengganu,0,0,0
1/09/2020,Poland,W.P. Labuan,0,0,0
1/09/2020,"North Korea, Democratic People's Republic of",Selangor,0,0,0
1/09/2020,Portugal,Johor,1,1,0
1/09/2020,Portugal,Kedah,0,0,0
1/09/2020,Portugal,Kelantan,0,0,0
1/09/2020,Portugal,Melaka,0,0,0
1/09/2020,Portugal,Pahang,0,0,0
1/09/2020,Portugal,Perak,0,0,0
1/09/2020,Portugal,Perlis,0,0,0
1/09/2020,Portugal,Pulau Pinang,0,0,0
1/09/2020,Portugal,Sabah,0,0,0
1/09/2020,Portugal,Sarawak,0,0,0
1/09/2020,Portugal,Selangor,9,5,4
1/09/2020,Portugal,W.P. Labuan,0,0,0
1/09/2020,Paraguay,Johor,0,0,0
1/09/2020,Paraguay,Kedah,0,0,0
1/09/2020,Paraguay,Perak,0,0,0
1/09/2020,Paraguay,Perlis,0,0,0
1/09/2020,Paraguay,Pulau Pinang,0,0,0
1/09/2020,Paraguay,Sabah,0,0,0
1/09/2020,Paraguay,Sarawak,0,0,0
1/09/2020,Paraguay,Selangor,0,0,0
1/09/2020,"Palestine, State of",Johor,0,0,0
1/09/2020,"Palestine, State of",Kedah,0,0,0
1/09/2020,"Palestine, State of",Kelantan,0,0,0
1/09/2020,"Palestine, State of",Melaka,0,0,0
1/09/2020,"Palestine, State of",Perak,0,0,0
1/09/2020,"Palestine, State of",Perlis,0,0,0
1/09/2020,"Palestine, State of",Pulau Pinang,0,0,0
1/09/2020,"Palestine, State of",Sabah,0,0,0
1/09/2020,"Palestine, State of",Sarawak,0,0,0
1/09/2020,"Palestine, State of",Selangor,9,8,1
1/09/2020,Qatar,Johor,0,0,0
1/09/2020,Qatar,Kedah,0,0,0
1/09/2020,Qatar,Perlis,0,0,0
1/09/2020,Qatar,Pulau Pinang,0,0,0
1/09/2020,Qatar,Sabah,0,0,0
1/09/2020,Qatar,Sarawak,0,0,0
1/09/2020,Qatar,Selangor,0,0,0
1/09/2020,Réunion,Johor,0,0,0
1/09/2020,Réunion,Sarawak,0,0,0
1/09/2020,Romania,Johor,0,0,0
1/09/2020,Romania,Kedah,0,0,0
1/09/2020,Romania,Kelantan,0,0,0
1/09/2020,Romania,Negeri Sembilan,0,0,0
1/09/2020,Romania,Pahang,0,0,0
1/09/2020,Romania,Perak,0,0,0
1/09/2020,Romania,Perlis,0,0,0
1/09/2020,Romania,Pulau Pinang,0,0,0
1/09/2020,Romania,Sabah,0,0,0
1/09/2020,Romania,Sarawak,1,1,0
1/09/2020,Romania,Selangor,14,13,1
1/09/2020,Romania,W.P. Labuan,0,0,0
1/09/2020,Russian Federation (Russia),Johor,3,3,0
1/09/2020,Russian Federation (Russia),Kedah,0,0,0
1/09/2020,Russian Federation (Russia),Kelantan,0,0,0
1/09/2020,Russian Federation (Russia),Melaka,0,0,0
1/09/2020,Russian Federation (Russia),Negeri Sembilan,0,0,0
1/09/2020,Russian Federation (Russia),Pahang,0,0,0
1/09/2020,Russian Federation (Russia),Perak,0,0,0
1/09/2020,Russian Federation (Russia),Perlis,0,0,0
1/09/2020,Russian Federation (Russia),Pulau Pinang,0,0,0
1/09/2020,Russian Federation (Russia),Sabah,0,0,0
1/09/2020,Russian Federation (Russia),Sarawak,0,0,0
1/09/2020,Russian Federation (Russia),Selangor,51,41,10
1/09/2020,Russian Federation (Russia),W.P. Labuan,0,0,0
1/09/2020,Rwanda,Johor,0,0,0
1/09/2020,Rwanda,Kedah,0,0,0
1/09/2020,Rwanda,Pulau Pinang,0,0,0
1/09/2020,Rwanda,Selangor,0,0,0
1/09/2020,Saudi Arabia,Johor,0,0,0
1/09/2020,Saudi Arabia,Kedah,0,0,0
1/09/2020,Saudi Arabia,Kelantan,0,0,0
1/09/2020,Saudi Arabia,Melaka,0,0,0
1/09/2020,Saudi Arabia,Perak,0,0,0
1/09/2020,Saudi Arabia,Perlis,0,0,0
1/09/2020,Saudi Arabia,Pulau Pinang,0,0,0
1/09/2020,Saudi Arabia,Sabah,0,0,0
1/09/2020,Saudi Arabia,Sarawak,0,0,0
1/09/2020,Saudi Arabia,Selangor,40,26,14
1/09/2020,Saudi Arabia,W.P. Labuan,0,0,0
1/09/2020,Sudan,Johor,0,0,0
1/09/2020,Sudan,Kedah,0,0,0
1/09/2020,Sudan,Kelantan,0,0,0
1/09/2020,Sudan,Perlis,0,0,0
1/09/2020,Sudan,Pulau Pinang,0,0,0
1/09/2020,Sudan,Sabah,0,0,0
1/09/2020,Sudan,Sarawak,0,0,0
1/09/2020,Sudan,Selangor,26,20,6
1/09/2020,Sudan,W.P. Labuan,0,0,0
1/09/2020,Senegal,Johor,0,0,0
1/09/2020,Senegal,Kedah,0,0,0
1/09/2020,Senegal,Kelantan,0,0,0
1/09/2020,Senegal,Perak,0,0,0
1/09/2020,Senegal,Perlis,0,0,0
1/09/2020,Senegal,Pulau Pinang,0,0,0
1/09/2020,Senegal,Sabah,0,0,0
1/09/2020,Senegal,Sarawak,0,0,0
1/09/2020,Senegal,Selangor,5,3,2
1/09/2020,Singapore,Johor,550,479,71
1/09/2020,Singapore,Kedah,0,0,0
1/09/2020,Singapore,Kelantan,0,0,0
1/09/2020,Singapore,Melaka,0,0,0
1/09/2020,Singapore,Negeri Sembilan,0,0,0
1/09/2020,Singapore,Pahang,1,1,0
1/09/2020,Singapore,Perak,1,1,0
1/09/2020,Singapore,Perlis,1,1,0
1/09/2020,Singapore,Pulau Pinang,14,14,0
1/09/2020,Singapore,Sabah,0,0,0
1/09/2020,Singapore,Sarawak,7,4,3
1/09/2020,Singapore,Selangor,307,235,72
1/09/2020,Singapore,Terengganu,0,0,0
1/09/2020,Singapore,W.P. Labuan,0,0,0
1/09/2020,South Georgia and the South Sandwich Islands,Johor,0,0,0
1/09/2020,South Georgia and the South Sandwich Islands,Sabah,0,0,0
1/09/2020,South Georgia and the South Sandwich Islands,Selangor,0,0,0
1/09/2020,Saint Helena,Sarawak,0,0,0
1/09/2020,Solomon Islands,Johor,0,0,0
1/09/2020,Solomon Islands,Perlis,0,0,0
1/09/2020,Solomon Islands,Pulau Pinang,0,0,0
1/09/2020,Solomon Islands,Sabah,0,0,0
1/09/2020,Solomon Islands,Sarawak,0,0,0
1/09/2020,Solomon Islands,Selangor,0,0,0
1/09/2020,Solomon Islands,W.P. Labuan,0,0,0
1/09/2020,Sierra Leone,Johor,0,0,0
1/09/2020,Sierra Leone,Kedah,0,0,0
1/09/2020,Sierra Leone,Perak,0,0,0
1/09/2020,Sierra Leone,Pulau Pinang,0,0,0
1/09/2020,Sierra Leone,Sabah,0,0,0
1/09/2020,Sierra Leone,Selangor,0,0,0
1/09/2020,El Salvador,Johor,0,0,0
1/09/2020,El Salvador,Kedah,0,0,0
1/09/2020,El Salvador,Perak,0,0,0
1/09/2020,El Salvador,Perlis,0,0,0
1/09/2020,El Salvador,Pulau Pinang,0,0,0
1/09/2020,El Salvador,Sabah,0,0,0
1/09/2020,El Salvador,Selangor,1,0,1
1/09/2020,El Salvador,W.P. Labuan,0,0,0
1/09/2020,San Marino,Johor,0,0,0
1/09/2020,San Marino,Selangor,0,0,0
1/09/2020,Somalia,Johor,0,0,0
1/09/2020,Somalia,Kedah,0,0,0
1/09/2020,Somalia,Kelantan,0,0,0
1/09/2020,Somalia,Perlis,0,0,0
1/09/2020,Somalia,Sabah,0,0,0
1/09/2020,Somalia,Sarawak,0,0,0
1/09/2020,Somalia,Selangor,6,4,2
1/09/2020,Serbia,Johor,0,0,0
1/09/2020,Serbia,Kedah,0,0,0
1/09/2020,Serbia,Kelantan,0,0,0
1/09/2020,Serbia,Pahang,0,0,0
1/09/2020,Serbia,Perak,0,0,0
1/09/2020,Serbia,Perlis,0,0,0
1/09/2020,Serbia,Pulau Pinang,0,0,0
1/09/2020,Serbia,Sabah,0,0,0
1/09/2020,Serbia,Sarawak,0,0,0
1/09/2020,Serbia,Selangor,0,0,0
1/09/2020,South Sudan,Johor,0,0,0
1/09/2020,South Sudan,Kedah,0,0,0
1/09/2020,South Sudan,Sarawak,0,0,0
1/09/2020,South Sudan,Selangor,1,0,1
1/09/2020,South Sudan,W.P. Labuan,0,0,0
1/09/2020,Sao Tome and Principe,Selangor,0,0,0
1/09/2020,Suriname,Johor,0,0,0
1/09/2020,Suriname,Kedah,0,0,0
1/09/2020,Suriname,Kelantan,0,0,0
1/09/2020,Suriname,Perak,0,0,0
1/09/2020,Suriname,Perlis,0,0,0
1/09/2020,Suriname,Pulau Pinang,0,0,0
1/09/2020,Suriname,Sabah,0,0,0
1/09/2020,Suriname,Sarawak,0,0,0
1/09/2020,Suriname,Selangor,0,0,0
1/09/2020,Slovakia,Johor,0,0,0
1/09/2020,Slovakia,Kedah,0,0,0
1/09/2020,Slovakia,Kelantan,0,0,0
1/09/2020,Slovakia,Negeri Sembilan,0,0,0
1/09/2020,Slovakia,Pahang,0,0,0
1/09/2020,Slovakia,Perak,0,0,0
1/09/2020,Slovakia,Perlis,0,0,0
1/09/2020,Slovakia,Pulau Pinang,0,0,0
1/09/2020,Slovakia,Sabah,0,0,0
1/09/2020,Slovakia,Sarawak,0,0,0
1/09/2020,Slovakia,Selangor,32,29,3
1/09/2020,Slovakia,W.P. Labuan,0,0,0
1/09/2020,Slovenia,Johor,0,0,0
1/09/2020,Slovenia,Kedah,0,0,0
1/09/2020,Slovenia,Kelantan,0,0,0
1/09/2020,Slovenia,Perak,0,0,0
1/09/2020,Slovenia,Perlis,0,0,0
1/09/2020,Slovenia,Pulau Pinang,0,0,0
1/09/2020,Slovenia,Sabah,0,0,0
1/09/2020,Slovenia,Sarawak,0,0,0
1/09/2020,Slovenia,Selangor,1,1,0
1/09/2020,Slovenia,W.P. Labuan,0,0,0
1/09/2020,Sweden,Johor,0,0,0
1/09/2020,Sweden,Kedah,0,0,0
1/09/2020,Sweden,Kelantan,0,0,0
1/09/2020,Sweden,Melaka,0,0,0
1/09/2020,Sweden,Negeri Sembilan,0,0,0
1/09/2020,Sweden,Pahang,0,0,0
1/09/2020,Sweden,Perak,0,0,0
1/09/2020,Sweden,Perlis,0,0,0
1/09/2020,Sweden,Pulau Pinang,0,0,0
1/09/2020,Sweden,Sabah,0,0,0
1/09/2020,Sweden,Sarawak,1,1,0
1/09/2020,Sweden,Selangor,9,6,3
1/09/2020,Sweden,W.P. Labuan,0,0,0
1/09/2020,Eswatini,Johor,0,0,0
1/09/2020,Eswatini,Kedah,0,0,0
1/09/2020,Eswatini,Pulau Pinang,0,0,0
1/09/2020,Eswatini,Sabah,0,0,0
1/09/2020,Eswatini,Selangor,0,0,0
1/09/2020,Seychelles,Johor,0,0,0
1/09/2020,Seychelles,Kedah,0,0,0
1/09/2020,Seychelles,Pulau Pinang,0,0,0
1/09/2020,Seychelles,Sabah,0,0,0
1/09/2020,Seychelles,Sarawak,0,0,0
1/09/2020,Seychelles,Selangor,5,1,4
1/09/2020,Syrian Arab Republic,Johor,1,1,0
1/09/2020,Syrian Arab Republic,Kedah,0,0,0
1/09/2020,Syrian Arab Republic,Kelantan,0,0,0
1/09/2020,Syrian Arab Republic,Pahang,0,0,0
1/09/2020,Syrian Arab Republic,Perlis,0,0,0
1/09/2020,Syrian Arab Republic,Pulau Pinang,0,0,0
1/09/2020,Syrian Arab Republic,Sabah,0,0,0
1/09/2020,Syrian Arab Republic,Sarawak,0,0,0
1/09/2020,Syrian Arab Republic,Selangor,42,40,2
1/09/2020,Syrian Arab Republic,W.P. Labuan,0,0,0
1/09/2020,Turks and Caicos Islands,Perlis,0,0,0
1/09/2020,TCD,Johor,0,0,0
1/09/2020,TCD,Kedah,0,0,0
1/09/2020,TCD,Perlis,0,0,0
1/09/2020,TCD,Selangor,0,0,0
1/09/2020,Togo,Johor,0,0,0
1/09/2020,Togo,Perak,0,0,0
1/09/2020,Togo,Pulau Pinang,0,0,0
1/09/2020,Togo,Selangor,0,0,0
1/09/2020,Thailand,Johor,98,97,1
1/09/2020,Thailand,Kedah,9291,8590,701
1/09/2020,Thailand,Kelantan,7,1,6
1/09/2020,Thailand,Melaka,0,0,0
1/09/2020,Thailand,Negeri Sembilan,0,0,0
1/09/2020,Thailand,Pahang,0,0,0
1/09/2020,Thailand,Perak,2,0,2
1/09/2020,Thailand,Perlis,5197,5037,160
1/09/2020,Thailand,Pulau Pinang,0,0,0
1/09/2020,Thailand,Sabah,1,0,1
1/09/2020,Thailand,Sarawak,17,14,3
1/09/2020,Thailand,Selangor,125,66,59
1/09/2020,Thailand,Terengganu,0,0,0
1/09/2020,Thailand,W.P. Labuan,0,0,0
1/09/2020,Tajikistan,Johor,0,0,0
1/09/2020,Tajikistan,Kedah,0,0,0
1/09/2020,Tajikistan,Perlis,0,0,0
1/09/2020,Tajikistan,Pulau Pinang,0,0,0
1/09/2020,Tajikistan,Sabah,0,0,0
1/09/2020,Tajikistan,Selangor,0,0,0
1/09/2020,Tokelau,Selangor,0,0,0
1/09/2020,Turkmenistan,Johor,0,0,0
1/09/2020,Turkmenistan,Kedah,0,0,0
1/09/2020,Turkmenistan,Kelantan,0,0,0
1/09/2020,Turkmenistan,Perlis,0,0,0
1/09/2020,Turkmenistan,Pulau Pinang,0,0,0
1/09/2020,Turkmenistan,Sabah,0,0,0
1/09/2020,Turkmenistan,Sarawak,0,0,0
1/09/2020,Turkmenistan,Selangor,2,1,1
1/09/2020,Timor-Leste,Johor,0,0,0
1/09/2020,Timor-Leste,Kedah,0,0,0
1/09/2020,Timor-Leste,Perlis,0,0,0
1/09/2020,Timor-Leste,Pulau Pinang,0,0,0
1/09/2020,Timor-Leste,Sabah,0,0,0
1/09/2020,Timor-Leste,Sarawak,0,0,0
1/09/2020,Timor-Leste,Selangor,6,3,3
1/09/2020,Tonga,Johor,0,0,0
1/09/2020,Tonga,Pulau Pinang,0,0,0
1/09/2020,Tonga,Sarawak,0,0,0
1/09/2020,Tonga,Selangor,0,0,0
1/09/2020,Trinidad and Tobago,Johor,0,0,0
1/09/2020,Trinidad and Tobago,Kedah,0,0,0
1/09/2020,Trinidad and Tobago,Pahang,0,0,0
1/09/2020,Trinidad and Tobago,Pulau Pinang,0,0,0
1/09/2020,Trinidad and Tobago,Sabah,0,0,0
1/09/2020,Trinidad and Tobago,Sarawak,0,0,0
1/09/2020,Trinidad and Tobago,Selangor,0,0,0
1/09/2020,Tunisia,Johor,0,0,0
1/09/2020,Tunisia,Kedah,0,0,0
1/09/2020,Tunisia,Kelantan,0,0,0
1/09/2020,Tunisia,Melaka,0,0,0
1/09/2020,Tunisia,Perak,0,0,0
1/09/2020,Tunisia,Perlis,0,0,0
1/09/2020,Tunisia,Pulau Pinang,0,0,0
1/09/2020,Tunisia,Sabah,0,0,0
1/09/2020,Tunisia,Sarawak,0,0,0
1/09/2020,Tunisia,Selangor,6,2,4
1/09/2020,Tunisia,W.P. Labuan,0,0,0
1/09/2020,Türkiye,Johor,0,0,0
1/09/2020,Türkiye,Kedah,0,0,0
1/09/2020,Türkiye,Kelantan,0,0,0
1/09/2020,Türkiye,Melaka,0,0,0
1/09/2020,Türkiye,Negeri Sembilan,0,0,0
1/09/2020,Türkiye,Pahang,0,0,0
1/09/2020,Türkiye,Perak,0,0,0
1/09/2020,Türkiye,Perlis,0,0,0
1/09/2020,Türkiye,Pulau Pinang,0,0,0
1/09/2020,Türkiye,Sabah,0,0,0
1/09/2020,Türkiye,Sarawak,0,0,0
1/09/2020,Türkiye,Selangor,15,8,7
1/09/2020,Türkiye,W.P. Labuan,0,0,0
1/09/2020,Tuvalu,Selangor,0,0,0
1/09/2020,"Taiwan, Province of China",Johor,0,0,0
1/09/2020,"Taiwan, Province of China",Kedah,0,0,0
1/09/2020,"Taiwan, Province of China",Kelantan,0,0,0
1/09/2020,"Taiwan, Province of China",Melaka,0,0,0
1/09/2020,"Taiwan, Province of China",Negeri Sembilan,0,0,0
1/09/2020,"Taiwan, Province of China",Pahang,0,0,0
1/09/2020,"Taiwan, Province of China",Perak,0,0,0
1/09/2020,"Taiwan, Province of China",Perlis,0,0,0
1/09/2020,"Taiwan, Province of China",Pulau Pinang,5,3,2
1/09/2020,"Taiwan, Province of China",Sabah,0,0,0
1/09/2020,"Taiwan, Province of China",Sarawak,2,1,1
1/09/2020,"Taiwan, Province of China",Selangor,95,63,32
1/09/2020,"Taiwan, Province of China",W.P. Labuan,0,0,0
1/09/2020,"Tanzania, United Republic of",Johor,0,0,0
1/09/2020,"Tanzania, United Republic of",Kedah,0,0,0
1/09/2020,"Tanzania, United Republic of",Perak,0,0,0
1/09/2020,"Tanzania, United Republic of",Perlis,0,0,0
1/09/2020,"Tanzania, United Republic of",Pulau Pinang,0,0,0
1/09/2020,"Tanzania, United Republic of",Sabah,0,0,0
1/09/2020,"Tanzania, United Republic of",Sarawak,0,0,0
1/09/2020,"Tanzania, United Republic of",Selangor,7,3,4
1/09/2020,Uganda,Johor,0,0,0
1/09/2020,Uganda,Kedah,0,0,0
1/09/2020,Uganda,Perak,0,0,0
1/09/2020,Uganda,Perlis,0,0,0
1/09/2020,Uganda,Pulau Pinang,0,0,0
1/09/2020,Uganda,Sabah,0,0,0
1/09/2020,Uganda,Sarawak,0,0,0
1/09/2020,Uganda,Selangor,0,0,0
1/09/2020,Ukraine,Johor,31,31,0
1/09/2020,Ukraine,Kedah,0,0,0
1/09/2020,Ukraine,Kelantan,0,0,0
1/09/2020,Ukraine,Melaka,0,0,0
1/09/2020,Ukraine,Negeri Sembilan,0,0,0
1/09/2020,Ukraine,Pahang,0,0,0
1/09/2020,Ukraine,Perak,0,0,0
1/09/2020,Ukraine,Perlis,0,0,0
1/09/2020,Ukraine,Pulau Pinang,0,0,0
1/09/2020,Ukraine,Sabah,0,0,0
1/09/2020,Ukraine,Sarawak,0,0,0
1/09/2020,Ukraine,Selangor,112,110,2
1/09/2020,Ukraine,W.P. Labuan,0,0,0
1/09/2020,Uruguay,Johor,0,0,0
1/09/2020,Uruguay,Kedah,0,0,0
1/09/2020,Uruguay,Kelantan,0,0,0
1/09/2020,Uruguay,Perak,0,0,0
1/09/2020,Uruguay,Perlis,0,0,0
1/09/2020,Uruguay,Pulau Pinang,0,0,0
1/09/2020,Uruguay,Sabah,0,0,0
1/09/2020,Uruguay,Sarawak,0,0,0
1/09/2020,Uruguay,Selangor,0,0,0
1/09/2020,Uruguay,W.P. Labuan,0,0,0
1/09/2020,United States of America,Johor,0,0,0
1/09/2020,United States of America,Kedah,0,0,0
1/09/2020,United States of America,Kelantan,0,0,0
1/09/2020,United States of America,Melaka,0,0,0
1/09/2020,United States of America,Negeri Sembilan,0,0,0
1/09/2020,United States of America,Pahang,0,0,0
1/09/2020,United States of America,Perak,0,0,0
1/09/2020,United States of America,Perlis,0,0,0
1/09/2020,United States of America,Pulau Pinang,1,1,0
1/09/2020,United States of America,Sabah,1,1,0
1/09/2020,United States of America,Sarawak,0,0,0
1/09/2020,United States of America,Selangor,179,104,75
1/09/2020,United States of America,Terengganu,0,0,0
1/09/2020,United States of America,W.P. Labuan,0,0,0
1/09/2020,Uzbekistan,Johor,0,0,0
1/09/2020,Uzbekistan,Kedah,0,0,0
1/09/2020,Uzbekistan,Kelantan,0,0,0
1/09/2020,Uzbekistan,Perak,0,0,0
1/09/2020,Uzbekistan,Perlis,0,0,0
1/09/2020,Uzbekistan,Pulau Pinang,0,0,0
1/09/2020,Uzbekistan,Sabah,0,0,0
1/09/2020,Uzbekistan,Sarawak,0,0,0
1/09/2020,Uzbekistan,Selangor,9,4,5
1/09/2020,Holy See,Johor,0,0,0
1/09/2020,Holy See,Sarawak,0,0,0
1/09/2020,Holy See,Selangor,1,1,0
1/09/2020,Saint Vincent and the Grenadines,Johor,0,0,0
1/09/2020,Saint Vincent and the Grenadines,Kedah,0,0,0
1/09/2020,Saint Vincent and the Grenadines,Pulau Pinang,0,0,0
1/09/2020,Saint Vincent and the Grenadines,Sarawak,0,0,0
1/09/2020,Saint Vincent and the Grenadines,Selangor,0,0,0
1/09/2020,"Venezuela, Bolivarian Republic of",Johor,0,0,0
1/09/2020,"Venezuela, Bolivarian Republic of",Kedah,0,0,0
1/09/2020,"Venezuela, Bolivarian Republic of",Kelantan,0,0,0
1/09/2020,"Venezuela, Bolivarian Republic of",Melaka,0,0,0
1/09/2020,"Venezuela, Bolivarian Republic of",Perak,0,0,0
1/09/2020,"Venezuela, Bolivarian Republic of",Perlis,0,0,0
1/09/2020,"Venezuela, Bolivarian Republic of",Pulau Pinang,0,0,0
1/09/2020,"Venezuela, Bolivarian Republic of",Sabah,0,0,0
1/09/2020,"Venezuela, Bolivarian Republic of",Sarawak,0,0,0
1/09/2020,"Venezuela, Bolivarian Republic of",Selangor,1,0,1
1/09/2020,"Venezuela, Bolivarian Republic of",W.P. Labuan,0,0,0
1/09/2020,Viet Nam,Johor,4,0,4
1/09/2020,Viet Nam,Kedah,0,0,0
1/09/2020,Viet Nam,Kelantan,0,0,0
1/09/2020,Viet Nam,Melaka,0,0,0
1/09/2020,Viet Nam,Negeri Sembilan,0,0,0
1/09/2020,Viet Nam,Pahang,0,0,0
1/09/2020,Viet Nam,Perak,0,0,0
1/09/2020,Viet Nam,Perlis,0,0,0
1/09/2020,Viet Nam,Pulau Pinang,0,0,0
1/09/2020,Viet Nam,Sabah,0,0,0
1/09/2020,Viet Nam,Sarawak,1,0,1
1/09/2020,Viet Nam,Selangor,93,26,67
1/09/2020,Viet Nam,Terengganu,0,0,0
1/09/2020,Viet Nam,W.P. Labuan,0,0,0
1/09/2020,Vanuatu,Johor,0,0,0
1/09/2020,Vanuatu,Kedah,0,0,0
1/09/2020,Vanuatu,Pulau Pinang,0,0,0
1/09/2020,Vanuatu,Sabah,0,0,0
1/09/2020,Vanuatu,Sarawak,0,0,0
1/09/2020,Vanuatu,Selangor,1,1,0
1/09/2020, Samoa,Johor,0,0,0
1/09/2020, Samoa,Sarawak,0,0,0
1/09/2020, Samoa,Selangor,0,0,0
1/09/2020,Yemen,Johor,0,0,0
1/09/2020,Yemen,Kedah,0,0,0
1/09/2020,Yemen,Kelantan,0,0,0
1/09/2020,Yemen,Melaka,0,0,0
1/09/2020,Yemen,Pahang,0,0,0
1/09/2020,Yemen,Perak,0,0,0
1/09/2020,Yemen,Perlis,0,0,0
1/09/2020,Yemen,Pulau Pinang,0,0,0
1/09/2020,Yemen,Sabah,0,0,0
1/09/2020,Yemen,Sarawak,0,0,0
1/09/2020,Yemen,Selangor,25,20,5
1/09/2020,Yemen,W.P. Labuan,0,0,0
1/09/2020,South Africa,Johor,0,0,0
1/09/2020,South Africa,Kedah,0,0,0
1/09/2020,South Africa,Kelantan,0,0,0
1/09/2020,South Africa,Melaka,0,0,0
1/09/2020,South Africa,Pahang,0,0,0
1/09/2020,South Africa,Perak,0,0,0
1/09/2020,South Africa,Perlis,0,0,0
1/09/2020,South Africa,Pulau Pinang,0,0,0
1/09/2020,South Africa,Sabah,0,0,0
1/09/2020,South Africa,Sarawak,0,0,0
1/09/2020,South Africa,Selangor,23,14,9
1/09/2020,South Africa,Terengganu,0,0,0
1/09/2020,South Africa,W.P. Labuan,0,0,0
1/09/2020,ZAR,Selangor,0,0,0
1/09/2020,Zambia,Johor,0,0,0
1/09/2020,Zambia,Kedah,0,0,0
1/09/2020,Zambia,Perak,0,0,0
1/09/2020,Zambia,Perlis,0,0,0
1/09/2020,Zambia,Pulau Pinang,0,0,0
1/09/2020,Zambia,Sabah,0,0,0
1/09/2020,Zambia,Sarawak,0,0,0
1/09/2020,Zambia,Selangor,8,4,4
1/09/2020,Zimbabwe,Johor,0,0,0
1/09/2020,Zimbabwe,Kedah,0,0,0
1/09/2020,Zimbabwe,Kelantan,0,0,0
1/09/2020,Zimbabwe,Perak,0,0,0
1/09/2020,Zimbabwe,Perlis,0,0,0
1/09/2020,Zimbabwe,Pulau Pinang,0,0,0
1/09/2020,Zimbabwe,Sabah,0,0,0
1/09/2020,Zimbabwe,Sarawak,0,0,0
1/09/2020,Zimbabwe,Selangor,0,0,0
1/10/2020,Aruba,Kedah,0,0,0
1/10/2020,Aruba,Pulau Pinang,0,0,0
1/10/2020,Afghanistan,Johor,0,0,0
1/10/2020,Afghanistan,Kedah,0,0,0
1/10/2020,Afghanistan,Perlis,0,0,0
1/10/2020,Afghanistan,Pulau Pinang,0,0,0
1/10/2020,Afghanistan,Sarawak,0,0,0
1/10/2020,Afghanistan,Selangor,12,7,5
1/10/2020,Angola,Johor,0,0,0
1/10/2020,Angola,Kedah,0,0,0
1/10/2020,Angola,Sabah,0,0,0
1/10/2020,Angola,Selangor,0,0,0
1/10/2020,Anguilla,Selangor,0,0,0
1/10/2020,Albania,Johor,0,0,0
1/10/2020,Albania,Kedah,0,0,0
1/10/2020,Albania,Perak,0,0,0
1/10/2020,Albania,Perlis,0,0,0
1/10/2020,Albania,Pulau Pinang,0,0,0
1/10/2020,Albania,Sabah,0,0,0
1/10/2020,Albania,Sarawak,0,0,0
1/10/2020,Albania,Selangor,3,2,1
1/10/2020,Andorra,Johor,0,0,0
1/10/2020,Andorra,Kedah,0,0,0
1/10/2020,Andorra,Perlis,0,0,0
1/10/2020,Andorra,Pulau Pinang,0,0,0
1/10/2020,Andorra,Selangor,0,0,0
1/10/2020,Antigua and Barbuda,Selangor,0,0,0
1/10/2020,United Arab Emirates,Johor,0,0,0
1/10/2020,United Arab Emirates,Kedah,0,0,0
1/10/2020,United Arab Emirates,Kelantan,0,0,0
1/10/2020,United Arab Emirates,Perak,0,0,0
1/10/2020,United Arab Emirates,Perlis,0,0,0
1/10/2020,United Arab Emirates,Pulau Pinang,0,0,0
1/10/2020,United Arab Emirates,Sabah,0,0,0
1/10/2020,United Arab Emirates,Sarawak,0,0,0
1/10/2020,United Arab Emirates,Selangor,6,4,2
1/10/2020,Argentina,Johor,0,0,0
1/10/2020,Argentina,Kedah,0,0,0
1/10/2020,Argentina,Kelantan,0,0,0
1/10/2020,Argentina,Melaka,0,0,0
1/10/2020,Argentina,Perak,0,0,0
1/10/2020,Argentina,Perlis,0,0,0
1/10/2020,Argentina,Pulau Pinang,0,0,0
1/10/2020,Argentina,Sabah,0,0,0
1/10/2020,Argentina,Sarawak,0,0,0
1/10/2020,Argentina,Selangor,1,0,1
1/10/2020,Argentina,W.P. Labuan,0,0,0
1/10/2020,Armenia,Johor,0,0,0
1/10/2020,Armenia,Kedah,0,0,0
1/10/2020,Armenia,Kelantan,0,0,0
1/10/2020,Armenia,Perak,0,0,0
1/10/2020,Armenia,Perlis,0,0,0
1/10/2020,Armenia,Pulau Pinang,0,0,0
1/10/2020,Armenia,Sabah,0,0,0
1/10/2020,Armenia,Sarawak,0,0,0
1/10/2020,Armenia,Selangor,0,0,0
1/10/2020,Antarctica,Selangor,0,0,0
1/10/2020,Antigua and Barbuda,Johor,0,0,0
1/10/2020,Antigua and Barbuda,Kedah,0,0,0
1/10/2020,Antigua and Barbuda,Pulau Pinang,0,0,0
1/10/2020,Antigua and Barbuda,Sarawak,0,0,0
1/10/2020,Antigua and Barbuda,Selangor,1,1,0
1/10/2020,Australia,Johor,3,3,0
1/10/2020,Australia,Kedah,0,0,0
1/10/2020,Australia,Kelantan,0,0,0
1/10/2020,Australia,Melaka,0,0,0
1/10/2020,Australia,Negeri Sembilan,0,0,0
1/10/2020,Australia,Pahang,0,0,0
1/10/2020,Australia,Perak,0,0,0
1/10/2020,Australia,Perlis,0,0,0
1/10/2020,Australia,Pulau Pinang,5,2,3
1/10/2020,Australia,Sabah,0,0,0
1/10/2020,Australia,Sarawak,4,1,3
1/10/2020,Australia,Selangor,89,60,29
1/10/2020,Australia,Terengganu,0,0,0
1/10/2020,Australia,W.P. Labuan,0,0,0
1/10/2020,Austria,Johor,1,1,0
1/10/2020,Austria,Kedah,0,0,0
1/10/2020,Austria,Kelantan,0,0,0
1/10/2020,Austria,Melaka,0,0,0
1/10/2020,Austria,Negeri Sembilan,0,0,0
1/10/2020,Austria,Pahang,0,0,0
1/10/2020,Austria,Perak,0,0,0
1/10/2020,Austria,Perlis,0,0,0
1/10/2020,Austria,Pulau Pinang,0,0,0
1/10/2020,Austria,Sabah,1,1,0
1/10/2020,Austria,Sarawak,0,0,0
1/10/2020,Austria,Selangor,6,4,2
1/10/2020,Austria,Terengganu,0,0,0
1/10/2020,Austria,W.P. Labuan,0,0,0
1/10/2020,Azerbaijan,Johor,0,0,0
1/10/2020,Azerbaijan,Kedah,0,0,0
1/10/2020,Azerbaijan,Kelantan,0,0,0
1/10/2020,Azerbaijan,Melaka,0,0,0
1/10/2020,Azerbaijan,Perlis,0,0,0
1/10/2020,Azerbaijan,Pulau Pinang,0,0,0
1/10/2020,Azerbaijan,Sabah,0,0,0
1/10/2020,Azerbaijan,Sarawak,0,0,0
1/10/2020,Azerbaijan,Selangor,4,2,2
1/10/2020,Azerbaijan,W.P. Labuan,0,0,0
1/10/2020,Burundi,Pulau Pinang,0,0,0
1/10/2020,Burundi,Sarawak,0,0,0
1/10/2020,Burundi,Selangor,0,0,0
1/10/2020,Belgium,Johor,0,0,0
1/10/2020,Belgium,Kedah,0,0,0
1/10/2020,Belgium,Kelantan,0,0,0
1/10/2020,Belgium,Melaka,0,0,0
1/10/2020,Belgium,Negeri Sembilan,0,0,0
1/10/2020,Belgium,Pahang,0,0,0
1/10/2020,Belgium,Perak,1,1,0
1/10/2020,Belgium,Perlis,0,0,0
1/10/2020,Belgium,Pulau Pinang,0,0,0
1/10/2020,Belgium,Sabah,0,0,0
1/10/2020,Belgium,Sarawak,0,0,0
1/10/2020,Belgium,Selangor,20,13,7
1/10/2020,Belgium,W.P. Labuan,0,0,0
1/10/2020,Benin,Johor,0,0,0
1/10/2020,Benin,Kedah,0,0,0
1/10/2020,Benin,Perak,0,0,0
1/10/2020,Benin,Pulau Pinang,0,0,0
1/10/2020,Benin,Sabah,0,0,0
1/10/2020,Benin,Sarawak,0,0,0
1/10/2020,Benin,Selangor,0,0,0
1/10/2020,Burkina Faso,Perak,0,0,0
1/10/2020,Burkina Faso,Pulau Pinang,0,0,0
1/10/2020,Burkina Faso,Selangor,0,0,0
1/10/2020,Bangladesh,Johor,2,2,0
1/10/2020,Bangladesh,Kedah,0,0,0
1/10/2020,Bangladesh,Kelantan,0,0,0
1/10/2020,Bangladesh,Melaka,0,0,0
1/10/2020,Bangladesh,Negeri Sembilan,0,0,0
1/10/2020,Bangladesh,Pahang,0,0,0
1/10/2020,Bangladesh,Perak,0,0,0
1/10/2020,Bangladesh,Perlis,0,0,0
1/10/2020,Bangladesh,Pulau Pinang,0,0,0
1/10/2020,Bangladesh,Sabah,0,0,0
1/10/2020,Bangladesh,Sarawak,0,0,0
1/10/2020,Bangladesh,Selangor,61,57,4
1/10/2020,Bangladesh,W.P. Labuan,0,0,0
1/10/2020,Bulgaria,Johor,0,0,0
1/10/2020,Bulgaria,Kedah,0,0,0
1/10/2020,Bulgaria,Kelantan,0,0,0
1/10/2020,Bulgaria,Pahang,0,0,0
1/10/2020,Bulgaria,Perak,0,0,0
1/10/2020,Bulgaria,Perlis,0,0,0
1/10/2020,Bulgaria,Pulau Pinang,0,0,0
1/10/2020,Bulgaria,Sabah,0,0,0
1/10/2020,Bulgaria,Sarawak,0,0,0
1/10/2020,Bulgaria,Selangor,17,16,1
1/10/2020,Bulgaria,W.P. Labuan,0,0,0
1/10/2020,Bahrain,Johor,0,0,0
1/10/2020,Bahrain,Kedah,0,0,0
1/10/2020,Bahrain,Kelantan,0,0,0
1/10/2020,Bahrain,Perlis,0,0,0
1/10/2020,Bahrain,Pulau Pinang,0,0,0
1/10/2020,Bahrain,Sabah,0,0,0
1/10/2020,Bahrain,Sarawak,0,0,0
1/10/2020,Bahrain,Selangor,2,1,1
1/10/2020,Bahamas,Johor,0,0,0
1/10/2020,Bahamas,Kedah,0,0,0
1/10/2020,Bahamas,Perak,0,0,0
1/10/2020,Bahamas,Sabah,0,0,0
1/10/2020,Bahamas,Sarawak,0,0,0
1/10/2020,Bahamas,Selangor,0,0,0
1/10/2020,Bosnia and Herzegovina,Johor,0,0,0
1/10/2020,Bosnia and Herzegovina,Kedah,0,0,0
1/10/2020,Bosnia and Herzegovina,Perlis,0,0,0
1/10/2020,Bosnia and Herzegovina,Pulau Pinang,0,0,0
1/10/2020,Bosnia and Herzegovina,Sabah,0,0,0
1/10/2020,Bosnia and Herzegovina,Sarawak,0,0,0
1/10/2020,Bosnia and Herzegovina,Selangor,10,6,4
1/10/2020,Belarus,Johor,0,0,0
1/10/2020,Belarus,Kedah,0,0,0
1/10/2020,Belarus,Kelantan,0,0,0
1/10/2020,Belarus,Pahang,0,0,0
1/10/2020,Belarus,Perak,0,0,0
1/10/2020,Belarus,Perlis,0,0,0
1/10/2020,Belarus,Pulau Pinang,0,0,0
1/10/2020,Belarus,Sabah,0,0,0
1/10/2020,Belarus,Sarawak,0,0,0
1/10/2020,Belarus,Selangor,1,0,1
1/10/2020,Belarus,W.P. Labuan,0,0,0
1/10/2020,Belize,Johor,0,0,0
1/10/2020,Belize,Pulau Pinang,0,0,0
1/10/2020,Belize,Sarawak,0,0,0
1/10/2020,Belize,Selangor,1,0,1
1/10/2020,Bermuda,Selangor,0,0,0
1/10/2020,Bolivia,Johor,0,0,0
1/10/2020,Bolivia,Kedah,0,0,0
1/10/2020,Bolivia,Melaka,0,0,0
1/10/2020,Bolivia,Perak,0,0,0
1/10/2020,Bolivia,Perlis,0,0,0
1/10/2020,Bolivia,Pulau Pinang,0,0,0
1/10/2020,Bolivia,Sabah,0,0,0
1/10/2020,Bolivia,Sarawak,0,0,0
1/10/2020,Bolivia,Selangor,0,0,0
1/10/2020,Brazil,Johor,0,0,0
1/10/2020,Brazil,Kedah,0,0,0
1/10/2020,Brazil,Kelantan,0,0,0
1/10/2020,Brazil,Melaka,0,0,0
1/10/2020,Brazil,Pahang,0,0,0
1/10/2020,Brazil,Perak,0,0,0
1/10/2020,Brazil,Perlis,0,0,0
1/10/2020,Brazil,Pulau Pinang,0,0,0
1/10/2020,Brazil,Sabah,0,0,0
1/10/2020,Brazil,Sarawak,0,0,0
1/10/2020,Brazil,Selangor,10,8,2
1/10/2020,Brazil,W.P. Labuan,0,0,0
1/10/2020,Barbados,Johor,0,0,0
1/10/2020,Barbados,Kedah,0,0,0
1/10/2020,Barbados,Perlis,0,0,0
1/10/2020,Barbados,Pulau Pinang,0,0,0
1/10/2020,Barbados,Selangor,0,0,0
1/10/2020,Brunei Darussalam,Johor,1,1,0
1/10/2020,Brunei Darussalam,Kedah,0,0,0
1/10/2020,Brunei Darussalam,Kelantan,0,0,0
1/10/2020,Brunei Darussalam,Melaka,0,0,0
1/10/2020,Brunei Darussalam,Pahang,0,0,0
1/10/2020,Brunei Darussalam,Perak,0,0,0
1/10/2020,Brunei Darussalam,Perlis,0,0,0
1/10/2020,Brunei Darussalam,Pulau Pinang,0,0,0
1/10/2020,Brunei Darussalam,Sabah,0,0,0
1/10/2020,Brunei Darussalam,Sarawak,198,188,10
1/10/2020,Brunei Darussalam,Selangor,29,15,14
1/10/2020,Brunei Darussalam,W.P. Labuan,0,0,0
1/10/2020,Bhutan,Johor,0,0,0
1/10/2020,Bhutan,Kedah,0,0,0
1/10/2020,Bhutan,Perak,0,0,0
1/10/2020,Bhutan,Perlis,0,0,0
1/10/2020,Bhutan,Pulau Pinang,0,0,0
1/10/2020,Bhutan,Sabah,0,0,0
1/10/2020,Bhutan,Sarawak,0,0,0
1/10/2020,Bhutan,Selangor,1,0,1
1/10/2020,Botswana,Johor,0,0,0
1/10/2020,Botswana,Kedah,0,0,0
1/10/2020,Botswana,Perlis,0,0,0
1/10/2020,Botswana,Pulau Pinang,0,0,0
1/10/2020,Botswana,Sabah,0,0,0
1/10/2020,Botswana,Sarawak,0,0,0
1/10/2020,Botswana,Selangor,0,0,0
1/10/2020,Central African Republic,Kedah,0,0,0
1/10/2020,Central African Republic,Selangor,0,0,0
1/10/2020,Canada,Johor,1,1,0
1/10/2020,Canada,Kedah,0,0,0
1/10/2020,Canada,Kelantan,0,0,0
1/10/2020,Canada,Melaka,0,0,0
1/10/2020,Canada,Negeri Sembilan,0,0,0
1/10/2020,Canada,Pahang,0,0,0
1/10/2020,Canada,Perak,0,0,0
1/10/2020,Canada,Perlis,0,0,0
1/10/2020,Canada,Pulau Pinang,2,1,1
1/10/2020,Canada,Sabah,0,0,0
1/10/2020,Canada,Sarawak,0,0,0
1/10/2020,Canada,Selangor,40,26,14
1/10/2020,Canada,Terengganu,0,0,0
1/10/2020,Canada,W.P. Labuan,0,0,0
1/10/2020,Cocos (Keeling) Islands,Selangor,0,0,0
1/10/2020,Switzerland,Johor,0,0,0
1/10/2020,Switzerland,Kedah,0,0,0
1/10/2020,Switzerland,Kelantan,0,0,0
1/10/2020,Switzerland,Melaka,0,0,0
1/10/2020,Switzerland,Negeri Sembilan,0,0,0
1/10/2020,Switzerland,Pahang,0,0,0
1/10/2020,Switzerland,Perak,0,0,0
1/10/2020,Switzerland,Perlis,0,0,0
1/10/2020,Switzerland,Pulau Pinang,2,2,0
1/10/2020,Switzerland,Sabah,0,0,0
1/10/2020,Switzerland,Sarawak,0,0,0
1/10/2020,Switzerland,Selangor,21,12,9
1/10/2020,Switzerland,W.P. Labuan,0,0,0
1/10/2020,Chile,Johor,0,0,0
1/10/2020,Chile,Kedah,0,0,0
1/10/2020,Chile,Kelantan,0,0,0
1/10/2020,Chile,Melaka,0,0,0
1/10/2020,Chile,Pahang,0,0,0
1/10/2020,Chile,Perak,0,0,0
1/10/2020,Chile,Perlis,0,0,0
1/10/2020,Chile,Pulau Pinang,0,0,0
1/10/2020,Chile,Sabah,0,0,0
1/10/2020,Chile,Sarawak,0,0,0
1/10/2020,Chile,Selangor,4,4,0
1/10/2020,China,Johor,43,32,11
1/10/2020,China,Kedah,0,0,0
1/10/2020,China,Kelantan,0,0,0
1/10/2020,China,Melaka,0,0,0
1/10/2020,China,Pahang,0,0,0
1/10/2020,China,Perak,0,0,0
1/10/2020,China,Perlis,0,0,0
1/10/2020,China,Pulau Pinang,3,2,1
1/10/2020,China,Sabah,0,0,0
1/10/2020,China,Sarawak,101,55,46
1/10/2020,China,Selangor,1142,908,234
1/10/2020,China,Terengganu,0,0,0
1/10/2020,China,W.P. Labuan,0,0,0
1/10/2020,Côte d'Ivoire,Johor,0,0,0
1/10/2020,Côte d'Ivoire,Kedah,0,0,0
1/10/2020,Côte d'Ivoire,Pulau Pinang,0,0,0
1/10/2020,Côte d'Ivoire,Sabah,0,0,0
1/10/2020,Côte d'Ivoire,Sarawak,0,0,0
1/10/2020,Côte d'Ivoire,Selangor,0,0,0
1/10/2020,Cameroon,Johor,0,0,0
1/10/2020,Cameroon,Kedah,0,0,0
1/10/2020,Cameroon,Pulau Pinang,0,0,0
1/10/2020,Cameroon,Sabah,0,0,0
1/10/2020,Cameroon,Sarawak,0,0,0
1/10/2020,Cameroon,Selangor,0,0,0
1/10/2020,Congo,Johor,0,0,0
1/10/2020,Congo,Pulau Pinang,0,0,0
1/10/2020,Congo,Sarawak,0,0,0
1/10/2020,Congo,Selangor,1,0,1
1/10/2020,Congo,Johor,0,0,0
1/10/2020,Congo,Kedah,0,0,0
1/10/2020,Congo,Selangor,0,0,0
1/10/2020,Cook Islands,Selangor,0,0,0
1/10/2020,Colombia,Johor,0,0,0
1/10/2020,Colombia,Kedah,0,0,0
1/10/2020,Colombia,Perak,0,0,0
1/10/2020,Colombia,Pulau Pinang,0,0,0
1/10/2020,Colombia,Sabah,0,0,0
1/10/2020,Colombia,Sarawak,0,0,0
1/10/2020,Colombia,Selangor,1,1,0
1/10/2020,Colombia,W.P. Labuan,0,0,0
1/10/2020,Comoros,Johor,0,0,0
1/10/2020,Comoros,Kedah,0,0,0
1/10/2020,Comoros,Selangor,2,0,2
1/10/2020,Cabo Verde,Johor,0,0,0
1/10/2020,Cabo Verde,Kedah,0,0,0
1/10/2020,Cabo Verde,Pulau Pinang,0,0,0
1/10/2020,Cabo Verde,Sabah,0,0,0
1/10/2020,Cabo Verde,Selangor,0,0,0
1/10/2020,Costa Rica,Johor,2,2,0
1/10/2020,Costa Rica,Kedah,0,0,0
1/10/2020,Costa Rica,Perak,0,0,0
1/10/2020,Costa Rica,Perlis,0,0,0
1/10/2020,Costa Rica,Pulau Pinang,0,0,0
1/10/2020,Costa Rica,Sabah,0,0,0
1/10/2020,Costa Rica,Sarawak,0,0,0
1/10/2020,Costa Rica,Selangor,1,1,0
1/10/2020,Cuba,Johor,0,0,0
1/10/2020,Cuba,Kedah,0,0,0
1/10/2020,Cuba,Perlis,0,0,0
1/10/2020,Cuba,Pulau Pinang,0,0,0
1/10/2020,Cuba,Sabah,0,0,0
1/10/2020,Cuba,Sarawak,0,0,0
1/10/2020,Cuba,Selangor,0,0,0
1/10/2020,Cyprus,Johor,0,0,0
1/10/2020,Cyprus,Kedah,0,0,0
1/10/2020,Cyprus,Perak,0,0,0
1/10/2020,Cyprus,Perlis,0,0,0
1/10/2020,Cyprus,Pulau Pinang,0,0,0
1/10/2020,Cyprus,Sabah,0,0,0
1/10/2020,Cyprus,Sarawak,0,0,0
1/10/2020,Cyprus,Selangor,0,0,0
1/10/2020,Czechia,Johor,0,0,0
1/10/2020,Czechia,Kedah,0,0,0
1/10/2020,Czechia,Kelantan,0,0,0
1/10/2020,Czechia,Melaka,0,0,0
1/10/2020,Czechia,Negeri Sembilan,0,0,0
1/10/2020,Czechia,Perak,0,0,0
1/10/2020,Czechia,Perlis,0,0,0
1/10/2020,Czechia,Pulau Pinang,0,0,0
1/10/2020,Czechia,Sabah,0,0,0
1/10/2020,Czechia,Sarawak,0,0,0
1/10/2020,Czechia,Selangor,5,4,1
1/10/2020,Czechia,W.P. Labuan,0,0,0
1/10/2020,Germany,Johor,1,1,0
1/10/2020,Germany,Kedah,0,0,0
1/10/2020,Germany,Kelantan,0,0,0
1/10/2020,Germany,Melaka,0,0,0
1/10/2020,Germany,Negeri Sembilan,0,0,0
1/10/2020,Germany,Pahang,0,0,0
1/10/2020,Germany,Perak,0,0,0
1/10/2020,Germany,Perlis,0,0,0
1/10/2020,Germany,Pulau Pinang,1,0,1
1/10/2020,Germany,Sabah,0,0,0
1/10/2020,Germany,Sarawak,0,0,0
1/10/2020,Germany,Selangor,110,87,23
1/10/2020,Germany,Terengganu,0,0,0
1/10/2020,Germany,W.P. Labuan,0,0,0
1/10/2020,Djibouti,Johor,0,0,0
1/10/2020,Djibouti,Selangor,2,2,0
1/10/2020,Dominica,Johor,0,0,0
1/10/2020,Dominica,Kedah,0,0,0
1/10/2020,Dominica,Pulau Pinang,0,0,0
1/10/2020,Dominica,Sabah,0,0,0
1/10/2020,Dominica,Sarawak,0,0,0
1/10/2020,Dominica,Selangor,0,0,0
1/10/2020,Dominica,W.P. Labuan,0,0,0
1/10/2020,Denmark,Johor,8,8,0
1/10/2020,Denmark,Kedah,0,0,0
1/10/2020,Denmark,Kelantan,0,0,0
1/10/2020,Denmark,Melaka,0,0,0
1/10/2020,Denmark,Negeri Sembilan,0,0,0
1/10/2020,Denmark,Pahang,0,0,0
1/10/2020,Denmark,Perak,0,0,0
1/10/2020,Denmark,Perlis,0,0,0
1/10/2020,Denmark,Pulau Pinang,0,0,0
1/10/2020,Denmark,Sabah,0,0,0
1/10/2020,Denmark,Sarawak,1,1,0
1/10/2020,Denmark,Selangor,19,17,2
1/10/2020,Denmark,W.P. Labuan,0,0,0
1/10/2020,Dominican Republic,Johor,0,0,0
1/10/2020,Dominican Republic,Kedah,0,0,0
1/10/2020,Dominican Republic,Perak,0,0,0
1/10/2020,Dominican Republic,Perlis,0,0,0
1/10/2020,Dominican Republic,Pulau Pinang,0,0,0
1/10/2020,Dominican Republic,Sabah,0,0,0
1/10/2020,Dominican Republic,Sarawak,0,0,0
1/10/2020,Dominican Republic,Selangor,0,0,0
1/10/2020,Algeria,Johor,0,0,0
1/10/2020,Algeria,Kedah,0,0,0
1/10/2020,Algeria,Kelantan,0,0,0
1/10/2020,Algeria,Melaka,0,0,0
1/10/2020,Algeria,Perak,0,0,0
1/10/2020,Algeria,Perlis,0,0,0
1/10/2020,Algeria,Pulau Pinang,0,0,0
1/10/2020,Algeria,Sabah,0,0,0
1/10/2020,Algeria,Sarawak,0,0,0
1/10/2020,Algeria,Selangor,1,1,0
1/10/2020,Algeria,W.P. Labuan,0,0,0
1/10/2020,Ecuador,Johor,0,0,0
1/10/2020,Ecuador,Kedah,0,0,0
1/10/2020,Ecuador,Perak,0,0,0
1/10/2020,Ecuador,Perlis,0,0,0
1/10/2020,Ecuador,Pulau Pinang,0,0,0
1/10/2020,Ecuador,Sabah,0,0,0
1/10/2020,Ecuador,Sarawak,0,0,0
1/10/2020,Ecuador,Selangor,0,0,0
1/10/2020,Egypt,Johor,0,0,0
1/10/2020,Egypt,Kedah,0,0,0
1/10/2020,Egypt,Kelantan,0,0,0
1/10/2020,Egypt,Melaka,0,0,0
1/10/2020,Egypt,Pahang,0,0,0
1/10/2020,Egypt,Perak,0,0,0
1/10/2020,Egypt,Perlis,0,0,0
1/10/2020,Egypt,Pulau Pinang,0,0,0
1/10/2020,Egypt,Sabah,0,0,0
1/10/2020,Egypt,Sarawak,1,1,0
1/10/2020,Egypt,Selangor,52,38,14
1/10/2020,Egypt,Terengganu,0,0,0
1/10/2020,Egypt,W.P. Labuan,0,0,0
1/10/2020,Eritrea,Johor,0,0,0
1/10/2020,Eritrea,Pulau Pinang,0,0,0
1/10/2020,Eritrea,Sabah,0,0,0
1/10/2020,Eritrea,Selangor,0,0,0
1/10/2020,Spain,Johor,0,0,0
1/10/2020,Spain,Kedah,0,0,0
1/10/2020,Spain,Kelantan,0,0,0
1/10/2020,Spain,Melaka,0,0,0
1/10/2020,Spain,Negeri Sembilan,0,0,0
1/10/2020,Spain,Pahang,0,0,0
1/10/2020,Spain,Perak,0,0,0
1/10/2020,Spain,Perlis,0,0,0
1/10/2020,Spain,Pulau Pinang,0,0,0
1/10/2020,Spain,Sabah,0,0,0
1/10/2020,Spain,Sarawak,0,0,0
1/10/2020,Spain,Selangor,12,6,6
1/10/2020,Spain,W.P. Labuan,0,0,0
1/10/2020,Estonia,Johor,0,0,0
1/10/2020,Estonia,Kedah,0,0,0
1/10/2020,Estonia,Kelantan,0,0,0
1/10/2020,Estonia,Pahang,0,0,0
1/10/2020,Estonia,Perak,0,0,0
1/10/2020,Estonia,Perlis,0,0,0
1/10/2020,Estonia,Pulau Pinang,0,0,0
1/10/2020,Estonia,Sabah,0,0,0
1/10/2020,Estonia,Sarawak,0,0,0
1/10/2020,Estonia,Selangor,0,0,0
1/10/2020,Estonia,W.P. Labuan,0,0,0
1/10/2020,Ethiopia,Johor,0,0,0
1/10/2020,Ethiopia,Kedah,0,0,0
1/10/2020,Ethiopia,Pulau Pinang,0,0,0
1/10/2020,Ethiopia,Sarawak,0,0,0
1/10/2020,Ethiopia,Selangor,0,0,0
1/10/2020,Finland,Johor,0,0,0
1/10/2020,Finland,Kedah,0,0,0
1/10/2020,Finland,Kelantan,0,0,0
1/10/2020,Finland,Melaka,0,0,0
1/10/2020,Finland,Negeri Sembilan,0,0,0
1/10/2020,Finland,Pahang,0,0,0
1/10/2020,Finland,Perak,0,0,0
1/10/2020,Finland,Perlis,0,0,0
1/10/2020,Finland,Pulau Pinang,0,0,0
1/10/2020,Finland,Sabah,0,0,0
1/10/2020,Finland,Sarawak,0,0,0
1/10/2020,Finland,Selangor,2,1,1
1/10/2020,Finland,W.P. Labuan,0,0,0
1/10/2020,Fiji,Johor,0,0,0
1/10/2020,Fiji,Kedah,0,0,0
1/10/2020,Fiji,Kelantan,0,0,0
1/10/2020,Fiji,Perak,0,0,0
1/10/2020,Fiji,Perlis,0,0,0
1/10/2020,Fiji,Pulau Pinang,0,0,0
1/10/2020,Fiji,Sabah,0,0,0
1/10/2020,Fiji,Sarawak,0,0,0
1/10/2020,Fiji,Selangor,0,0,0
1/10/2020,France,Johor,2,2,0
1/10/2020,France,Kedah,0,0,0
1/10/2020,France,Kelantan,0,0,0
1/10/2020,France,Melaka,0,0,0
1/10/2020,France,Negeri Sembilan,0,0,0
1/10/2020,France,Pahang,0,0,0
1/10/2020,France,Perak,0,0,0
1/10/2020,France,Perlis,0,0,0
1/10/2020,France,Pulau Pinang,0,0,0
1/10/2020,France,Sabah,0,0,0
1/10/2020,France,Sarawak,0,0,0
1/10/2020,France,Selangor,78,48,30
1/10/2020,France,Terengganu,0,0,0
1/10/2020,France,W.P. Labuan,0,0,0
1/10/2020,"Micronesia, Federated States of",Johor,0,0,0
1/10/2020,"Micronesia, Federated States of",Pulau Pinang,0,0,0
1/10/2020,"Micronesia, Federated States of",Selangor,0,0,0
1/10/2020,Gabon,Johor,0,0,0
1/10/2020,Gabon,Pulau Pinang,0,0,0
1/10/2020,Gabon,Sarawak,0,0,0
1/10/2020,Gabon,Selangor,0,0,0
1/10/2020,United Kingdom of Great Britain and Northern Ireland,Johor,4,4,0
1/10/2020,United Kingdom of Great Britain and Northern Ireland,Kedah,0,0,0
1/10/2020,United Kingdom of Great Britain and Northern Ireland,Kelantan,0,0,0
1/10/2020,United Kingdom of Great Britain and Northern Ireland,Melaka,0,0,0
1/10/2020,United Kingdom of Great Britain and Northern Ireland,Negeri Sembilan,0,0,0
1/10/2020,United Kingdom of Great Britain and Northern Ireland,Pahang,0,0,0
1/10/2020,United Kingdom of Great Britain and Northern Ireland,Perak,0,0,0
1/10/2020,United Kingdom of Great Britain and Northern Ireland,Perlis,0,0,0
1/10/2020,United Kingdom of Great Britain and Northern Ireland,Pulau Pinang,5,5,0
1/10/2020,United Kingdom of Great Britain and Northern Ireland,Sabah,1,1,0
1/10/2020,United Kingdom of Great Britain and Northern Ireland,Sarawak,0,0,0
1/10/2020,United Kingdom of Great Britain and Northern Ireland,Selangor,209,156,53
1/10/2020,United Kingdom of Great Britain and Northern Ireland,Terengganu,0,0,0
1/10/2020,United Kingdom of Great Britain and Northern Ireland,W.P. Labuan,0,0,0
1/10/2020,Georgia,Johor,0,0,0
1/10/2020,Georgia,Kedah,0,0,0
1/10/2020,Georgia,Melaka,0,0,0
1/10/2020,Georgia,Perak,0,0,0
1/10/2020,Georgia,Perlis,0,0,0
1/10/2020,Georgia,Pulau Pinang,0,0,0
1/10/2020,Georgia,Sabah,0,0,0
1/10/2020,Georgia,Sarawak,0,0,0
1/10/2020,Georgia,Selangor,9,8,1
1/10/2020,Ghana,Johor,0,0,0
1/10/2020,Ghana,Kedah,0,0,0
1/10/2020,Ghana,Kelantan,0,0,0
1/10/2020,Ghana,Pulau Pinang,0,0,0
1/10/2020,Ghana,Sabah,0,0,0
1/10/2020,Ghana,Sarawak,0,0,0
1/10/2020,Ghana,Selangor,2,1,1
1/10/2020,Gibraltar,Johor,0,0,0
1/10/2020,Gibraltar,Sarawak,0,0,0
1/10/2020,Guinea,Johor,0,0,0
1/10/2020,Guinea,Kedah,0,0,0
1/10/2020,Guinea,Kelantan,0,0,0
1/10/2020,Guinea,Perlis,0,0,0
1/10/2020,Guinea,Pulau Pinang,0,0,0
1/10/2020,Guinea,Sabah,0,0,0
1/10/2020,Guinea,Sarawak,0,0,0
1/10/2020,Guinea,Selangor,0,0,0
1/10/2020,Guadeloupe,Selangor,0,0,0
1/10/2020,Gambia,Johor,0,0,0
1/10/2020,Gambia,Kedah,0,0,0
1/10/2020,Gambia,Kelantan,0,0,0
1/10/2020,Gambia,Pulau Pinang,0,0,0
1/10/2020,Gambia,Sabah,0,0,0
1/10/2020,Gambia,Sarawak,0,0,0
1/10/2020,Gambia,Selangor,0,0,0
1/10/2020,Guinea-Bissau,Johor,0,0,0
1/10/2020,Guinea-Bissau,Selangor,0,0,0
1/10/2020,Equatorial Guinea,Johor,0,0,0
1/10/2020,Equatorial Guinea,Selangor,0,0,0
1/10/2020,Greece,Johor,0,0,0
1/10/2020,Greece,Kedah,0,0,0
1/10/2020,Greece,Kelantan,0,0,0
1/10/2020,Greece,Melaka,0,0,0
1/10/2020,Greece,Negeri Sembilan,0,0,0
1/10/2020,Greece,Pahang,0,0,0
1/10/2020,Greece,Perak,0,0,0
1/10/2020,Greece,Perlis,0,0,0
1/10/2020,Greece,Pulau Pinang,0,0,0
1/10/2020,Greece,Sabah,0,0,0
1/10/2020,Greece,Sarawak,0,0,0
1/10/2020,Greece,Selangor,14,13,1
1/10/2020,Grenada,Johor,0,0,0
1/10/2020,Grenada,Kedah,0,0,0
1/10/2020,Grenada,Pulau Pinang,0,0,0
1/10/2020,Grenada,Sabah,0,0,0
1/10/2020,Grenada,Sarawak,0,0,0
1/10/2020,Grenada,Selangor,0,0,0
1/10/2020,Greenland,Johor,0,0,0
1/10/2020,Greenland,Selangor,0,0,0
1/10/2020,Guatemala,Johor,0,0,0
1/10/2020,Guatemala,Kedah,0,0,0
1/10/2020,Guatemala,Pahang,0,0,0
1/10/2020,Guatemala,Perak,0,0,0
1/10/2020,Guatemala,Pulau Pinang,0,0,0
1/10/2020,Guatemala,Sabah,0,0,0
1/10/2020,Guatemala,Sarawak,0,0,0
1/10/2020,Guatemala,Selangor,0,0,0
1/10/2020,Guatemala,W.P. Labuan,0,0,0
1/10/2020,Guyana,Johor,0,0,0
1/10/2020,Guyana,Kedah,0,0,0
1/10/2020,Guyana,Pulau Pinang,0,0,0
1/10/2020,Guyana,Sarawak,0,0,0
1/10/2020,Guyana,Selangor,0,0,0
1/10/2020,Hong Kong,Johor,0,0,0
1/10/2020,Hong Kong,Kedah,0,0,0
1/10/2020,Hong Kong,Kelantan,0,0,0
1/10/2020,Hong Kong,Pahang,0,0,0
1/10/2020,Hong Kong,Perak,0,0,0
1/10/2020,Hong Kong,Perlis,0,0,0
1/10/2020,Hong Kong,Pulau Pinang,0,0,0
1/10/2020,Hong Kong,Sabah,0,0,0
1/10/2020,Hong Kong,Sarawak,0,0,0
1/10/2020,Hong Kong,Selangor,0,0,0
1/10/2020,Hong Kong,Terengganu,0,0,0
1/10/2020,Heard Island and McDonald Islands,Johor,0,0,0
1/10/2020,Honduras,Johor,0,0,0
1/10/2020,Honduras,Kedah,0,0,0
1/10/2020,Honduras,Perak,0,0,0
1/10/2020,Honduras,Pulau Pinang,0,0,0
1/10/2020,Honduras,Sabah,0,0,0
1/10/2020,Honduras,Sarawak,0,0,0
1/10/2020,Honduras,Selangor,3,3,0
1/10/2020,Croatia,Johor,0,0,0
1/10/2020,Croatia,Kedah,0,0,0
1/10/2020,Croatia,Kelantan,0,0,0
1/10/2020,Croatia,Melaka,0,0,0
1/10/2020,Croatia,Pahang,0,0,0
1/10/2020,Croatia,Perak,0,0,0
1/10/2020,Croatia,Perlis,0,0,0
1/10/2020,Croatia,Pulau Pinang,0,0,0
1/10/2020,Croatia,Sabah,0,0,0
1/10/2020,Croatia,Sarawak,0,0,0
1/10/2020,Croatia,Selangor,10,9,1
1/10/2020,Haiti,Johor,0,0,0
1/10/2020,Haiti,Kedah,0,0,0
1/10/2020,Haiti,Kelantan,0,0,0
1/10/2020,Haiti,Perak,0,0,0
1/10/2020,Haiti,Pulau Pinang,0,0,0
1/10/2020,Haiti,Sabah,0,0,0
1/10/2020,Haiti,Selangor,0,0,0
1/10/2020,Hungary,Johor,0,0,0
1/10/2020,Hungary,Kedah,0,0,0
1/10/2020,Hungary,Kelantan,0,0,0
1/10/2020,Hungary,Pahang,0,0,0
1/10/2020,Hungary,Perak,0,0,0
1/10/2020,Hungary,Perlis,0,0,0
1/10/2020,Hungary,Pulau Pinang,0,0,0
1/10/2020,Hungary,Sabah,0,0,0
1/10/2020,Hungary,Sarawak,0,0,0
1/10/2020,Hungary,Selangor,4,2,2
1/10/2020,Hungary,W.P. Labuan,0,0,0
1/10/2020,Indonesia,Johor,238,227,11
1/10/2020,Indonesia,Kedah,3,3,0
1/10/2020,Indonesia,Kelantan,0,0,0
1/10/2020,Indonesia,Melaka,2,1,1
1/10/2020,Indonesia,Negeri Sembilan,0,0,0
1/10/2020,Indonesia,Pahang,0,0,0
1/10/2020,Indonesia,Perak,0,0,0
1/10/2020,Indonesia,Perlis,7,5,2
1/10/2020,Indonesia,Pulau Pinang,2,2,0
1/10/2020,Indonesia,Sabah,0,0,0
1/10/2020,Indonesia,Sarawak,276,260,16
1/10/2020,Indonesia,Selangor,445,369,76
1/10/2020,Indonesia,Terengganu,0,0,0
1/10/2020,Indonesia,W.P. Labuan,1,1,0
1/10/2020,India,Johor,39,37,2
1/10/2020,India,Kedah,0,0,0
1/10/2020,India,Kelantan,0,0,0
1/10/2020,India,Melaka,0,0,0
1/10/2020,India,Negeri Sembilan,0,0,0
1/10/2020,India,Pahang,0,0,0
1/10/2020,India,Perak,0,0,0
1/10/2020,India,Perlis,0,0,0
1/10/2020,India,Pulau Pinang,0,0,0
1/10/2020,India,Sabah,0,0,0
1/10/2020,India,Sarawak,0,0,0
1/10/2020,India,Selangor,353,305,48
1/10/2020,India,Terengganu,0,0,0
1/10/2020,India,W.P. Labuan,0,0,0
1/10/2020, British Indian Ocean Territory,Pulau Pinang,0,0,0
1/10/2020, British Indian Ocean Territory,Selangor,0,0,0
1/10/2020,Ireland,Johor,0,0,0
1/10/2020,Ireland,Kedah,0,0,0
1/10/2020,Ireland,Kelantan,0,0,0
1/10/2020,Ireland,Negeri Sembilan,0,0,0
1/10/2020,Ireland,Pahang,0,0,0
1/10/2020,Ireland,Perak,0,0,0
1/10/2020,Ireland,Perlis,0,0,0
1/10/2020,Ireland,Pulau Pinang,0,0,0
1/10/2020,Ireland,Sabah,0,0,0
1/10/2020,Ireland,Sarawak,0,0,0
1/10/2020,Ireland,Selangor,19,11,8
1/10/2020,Ireland,Terengganu,0,0,0
1/10/2020,Ireland,W.P. Labuan,0,0,0
1/10/2020,"Iran, Islamic Republic of",Johor,0,0,0
1/10/2020,"Iran, Islamic Republic of",Kedah,0,0,0
1/10/2020,"Iran, Islamic Republic of",Kelantan,0,0,0
1/10/2020,"Iran, Islamic Republic of",Perak,0,0,0
1/10/2020,"Iran, Islamic Republic of",Perlis,0,0,0
1/10/2020,"Iran, Islamic Republic of",Pulau Pinang,0,0,0
1/10/2020,"Iran, Islamic Republic of",Sabah,0,0,0
1/10/2020,"Iran, Islamic Republic of",Sarawak,0,0,0
1/10/2020,"Iran, Islamic Republic of",Selangor,30,13,17
1/10/2020,"Iran, Islamic Republic of",W.P. Labuan,0,0,0
1/10/2020,Iraq,Johor,0,0,0
1/10/2020,Iraq,Kedah,0,0,0
1/10/2020,Iraq,Kelantan,0,0,0
1/10/2020,Iraq,Melaka,0,0,0
1/10/2020,Iraq,Pahang,0,0,0
1/10/2020,Iraq,Perak,0,0,0
1/10/2020,Iraq,Perlis,0,0,0
1/10/2020,Iraq,Pulau Pinang,0,0,0
1/10/2020,Iraq,Sabah,0,0,0
1/10/2020,Iraq,Sarawak,0,0,0
1/10/2020,Iraq,Selangor,10,6,4
1/10/2020,Iceland,Johor,0,0,0
1/10/2020,Iceland,Kedah,0,0,0
1/10/2020,Iceland,Kelantan,0,0,0
1/10/2020,Iceland,Perak,0,0,0
1/10/2020,Iceland,Perlis,0,0,0
1/10/2020,Iceland,Pulau Pinang,0,0,0
1/10/2020,Iceland,Sabah,0,0,0
1/10/2020,Iceland,Sarawak,0,0,0
1/10/2020,Iceland,Selangor,0,0,0
1/10/2020,Iceland,W.P. Labuan,0,0,0
1/10/2020,Israel,Pulau Pinang,0,0,0
1/10/2020,Italy,Johor,0,0,0
1/10/2020,Italy,Kedah,0,0,0
1/10/2020,Italy,Kelantan,0,0,0
1/10/2020,Italy,Melaka,0,0,0
1/10/2020,Italy,Negeri Sembilan,0,0,0
1/10/2020,Italy,Pahang,0,0,0
1/10/2020,Italy,Perak,0,0,0
1/10/2020,Italy,Perlis,0,0,0
1/10/2020,Italy,Pulau Pinang,0,0,0
1/10/2020,Italy,Sabah,0,0,0
1/10/2020,Italy,Sarawak,0,0,0
1/10/2020,Italy,Selangor,38,34,4
1/10/2020,Italy,W.P. Labuan,0,0,0
1/10/2020,Jamaica,Johor,0,0,0
1/10/2020,Jamaica,Kedah,0,0,0
1/10/2020,Jamaica,Perak,0,0,0
1/10/2020,Jamaica,Pulau Pinang,0,0,0
1/10/2020,Jamaica,Sabah,0,0,0
1/10/2020,Jamaica,Sarawak,0,0,0
1/10/2020,Jamaica,Selangor,0,0,0
1/10/2020,Jamaica,W.P. Labuan,0,0,0
1/10/2020,Jordan,Johor,0,0,0
1/10/2020,Jordan,Kedah,0,0,0
1/10/2020,Jordan,Kelantan,0,0,0
1/10/2020,Jordan,Melaka,0,0,0
1/10/2020,Jordan,Perlis,0,0,0
1/10/2020,Jordan,Pulau Pinang,0,0,0
1/10/2020,Jordan,Sabah,0,0,0
1/10/2020,Jordan,Sarawak,0,0,0
1/10/2020,Jordan,Selangor,5,4,1
1/10/2020,Jordan,W.P. Labuan,0,0,0
1/10/2020,Japan,Johor,6,6,0
1/10/2020,Japan,Kedah,0,0,0
1/10/2020,Japan,Kelantan,0,0,0
1/10/2020,Japan,Melaka,0,0,0
1/10/2020,Japan,Negeri Sembilan,0,0,0
1/10/2020,Japan,Pahang,0,0,0
1/10/2020,Japan,Perak,0,0,0
1/10/2020,Japan,Perlis,0,0,0
1/10/2020,Japan,Pulau Pinang,3,3,0
1/10/2020,Japan,Sabah,0,0,0
1/10/2020,Japan,Sarawak,0,0,0
1/10/2020,Japan,Selangor,481,323,158
1/10/2020,Japan,W.P. Labuan,0,0,0
1/10/2020,Kazakhstan,Johor,0,0,0
1/10/2020,Kazakhstan,Kedah,0,0,0
1/10/2020,Kazakhstan,Kelantan,0,0,0
1/10/2020,Kazakhstan,Melaka,0,0,0
1/10/2020,Kazakhstan,Perak,0,0,0
1/10/2020,Kazakhstan,Perlis,0,0,0
1/10/2020,Kazakhstan,Pulau Pinang,0,0,0
1/10/2020,Kazakhstan,Sabah,0,0,0
1/10/2020,Kazakhstan,Sarawak,0,0,0
1/10/2020,Kazakhstan,Selangor,2,0,2
1/10/2020,Kazakhstan,W.P. Labuan,0,0,0
1/10/2020,Kenya,Johor,0,0,0
1/10/2020,Kenya,Kedah,0,0,0
1/10/2020,Kenya,Kelantan,0,0,0
1/10/2020,Kenya,Perak,0,0,0
1/10/2020,Kenya,Perlis,0,0,0
1/10/2020,Kenya,Pulau Pinang,0,0,0
1/10/2020,Kenya,Sabah,0,0,0
1/10/2020,Kenya,Sarawak,0,0,0
1/10/2020,Kenya,Selangor,6,2,4
1/10/2020,Kyrgyzstan,Johor,0,0,0
1/10/2020,Kyrgyzstan,Kedah,0,0,0
1/10/2020,Kyrgyzstan,Kelantan,0,0,0
1/10/2020,Kyrgyzstan,Perak,0,0,0
1/10/2020,Kyrgyzstan,Perlis,0,0,0
1/10/2020,Kyrgyzstan,Pulau Pinang,0,0,0
1/10/2020,Kyrgyzstan,Sabah,0,0,0
1/10/2020,Kyrgyzstan,Sarawak,0,0,0
1/10/2020,Kyrgyzstan,Selangor,4,3,1
1/10/2020,Cambodia,Johor,0,0,0
1/10/2020,Cambodia,Kedah,0,0,0
1/10/2020,Cambodia,Kelantan,0,0,0
1/10/2020,Cambodia,Melaka,0,0,0
1/10/2020,Cambodia,Negeri Sembilan,0,0,0
1/10/2020,Cambodia,Pahang,0,0,0
1/10/2020,Cambodia,Perak,0,0,0
1/10/2020,Cambodia,Perlis,22,22,0
1/10/2020,Cambodia,Pulau Pinang,0,0,0
1/10/2020,Cambodia,Sabah,0,0,0
1/10/2020,Cambodia,Sarawak,0,0,0
1/10/2020,Cambodia,Selangor,5,3,2
1/10/2020,Cambodia,W.P. Labuan,0,0,0
1/10/2020,Kiribati,Johor,0,0,0
1/10/2020,Kiribati,Sabah,0,0,0
1/10/2020,Kiribati,Selangor,12,12,0
1/10/2020,Saint Kitts and Nevis,Johor,0,0,0
1/10/2020,Saint Kitts and Nevis,Kedah,0,0,0
1/10/2020,Saint Kitts and Nevis,Perlis,0,0,0
1/10/2020,Saint Kitts and Nevis,Pulau Pinang,0,0,0
1/10/2020,Saint Kitts and Nevis,Sabah,0,0,0
1/10/2020,Saint Kitts and Nevis,Selangor,2,2,0
1/10/2020,Saint Kitts and Nevis,W.P. Labuan,0,0,0
1/10/2020,"Korea, Republic of",Johor,4,4,0
1/10/2020,"Korea, Republic of",Kedah,0,0,0
1/10/2020,"Korea, Republic of",Kelantan,0,0,0
1/10/2020,"Korea, Republic of",Melaka,0,0,0
1/10/2020,"Korea, Republic of",Negeri Sembilan,0,0,0
1/10/2020,"Korea, Republic of",Pahang,0,0,0
1/10/2020,"Korea, Republic of",Perak,0,0,0
1/10/2020,"Korea, Republic of",Perlis,0,0,0
1/10/2020,"Korea, Republic of",Pulau Pinang,1,1,0
1/10/2020,"Korea, Republic of",Sabah,0,0,0
1/10/2020,"Korea, Republic of",Sarawak,1,1,0
1/10/2020,"Korea, Republic of",Selangor,305,173,132
1/10/2020,"Korea, Republic of",Terengganu,0,0,0
1/10/2020,"Korea, Republic of",W.P. Labuan,0,0,0
1/10/2020,Kuwait,Johor,0,0,0
1/10/2020,Kuwait,Kedah,0,0,0
1/10/2020,Kuwait,Kelantan,0,0,0
1/10/2020,Kuwait,Perak,0,0,0
1/10/2020,Kuwait,Perlis,0,0,0
1/10/2020,Kuwait,Pulau Pinang,0,0,0
1/10/2020,Kuwait,Sabah,0,0,0
1/10/2020,Kuwait,Sarawak,0,0,0
1/10/2020,Kuwait,Selangor,3,3,0
1/10/2020,Kuwait,W.P. Labuan,0,0,0
1/10/2020, Lao People's Democratic Republic,Johor,0,0,0
1/10/2020, Lao People's Democratic Republic,Kedah,0,0,0
1/10/2020, Lao People's Democratic Republic,Kelantan,0,0,0
1/10/2020, Lao People's Democratic Republic,Melaka,0,0,0
1/10/2020, Lao People's Democratic Republic,Perak,0,0,0
1/10/2020, Lao People's Democratic Republic,Perlis,0,0,0
1/10/2020, Lao People's Democratic Republic,Pulau Pinang,0,0,0
1/10/2020, Lao People's Democratic Republic,Sabah,0,0,0
1/10/2020, Lao People's Democratic Republic,Sarawak,0,0,0
1/10/2020, Lao People's Democratic Republic,Selangor,3,3,0
1/10/2020, Lao People's Democratic Republic,W.P. Labuan,0,0,0
1/10/2020,Lebanon,Johor,0,0,0
1/10/2020,Lebanon,Kedah,0,0,0
1/10/2020,Lebanon,Kelantan,0,0,0
1/10/2020,Lebanon,Pahang,0,0,0
1/10/2020,Lebanon,Perak,0,0,0
1/10/2020,Lebanon,Perlis,0,0,0
1/10/2020,Lebanon,Pulau Pinang,0,0,0
1/10/2020,Lebanon,Sabah,0,0,0
1/10/2020,Lebanon,Sarawak,0,0,0
1/10/2020,Lebanon,Selangor,3,1,2
1/10/2020,Lebanon,W.P. Labuan,0,0,0
1/10/2020,Liberia,Johor,0,0,0
1/10/2020,Liberia,Kedah,0,0,0
1/10/2020,Liberia,Sabah,0,0,0
1/10/2020,Liberia,Sarawak,0,0,0
1/10/2020,Liberia,Selangor,0,0,0
1/10/2020,Libya,Johor,2,2,0
1/10/2020,Libya,Kedah,0,0,0
1/10/2020,Libya,Perlis,0,0,0
1/10/2020,Libya,Pulau Pinang,0,0,0
1/10/2020,Libya,Sabah,0,0,0
1/10/2020,Libya,Sarawak,0,0,0
1/10/2020,Libya,Selangor,3,3,0
1/10/2020,Saint Lucia,Johor,0,0,0
1/10/2020,Saint Lucia,Kedah,0,0,0
1/10/2020,Saint Lucia,Pulau Pinang,0,0,0
1/10/2020,Saint Lucia,Sarawak,0,0,0
1/10/2020,Saint Lucia,Selangor,1,1,0
1/10/2020,Liechtenstein,Johor,0,0,0
1/10/2020,Liechtenstein,Kedah,0,0,0
1/10/2020,Liechtenstein,Perlis,0,0,0
1/10/2020,Liechtenstein,Pulau Pinang,0,0,0
1/10/2020,Liechtenstein,Sabah,0,0,0
1/10/2020,Liechtenstein,Sarawak,0,0,0
1/10/2020,Liechtenstein,Selangor,0,0,0
1/10/2020,LKA,Johor,2,2,0
1/10/2020,LKA,Kedah,0,0,0
1/10/2020,LKA,Kelantan,0,0,0
1/10/2020,LKA,Melaka,0,0,0
1/10/2020,LKA,Pahang,0,0,0
1/10/2020,LKA,Perak,0,0,0
1/10/2020,LKA,Perlis,0,0,0
1/10/2020,LKA,Pulau Pinang,0,0,0
1/10/2020,LKA,Sabah,0,0,0
1/10/2020,LKA,Sarawak,0,0,0
1/10/2020,LKA,Selangor,23,19,4
1/10/2020,LKA,W.P. Labuan,0,0,0
1/10/2020,Lesotho,Johor,0,0,0
1/10/2020,Lesotho,Kedah,0,0,0
1/10/2020,Lesotho,Pulau Pinang,0,0,0
1/10/2020,Lesotho,Sarawak,0,0,0
1/10/2020,Lesotho,Selangor,0,0,0
1/10/2020,Lithuania,Johor,0,0,0
1/10/2020,Lithuania,Kedah,0,0,0
1/10/2020,Lithuania,Kelantan,0,0,0
1/10/2020,Lithuania,Pahang,0,0,0
1/10/2020,Lithuania,Perak,0,0,0
1/10/2020,Lithuania,Perlis,0,0,0
1/10/2020,Lithuania,Pulau Pinang,0,0,0
1/10/2020,Lithuania,Sabah,0,0,0
1/10/2020,Lithuania,Sarawak,0,0,0
1/10/2020,Lithuania,Selangor,7,4,3
1/10/2020,Lithuania,W.P. Labuan,0,0,0
1/10/2020,Luxembourg,Johor,0,0,0
1/10/2020,Luxembourg,Kedah,0,0,0
1/10/2020,Luxembourg,Kelantan,0,0,0
1/10/2020,Luxembourg,Perak,0,0,0
1/10/2020,Luxembourg,Perlis,0,0,0
1/10/2020,Luxembourg,Pulau Pinang,0,0,0
1/10/2020,Luxembourg,Sabah,0,0,0
1/10/2020,Luxembourg,Sarawak,0,0,0
1/10/2020,Luxembourg,Selangor,2,2,0
1/10/2020,Latvia,Johor,0,0,0
1/10/2020,Latvia,Kedah,0,0,0
1/10/2020,Latvia,Kelantan,0,0,0
1/10/2020,Latvia,Pahang,0,0,0
1/10/2020,Latvia,Perak,0,0,0
1/10/2020,Latvia,Perlis,0,0,0
1/10/2020,Latvia,Pulau Pinang,0,0,0
1/10/2020,Latvia,Sabah,0,0,0
1/10/2020,Latvia,Sarawak,0,0,0
1/10/2020,Latvia,Selangor,4,3,1
1/10/2020,Latvia,W.P. Labuan,0,0,0
1/10/2020,Macao,Johor,0,0,0
1/10/2020,Macao,Pahang,0,0,0
1/10/2020,Macao,Perak,0,0,0
1/10/2020,Macao,Selangor,0,0,0
1/10/2020,Macao,W.P. Labuan,0,0,0
1/10/2020,Morocco,Johor,0,0,0
1/10/2020,Morocco,Kedah,0,0,0
1/10/2020,Morocco,Kelantan,0,0,0
1/10/2020,Morocco,Melaka,0,0,0
1/10/2020,Morocco,Pahang,0,0,0
1/10/2020,Morocco,Perak,0,0,0
1/10/2020,Morocco,Perlis,0,0,0
1/10/2020,Morocco,Pulau Pinang,0,0,0
1/10/2020,Morocco,Sabah,0,0,0
1/10/2020,Morocco,Sarawak,0,0,0
1/10/2020,Morocco,Selangor,10,7,3
1/10/2020,Morocco,W.P. Labuan,0,0,0
1/10/2020,Monaco,Johor,0,0,0
1/10/2020,Monaco,Kedah,0,0,0
1/10/2020,Monaco,Sabah,0,0,0
1/10/2020,Monaco,Selangor,0,0,0
1/10/2020,"Moldova, Republic of",Johor,0,0,0
1/10/2020,"Moldova, Republic of",Kedah,0,0,0
1/10/2020,"Moldova, Republic of",Kelantan,0,0,0
1/10/2020,"Moldova, Republic of",Negeri Sembilan,0,0,0
1/10/2020,"Moldova, Republic of",Perlis,0,0,0
1/10/2020,"Moldova, Republic of",Pulau Pinang,0,0,0
1/10/2020,"Moldova, Republic of",Sabah,0,0,0
1/10/2020,"Moldova, Republic of",Sarawak,0,0,0
1/10/2020,"Moldova, Republic of",Selangor,0,0,0
1/10/2020,Madagascar,Johor,0,0,0
1/10/2020,Madagascar,Kedah,0,0,0
1/10/2020,Madagascar,Perak,0,0,0
1/10/2020,Madagascar,Perlis,0,0,0
1/10/2020,Madagascar,Pulau Pinang,0,0,0
1/10/2020,Madagascar,Sabah,0,0,0
1/10/2020,Madagascar,Sarawak,0,0,0
1/10/2020,Madagascar,Selangor,0,0,0
1/10/2020,Maldives,Johor,0,0,0
1/10/2020,Maldives,Kedah,0,0,0
1/10/2020,Maldives,Kelantan,0,0,0
1/10/2020,Maldives,Perak,0,0,0
1/10/2020,Maldives,Perlis,0,0,0
1/10/2020,Maldives,Pulau Pinang,0,0,0
1/10/2020,Maldives,Sabah,0,0,0
1/10/2020,Maldives,Sarawak,0,0,0
1/10/2020,Maldives,Selangor,83,30,53
1/10/2020,Mexico,Johor,2,2,0
1/10/2020,Mexico,Kedah,0,0,0
1/10/2020,Mexico,Kelantan,0,0,0
1/10/2020,Mexico,Pahang,0,0,0
1/10/2020,Mexico,Perak,0,0,0
1/10/2020,Mexico,Perlis,0,0,0
1/10/2020,Mexico,Pulau Pinang,0,0,0
1/10/2020,Mexico,Sabah,0,0,0
1/10/2020,Mexico,Sarawak,0,0,0
1/10/2020,Mexico,Selangor,12,10,2
1/10/2020,Mexico,W.P. Labuan,0,0,0
1/10/2020,Marshall Islands,Johor,0,0,0
1/10/2020,Marshall Islands,Kedah,0,0,0
1/10/2020,Marshall Islands,Perak,0,0,0
1/10/2020,Marshall Islands,Pulau Pinang,0,0,0
1/10/2020,Marshall Islands,Sabah,0,0,0
1/10/2020,Marshall Islands,Selangor,0,0,0
1/10/2020,North Macedonia,Johor,0,0,0
1/10/2020,North Macedonia,Kedah,0,0,0
1/10/2020,North Macedonia,Perak,0,0,0
1/10/2020,North Macedonia,Pulau Pinang,0,0,0
1/10/2020,North Macedonia,Sabah,0,0,0
1/10/2020,North Macedonia,Sarawak,0,0,0
1/10/2020,North Macedonia,Selangor,4,2,2
1/10/2020,Mali,Johor,0,0,0
1/10/2020,Mali,Sabah,0,0,0
1/10/2020,Mali,Selangor,1,1,0
1/10/2020,Malta,Johor,0,0,0
1/10/2020,Malta,Kedah,0,0,0
1/10/2020,Malta,Kelantan,0,0,0
1/10/2020,Malta,Perak,0,0,0
1/10/2020,Malta,Perlis,0,0,0
1/10/2020,Malta,Pulau Pinang,0,0,0
1/10/2020,Malta,Sabah,0,0,0
1/10/2020,Malta,Sarawak,0,0,0
1/10/2020,Malta,Selangor,1,1,0
1/10/2020,Malta,W.P. Labuan,0,0,0
1/10/2020,Myanmar,Johor,14,14,0
1/10/2020,Myanmar,Kedah,0,0,0
1/10/2020,Myanmar,Kelantan,0,0,0
1/10/2020,Myanmar,Negeri Sembilan,0,0,0
1/10/2020,Myanmar,Pahang,0,0,0
1/10/2020,Myanmar,Perak,0,0,0
1/10/2020,Myanmar,Perlis,0,0,0
1/10/2020,Myanmar,Pulau Pinang,2,1,1
1/10/2020,Myanmar,Sabah,0,0,0
1/10/2020,Myanmar,Sarawak,0,0,0
1/10/2020,Myanmar,Selangor,64,56,8
1/10/2020,Myanmar,Terengganu,0,0,0
1/10/2020,Myanmar,W.P. Labuan,0,0,0
1/10/2020,Montenegro,Johor,0,0,0
1/10/2020,Montenegro,Kedah,0,0,0
1/10/2020,Montenegro,Pulau Pinang,0,0,0
1/10/2020,Montenegro,Sabah,0,0,0
1/10/2020,Montenegro,Sarawak,0,0,0
1/10/2020,Montenegro,Selangor,0,0,0
1/10/2020,Mongolia,Johor,0,0,0
1/10/2020,Mongolia,Kedah,0,0,0
1/10/2020,Mongolia,Kelantan,0,0,0
1/10/2020,Mongolia,Perak,0,0,0
1/10/2020,Mongolia,Perlis,0,0,0
1/10/2020,Mongolia,Pulau Pinang,0,0,0
1/10/2020,Mongolia,Sabah,0,0,0
1/10/2020,Mongolia,Sarawak,0,0,0
1/10/2020,Mongolia,Selangor,4,2,2
1/10/2020,Northern Mariana Islands,Selangor,0,0,0
1/10/2020,Mozambique,Johor,0,0,0
1/10/2020,Mozambique,Kedah,0,0,0
1/10/2020,Mozambique,Perak,0,0,0
1/10/2020,Mozambique,Pulau Pinang,0,0,0
1/10/2020,Mozambique,Sabah,0,0,0
1/10/2020,Mozambique,Sarawak,0,0,0
1/10/2020,Mozambique,Selangor,1,0,1
1/10/2020,Mauritania,Johor,0,0,0
1/10/2020,Mauritania,Kedah,0,0,0
1/10/2020,Mauritania,Pulau Pinang,0,0,0
1/10/2020,Mauritania,Sabah,0,0,0
1/10/2020,Mauritania,Sarawak,0,0,0
1/10/2020,Mauritania,Selangor,0,0,0
1/10/2020,Mauritius,Johor,0,0,0
1/10/2020,Mauritius,Kedah,0,0,0
1/10/2020,Mauritius,Kelantan,0,0,0
1/10/2020,Mauritius,Pahang,0,0,0
1/10/2020,Mauritius,Perak,0,0,0
1/10/2020,Mauritius,Perlis,0,0,0
1/10/2020,Mauritius,Pulau Pinang,0,0,0
1/10/2020,Mauritius,Sabah,0,0,0
1/10/2020,Mauritius,Sarawak,0,0,0
1/10/2020,Mauritius,Selangor,11,5,6
1/10/2020,Malawi,Johor,0,0,0
1/10/2020,Malawi,Pulau Pinang,0,0,0
1/10/2020,Malawi,Sabah,0,0,0
1/10/2020,Malawi,Sarawak,0,0,0
1/10/2020,Malawi,Selangor,0,0,0
1/10/2020,Mayotte,Selangor,0,0,0
1/10/2020,Namibia,Johor,0,0,0
1/10/2020,Namibia,Kedah,0,0,0
1/10/2020,Namibia,Perak,0,0,0
1/10/2020,Namibia,Perlis,0,0,0
1/10/2020,Namibia,Pulau Pinang,0,0,0
1/10/2020,Namibia,Sabah,0,0,0
1/10/2020,Namibia,Sarawak,0,0,0
1/10/2020,Namibia,Selangor,1,1,0
1/10/2020,New Caledonia,Selangor,0,0,0
1/10/2020,Niger,Johor,0,0,0
1/10/2020,Niger,Sabah,0,0,0
1/10/2020,Niger,Selangor,0,0,0
1/10/2020,Nigeria,Johor,0,0,0
1/10/2020,Nigeria,Kedah,0,0,0
1/10/2020,Nigeria,Perlis,0,0,0
1/10/2020,Nigeria,Pulau Pinang,0,0,0
1/10/2020,Nigeria,Sabah,0,0,0
1/10/2020,Nigeria,Sarawak,0,0,0
1/10/2020,Nigeria,Selangor,24,18,6
1/10/2020,Nicaragua,Johor,0,0,0
1/10/2020,Nicaragua,Kedah,0,0,0
1/10/2020,Nicaragua,Pulau Pinang,0,0,0
1/10/2020,Nicaragua,Sabah,0,0,0
1/10/2020,Nicaragua,Selangor,2,1,1
1/10/2020,Netherlands,Johor,3,3,0
1/10/2020,Netherlands,Kedah,0,0,0
1/10/2020,Netherlands,Kelantan,0,0,0
1/10/2020,Netherlands,Melaka,0,0,0
1/10/2020,Netherlands,Negeri Sembilan,0,0,0
1/10/2020,Netherlands,Pahang,0,0,0
1/10/2020,Netherlands,Perak,0,0,0
1/10/2020,Netherlands,Perlis,0,0,0
1/10/2020,Netherlands,Pulau Pinang,0,0,0
1/10/2020,Netherlands,Sabah,0,0,0
1/10/2020,Netherlands,Sarawak,0,0,0
1/10/2020,Netherlands,Selangor,53,42,11
1/10/2020,Netherlands,Terengganu,0,0,0
1/10/2020,Netherlands,W.P. Labuan,0,0,0
1/10/2020,Norway,Johor,0,0,0
1/10/2020,Norway,Kedah,0,0,0
1/10/2020,Norway,Kelantan,0,0,0
1/10/2020,Norway,Melaka,0,0,0
1/10/2020,Norway,Pahang,0,0,0
1/10/2020,Norway,Perak,0,0,0
1/10/2020,Norway,Perlis,0,0,0
1/10/2020,Norway,Pulau Pinang,0,0,0
1/10/2020,Norway,Sabah,0,0,0
1/10/2020,Norway,Sarawak,0,0,0
1/10/2020,Norway,Selangor,8,7,1
1/10/2020,Norway,W.P. Labuan,0,0,0
1/10/2020,Nepal,Johor,0,0,0
1/10/2020,Nepal,Kedah,0,0,0
1/10/2020,Nepal,Pahang,0,0,0
1/10/2020,Nepal,Perak,0,0,0
1/10/2020,Nepal,Perlis,0,0,0
1/10/2020,Nepal,Pulau Pinang,0,0,0
1/10/2020,Nepal,Sabah,0,0,0
1/10/2020,Nepal,Sarawak,0,0,0
1/10/2020,Nepal,Selangor,49,43,6
1/10/2020,Nepal,W.P. Labuan,0,0,0
1/10/2020,Nauru,Johor,0,0,0
1/10/2020,Nauru,Pulau Pinang,0,0,0
1/10/2020,Nauru,Selangor,0,0,0
1/10/2020,New Zealand,Johor,1,1,0
1/10/2020,New Zealand,Kedah,0,0,0
1/10/2020,New Zealand,Kelantan,0,0,0
1/10/2020,New Zealand,Melaka,0,0,0
1/10/2020,New Zealand,Negeri Sembilan,0,0,0
1/10/2020,New Zealand,Pahang,0,0,0
1/10/2020,New Zealand,Perak,0,0,0
1/10/2020,New Zealand,Perlis,0,0,0
1/10/2020,New Zealand,Pulau Pinang,0,0,0
1/10/2020,New Zealand,Sabah,0,0,0
1/10/2020,New Zealand,Sarawak,0,0,0
1/10/2020,New Zealand,Selangor,28,21,7
1/10/2020,New Zealand,Terengganu,0,0,0
1/10/2020,New Zealand,W.P. Labuan,0,0,0
1/10/2020,Oman,Johor,0,0,0
1/10/2020,Oman,Kedah,0,0,0
1/10/2020,Oman,Kelantan,0,0,0
1/10/2020,Oman,Melaka,0,0,0
1/10/2020,Oman,Perak,0,0,0
1/10/2020,Oman,Perlis,0,0,0
1/10/2020,Oman,Pulau Pinang,0,0,0
1/10/2020,Oman,Sabah,0,0,0
1/10/2020,Oman,Sarawak,0,0,0
1/10/2020,Oman,Selangor,9,7,2
1/10/2020,Pakistan,Johor,2,2,0
1/10/2020,Pakistan,Kedah,0,0,0
1/10/2020,Pakistan,Kelantan,0,0,0
1/10/2020,Pakistan,Melaka,0,0,0
1/10/2020,Pakistan,Negeri Sembilan,0,0,0
1/10/2020,Pakistan,Pahang,0,0,0
1/10/2020,Pakistan,Perak,0,0,0
1/10/2020,Pakistan,Perlis,0,0,0
1/10/2020,Pakistan,Pulau Pinang,0,0,0
1/10/2020,Pakistan,Sabah,0,0,0
1/10/2020,Pakistan,Sarawak,0,0,0
1/10/2020,Pakistan,Selangor,76,45,31
1/10/2020,Pakistan,W.P. Labuan,0,0,0
1/10/2020,Panama,Johor,0,0,0
1/10/2020,Panama,Kedah,0,0,0
1/10/2020,Panama,Perak,0,0,0
1/10/2020,Panama,Perlis,0,0,0
1/10/2020,Panama,Pulau Pinang,0,0,0
1/10/2020,Panama,Sabah,0,0,0
1/10/2020,Panama,Sarawak,0,0,0
1/10/2020,Panama,Selangor,0,0,0
1/10/2020,Peru,Johor,2,2,0
1/10/2020,Peru,Kedah,0,0,0
1/10/2020,Peru,Kelantan,0,0,0
1/10/2020,Peru,Pahang,0,0,0
1/10/2020,Peru,Perak,0,0,0
1/10/2020,Peru,Perlis,0,0,0
1/10/2020,Peru,Pulau Pinang,0,0,0
1/10/2020,Peru,Sabah,0,0,0
1/10/2020,Peru,Sarawak,0,0,0
1/10/2020,Peru,Selangor,0,0,0
1/10/2020,Peru,W.P. Labuan,0,0,0
1/10/2020,Philippines,Johor,37,36,1
1/10/2020,Philippines,Kedah,0,0,0
1/10/2020,Philippines,Kelantan,0,0,0
1/10/2020,Philippines,Melaka,0,0,0
1/10/2020,Philippines,Negeri Sembilan,0,0,0
1/10/2020,Philippines,Pahang,0,0,0
1/10/2020,Philippines,Perak,0,0,0
1/10/2020,Philippines,Perlis,0,0,0
1/10/2020,Philippines,Pulau Pinang,2,2,0
1/10/2020,Philippines,Sabah,0,0,0
1/10/2020,Philippines,Sarawak,32,32,0
1/10/2020,Philippines,Selangor,380,346,34
1/10/2020,Philippines,Terengganu,0,0,0
1/10/2020,Philippines,W.P. Labuan,4,4,0
1/10/2020,Palau,Johor,0,0,0
1/10/2020,Palau,Pulau Pinang,0,0,0
1/10/2020,Palau,Selangor,0,0,0
1/10/2020,Papua New Guinea,Johor,0,0,0
1/10/2020,Papua New Guinea,Kedah,0,0,0
1/10/2020,Papua New Guinea,Kelantan,0,0,0
1/10/2020,Papua New Guinea,Perak,0,0,0
1/10/2020,Papua New Guinea,Pulau Pinang,0,0,0
1/10/2020,Papua New Guinea,Sabah,0,0,0
1/10/2020,Papua New Guinea,Sarawak,0,0,0
1/10/2020,Papua New Guinea,Selangor,0,0,0
1/10/2020,Poland,Johor,4,4,0
1/10/2020,Poland,Kedah,0,0,0
1/10/2020,Poland,Kelantan,0,0,0
1/10/2020,Poland,Melaka,0,0,0
1/10/2020,Poland,Negeri Sembilan,0,0,0
1/10/2020,Poland,Pahang,0,0,0
1/10/2020,Poland,Perak,0,0,0
1/10/2020,Poland,Perlis,0,0,0
1/10/2020,Poland,Pulau Pinang,0,0,0
1/10/2020,Poland,Sabah,0,0,0
1/10/2020,Poland,Sarawak,0,0,0
1/10/2020,Poland,Selangor,22,20,2
1/10/2020,Poland,Terengganu,0,0,0
1/10/2020,Poland,W.P. Labuan,0,0,0
1/10/2020,"North Korea, Democratic People's Republic of",Selangor,0,0,0
1/10/2020,Portugal,Johor,1,1,0
1/10/2020,Portugal,Kedah,0,0,0
1/10/2020,Portugal,Kelantan,0,0,0
1/10/2020,Portugal,Melaka,0,0,0
1/10/2020,Portugal,Pahang,0,0,0
1/10/2020,Portugal,Perak,0,0,0
1/10/2020,Portugal,Perlis,0,0,0
1/10/2020,Portugal,Pulau Pinang,0,0,0
1/10/2020,Portugal,Sabah,0,0,0
1/10/2020,Portugal,Sarawak,0,0,0
1/10/2020,Portugal,Selangor,15,9,6
1/10/2020,Portugal,W.P. Labuan,0,0,0
1/10/2020,Paraguay,Johor,0,0,0
1/10/2020,Paraguay,Kedah,0,0,0
1/10/2020,Paraguay,Perak,0,0,0
1/10/2020,Paraguay,Perlis,0,0,0
1/10/2020,Paraguay,Pulau Pinang,0,0,0
1/10/2020,Paraguay,Sabah,0,0,0
1/10/2020,Paraguay,Sarawak,0,0,0
1/10/2020,Paraguay,Selangor,0,0,0
1/10/2020,"Palestine, State of",Johor,0,0,0
1/10/2020,"Palestine, State of",Kedah,0,0,0
1/10/2020,"Palestine, State of",Kelantan,0,0,0
1/10/2020,"Palestine, State of",Melaka,0,0,0
1/10/2020,"Palestine, State of",Perak,0,0,0
1/10/2020,"Palestine, State of",Perlis,0,0,0
1/10/2020,"Palestine, State of",Pulau Pinang,0,0,0
1/10/2020,"Palestine, State of",Sabah,0,0,0
1/10/2020,"Palestine, State of",Sarawak,0,0,0
1/10/2020,"Palestine, State of",Selangor,10,8,2
1/10/2020,Qatar,Johor,0,0,0
1/10/2020,Qatar,Kedah,0,0,0
1/10/2020,Qatar,Perlis,0,0,0
1/10/2020,Qatar,Pulau Pinang,0,0,0
1/10/2020,Qatar,Sabah,0,0,0
1/10/2020,Qatar,Sarawak,0,0,0
1/10/2020,Qatar,Selangor,0,0,0
1/10/2020,Réunion,Johor,0,0,0
1/10/2020,Réunion,Sarawak,0,0,0
1/10/2020,Romania,Johor,0,0,0
1/10/2020,Romania,Kedah,0,0,0
1/10/2020,Romania,Kelantan,0,0,0
1/10/2020,Romania,Negeri Sembilan,0,0,0
1/10/2020,Romania,Pahang,0,0,0
1/10/2020,Romania,Perak,0,0,0
1/10/2020,Romania,Perlis,0,0,0
1/10/2020,Romania,Pulau Pinang,0,0,0
1/10/2020,Romania,Sabah,0,0,0
1/10/2020,Romania,Sarawak,0,0,0
1/10/2020,Romania,Selangor,18,14,4
1/10/2020,Romania,W.P. Labuan,0,0,0
1/10/2020,Russian Federation (Russia),Johor,6,6,0
1/10/2020,Russian Federation (Russia),Kedah,0,0,0
1/10/2020,Russian Federation (Russia),Kelantan,0,0,0
1/10/2020,Russian Federation (Russia),Melaka,0,0,0
1/10/2020,Russian Federation (Russia),Negeri Sembilan,0,0,0
1/10/2020,Russian Federation (Russia),Pahang,0,0,0
1/10/2020,Russian Federation (Russia),Perak,0,0,0
1/10/2020,Russian Federation (Russia),Perlis,0,0,0
1/10/2020,Russian Federation (Russia),Pulau Pinang,0,0,0
1/10/2020,Russian Federation (Russia),Sabah,0,0,0
1/10/2020,Russian Federation (Russia),Sarawak,0,0,0
1/10/2020,Russian Federation (Russia),Selangor,28,19,9
1/10/2020,Russian Federation (Russia),W.P. Labuan,0,0,0
1/10/2020,Rwanda,Johor,0,0,0
1/10/2020,Rwanda,Kedah,0,0,0
1/10/2020,Rwanda,Pulau Pinang,0,0,0
1/10/2020,Rwanda,Selangor,0,0,0
1/10/2020,Saudi Arabia,Johor,0,0,0
1/10/2020,Saudi Arabia,Kedah,0,0,0
1/10/2020,Saudi Arabia,Kelantan,0,0,0
1/10/2020,Saudi Arabia,Melaka,0,0,0
1/10/2020,Saudi Arabia,Perak,0,0,0
1/10/2020,Saudi Arabia,Perlis,0,0,0
1/10/2020,Saudi Arabia,Pulau Pinang,0,0,0
1/10/2020,Saudi Arabia,Sabah,0,0,0
1/10/2020,Saudi Arabia,Sarawak,0,0,0
1/10/2020,Saudi Arabia,Selangor,105,63,42
1/10/2020,Saudi Arabia,W.P. Labuan,0,0,0
1/10/2020,Sudan,Johor,0,0,0
1/10/2020,Sudan,Kedah,0,0,0
1/10/2020,Sudan,Kelantan,0,0,0
1/10/2020,Sudan,Perlis,0,0,0
1/10/2020,Sudan,Pulau Pinang,0,0,0
1/10/2020,Sudan,Sabah,0,0,0
1/10/2020,Sudan,Sarawak,0,0,0
1/10/2020,Sudan,Selangor,28,21,7
1/10/2020,Sudan,W.P. Labuan,0,0,0
1/10/2020,Senegal,Johor,0,0,0
1/10/2020,Senegal,Kedah,0,0,0
1/10/2020,Senegal,Kelantan,0,0,0
1/10/2020,Senegal,Perak,0,0,0
1/10/2020,Senegal,Perlis,0,0,0
1/10/2020,Senegal,Pulau Pinang,0,0,0
1/10/2020,Senegal,Sabah,0,0,0
1/10/2020,Senegal,Sarawak,0,0,0
1/10/2020,Senegal,Selangor,1,0,1
1/10/2020,Singapore,Johor,596,524,72
1/10/2020,Singapore,Kedah,2,1,1
1/10/2020,Singapore,Kelantan,0,0,0
1/10/2020,Singapore,Melaka,0,0,0
1/10/2020,Singapore,Negeri Sembilan,0,0,0
1/10/2020,Singapore,Pahang,0,0,0
1/10/2020,Singapore,Perak,2,1,1
1/10/2020,Singapore,Perlis,0,0,0
1/10/2020,Singapore,Pulau Pinang,30,22,8
1/10/2020,Singapore,Sabah,0,0,0
1/10/2020,Singapore,Sarawak,5,4,1
1/10/2020,Singapore,Selangor,226,169,57
1/10/2020,Singapore,Terengganu,0,0,0
1/10/2020,Singapore,W.P. Labuan,0,0,0
1/10/2020,South Georgia and the South Sandwich Islands,Johor,0,0,0
1/10/2020,South Georgia and the South Sandwich Islands,Sabah,0,0,0
1/10/2020,South Georgia and the South Sandwich Islands,Selangor,0,0,0
1/10/2020,Saint Helena,Sarawak,0,0,0
1/10/2020,Solomon Islands,Johor,0,0,0
1/10/2020,Solomon Islands,Perlis,0,0,0
1/10/2020,Solomon Islands,Pulau Pinang,0,0,0
1/10/2020,Solomon Islands,Sabah,0,0,0
1/10/2020,Solomon Islands,Sarawak,0,0,0
1/10/2020,Solomon Islands,Selangor,0,0,0
1/10/2020,Solomon Islands,W.P. Labuan,0,0,0
1/10/2020,Sierra Leone,Johor,0,0,0
1/10/2020,Sierra Leone,Kedah,0,0,0
1/10/2020,Sierra Leone,Perak,0,0,0
1/10/2020,Sierra Leone,Pulau Pinang,0,0,0
1/10/2020,Sierra Leone,Sabah,0,0,0
1/10/2020,Sierra Leone,Selangor,0,0,0
1/10/2020,El Salvador,Johor,0,0,0
1/10/2020,El Salvador,Kedah,0,0,0
1/10/2020,El Salvador,Perak,0,0,0
1/10/2020,El Salvador,Perlis,0,0,0
1/10/2020,El Salvador,Pulau Pinang,0,0,0
1/10/2020,El Salvador,Sabah,0,0,0
1/10/2020,El Salvador,Selangor,0,0,0
1/10/2020,El Salvador,W.P. Labuan,0,0,0
1/10/2020,San Marino,Johor,0,0,0
1/10/2020,San Marino,Selangor,0,0,0
1/10/2020,Somalia,Johor,0,0,0
1/10/2020,Somalia,Kedah,0,0,0
1/10/2020,Somalia,Kelantan,0,0,0
1/10/2020,Somalia,Perlis,0,0,0
1/10/2020,Somalia,Sabah,0,0,0
1/10/2020,Somalia,Sarawak,0,0,0
1/10/2020,Somalia,Selangor,2,2,0
1/10/2020,Serbia,Johor,2,2,0
1/10/2020,Serbia,Kedah,0,0,0
1/10/2020,Serbia,Kelantan,0,0,0
1/10/2020,Serbia,Pahang,0,0,0
1/10/2020,Serbia,Perak,0,0,0
1/10/2020,Serbia,Perlis,0,0,0
1/10/2020,Serbia,Pulau Pinang,0,0,0
1/10/2020,Serbia,Sabah,0,0,0
1/10/2020,Serbia,Sarawak,0,0,0
1/10/2020,Serbia,Selangor,4,1,3
1/10/2020,South Sudan,Johor,0,0,0
1/10/2020,South Sudan,Kedah,0,0,0
1/10/2020,South Sudan,Sarawak,0,0,0
1/10/2020,South Sudan,Selangor,0,0,0
1/10/2020,South Sudan,W.P. Labuan,0,0,0
1/10/2020,Sao Tome and Principe,Selangor,0,0,0
1/10/2020,Suriname,Johor,0,0,0
1/10/2020,Suriname,Kedah,0,0,0
1/10/2020,Suriname,Kelantan,0,0,0
1/10/2020,Suriname,Perak,0,0,0
1/10/2020,Suriname,Perlis,0,0,0
1/10/2020,Suriname,Pulau Pinang,0,0,0
1/10/2020,Suriname,Sabah,0,0,0
1/10/2020,Suriname,Sarawak,0,0,0
1/10/2020,Suriname,Selangor,0,0,0
1/10/2020,Slovakia,Johor,0,0,0
1/10/2020,Slovakia,Kedah,0,0,0
1/10/2020,Slovakia,Kelantan,0,0,0
1/10/2020,Slovakia,Negeri Sembilan,0,0,0
1/10/2020,Slovakia,Pahang,0,0,0
1/10/2020,Slovakia,Perak,0,0,0
1/10/2020,Slovakia,Perlis,0,0,0
1/10/2020,Slovakia,Pulau Pinang,0,0,0
1/10/2020,Slovakia,Sabah,0,0,0
1/10/2020,Slovakia,Sarawak,0,0,0
1/10/2020,Slovakia,Selangor,17,15,2
1/10/2020,Slovakia,W.P. Labuan,0,0,0
1/10/2020,Slovenia,Johor,0,0,0
1/10/2020,Slovenia,Kedah,0,0,0
1/10/2020,Slovenia,Kelantan,0,0,0
1/10/2020,Slovenia,Perak,0,0,0
1/10/2020,Slovenia,Perlis,0,0,0
1/10/2020,Slovenia,Pulau Pinang,0,0,0
1/10/2020,Slovenia,Sabah,0,0,0
1/10/2020,Slovenia,Sarawak,0,0,0
1/10/2020,Slovenia,Selangor,0,0,0
1/10/2020,Slovenia,W.P. Labuan,0,0,0
1/10/2020,Sweden,Johor,1,1,0
1/10/2020,Sweden,Kedah,0,0,0
1/10/2020,Sweden,Kelantan,0,0,0
1/10/2020,Sweden,Melaka,0,0,0
1/10/2020,Sweden,Negeri Sembilan,0,0,0
1/10/2020,Sweden,Pahang,0,0,0
1/10/2020,Sweden,Perak,0,0,0
1/10/2020,Sweden,Perlis,0,0,0
1/10/2020,Sweden,Pulau Pinang,0,0,0
1/10/2020,Sweden,Sabah,0,0,0
1/10/2020,Sweden,Sarawak,0,0,0
1/10/2020,Sweden,Selangor,21,15,6
1/10/2020,Sweden,W.P. Labuan,0,0,0
1/10/2020,Eswatini,Johor,0,0,0
1/10/2020,Eswatini,Kedah,0,0,0
1/10/2020,Eswatini,Pulau Pinang,0,0,0
1/10/2020,Eswatini,Sabah,0,0,0
1/10/2020,Eswatini,Selangor,0,0,0
1/10/2020,Seychelles,Johor,0,0,0
1/10/2020,Seychelles,Kedah,0,0,0
1/10/2020,Seychelles,Pulau Pinang,0,0,0
1/10/2020,Seychelles,Sabah,0,0,0
1/10/2020,Seychelles,Sarawak,0,0,0
1/10/2020,Seychelles,Selangor,3,2,1
1/10/2020,Syrian Arab Republic,Johor,0,0,0
1/10/2020,Syrian Arab Republic,Kedah,0,0,0
1/10/2020,Syrian Arab Republic,Kelantan,0,0,0
1/10/2020,Syrian Arab Republic,Pahang,0,0,0
1/10/2020,Syrian Arab Republic,Perlis,0,0,0
1/10/2020,Syrian Arab Republic,Pulau Pinang,0,0,0
1/10/2020,Syrian Arab Republic,Sabah,0,0,0
1/10/2020,Syrian Arab Republic,Sarawak,0,0,0
1/10/2020,Syrian Arab Republic,Selangor,29,27,2
1/10/2020,Syrian Arab Republic,W.P. Labuan,0,0,0
1/10/2020,Turks and Caicos Islands,Perlis,0,0,0
1/10/2020,TCD,Johor,0,0,0
1/10/2020,TCD,Kedah,0,0,0
1/10/2020,TCD,Perlis,0,0,0
1/10/2020,TCD,Selangor,0,0,0
1/10/2020,Togo,Johor,0,0,0
1/10/2020,Togo,Perak,0,0,0
1/10/2020,Togo,Pulau Pinang,0,0,0
1/10/2020,Togo,Selangor,1,0,1
1/10/2020,Thailand,Johor,106,105,1
1/10/2020,Thailand,Kedah,9601,8863,738
1/10/2020,Thailand,Kelantan,1,0,1
1/10/2020,Thailand,Melaka,0,0,0
1/10/2020,Thailand,Negeri Sembilan,0,0,0
1/10/2020,Thailand,Pahang,0,0,0
1/10/2020,Thailand,Perak,1,0,1
1/10/2020,Thailand,Perlis,5460,5248,212
1/10/2020,Thailand,Pulau Pinang,0,0,0
1/10/2020,Thailand,Sabah,0,0,0
1/10/2020,Thailand,Sarawak,17,16,1
1/10/2020,Thailand,Selangor,139,69,70
1/10/2020,Thailand,Terengganu,0,0,0
1/10/2020,Thailand,W.P. Labuan,0,0,0
1/10/2020,Tajikistan,Johor,0,0,0
1/10/2020,Tajikistan,Kedah,0,0,0
1/10/2020,Tajikistan,Perlis,0,0,0
1/10/2020,Tajikistan,Pulau Pinang,0,0,0
1/10/2020,Tajikistan,Sabah,0,0,0
1/10/2020,Tajikistan,Selangor,1,0,1
1/10/2020,Tokelau,Selangor,0,0,0
1/10/2020,Turkmenistan,Johor,0,0,0
1/10/2020,Turkmenistan,Kedah,0,0,0
1/10/2020,Turkmenistan,Kelantan,0,0,0
1/10/2020,Turkmenistan,Perlis,0,0,0
1/10/2020,Turkmenistan,Pulau Pinang,0,0,0
1/10/2020,Turkmenistan,Sabah,0,0,0
1/10/2020,Turkmenistan,Sarawak,0,0,0
1/10/2020,Turkmenistan,Selangor,0,0,0
1/10/2020,Timor-Leste,Johor,0,0,0
1/10/2020,Timor-Leste,Kedah,0,0,0
1/10/2020,Timor-Leste,Perlis,0,0,0
1/10/2020,Timor-Leste,Pulau Pinang,0,0,0
1/10/2020,Timor-Leste,Sabah,0,0,0
1/10/2020,Timor-Leste,Sarawak,0,0,0
1/10/2020,Timor-Leste,Selangor,0,0,0
1/10/2020,Tonga,Johor,0,0,0
1/10/2020,Tonga,Pulau Pinang,0,0,0
1/10/2020,Tonga,Sarawak,0,0,0
1/10/2020,Tonga,Selangor,0,0,0
1/10/2020,Trinidad and Tobago,Johor,0,0,0
1/10/2020,Trinidad and Tobago,Kedah,0,0,0
1/10/2020,Trinidad and Tobago,Pahang,0,0,0
1/10/2020,Trinidad and Tobago,Pulau Pinang,0,0,0
1/10/2020,Trinidad and Tobago,Sabah,0,0,0
1/10/2020,Trinidad and Tobago,Sarawak,0,0,0
1/10/2020,Trinidad and Tobago,Selangor,0,0,0
1/10/2020,Tunisia,Johor,0,0,0
1/10/2020,Tunisia,Kedah,0,0,0
1/10/2020,Tunisia,Kelantan,0,0,0
1/10/2020,Tunisia,Melaka,0,0,0
1/10/2020,Tunisia,Perak,0,0,0
1/10/2020,Tunisia,Perlis,0,0,0
1/10/2020,Tunisia,Pulau Pinang,0,0,0
1/10/2020,Tunisia,Sabah,0,0,0
1/10/2020,Tunisia,Sarawak,0,0,0
1/10/2020,Tunisia,Selangor,7,3,4
1/10/2020,Tunisia,W.P. Labuan,0,0,0
1/10/2020,Türkiye,Johor,0,0,0
1/10/2020,Türkiye,Kedah,0,0,0
1/10/2020,Türkiye,Kelantan,0,0,0
1/10/2020,Türkiye,Melaka,0,0,0
1/10/2020,Türkiye,Negeri Sembilan,0,0,0
1/10/2020,Türkiye,Pahang,0,0,0
1/10/2020,Türkiye,Perak,0,0,0
1/10/2020,Türkiye,Perlis,0,0,0
1/10/2020,Türkiye,Pulau Pinang,0,0,0
1/10/2020,Türkiye,Sabah,0,0,0
1/10/2020,Türkiye,Sarawak,0,0,0
1/10/2020,Türkiye,Selangor,20,18,2
1/10/2020,Türkiye,W.P. Labuan,0,0,0
1/10/2020,Tuvalu,Selangor,0,0,0
1/10/2020,"Taiwan, Province of China",Johor,9,6,3
1/10/2020,"Taiwan, Province of China",Kedah,0,0,0
1/10/2020,"Taiwan, Province of China",Kelantan,0,0,0
1/10/2020,"Taiwan, Province of China",Melaka,0,0,0
1/10/2020,"Taiwan, Province of China",Negeri Sembilan,0,0,0
1/10/2020,"Taiwan, Province of China",Pahang,0,0,0
1/10/2020,"Taiwan, Province of China",Perak,0,0,0
1/10/2020,"Taiwan, Province of China",Perlis,0,0,0
1/10/2020,"Taiwan, Province of China",Pulau Pinang,7,3,4
1/10/2020,"Taiwan, Province of China",Sabah,0,0,0
1/10/2020,"Taiwan, Province of China",Sarawak,3,3,0
1/10/2020,"Taiwan, Province of China",Selangor,123,87,36
1/10/2020,"Taiwan, Province of China",W.P. Labuan,0,0,0
1/10/2020,"Tanzania, United Republic of",Johor,0,0,0
1/10/2020,"Tanzania, United Republic of",Kedah,0,0,0
1/10/2020,"Tanzania, United Republic of",Perak,0,0,0
1/10/2020,"Tanzania, United Republic of",Perlis,0,0,0
1/10/2020,"Tanzania, United Republic of",Pulau Pinang,0,0,0
1/10/2020,"Tanzania, United Republic of",Sabah,0,0,0
1/10/2020,"Tanzania, United Republic of",Sarawak,0,0,0
1/10/2020,"Tanzania, United Republic of",Selangor,2,1,1
1/10/2020,Uganda,Johor,0,0,0
1/10/2020,Uganda,Kedah,0,0,0
1/10/2020,Uganda,Perak,0,0,0
1/10/2020,Uganda,Perlis,0,0,0
1/10/2020,Uganda,Pulau Pinang,0,0,0
1/10/2020,Uganda,Sabah,0,0,0
1/10/2020,Uganda,Sarawak,0,0,0
1/10/2020,Uganda,Selangor,0,0,0
1/10/2020,Ukraine,Johor,4,4,0
1/10/2020,Ukraine,Kedah,0,0,0
1/10/2020,Ukraine,Kelantan,0,0,0
1/10/2020,Ukraine,Melaka,0,0,0
1/10/2020,Ukraine,Negeri Sembilan,0,0,0
1/10/2020,Ukraine,Pahang,0,0,0
1/10/2020,Ukraine,Perak,0,0,0
1/10/2020,Ukraine,Perlis,0,0,0
1/10/2020,Ukraine,Pulau Pinang,0,0,0
1/10/2020,Ukraine,Sabah,0,0,0
1/10/2020,Ukraine,Sarawak,0,0,0
1/10/2020,Ukraine,Selangor,63,60,3
1/10/2020,Ukraine,W.P. Labuan,0,0,0
1/10/2020,Uruguay,Johor,0,0,0
1/10/2020,Uruguay,Kedah,0,0,0
1/10/2020,Uruguay,Kelantan,0,0,0
1/10/2020,Uruguay,Perak,0,0,0
1/10/2020,Uruguay,Perlis,0,0,0
1/10/2020,Uruguay,Pulau Pinang,0,0,0
1/10/2020,Uruguay,Sabah,0,0,0
1/10/2020,Uruguay,Sarawak,0,0,0
1/10/2020,Uruguay,Selangor,0,0,0
1/10/2020,Uruguay,W.P. Labuan,0,0,0
1/10/2020,United States of America,Johor,3,3,0
1/10/2020,United States of America,Kedah,0,0,0
1/10/2020,United States of America,Kelantan,0,0,0
1/10/2020,United States of America,Melaka,0,0,0
1/10/2020,United States of America,Negeri Sembilan,0,0,0
1/10/2020,United States of America,Pahang,0,0,0
1/10/2020,United States of America,Perak,1,0,1
1/10/2020,United States of America,Perlis,0,0,0
1/10/2020,United States of America,Pulau Pinang,1,0,1
1/10/2020,United States of America,Sabah,0,0,0
1/10/2020,United States of America,Sarawak,0,0,0
1/10/2020,United States of America,Selangor,106,82,24
1/10/2020,United States of America,Terengganu,0,0,0
1/10/2020,United States of America,W.P. Labuan,0,0,0
1/10/2020,Uzbekistan,Johor,0,0,0
1/10/2020,Uzbekistan,Kedah,0,0,0
1/10/2020,Uzbekistan,Kelantan,0,0,0
1/10/2020,Uzbekistan,Perak,0,0,0
1/10/2020,Uzbekistan,Perlis,0,0,0
1/10/2020,Uzbekistan,Pulau Pinang,0,0,0
1/10/2020,Uzbekistan,Sabah,0,0,0
1/10/2020,Uzbekistan,Sarawak,0,0,0
1/10/2020,Uzbekistan,Selangor,5,4,1
1/10/2020,Holy See,Johor,0,0,0
1/10/2020,Holy See,Sarawak,0,0,0
1/10/2020,Holy See,Selangor,0,0,0
1/10/2020,Saint Vincent and the Grenadines,Johor,0,0,0
1/10/2020,Saint Vincent and the Grenadines,Kedah,0,0,0
1/10/2020,Saint Vincent and the Grenadines,Pulau Pinang,0,0,0
1/10/2020,Saint Vincent and the Grenadines,Sarawak,0,0,0
1/10/2020,Saint Vincent and the Grenadines,Selangor,0,0,0
1/10/2020,"Venezuela, Bolivarian Republic of",Johor,0,0,0
1/10/2020,"Venezuela, Bolivarian Republic of",Kedah,0,0,0
1/10/2020,"Venezuela, Bolivarian Republic of",Kelantan,0,0,0
1/10/2020,"Venezuela, Bolivarian Republic of",Melaka,0,0,0
1/10/2020,"Venezuela, Bolivarian Republic of",Perak,0,0,0
1/10/2020,"Venezuela, Bolivarian Republic of",Perlis,0,0,0
1/10/2020,"Venezuela, Bolivarian Republic of",Pulau Pinang,0,0,0
1/10/2020,"Venezuela, Bolivarian Republic of",Sabah,0,0,0
1/10/2020,"Venezuela, Bolivarian Republic of",Sarawak,0,0,0
1/10/2020,"Venezuela, Bolivarian Republic of",Selangor,1,1,0
1/10/2020,"Venezuela, Bolivarian Republic of",W.P. Labuan,0,0,0
1/10/2020,Viet Nam,Johor,0,0,0
1/10/2020,Viet Nam,Kedah,0,0,0
1/10/2020,Viet Nam,Kelantan,0,0,0
1/10/2020,Viet Nam,Melaka,0,0,0
1/10/2020,Viet Nam,Negeri Sembilan,0,0,0
1/10/2020,Viet Nam,Pahang,0,0,0
1/10/2020,Viet Nam,Perak,0,0,0
1/10/2020,Viet Nam,Perlis,0,0,0
1/10/2020,Viet Nam,Pulau Pinang,0,0,0
1/10/2020,Viet Nam,Sabah,0,0,0
1/10/2020,Viet Nam,Sarawak,3,0,3
1/10/2020,Viet Nam,Selangor,95,42,53
1/10/2020,Viet Nam,Terengganu,0,0,0
1/10/2020,Viet Nam,W.P. Labuan,0,0,0
1/10/2020,Vanuatu,Johor,0,0,0
1/10/2020,Vanuatu,Kedah,0,0,0
1/10/2020,Vanuatu,Pulau Pinang,0,0,0
1/10/2020,Vanuatu,Sabah,0,0,0
1/10/2020,Vanuatu,Sarawak,0,0,0
1/10/2020,Vanuatu,Selangor,0,0,0
1/10/2020, Samoa,Johor,0,0,0
1/10/2020, Samoa,Sarawak,0,0,0
1/10/2020, Samoa,Selangor,0,0,0
1/10/2020,Yemen,Johor,0,0,0
1/10/2020,Yemen,Kedah,0,0,0
1/10/2020,Yemen,Kelantan,0,0,0
1/10/2020,Yemen,Melaka,0,0,0
1/10/2020,Yemen,Pahang,0,0,0
1/10/2020,Yemen,Perak,0,0,0
1/10/2020,Yemen,Perlis,0,0,0
1/10/2020,Yemen,Pulau Pinang,0,0,0
1/10/2020,Yemen,Sabah,0,0,0
1/10/2020,Yemen,Sarawak,0,0,0
1/10/2020,Yemen,Selangor,26,19,7
1/10/2020,Yemen,W.P. Labuan,0,0,0
1/10/2020,South Africa,Johor,2,2,0
1/10/2020,South Africa,Kedah,0,0,0
1/10/2020,South Africa,Kelantan,0,0,0
1/10/2020,South Africa,Melaka,0,0,0
1/10/2020,South Africa,Pahang,0,0,0
1/10/2020,South Africa,Perak,0,0,0
1/10/2020,South Africa,Perlis,0,0,0
1/10/2020,South Africa,Pulau Pinang,0,0,0
1/10/2020,South Africa,Sabah,0,0,0
1/10/2020,South Africa,Sarawak,0,0,0
1/10/2020,South Africa,Selangor,30,23,7
1/10/2020,South Africa,Terengganu,0,0,0
1/10/2020,South Africa,W.P. Labuan,0,0,0
1/10/2020,ZAR,Selangor,0,0,0
1/10/2020,Zambia,Johor,0,0,0
1/10/2020,Zambia,Kedah,0,0,0
1/10/2020,Zambia,Perak,0,0,0
1/10/2020,Zambia,Perlis,0,0,0
1/10/2020,Zambia,Pulau Pinang,0,0,0
1/10/2020,Zambia,Sabah,0,0,0
1/10/2020,Zambia,Sarawak,0,0,0
1/10/2020,Zambia,Selangor,2,1,1
1/10/2020,Zimbabwe,Johor,0,0,0
1/10/2020,Zimbabwe,Kedah,0,0,0
1/10/2020,Zimbabwe,Kelantan,0,0,0
1/10/2020,Zimbabwe,Perak,0,0,0
1/10/2020,Zimbabwe,Perlis,0,0,0
1/10/2020,Zimbabwe,Pulau Pinang,0,0,0
1/10/2020,Zimbabwe,Sabah,0,0,0
1/10/2020,Zimbabwe,Sarawak,0,0,0
1/10/2020,Zimbabwe,Selangor,8,3,5
1/11/2020,Aruba,Kedah,0,0,0
1/11/2020,Aruba,Pulau Pinang,0,0,0
1/11/2020,Afghanistan,Johor,0,0,0
1/11/2020,Afghanistan,Kedah,0,0,0
1/11/2020,Afghanistan,Perlis,0,0,0
1/11/2020,Afghanistan,Pulau Pinang,0,0,0
1/11/2020,Afghanistan,Sarawak,0,0,0
1/11/2020,Afghanistan,Selangor,4,4,0
1/11/2020,Angola,Johor,0,0,0
1/11/2020,Angola,Kedah,0,0,0
1/11/2020,Angola,Sabah,0,0,0
1/11/2020,Angola,Selangor,0,0,0
1/11/2020,Anguilla,Selangor,0,0,0
1/11/2020,Albania,Johor,0,0,0
1/11/2020,Albania,Kedah,0,0,0
1/11/2020,Albania,Perak,0,0,0
1/11/2020,Albania,Perlis,0,0,0
1/11/2020,Albania,Pulau Pinang,0,0,0
1/11/2020,Albania,Sabah,0,0,0
1/11/2020,Albania,Sarawak,0,0,0
1/11/2020,Albania,Selangor,0,0,0
1/11/2020,Andorra,Johor,0,0,0
1/11/2020,Andorra,Kedah,0,0,0
1/11/2020,Andorra,Perlis,0,0,0
1/11/2020,Andorra,Pulau Pinang,0,0,0
1/11/2020,Andorra,Selangor,0,0,0
1/11/2020,Antigua and Barbuda,Selangor,0,0,0
1/11/2020,United Arab Emirates,Johor,0,0,0
1/11/2020,United Arab Emirates,Kedah,0,0,0
1/11/2020,United Arab Emirates,Kelantan,0,0,0
1/11/2020,United Arab Emirates,Perak,0,0,0
1/11/2020,United Arab Emirates,Perlis,0,0,0
1/11/2020,United Arab Emirates,Pulau Pinang,0,0,0
1/11/2020,United Arab Emirates,Sabah,0,0,0
1/11/2020,United Arab Emirates,Sarawak,0,0,0
1/11/2020,United Arab Emirates,Selangor,0,0,0
1/11/2020,Argentina,Johor,0,0,0
1/11/2020,Argentina,Kedah,0,0,0
1/11/2020,Argentina,Kelantan,0,0,0
1/11/2020,Argentina,Melaka,0,0,0
1/11/2020,Argentina,Perak,0,0,0
1/11/2020,Argentina,Perlis,0,0,0
1/11/2020,Argentina,Pulau Pinang,0,0,0
1/11/2020,Argentina,Sabah,0,0,0
1/11/2020,Argentina,Sarawak,0,0,0
1/11/2020,Argentina,Selangor,3,3,0
1/11/2020,Argentina,W.P. Labuan,0,0,0
1/11/2020,Armenia,Johor,0,0,0
1/11/2020,Armenia,Kedah,0,0,0
1/11/2020,Armenia,Kelantan,0,0,0
1/11/2020,Armenia,Perak,0,0,0
1/11/2020,Armenia,Perlis,0,0,0
1/11/2020,Armenia,Pulau Pinang,0,0,0
1/11/2020,Armenia,Sabah,0,0,0
1/11/2020,Armenia,Sarawak,0,0,0
1/11/2020,Armenia,Selangor,0,0,0
1/11/2020,Antarctica,Selangor,0,0,0
1/11/2020,Antigua and Barbuda,Johor,0,0,0
1/11/2020,Antigua and Barbuda,Kedah,0,0,0
1/11/2020,Antigua and Barbuda,Pulau Pinang,0,0,0
1/11/2020,Antigua and Barbuda,Sarawak,0,0,0
1/11/2020,Antigua and Barbuda,Selangor,0,0,0
1/11/2020,Australia,Johor,41,38,3
1/11/2020,Australia,Kedah,0,0,0
1/11/2020,Australia,Kelantan,0,0,0
1/11/2020,Australia,Melaka,0,0,0
1/11/2020,Australia,Negeri Sembilan,0,0,0
1/11/2020,Australia,Pahang,0,0,0
1/11/2020,Australia,Perak,0,0,0
1/11/2020,Australia,Perlis,0,0,0
1/11/2020,Australia,Pulau Pinang,5,5,0
1/11/2020,Australia,Sabah,3,3,0
1/11/2020,Australia,Sarawak,0,0,0
1/11/2020,Australia,Selangor,126,87,39
1/11/2020,Australia,Terengganu,0,0,0
1/11/2020,Australia,W.P. Labuan,0,0,0
1/11/2020,Austria,Johor,0,0,0
1/11/2020,Austria,Kedah,0,0,0
1/11/2020,Austria,Kelantan,0,0,0
1/11/2020,Austria,Melaka,0,0,0
1/11/2020,Austria,Negeri Sembilan,0,0,0
1/11/2020,Austria,Pahang,0,0,0
1/11/2020,Austria,Perak,0,0,0
1/11/2020,Austria,Perlis,0,0,0
1/11/2020,Austria,Pulau Pinang,0,0,0
1/11/2020,Austria,Sabah,0,0,0
1/11/2020,Austria,Sarawak,0,0,0
1/11/2020,Austria,Selangor,4,4,0
1/11/2020,Austria,Terengganu,0,0,0
1/11/2020,Austria,W.P. Labuan,0,0,0
1/11/2020,Azerbaijan,Johor,0,0,0
1/11/2020,Azerbaijan,Kedah,0,0,0
1/11/2020,Azerbaijan,Kelantan,0,0,0
1/11/2020,Azerbaijan,Melaka,0,0,0
1/11/2020,Azerbaijan,Perlis,0,0,0
1/11/2020,Azerbaijan,Pulau Pinang,0,0,0
1/11/2020,Azerbaijan,Sabah,0,0,0
1/11/2020,Azerbaijan,Sarawak,0,0,0
1/11/2020,Azerbaijan,Selangor,2,2,0
1/11/2020,Azerbaijan,W.P. Labuan,0,0,0
1/11/2020,Burundi,Pulau Pinang,0,0,0
1/11/2020,Burundi,Sarawak,0,0,0
1/11/2020,Burundi,Selangor,0,0,0
1/11/2020,Belgium,Johor,0,0,0
1/11/2020,Belgium,Kedah,0,0,0
1/11/2020,Belgium,Kelantan,0,0,0
1/11/2020,Belgium,Melaka,0,0,0
1/11/2020,Belgium,Negeri Sembilan,0,0,0
1/11/2020,Belgium,Pahang,0,0,0
1/11/2020,Belgium,Perak,0,0,0
1/11/2020,Belgium,Perlis,0,0,0
1/11/2020,Belgium,Pulau Pinang,0,0,0
1/11/2020,Belgium,Sabah,0,0,0
1/11/2020,Belgium,Sarawak,0,0,0
1/11/2020,Belgium,Selangor,13,11,2
1/11/2020,Belgium,W.P. Labuan,0,0,0
1/11/2020,Benin,Johor,0,0,0
1/11/2020,Benin,Kedah,0,0,0
1/11/2020,Benin,Perak,0,0,0
1/11/2020,Benin,Pulau Pinang,0,0,0
1/11/2020,Benin,Sabah,0,0,0
1/11/2020,Benin,Sarawak,0,0,0
1/11/2020,Benin,Selangor,0,0,0
1/11/2020,Burkina Faso,Perak,0,0,0
1/11/2020,Burkina Faso,Pulau Pinang,0,0,0
1/11/2020,Burkina Faso,Selangor,0,0,0
1/11/2020,Bangladesh,Johor,0,0,0
1/11/2020,Bangladesh,Kedah,0,0,0
1/11/2020,Bangladesh,Kelantan,0,0,0
1/11/2020,Bangladesh,Melaka,0,0,0
1/11/2020,Bangladesh,Negeri Sembilan,0,0,0
1/11/2020,Bangladesh,Pahang,0,0,0
1/11/2020,Bangladesh,Perak,0,0,0
1/11/2020,Bangladesh,Perlis,0,0,0
1/11/2020,Bangladesh,Pulau Pinang,0,0,0
1/11/2020,Bangladesh,Sabah,0,0,0
1/11/2020,Bangladesh,Sarawak,3,3,0
1/11/2020,Bangladesh,Selangor,66,56,10
1/11/2020,Bangladesh,W.P. Labuan,0,0,0
1/11/2020,Bulgaria,Johor,0,0,0
1/11/2020,Bulgaria,Kedah,0,0,0
1/11/2020,Bulgaria,Kelantan,0,0,0
1/11/2020,Bulgaria,Pahang,0,0,0
1/11/2020,Bulgaria,Perak,0,0,0
1/11/2020,Bulgaria,Perlis,0,0,0
1/11/2020,Bulgaria,Pulau Pinang,0,0,0
1/11/2020,Bulgaria,Sabah,0,0,0
1/11/2020,Bulgaria,Sarawak,0,0,0
1/11/2020,Bulgaria,Selangor,9,8,1
1/11/2020,Bulgaria,W.P. Labuan,0,0,0
1/11/2020,Bahrain,Johor,0,0,0
1/11/2020,Bahrain,Kedah,0,0,0
1/11/2020,Bahrain,Kelantan,0,0,0
1/11/2020,Bahrain,Perlis,0,0,0
1/11/2020,Bahrain,Pulau Pinang,0,0,0
1/11/2020,Bahrain,Sabah,0,0,0
1/11/2020,Bahrain,Sarawak,0,0,0
1/11/2020,Bahrain,Selangor,2,2,0
1/11/2020,Bahamas,Johor,0,0,0
1/11/2020,Bahamas,Kedah,0,0,0
1/11/2020,Bahamas,Perak,0,0,0
1/11/2020,Bahamas,Sabah,0,0,0
1/11/2020,Bahamas,Sarawak,0,0,0
1/11/2020,Bahamas,Selangor,0,0,0
1/11/2020,Bosnia and Herzegovina,Johor,0,0,0
1/11/2020,Bosnia and Herzegovina,Kedah,0,0,0
1/11/2020,Bosnia and Herzegovina,Perlis,0,0,0
1/11/2020,Bosnia and Herzegovina,Pulau Pinang,0,0,0
1/11/2020,Bosnia and Herzegovina,Sabah,0,0,0
1/11/2020,Bosnia and Herzegovina,Sarawak,0,0,0
1/11/2020,Bosnia and Herzegovina,Selangor,3,2,1
1/11/2020,Belarus,Johor,0,0,0
1/11/2020,Belarus,Kedah,0,0,0
1/11/2020,Belarus,Kelantan,0,0,0
1/11/2020,Belarus,Pahang,0,0,0
1/11/2020,Belarus,Perak,0,0,0
1/11/2020,Belarus,Perlis,0,0,0
1/11/2020,Belarus,Pulau Pinang,0,0,0
1/11/2020,Belarus,Sabah,0,0,0
1/11/2020,Belarus,Sarawak,0,0,0
1/11/2020,Belarus,Selangor,2,0,2
1/11/2020,Belarus,W.P. Labuan,0,0,0
1/11/2020,Belize,Johor,0,0,0
1/11/2020,Belize,Pulau Pinang,0,0,0
1/11/2020,Belize,Sarawak,0,0,0
1/11/2020,Belize,Selangor,1,1,0
1/11/2020,Bermuda,Selangor,0,0,0
1/11/2020,Bolivia,Johor,0,0,0
1/11/2020,Bolivia,Kedah,0,0,0
1/11/2020,Bolivia,Melaka,0,0,0
1/11/2020,Bolivia,Perak,0,0,0
1/11/2020,Bolivia,Perlis,0,0,0
1/11/2020,Bolivia,Pulau Pinang,0,0,0
1/11/2020,Bolivia,Sabah,0,0,0
1/11/2020,Bolivia,Sarawak,0,0,0
1/11/2020,Bolivia,Selangor,0,0,0
1/11/2020,Brazil,Johor,1,0,1
1/11/2020,Brazil,Kedah,0,0,0
1/11/2020,Brazil,Kelantan,0,0,0
1/11/2020,Brazil,Melaka,0,0,0
1/11/2020,Brazil,Pahang,0,0,0
1/11/2020,Brazil,Perak,0,0,0
1/11/2020,Brazil,Perlis,0,0,0
1/11/2020,Brazil,Pulau Pinang,0,0,0
1/11/2020,Brazil,Sabah,0,0,0
1/11/2020,Brazil,Sarawak,0,0,0
1/11/2020,Brazil,Selangor,4,4,0
1/11/2020,Brazil,W.P. Labuan,0,0,0
1/11/2020,Barbados,Johor,0,0,0
1/11/2020,Barbados,Kedah,0,0,0
1/11/2020,Barbados,Perlis,0,0,0
1/11/2020,Barbados,Pulau Pinang,0,0,0
1/11/2020,Barbados,Selangor,0,0,0
1/11/2020,Brunei Darussalam,Johor,0,0,0
1/11/2020,Brunei Darussalam,Kedah,0,0,0
1/11/2020,Brunei Darussalam,Kelantan,0,0,0
1/11/2020,Brunei Darussalam,Melaka,0,0,0
1/11/2020,Brunei Darussalam,Pahang,0,0,0
1/11/2020,Brunei Darussalam,Perak,0,0,0
1/11/2020,Brunei Darussalam,Perlis,0,0,0
1/11/2020,Brunei Darussalam,Pulau Pinang,0,0,0
1/11/2020,Brunei Darussalam,Sabah,0,0,0
1/11/2020,Brunei Darussalam,Sarawak,322,312,10
1/11/2020,Brunei Darussalam,Selangor,8,5,3
1/11/2020,Brunei Darussalam,W.P. Labuan,4,3,1
1/11/2020,Bhutan,Johor,0,0,0
1/11/2020,Bhutan,Kedah,0,0,0
1/11/2020,Bhutan,Perak,0,0,0
1/11/2020,Bhutan,Perlis,0,0,0
1/11/2020,Bhutan,Pulau Pinang,0,0,0
1/11/2020,Bhutan,Sabah,0,0,0
1/11/2020,Bhutan,Sarawak,0,0,0
1/11/2020,Bhutan,Selangor,0,0,0
1/11/2020,Botswana,Johor,0,0,0
1/11/2020,Botswana,Kedah,0,0,0
1/11/2020,Botswana,Perlis,0,0,0
1/11/2020,Botswana,Pulau Pinang,0,0,0
1/11/2020,Botswana,Sabah,0,0,0
1/11/2020,Botswana,Sarawak,0,0,0
1/11/2020,Botswana,Selangor,0,0,0
1/11/2020,Central African Republic,Kedah,0,0,0
1/11/2020,Central African Republic,Selangor,0,0,0
1/11/2020,Canada,Johor,0,0,0
1/11/2020,Canada,Kedah,0,0,0
1/11/2020,Canada,Kelantan,0,0,0
1/11/2020,Canada,Melaka,0,0,0
1/11/2020,Canada,Negeri Sembilan,0,0,0
1/11/2020,Canada,Pahang,0,0,0
1/11/2020,Canada,Perak,2,1,1
1/11/2020,Canada,Perlis,0,0,0
1/11/2020,Canada,Pulau Pinang,1,1,0
1/11/2020,Canada,Sabah,0,0,0
1/11/2020,Canada,Sarawak,0,0,0
1/11/2020,Canada,Selangor,49,33,16
1/11/2020,Canada,Terengganu,0,0,0
1/11/2020,Canada,W.P. Labuan,0,0,0
1/11/2020,Cocos (Keeling) Islands,Selangor,0,0,0
1/11/2020,Switzerland,Johor,0,0,0
1/11/2020,Switzerland,Kedah,0,0,0
1/11/2020,Switzerland,Kelantan,0,0,0
1/11/2020,Switzerland,Melaka,0,0,0
1/11/2020,Switzerland,Negeri Sembilan,0,0,0
1/11/2020,Switzerland,Pahang,0,0,0
1/11/2020,Switzerland,Perak,0,0,0
1/11/2020,Switzerland,Perlis,0,0,0
1/11/2020,Switzerland,Pulau Pinang,0,0,0
1/11/2020,Switzerland,Sabah,0,0,0
1/11/2020,Switzerland,Sarawak,0,0,0
1/11/2020,Switzerland,Selangor,16,11,5
1/11/2020,Switzerland,W.P. Labuan,0,0,0
1/11/2020,Chile,Johor,0,0,0
1/11/2020,Chile,Kedah,0,0,0
1/11/2020,Chile,Kelantan,0,0,0
1/11/2020,Chile,Melaka,0,0,0
1/11/2020,Chile,Pahang,0,0,0
1/11/2020,Chile,Perak,0,0,0
1/11/2020,Chile,Perlis,0,0,0
1/11/2020,Chile,Pulau Pinang,0,0,0
1/11/2020,Chile,Sabah,0,0,0
1/11/2020,Chile,Sarawak,0,0,0
1/11/2020,Chile,Selangor,0,0,0
1/11/2020,China,Johor,26,23,3
1/11/2020,China,Kedah,0,0,0
1/11/2020,China,Kelantan,0,0,0
1/11/2020,China,Melaka,0,0,0
1/11/2020,China,Pahang,0,0,0
1/11/2020,China,Perak,0,0,0
1/11/2020,China,Perlis,0,0,0
1/11/2020,China,Pulau Pinang,2,0,2
1/11/2020,China,Sabah,0,0,0
1/11/2020,China,Sarawak,231,188,43
1/11/2020,China,Selangor,1374,1094,280
1/11/2020,China,Terengganu,0,0,0
1/11/2020,China,W.P. Labuan,0,0,0
1/11/2020,Côte d'Ivoire,Johor,0,0,0
1/11/2020,Côte d'Ivoire,Kedah,0,0,0
1/11/2020,Côte d'Ivoire,Pulau Pinang,0,0,0
1/11/2020,Côte d'Ivoire,Sabah,0,0,0
1/11/2020,Côte d'Ivoire,Sarawak,0,0,0
1/11/2020,Côte d'Ivoire,Selangor,0,0,0
1/11/2020,Cameroon,Johor,0,0,0
1/11/2020,Cameroon,Kedah,0,0,0
1/11/2020,Cameroon,Pulau Pinang,0,0,0
1/11/2020,Cameroon,Sabah,0,0,0
1/11/2020,Cameroon,Sarawak,0,0,0
1/11/2020,Cameroon,Selangor,0,0,0
1/11/2020,Congo,Johor,0,0,0
1/11/2020,Congo,Pulau Pinang,0,0,0
1/11/2020,Congo,Sarawak,0,0,0
1/11/2020,Congo,Selangor,0,0,0
1/11/2020,Congo,Johor,0,0,0
1/11/2020,Congo,Kedah,0,0,0
1/11/2020,Congo,Selangor,0,0,0
1/11/2020,Cook Islands,Selangor,0,0,0
1/11/2020,Colombia,Johor,0,0,0
1/11/2020,Colombia,Kedah,0,0,0
1/11/2020,Colombia,Perak,0,0,0
1/11/2020,Colombia,Pulau Pinang,0,0,0
1/11/2020,Colombia,Sabah,0,0,0
1/11/2020,Colombia,Sarawak,0,0,0
1/11/2020,Colombia,Selangor,3,0,3
1/11/2020,Colombia,W.P. Labuan,0,0,0
1/11/2020,Comoros,Johor,0,0,0
1/11/2020,Comoros,Kedah,0,0,0
1/11/2020,Comoros,Selangor,2,0,2
1/11/2020,Cabo Verde,Johor,0,0,0
1/11/2020,Cabo Verde,Kedah,0,0,0
1/11/2020,Cabo Verde,Pulau Pinang,0,0,0
1/11/2020,Cabo Verde,Sabah,0,0,0
1/11/2020,Cabo Verde,Selangor,0,0,0
1/11/2020,Costa Rica,Johor,0,0,0
1/11/2020,Costa Rica,Kedah,0,0,0
1/11/2020,Costa Rica,Perak,0,0,0
1/11/2020,Costa Rica,Perlis,0,0,0
1/11/2020,Costa Rica,Pulau Pinang,0,0,0
1/11/2020,Costa Rica,Sabah,0,0,0
1/11/2020,Costa Rica,Sarawak,0,0,0
1/11/2020,Costa Rica,Selangor,0,0,0
1/11/2020,Cuba,Johor,0,0,0
1/11/2020,Cuba,Kedah,0,0,0
1/11/2020,Cuba,Perlis,0,0,0
1/11/2020,Cuba,Pulau Pinang,0,0,0
1/11/2020,Cuba,Sabah,0,0,0
1/11/2020,Cuba,Sarawak,0,0,0
1/11/2020,Cuba,Selangor,0,0,0
1/11/2020,Cyprus,Johor,0,0,0
1/11/2020,Cyprus,Kedah,0,0,0
1/11/2020,Cyprus,Perak,0,0,0
1/11/2020,Cyprus,Perlis,0,0,0
1/11/2020,Cyprus,Pulau Pinang,0,0,0
1/11/2020,Cyprus,Sabah,0,0,0
1/11/2020,Cyprus,Sarawak,0,0,0
1/11/2020,Cyprus,Selangor,0,0,0
1/11/2020,Czechia,Johor,0,0,0
1/11/2020,Czechia,Kedah,0,0,0
1/11/2020,Czechia,Kelantan,0,0,0
1/11/2020,Czechia,Melaka,0,0,0
1/11/2020,Czechia,Negeri Sembilan,0,0,0
1/11/2020,Czechia,Perak,0,0,0
1/11/2020,Czechia,Perlis,0,0,0
1/11/2020,Czechia,Pulau Pinang,0,0,0
1/11/2020,Czechia,Sabah,0,0,0
1/11/2020,Czechia,Sarawak,0,0,0
1/11/2020,Czechia,Selangor,8,7,1
1/11/2020,Czechia,W.P. Labuan,0,0,0
1/11/2020,Germany,Johor,6,6,0
1/11/2020,Germany,Kedah,0,0,0
1/11/2020,Germany,Kelantan,0,0,0
1/11/2020,Germany,Melaka,0,0,0
1/11/2020,Germany,Negeri Sembilan,0,0,0
1/11/2020,Germany,Pahang,0,0,0
1/11/2020,Germany,Perak,0,0,0
1/11/2020,Germany,Perlis,0,0,0
1/11/2020,Germany,Pulau Pinang,1,0,1
1/11/2020,Germany,Sabah,0,0,0
1/11/2020,Germany,Sarawak,0,0,0
1/11/2020,Germany,Selangor,48,40,8
1/11/2020,Germany,Terengganu,0,0,0
1/11/2020,Germany,W.P. Labuan,0,0,0
1/11/2020,Djibouti,Johor,0,0,0
1/11/2020,Djibouti,Selangor,0,0,0
1/11/2020,Dominica,Johor,0,0,0
1/11/2020,Dominica,Kedah,0,0,0
1/11/2020,Dominica,Pulau Pinang,0,0,0
1/11/2020,Dominica,Sabah,0,0,0
1/11/2020,Dominica,Sarawak,0,0,0
1/11/2020,Dominica,Selangor,0,0,0
1/11/2020,Dominica,W.P. Labuan,0,0,0
1/11/2020,Denmark,Johor,4,2,2
1/11/2020,Denmark,Kedah,0,0,0
1/11/2020,Denmark,Kelantan,0,0,0
1/11/2020,Denmark,Melaka,0,0,0
1/11/2020,Denmark,Negeri Sembilan,0,0,0
1/11/2020,Denmark,Pahang,0,0,0
1/11/2020,Denmark,Perak,0,0,0
1/11/2020,Denmark,Perlis,0,0,0
1/11/2020,Denmark,Pulau Pinang,0,0,0
1/11/2020,Denmark,Sabah,0,0,0
1/11/2020,Denmark,Sarawak,0,0,0
1/11/2020,Denmark,Selangor,20,17,3
1/11/2020,Denmark,W.P. Labuan,0,0,0
1/11/2020,Dominican Republic,Johor,0,0,0
1/11/2020,Dominican Republic,Kedah,0,0,0
1/11/2020,Dominican Republic,Perak,0,0,0
1/11/2020,Dominican Republic,Perlis,0,0,0
1/11/2020,Dominican Republic,Pulau Pinang,0,0,0
1/11/2020,Dominican Republic,Sabah,0,0,0
1/11/2020,Dominican Republic,Sarawak,0,0,0
1/11/2020,Dominican Republic,Selangor,0,0,0
1/11/2020,Algeria,Johor,0,0,0
1/11/2020,Algeria,Kedah,0,0,0
1/11/2020,Algeria,Kelantan,0,0,0
1/11/2020,Algeria,Melaka,0,0,0
1/11/2020,Algeria,Perak,0,0,0
1/11/2020,Algeria,Perlis,0,0,0
1/11/2020,Algeria,Pulau Pinang,0,0,0
1/11/2020,Algeria,Sabah,0,0,0
1/11/2020,Algeria,Sarawak,0,0,0
1/11/2020,Algeria,Selangor,4,3,1
1/11/2020,Algeria,W.P. Labuan,0,0,0
1/11/2020,Ecuador,Johor,0,0,0
1/11/2020,Ecuador,Kedah,0,0,0
1/11/2020,Ecuador,Perak,0,0,0
1/11/2020,Ecuador,Perlis,0,0,0
1/11/2020,Ecuador,Pulau Pinang,0,0,0
1/11/2020,Ecuador,Sabah,0,0,0
1/11/2020,Ecuador,Sarawak,0,0,0
1/11/2020,Ecuador,Selangor,1,1,0
1/11/2020,Egypt,Johor,0,0,0
1/11/2020,Egypt,Kedah,0,0,0
1/11/2020,Egypt,Kelantan,0,0,0
1/11/2020,Egypt,Melaka,0,0,0
1/11/2020,Egypt,Pahang,0,0,0
1/11/2020,Egypt,Perak,0,0,0
1/11/2020,Egypt,Perlis,0,0,0
1/11/2020,Egypt,Pulau Pinang,0,0,0
1/11/2020,Egypt,Sabah,0,0,0
1/11/2020,Egypt,Sarawak,0,0,0
1/11/2020,Egypt,Selangor,28,23,5
1/11/2020,Egypt,Terengganu,0,0,0
1/11/2020,Egypt,W.P. Labuan,0,0,0
1/11/2020,Eritrea,Johor,0,0,0
1/11/2020,Eritrea,Pulau Pinang,0,0,0
1/11/2020,Eritrea,Sabah,0,0,0
1/11/2020,Eritrea,Selangor,0,0,0
1/11/2020,Spain,Johor,0,0,0
1/11/2020,Spain,Kedah,0,0,0
1/11/2020,Spain,Kelantan,0,0,0
1/11/2020,Spain,Melaka,0,0,0
1/11/2020,Spain,Negeri Sembilan,0,0,0
1/11/2020,Spain,Pahang,0,0,0
1/11/2020,Spain,Perak,0,0,0
1/11/2020,Spain,Perlis,0,0,0
1/11/2020,Spain,Pulau Pinang,0,0,0
1/11/2020,Spain,Sabah,0,0,0
1/11/2020,Spain,Sarawak,0,0,0
1/11/2020,Spain,Selangor,14,12,2
1/11/2020,Spain,W.P. Labuan,0,0,0
1/11/2020,Estonia,Johor,0,0,0
1/11/2020,Estonia,Kedah,0,0,0
1/11/2020,Estonia,Kelantan,0,0,0
1/11/2020,Estonia,Pahang,0,0,0
1/11/2020,Estonia,Perak,0,0,0
1/11/2020,Estonia,Perlis,0,0,0
1/11/2020,Estonia,Pulau Pinang,0,0,0
1/11/2020,Estonia,Sabah,0,0,0
1/11/2020,Estonia,Sarawak,0,0,0
1/11/2020,Estonia,Selangor,3,3,0
1/11/2020,Estonia,W.P. Labuan,0,0,0
1/11/2020,Ethiopia,Johor,0,0,0
1/11/2020,Ethiopia,Kedah,0,0,0
1/11/2020,Ethiopia,Pulau Pinang,0,0,0
1/11/2020,Ethiopia,Sarawak,0,0,0
1/11/2020,Ethiopia,Selangor,0,0,0
1/11/2020,Finland,Johor,0,0,0
1/11/2020,Finland,Kedah,0,0,0
1/11/2020,Finland,Kelantan,0,0,0
1/11/2020,Finland,Melaka,0,0,0
1/11/2020,Finland,Negeri Sembilan,0,0,0
1/11/2020,Finland,Pahang,0,0,0
1/11/2020,Finland,Perak,0,0,0
1/11/2020,Finland,Perlis,0,0,0
1/11/2020,Finland,Pulau Pinang,0,0,0
1/11/2020,Finland,Sabah,0,0,0
1/11/2020,Finland,Sarawak,0,0,0
1/11/2020,Finland,Selangor,5,5,0
1/11/2020,Finland,W.P. Labuan,0,0,0
1/11/2020,Fiji,Johor,0,0,0
1/11/2020,Fiji,Kedah,0,0,0
1/11/2020,Fiji,Kelantan,0,0,0
1/11/2020,Fiji,Perak,0,0,0
1/11/2020,Fiji,Perlis,0,0,0
1/11/2020,Fiji,Pulau Pinang,0,0,0
1/11/2020,Fiji,Sabah,0,0,0
1/11/2020,Fiji,Sarawak,0,0,0
1/11/2020,Fiji,Selangor,1,0,1
1/11/2020,France,Johor,2,2,0
1/11/2020,France,Kedah,0,0,0
1/11/2020,France,Kelantan,0,0,0
1/11/2020,France,Melaka,0,0,0
1/11/2020,France,Negeri Sembilan,0,0,0
1/11/2020,France,Pahang,0,0,0
1/11/2020,France,Perak,0,0,0
1/11/2020,France,Perlis,0,0,0
1/11/2020,France,Pulau Pinang,0,0,0
1/11/2020,France,Sabah,0,0,0
1/11/2020,France,Sarawak,0,0,0
1/11/2020,France,Selangor,44,35,9
1/11/2020,France,Terengganu,0,0,0
1/11/2020,France,W.P. Labuan,0,0,0
1/11/2020,"Micronesia, Federated States of",Johor,0,0,0
1/11/2020,"Micronesia, Federated States of",Pulau Pinang,0,0,0
1/11/2020,"Micronesia, Federated States of",Selangor,0,0,0
1/11/2020,Gabon,Johor,0,0,0
1/11/2020,Gabon,Pulau Pinang,0,0,0
1/11/2020,Gabon,Sarawak,0,0,0
1/11/2020,Gabon,Selangor,0,0,0
1/11/2020,United Kingdom of Great Britain and Northern Ireland,Johor,37,37,0
1/11/2020,United Kingdom of Great Britain and Northern Ireland,Kedah,0,0,0
1/11/2020,United Kingdom of Great Britain and Northern Ireland,Kelantan,0,0,0
1/11/2020,United Kingdom of Great Britain and Northern Ireland,Melaka,0,0,0
1/11/2020,United Kingdom of Great Britain and Northern Ireland,Negeri Sembilan,0,0,0
1/11/2020,United Kingdom of Great Britain and Northern Ireland,Pahang,0,0,0
1/11/2020,United Kingdom of Great Britain and Northern Ireland,Perak,1,0,1
1/11/2020,United Kingdom of Great Britain and Northern Ireland,Perlis,0,0,0
1/11/2020,United Kingdom of Great Britain and Northern Ireland,Pulau Pinang,5,4,1
1/11/2020,United Kingdom of Great Britain and Northern Ireland,Sabah,0,0,0
1/11/2020,United Kingdom of Great Britain and Northern Ireland,Sarawak,0,0,0
1/11/2020,United Kingdom of Great Britain and Northern Ireland,Selangor,199,160,39
1/11/2020,United Kingdom of Great Britain and Northern Ireland,Terengganu,0,0,0
1/11/2020,United Kingdom of Great Britain and Northern Ireland,W.P. Labuan,0,0,0
1/11/2020,Georgia,Johor,2,2,0
1/11/2020,Georgia,Kedah,0,0,0
1/11/2020,Georgia,Melaka,0,0,0
1/11/2020,Georgia,Perak,0,0,0
1/11/2020,Georgia,Perlis,0,0,0
1/11/2020,Georgia,Pulau Pinang,0,0,0
1/11/2020,Georgia,Sabah,0,0,0
1/11/2020,Georgia,Sarawak,0,0,0
1/11/2020,Georgia,Selangor,5,3,2
1/11/2020,Ghana,Johor,0,0,0
1/11/2020,Ghana,Kedah,0,0,0
1/11/2020,Ghana,Kelantan,0,0,0
1/11/2020,Ghana,Pulau Pinang,0,0,0
1/11/2020,Ghana,Sabah,0,0,0
1/11/2020,Ghana,Sarawak,0,0,0
1/11/2020,Ghana,Selangor,2,1,1
1/11/2020,Gibraltar,Johor,0,0,0
1/11/2020,Gibraltar,Sarawak,0,0,0
1/11/2020,Guinea,Johor,0,0,0
1/11/2020,Guinea,Kedah,0,0,0
1/11/2020,Guinea,Kelantan,0,0,0
1/11/2020,Guinea,Perlis,0,0,0
1/11/2020,Guinea,Pulau Pinang,0,0,0
1/11/2020,Guinea,Sabah,0,0,0
1/11/2020,Guinea,Sarawak,0,0,0
1/11/2020,Guinea,Selangor,0,0,0
1/11/2020,Guadeloupe,Selangor,0,0,0
1/11/2020,Gambia,Johor,0,0,0
1/11/2020,Gambia,Kedah,0,0,0
1/11/2020,Gambia,Kelantan,0,0,0
1/11/2020,Gambia,Pulau Pinang,0,0,0
1/11/2020,Gambia,Sabah,0,0,0
1/11/2020,Gambia,Sarawak,0,0,0
1/11/2020,Gambia,Selangor,1,0,1
1/11/2020,Guinea-Bissau,Johor,0,0,0
1/11/2020,Guinea-Bissau,Selangor,0,0,0
1/11/2020,Equatorial Guinea,Johor,0,0,0
1/11/2020,Equatorial Guinea,Selangor,0,0,0
1/11/2020,Greece,Johor,0,0,0
1/11/2020,Greece,Kedah,0,0,0
1/11/2020,Greece,Kelantan,0,0,0
1/11/2020,Greece,Melaka,0,0,0
1/11/2020,Greece,Negeri Sembilan,0,0,0
1/11/2020,Greece,Pahang,0,0,0
1/11/2020,Greece,Perak,0,0,0
1/11/2020,Greece,Perlis,0,0,0
1/11/2020,Greece,Pulau Pinang,0,0,0
1/11/2020,Greece,Sabah,0,0,0
1/11/2020,Greece,Sarawak,0,0,0
1/11/2020,Greece,Selangor,5,3,2
1/11/2020,Grenada,Johor,0,0,0
1/11/2020,Grenada,Kedah,0,0,0
1/11/2020,Grenada,Pulau Pinang,0,0,0
1/11/2020,Grenada,Sabah,0,0,0
1/11/2020,Grenada,Sarawak,0,0,0
1/11/2020,Grenada,Selangor,0,0,0
1/11/2020,Greenland,Johor,0,0,0
1/11/2020,Greenland,Selangor,0,0,0
1/11/2020,Guatemala,Johor,0,0,0
1/11/2020,Guatemala,Kedah,0,0,0
1/11/2020,Guatemala,Pahang,0,0,0
1/11/2020,Guatemala,Perak,0,0,0
1/11/2020,Guatemala,Pulau Pinang,0,0,0
1/11/2020,Guatemala,Sabah,0,0,0
1/11/2020,Guatemala,Sarawak,0,0,0
1/11/2020,Guatemala,Selangor,0,0,0
1/11/2020,Guatemala,W.P. Labuan,0,0,0
1/11/2020,Guyana,Johor,0,0,0
1/11/2020,Guyana,Kedah,0,0,0
1/11/2020,Guyana,Pulau Pinang,0,0,0
1/11/2020,Guyana,Sarawak,0,0,0
1/11/2020,Guyana,Selangor,0,0,0
1/11/2020,Hong Kong,Johor,0,0,0
1/11/2020,Hong Kong,Kedah,0,0,0
1/11/2020,Hong Kong,Kelantan,0,0,0
1/11/2020,Hong Kong,Pahang,0,0,0
1/11/2020,Hong Kong,Perak,0,0,0
1/11/2020,Hong Kong,Perlis,0,0,0
1/11/2020,Hong Kong,Pulau Pinang,0,0,0
1/11/2020,Hong Kong,Sabah,0,0,0
1/11/2020,Hong Kong,Sarawak,0,0,0
1/11/2020,Hong Kong,Selangor,2,1,1
1/11/2020,Hong Kong,Terengganu,0,0,0
1/11/2020,Heard Island and McDonald Islands,Johor,0,0,0
1/11/2020,Honduras,Johor,0,0,0
1/11/2020,Honduras,Kedah,0,0,0
1/11/2020,Honduras,Perak,0,0,0
1/11/2020,Honduras,Pulau Pinang,0,0,0
1/11/2020,Honduras,Sabah,0,0,0
1/11/2020,Honduras,Sarawak,0,0,0
1/11/2020,Honduras,Selangor,0,0,0
1/11/2020,Croatia,Johor,0,0,0
1/11/2020,Croatia,Kedah,0,0,0
1/11/2020,Croatia,Kelantan,0,0,0
1/11/2020,Croatia,Melaka,0,0,0
1/11/2020,Croatia,Pahang,0,0,0
1/11/2020,Croatia,Perak,0,0,0
1/11/2020,Croatia,Perlis,0,0,0
1/11/2020,Croatia,Pulau Pinang,0,0,0
1/11/2020,Croatia,Sabah,0,0,0
1/11/2020,Croatia,Sarawak,0,0,0
1/11/2020,Croatia,Selangor,14,14,0
1/11/2020,Haiti,Johor,0,0,0
1/11/2020,Haiti,Kedah,0,0,0
1/11/2020,Haiti,Kelantan,0,0,0
1/11/2020,Haiti,Perak,0,0,0
1/11/2020,Haiti,Pulau Pinang,0,0,0
1/11/2020,Haiti,Sabah,0,0,0
1/11/2020,Haiti,Selangor,0,0,0
1/11/2020,Hungary,Johor,0,0,0
1/11/2020,Hungary,Kedah,0,0,0
1/11/2020,Hungary,Kelantan,0,0,0
1/11/2020,Hungary,Pahang,0,0,0
1/11/2020,Hungary,Perak,0,0,0
1/11/2020,Hungary,Perlis,0,0,0
1/11/2020,Hungary,Pulau Pinang,0,0,0
1/11/2020,Hungary,Sabah,0,0,0
1/11/2020,Hungary,Sarawak,0,0,0
1/11/2020,Hungary,Selangor,5,5,0
1/11/2020,Hungary,W.P. Labuan,0,0,0
1/11/2020,Indonesia,Johor,224,195,29
1/11/2020,Indonesia,Kedah,0,0,0
1/11/2020,Indonesia,Kelantan,0,0,0
1/11/2020,Indonesia,Melaka,0,0,0
1/11/2020,Indonesia,Negeri Sembilan,0,0,0
1/11/2020,Indonesia,Pahang,0,0,0
1/11/2020,Indonesia,Perak,0,0,0
1/11/2020,Indonesia,Perlis,6,5,1
1/11/2020,Indonesia,Pulau Pinang,4,2,2
1/11/2020,Indonesia,Sabah,1,0,1
1/11/2020,Indonesia,Sarawak,362,361,1
1/11/2020,Indonesia,Selangor,364,251,113
1/11/2020,Indonesia,Terengganu,0,0,0
1/11/2020,Indonesia,W.P. Labuan,3,3,0
1/11/2020,India,Johor,34,34,0
1/11/2020,India,Kedah,0,0,0
1/11/2020,India,Kelantan,0,0,0
1/11/2020,India,Melaka,0,0,0
1/11/2020,India,Negeri Sembilan,0,0,0
1/11/2020,India,Pahang,0,0,0
1/11/2020,India,Perak,0,0,0
1/11/2020,India,Perlis,0,0,0
1/11/2020,India,Pulau Pinang,1,1,0
1/11/2020,India,Sabah,0,0,0
1/11/2020,India,Sarawak,0,0,0
1/11/2020,India,Selangor,392,336,56
1/11/2020,India,Terengganu,0,0,0
1/11/2020,India,W.P. Labuan,0,0,0
1/11/2020, British Indian Ocean Territory,Pulau Pinang,0,0,0
1/11/2020, British Indian Ocean Territory,Selangor,0,0,0
1/11/2020,Ireland,Johor,0,0,0
1/11/2020,Ireland,Kedah,0,0,0
1/11/2020,Ireland,Kelantan,0,0,0
1/11/2020,Ireland,Negeri Sembilan,0,0,0
1/11/2020,Ireland,Pahang,0,0,0
1/11/2020,Ireland,Perak,0,0,0
1/11/2020,Ireland,Perlis,0,0,0
1/11/2020,Ireland,Pulau Pinang,1,1,0
1/11/2020,Ireland,Sabah,0,0,0
1/11/2020,Ireland,Sarawak,0,0,0
1/11/2020,Ireland,Selangor,16,11,5
1/11/2020,Ireland,Terengganu,0,0,0
1/11/2020,Ireland,W.P. Labuan,0,0,0
1/11/2020,"Iran, Islamic Republic of",Johor,0,0,0
1/11/2020,"Iran, Islamic Republic of",Kedah,0,0,0
1/11/2020,"Iran, Islamic Republic of",Kelantan,0,0,0
1/11/2020,"Iran, Islamic Republic of",Perak,0,0,0
1/11/2020,"Iran, Islamic Republic of",Perlis,0,0,0
1/11/2020,"Iran, Islamic Republic of",Pulau Pinang,0,0,0
1/11/2020,"Iran, Islamic Republic of",Sabah,0,0,0
1/11/2020,"Iran, Islamic Republic of",Sarawak,0,0,0
1/11/2020,"Iran, Islamic Republic of",Selangor,26,13,13
1/11/2020,"Iran, Islamic Republic of",W.P. Labuan,0,0,0
1/11/2020,Iraq,Johor,0,0,0
1/11/2020,Iraq,Kedah,0,0,0
1/11/2020,Iraq,Kelantan,0,0,0
1/11/2020,Iraq,Melaka,0,0,0
1/11/2020,Iraq,Pahang,0,0,0
1/11/2020,Iraq,Perak,0,0,0
1/11/2020,Iraq,Perlis,0,0,0
1/11/2020,Iraq,Pulau Pinang,0,0,0
1/11/2020,Iraq,Sabah,0,0,0
1/11/2020,Iraq,Sarawak,0,0,0
1/11/2020,Iraq,Selangor,11,8,3
1/11/2020,Iceland,Johor,0,0,0
1/11/2020,Iceland,Kedah,0,0,0
1/11/2020,Iceland,Kelantan,0,0,0
1/11/2020,Iceland,Perak,0,0,0
1/11/2020,Iceland,Perlis,0,0,0
1/11/2020,Iceland,Pulau Pinang,0,0,0
1/11/2020,Iceland,Sabah,0,0,0
1/11/2020,Iceland,Sarawak,0,0,0
1/11/2020,Iceland,Selangor,0,0,0
1/11/2020,Iceland,W.P. Labuan,0,0,0
1/11/2020,Israel,Pulau Pinang,0,0,0
1/11/2020,Italy,Johor,0,0,0
1/11/2020,Italy,Kedah,0,0,0
1/11/2020,Italy,Kelantan,0,0,0
1/11/2020,Italy,Melaka,0,0,0
1/11/2020,Italy,Negeri Sembilan,0,0,0
1/11/2020,Italy,Pahang,0,0,0
1/11/2020,Italy,Perak,0,0,0
1/11/2020,Italy,Perlis,0,0,0
1/11/2020,Italy,Pulau Pinang,0,0,0
1/11/2020,Italy,Sabah,1,1,0
1/11/2020,Italy,Sarawak,0,0,0
1/11/2020,Italy,Selangor,17,16,1
1/11/2020,Italy,W.P. Labuan,0,0,0
1/11/2020,Jamaica,Johor,0,0,0
1/11/2020,Jamaica,Kedah,0,0,0
1/11/2020,Jamaica,Perak,0,0,0
1/11/2020,Jamaica,Pulau Pinang,0,0,0
1/11/2020,Jamaica,Sabah,0,0,0
1/11/2020,Jamaica,Sarawak,0,0,0
1/11/2020,Jamaica,Selangor,1,0,1
1/11/2020,Jamaica,W.P. Labuan,0,0,0
1/11/2020,Jordan,Johor,0,0,0
1/11/2020,Jordan,Kedah,0,0,0
1/11/2020,Jordan,Kelantan,0,0,0
1/11/2020,Jordan,Melaka,0,0,0
1/11/2020,Jordan,Perlis,0,0,0
1/11/2020,Jordan,Pulau Pinang,0,0,0
1/11/2020,Jordan,Sabah,0,0,0
1/11/2020,Jordan,Sarawak,0,0,0
1/11/2020,Jordan,Selangor,3,3,0
1/11/2020,Jordan,W.P. Labuan,0,0,0
1/11/2020,Japan,Johor,3,3,0
1/11/2020,Japan,Kedah,0,0,0
1/11/2020,Japan,Kelantan,0,0,0
1/11/2020,Japan,Melaka,0,0,0
1/11/2020,Japan,Negeri Sembilan,0,0,0
1/11/2020,Japan,Pahang,0,0,0
1/11/2020,Japan,Perak,0,0,0
1/11/2020,Japan,Perlis,0,0,0
1/11/2020,Japan,Pulau Pinang,12,8,4
1/11/2020,Japan,Sabah,0,0,0
1/11/2020,Japan,Sarawak,6,5,1
1/11/2020,Japan,Selangor,342,226,116
1/11/2020,Japan,W.P. Labuan,0,0,0
1/11/2020,Kazakhstan,Johor,0,0,0
1/11/2020,Kazakhstan,Kedah,0,0,0
1/11/2020,Kazakhstan,Kelantan,0,0,0
1/11/2020,Kazakhstan,Melaka,0,0,0
1/11/2020,Kazakhstan,Perak,0,0,0
1/11/2020,Kazakhstan,Perlis,0,0,0
1/11/2020,Kazakhstan,Pulau Pinang,0,0,0
1/11/2020,Kazakhstan,Sabah,0,0,0
1/11/2020,Kazakhstan,Sarawak,0,0,0
1/11/2020,Kazakhstan,Selangor,8,4,4
1/11/2020,Kazakhstan,W.P. Labuan,0,0,0
1/11/2020,Kenya,Johor,0,0,0
1/11/2020,Kenya,Kedah,0,0,0
1/11/2020,Kenya,Kelantan,0,0,0
1/11/2020,Kenya,Perak,0,0,0
1/11/2020,Kenya,Perlis,0,0,0
1/11/2020,Kenya,Pulau Pinang,0,0,0
1/11/2020,Kenya,Sabah,0,0,0
1/11/2020,Kenya,Sarawak,0,0,0
1/11/2020,Kenya,Selangor,1,1,0
1/11/2020,Kyrgyzstan,Johor,0,0,0
1/11/2020,Kyrgyzstan,Kedah,0,0,0
1/11/2020,Kyrgyzstan,Kelantan,0,0,0
1/11/2020,Kyrgyzstan,Perak,0,0,0
1/11/2020,Kyrgyzstan,Perlis,0,0,0
1/11/2020,Kyrgyzstan,Pulau Pinang,0,0,0
1/11/2020,Kyrgyzstan,Sabah,0,0,0
1/11/2020,Kyrgyzstan,Sarawak,0,0,0
1/11/2020,Kyrgyzstan,Selangor,1,0,1
1/11/2020,Cambodia,Johor,0,0,0
1/11/2020,Cambodia,Kedah,0,0,0
1/11/2020,Cambodia,Kelantan,0,0,0
1/11/2020,Cambodia,Melaka,0,0,0
1/11/2020,Cambodia,Negeri Sembilan,0,0,0
1/11/2020,Cambodia,Pahang,0,0,0
1/11/2020,Cambodia,Perak,0,0,0
1/11/2020,Cambodia,Perlis,0,0,0
1/11/2020,Cambodia,Pulau Pinang,0,0,0
1/11/2020,Cambodia,Sabah,0,0,0
1/11/2020,Cambodia,Sarawak,0,0,0
1/11/2020,Cambodia,Selangor,9,3,6
1/11/2020,Cambodia,W.P. Labuan,0,0,0
1/11/2020,Kiribati,Johor,0,0,0
1/11/2020,Kiribati,Sabah,0,0,0
1/11/2020,Kiribati,Selangor,10,10,0
1/11/2020,Saint Kitts and Nevis,Johor,0,0,0
1/11/2020,Saint Kitts and Nevis,Kedah,0,0,0
1/11/2020,Saint Kitts and Nevis,Perlis,0,0,0
1/11/2020,Saint Kitts and Nevis,Pulau Pinang,0,0,0
1/11/2020,Saint Kitts and Nevis,Sabah,0,0,0
1/11/2020,Saint Kitts and Nevis,Selangor,0,0,0
1/11/2020,Saint Kitts and Nevis,W.P. Labuan,0,0,0
1/11/2020,"Korea, Republic of",Johor,1,1,0
1/11/2020,"Korea, Republic of",Kedah,0,0,0
1/11/2020,"Korea, Republic of",Kelantan,0,0,0
1/11/2020,"Korea, Republic of",Melaka,0,0,0
1/11/2020,"Korea, Republic of",Negeri Sembilan,0,0,0
1/11/2020,"Korea, Republic of",Pahang,0,0,0
1/11/2020,"Korea, Republic of",Perak,0,0,0
1/11/2020,"Korea, Republic of",Perlis,0,0,0
1/11/2020,"Korea, Republic of",Pulau Pinang,0,0,0
1/11/2020,"Korea, Republic of",Sabah,0,0,0
1/11/2020,"Korea, Republic of",Sarawak,9,7,2
1/11/2020,"Korea, Republic of",Selangor,225,153,72
1/11/2020,"Korea, Republic of",Terengganu,0,0,0
1/11/2020,"Korea, Republic of",W.P. Labuan,0,0,0
1/11/2020,Kuwait,Johor,0,0,0
1/11/2020,Kuwait,Kedah,0,0,0
1/11/2020,Kuwait,Kelantan,0,0,0
1/11/2020,Kuwait,Perak,0,0,0
1/11/2020,Kuwait,Perlis,0,0,0
1/11/2020,Kuwait,Pulau Pinang,0,0,0
1/11/2020,Kuwait,Sabah,0,0,0
1/11/2020,Kuwait,Sarawak,0,0,0
1/11/2020,Kuwait,Selangor,0,0,0
1/11/2020,Kuwait,W.P. Labuan,0,0,0
1/11/2020, Lao People's Democratic Republic,Johor,0,0,0
1/11/2020, Lao People's Democratic Republic,Kedah,0,0,0
1/11/2020, Lao People's Democratic Republic,Kelantan,0,0,0
1/11/2020, Lao People's Democratic Republic,Melaka,0,0,0
1/11/2020, Lao People's Democratic Republic,Perak,0,0,0
1/11/2020, Lao People's Democratic Republic,Perlis,0,0,0
1/11/2020, Lao People's Democratic Republic,Pulau Pinang,0,0,0
1/11/2020, Lao People's Democratic Republic,Sabah,0,0,0
1/11/2020, Lao People's Democratic Republic,Sarawak,0,0,0
1/11/2020, Lao People's Democratic Republic,Selangor,3,1,2
1/11/2020, Lao People's Democratic Republic,W.P. Labuan,0,0,0
1/11/2020,Lebanon,Johor,0,0,0
1/11/2020,Lebanon,Kedah,0,0,0
1/11/2020,Lebanon,Kelantan,0,0,0
1/11/2020,Lebanon,Pahang,0,0,0
1/11/2020,Lebanon,Perak,0,0,0
1/11/2020,Lebanon,Perlis,0,0,0
1/11/2020,Lebanon,Pulau Pinang,0,0,0
1/11/2020,Lebanon,Sabah,0,0,0
1/11/2020,Lebanon,Sarawak,0,0,0
1/11/2020,Lebanon,Selangor,2,2,0
1/11/2020,Lebanon,W.P. Labuan,0,0,0
1/11/2020,Liberia,Johor,0,0,0
1/11/2020,Liberia,Kedah,0,0,0
1/11/2020,Liberia,Sabah,0,0,0
1/11/2020,Liberia,Sarawak,0,0,0
1/11/2020,Liberia,Selangor,1,1,0
1/11/2020,Libya,Johor,0,0,0
1/11/2020,Libya,Kedah,0,0,0
1/11/2020,Libya,Perlis,0,0,0
1/11/2020,Libya,Pulau Pinang,0,0,0
1/11/2020,Libya,Sabah,0,0,0
1/11/2020,Libya,Sarawak,0,0,0
1/11/2020,Libya,Selangor,1,0,1
1/11/2020,Saint Lucia,Johor,0,0,0
1/11/2020,Saint Lucia,Kedah,0,0,0
1/11/2020,Saint Lucia,Pulau Pinang,0,0,0
1/11/2020,Saint Lucia,Sarawak,0,0,0
1/11/2020,Saint Lucia,Selangor,0,0,0
1/11/2020,Liechtenstein,Johor,0,0,0
1/11/2020,Liechtenstein,Kedah,0,0,0
1/11/2020,Liechtenstein,Perlis,0,0,0
1/11/2020,Liechtenstein,Pulau Pinang,0,0,0
1/11/2020,Liechtenstein,Sabah,0,0,0
1/11/2020,Liechtenstein,Sarawak,0,0,0
1/11/2020,Liechtenstein,Selangor,0,0,0
1/11/2020,LKA,Johor,0,0,0
1/11/2020,LKA,Kedah,0,0,0
1/11/2020,LKA,Kelantan,0,0,0
1/11/2020,LKA,Melaka,0,0,0
1/11/2020,LKA,Pahang,0,0,0
1/11/2020,LKA,Perak,0,0,0
1/11/2020,LKA,Perlis,0,0,0
1/11/2020,LKA,Pulau Pinang,0,0,0
1/11/2020,LKA,Sabah,0,0,0
1/11/2020,LKA,Sarawak,0,0,0
1/11/2020,LKA,Selangor,21,12,9
1/11/2020,LKA,W.P. Labuan,0,0,0
1/11/2020,Lesotho,Johor,0,0,0
1/11/2020,Lesotho,Kedah,0,0,0
1/11/2020,Lesotho,Pulau Pinang,0,0,0
1/11/2020,Lesotho,Sarawak,0,0,0
1/11/2020,Lesotho,Selangor,0,0,0
1/11/2020,Lithuania,Johor,0,0,0
1/11/2020,Lithuania,Kedah,0,0,0
1/11/2020,Lithuania,Kelantan,0,0,0
1/11/2020,Lithuania,Pahang,0,0,0
1/11/2020,Lithuania,Perak,0,0,0
1/11/2020,Lithuania,Perlis,0,0,0
1/11/2020,Lithuania,Pulau Pinang,0,0,0
1/11/2020,Lithuania,Sabah,0,0,0
1/11/2020,Lithuania,Sarawak,0,0,0
1/11/2020,Lithuania,Selangor,3,3,0
1/11/2020,Lithuania,W.P. Labuan,0,0,0
1/11/2020,Luxembourg,Johor,0,0,0
1/11/2020,Luxembourg,Kedah,0,0,0
1/11/2020,Luxembourg,Kelantan,0,0,0
1/11/2020,Luxembourg,Perak,0,0,0
1/11/2020,Luxembourg,Perlis,0,0,0
1/11/2020,Luxembourg,Pulau Pinang,0,0,0
1/11/2020,Luxembourg,Sabah,0,0,0
1/11/2020,Luxembourg,Sarawak,0,0,0
1/11/2020,Luxembourg,Selangor,0,0,0
1/11/2020,Latvia,Johor,0,0,0
1/11/2020,Latvia,Kedah,0,0,0
1/11/2020,Latvia,Kelantan,0,0,0
1/11/2020,Latvia,Pahang,0,0,0
1/11/2020,Latvia,Perak,0,0,0
1/11/2020,Latvia,Perlis,0,0,0
1/11/2020,Latvia,Pulau Pinang,0,0,0
1/11/2020,Latvia,Sabah,0,0,0
1/11/2020,Latvia,Sarawak,0,0,0
1/11/2020,Latvia,Selangor,2,2,0
1/11/2020,Latvia,W.P. Labuan,0,0,0
1/11/2020,Macao,Johor,0,0,0
1/11/2020,Macao,Pahang,0,0,0
1/11/2020,Macao,Perak,0,0,0
1/11/2020,Macao,Selangor,0,0,0
1/11/2020,Macao,W.P. Labuan,0,0,0
1/11/2020,Morocco,Johor,0,0,0
1/11/2020,Morocco,Kedah,0,0,0
1/11/2020,Morocco,Kelantan,0,0,0
1/11/2020,Morocco,Melaka,0,0,0
1/11/2020,Morocco,Pahang,0,0,0
1/11/2020,Morocco,Perak,0,0,0
1/11/2020,Morocco,Perlis,0,0,0
1/11/2020,Morocco,Pulau Pinang,0,0,0
1/11/2020,Morocco,Sabah,0,0,0
1/11/2020,Morocco,Sarawak,0,0,0
1/11/2020,Morocco,Selangor,7,3,4
1/11/2020,Morocco,W.P. Labuan,0,0,0
1/11/2020,Monaco,Johor,0,0,0
1/11/2020,Monaco,Kedah,0,0,0
1/11/2020,Monaco,Sabah,0,0,0
1/11/2020,Monaco,Selangor,0,0,0
1/11/2020,"Moldova, Republic of",Johor,0,0,0
1/11/2020,"Moldova, Republic of",Kedah,0,0,0
1/11/2020,"Moldova, Republic of",Kelantan,0,0,0
1/11/2020,"Moldova, Republic of",Negeri Sembilan,0,0,0
1/11/2020,"Moldova, Republic of",Perlis,0,0,0
1/11/2020,"Moldova, Republic of",Pulau Pinang,0,0,0
1/11/2020,"Moldova, Republic of",Sabah,0,0,0
1/11/2020,"Moldova, Republic of",Sarawak,0,0,0
1/11/2020,"Moldova, Republic of",Selangor,0,0,0
1/11/2020,Madagascar,Johor,0,0,0
1/11/2020,Madagascar,Kedah,0,0,0
1/11/2020,Madagascar,Perak,0,0,0
1/11/2020,Madagascar,Perlis,0,0,0
1/11/2020,Madagascar,Pulau Pinang,0,0,0
1/11/2020,Madagascar,Sabah,0,0,0
1/11/2020,Madagascar,Sarawak,0,0,0
1/11/2020,Madagascar,Selangor,0,0,0
1/11/2020,Maldives,Johor,0,0,0
1/11/2020,Maldives,Kedah,0,0,0
1/11/2020,Maldives,Kelantan,0,0,0
1/11/2020,Maldives,Perak,0,0,0
1/11/2020,Maldives,Perlis,0,0,0
1/11/2020,Maldives,Pulau Pinang,0,0,0
1/11/2020,Maldives,Sabah,0,0,0
1/11/2020,Maldives,Sarawak,0,0,0
1/11/2020,Maldives,Selangor,16,12,4
1/11/2020,Mexico,Johor,0,0,0
1/11/2020,Mexico,Kedah,0,0,0
1/11/2020,Mexico,Kelantan,0,0,0
1/11/2020,Mexico,Pahang,0,0,0
1/11/2020,Mexico,Perak,0,0,0
1/11/2020,Mexico,Perlis,0,0,0
1/11/2020,Mexico,Pulau Pinang,0,0,0
1/11/2020,Mexico,Sabah,0,0,0
1/11/2020,Mexico,Sarawak,0,0,0
1/11/2020,Mexico,Selangor,6,4,2
1/11/2020,Mexico,W.P. Labuan,0,0,0
1/11/2020,Marshall Islands,Johor,0,0,0
1/11/2020,Marshall Islands,Kedah,0,0,0
1/11/2020,Marshall Islands,Perak,0,0,0
1/11/2020,Marshall Islands,Pulau Pinang,0,0,0
1/11/2020,Marshall Islands,Sabah,0,0,0
1/11/2020,Marshall Islands,Selangor,0,0,0
1/11/2020,North Macedonia,Johor,0,0,0
1/11/2020,North Macedonia,Kedah,0,0,0
1/11/2020,North Macedonia,Perak,0,0,0
1/11/2020,North Macedonia,Pulau Pinang,0,0,0
1/11/2020,North Macedonia,Sabah,0,0,0
1/11/2020,North Macedonia,Sarawak,0,0,0
1/11/2020,North Macedonia,Selangor,0,0,0
1/11/2020,Mali,Johor,0,0,0
1/11/2020,Mali,Sabah,0,0,0
1/11/2020,Mali,Selangor,0,0,0
1/11/2020,Malta,Johor,0,0,0
1/11/2020,Malta,Kedah,0,0,0
1/11/2020,Malta,Kelantan,0,0,0
1/11/2020,Malta,Perak,0,0,0
1/11/2020,Malta,Perlis,0,0,0
1/11/2020,Malta,Pulau Pinang,0,0,0
1/11/2020,Malta,Sabah,0,0,0
1/11/2020,Malta,Sarawak,0,0,0
1/11/2020,Malta,Selangor,0,0,0
1/11/2020,Malta,W.P. Labuan,0,0,0
1/11/2020,Myanmar,Johor,39,39,0
1/11/2020,Myanmar,Kedah,0,0,0
1/11/2020,Myanmar,Kelantan,0,0,0
1/11/2020,Myanmar,Negeri Sembilan,0,0,0
1/11/2020,Myanmar,Pahang,0,0,0
1/11/2020,Myanmar,Perak,0,0,0
1/11/2020,Myanmar,Perlis,0,0,0
1/11/2020,Myanmar,Pulau Pinang,0,0,0
1/11/2020,Myanmar,Sabah,0,0,0
1/11/2020,Myanmar,Sarawak,0,0,0
1/11/2020,Myanmar,Selangor,122,104,18
1/11/2020,Myanmar,Terengganu,0,0,0
1/11/2020,Myanmar,W.P. Labuan,0,0,0
1/11/2020,Montenegro,Johor,0,0,0
1/11/2020,Montenegro,Kedah,0,0,0
1/11/2020,Montenegro,Pulau Pinang,0,0,0
1/11/2020,Montenegro,Sabah,0,0,0
1/11/2020,Montenegro,Sarawak,0,0,0
1/11/2020,Montenegro,Selangor,1,1,0
1/11/2020,Mongolia,Johor,0,0,0
1/11/2020,Mongolia,Kedah,0,0,0
1/11/2020,Mongolia,Kelantan,0,0,0
1/11/2020,Mongolia,Perak,0,0,0
1/11/2020,Mongolia,Perlis,0,0,0
1/11/2020,Mongolia,Pulau Pinang,0,0,0
1/11/2020,Mongolia,Sabah,0,0,0
1/11/2020,Mongolia,Sarawak,0,0,0
1/11/2020,Mongolia,Selangor,2,0,2
1/11/2020,Northern Mariana Islands,Selangor,0,0,0
1/11/2020,Mozambique,Johor,0,0,0
1/11/2020,Mozambique,Kedah,0,0,0
1/11/2020,Mozambique,Perak,0,0,0
1/11/2020,Mozambique,Pulau Pinang,0,0,0
1/11/2020,Mozambique,Sabah,0,0,0
1/11/2020,Mozambique,Sarawak,0,0,0
1/11/2020,Mozambique,Selangor,0,0,0
1/11/2020,Mauritania,Johor,0,0,0
1/11/2020,Mauritania,Kedah,0,0,0
1/11/2020,Mauritania,Pulau Pinang,0,0,0
1/11/2020,Mauritania,Sabah,0,0,0
1/11/2020,Mauritania,Sarawak,0,0,0
1/11/2020,Mauritania,Selangor,0,0,0
1/11/2020,Mauritius,Johor,1,1,0
1/11/2020,Mauritius,Kedah,0,0,0
1/11/2020,Mauritius,Kelantan,0,0,0
1/11/2020,Mauritius,Pahang,0,0,0
1/11/2020,Mauritius,Perak,0,0,0
1/11/2020,Mauritius,Perlis,0,0,0
1/11/2020,Mauritius,Pulau Pinang,0,0,0
1/11/2020,Mauritius,Sabah,0,0,0
1/11/2020,Mauritius,Sarawak,0,0,0
1/11/2020,Mauritius,Selangor,5,3,2
1/11/2020,Malawi,Johor,0,0,0
1/11/2020,Malawi,Pulau Pinang,0,0,0
1/11/2020,Malawi,Sabah,0,0,0
1/11/2020,Malawi,Sarawak,0,0,0
1/11/2020,Malawi,Selangor,1,1,0
1/11/2020,Mayotte,Selangor,0,0,0
1/11/2020,Namibia,Johor,0,0,0
1/11/2020,Namibia,Kedah,0,0,0
1/11/2020,Namibia,Perak,0,0,0
1/11/2020,Namibia,Perlis,0,0,0
1/11/2020,Namibia,Pulau Pinang,0,0,0
1/11/2020,Namibia,Sabah,0,0,0
1/11/2020,Namibia,Sarawak,0,0,0
1/11/2020,Namibia,Selangor,0,0,0
1/11/2020,New Caledonia,Selangor,0,0,0
1/11/2020,Niger,Johor,0,0,0
1/11/2020,Niger,Sabah,0,0,0
1/11/2020,Niger,Selangor,0,0,0
1/11/2020,Nigeria,Johor,0,0,0
1/11/2020,Nigeria,Kedah,0,0,0
1/11/2020,Nigeria,Perlis,0,0,0
1/11/2020,Nigeria,Pulau Pinang,0,0,0
1/11/2020,Nigeria,Sabah,0,0,0
1/11/2020,Nigeria,Sarawak,0,0,0
1/11/2020,Nigeria,Selangor,64,55,9
1/11/2020,Nicaragua,Johor,0,0,0
1/11/2020,Nicaragua,Kedah,0,0,0
1/11/2020,Nicaragua,Pulau Pinang,0,0,0
1/11/2020,Nicaragua,Sabah,0,0,0
1/11/2020,Nicaragua,Selangor,0,0,0
1/11/2020,Netherlands,Johor,1,1,0
1/11/2020,Netherlands,Kedah,0,0,0
1/11/2020,Netherlands,Kelantan,0,0,0
1/11/2020,Netherlands,Melaka,0,0,0
1/11/2020,Netherlands,Negeri Sembilan,0,0,0
1/11/2020,Netherlands,Pahang,0,0,0
1/11/2020,Netherlands,Perak,0,0,0
1/11/2020,Netherlands,Perlis,0,0,0
1/11/2020,Netherlands,Pulau Pinang,5,4,1
1/11/2020,Netherlands,Sabah,0,0,0
1/11/2020,Netherlands,Sarawak,0,0,0
1/11/2020,Netherlands,Selangor,47,41,6
1/11/2020,Netherlands,Terengganu,0,0,0
1/11/2020,Netherlands,W.P. Labuan,0,0,0
1/11/2020,Norway,Johor,0,0,0
1/11/2020,Norway,Kedah,0,0,0
1/11/2020,Norway,Kelantan,0,0,0
1/11/2020,Norway,Melaka,0,0,0
1/11/2020,Norway,Pahang,0,0,0
1/11/2020,Norway,Perak,0,0,0
1/11/2020,Norway,Perlis,0,0,0
1/11/2020,Norway,Pulau Pinang,0,0,0
1/11/2020,Norway,Sabah,0,0,0
1/11/2020,Norway,Sarawak,0,0,0
1/11/2020,Norway,Selangor,13,12,1
1/11/2020,Norway,W.P. Labuan,0,0,0
1/11/2020,Nepal,Johor,0,0,0
1/11/2020,Nepal,Kedah,0,0,0
1/11/2020,Nepal,Pahang,0,0,0
1/11/2020,Nepal,Perak,0,0,0
1/11/2020,Nepal,Perlis,0,0,0
1/11/2020,Nepal,Pulau Pinang,0,0,0
1/11/2020,Nepal,Sabah,0,0,0
1/11/2020,Nepal,Sarawak,0,0,0
1/11/2020,Nepal,Selangor,163,159,4
1/11/2020,Nepal,W.P. Labuan,0,0,0
1/11/2020,Nauru,Johor,0,0,0
1/11/2020,Nauru,Pulau Pinang,0,0,0
1/11/2020,Nauru,Selangor,0,0,0
1/11/2020,New Zealand,Johor,3,3,0
1/11/2020,New Zealand,Kedah,0,0,0
1/11/2020,New Zealand,Kelantan,0,0,0
1/11/2020,New Zealand,Melaka,0,0,0
1/11/2020,New Zealand,Negeri Sembilan,0,0,0
1/11/2020,New Zealand,Pahang,0,0,0
1/11/2020,New Zealand,Perak,0,0,0
1/11/2020,New Zealand,Perlis,0,0,0
1/11/2020,New Zealand,Pulau Pinang,1,1,0
1/11/2020,New Zealand,Sabah,0,0,0
1/11/2020,New Zealand,Sarawak,0,0,0
1/11/2020,New Zealand,Selangor,19,16,3
1/11/2020,New Zealand,Terengganu,0,0,0
1/11/2020,New Zealand,W.P. Labuan,0,0,0
1/11/2020,Oman,Johor,0,0,0
1/11/2020,Oman,Kedah,0,0,0
1/11/2020,Oman,Kelantan,0,0,0
1/11/2020,Oman,Melaka,0,0,0
1/11/2020,Oman,Perak,0,0,0
1/11/2020,Oman,Perlis,0,0,0
1/11/2020,Oman,Pulau Pinang,0,0,0
1/11/2020,Oman,Sabah,0,0,0
1/11/2020,Oman,Sarawak,0,0,0
1/11/2020,Oman,Selangor,16,12,4
1/11/2020,Pakistan,Johor,0,0,0
1/11/2020,Pakistan,Kedah,0,0,0
1/11/2020,Pakistan,Kelantan,0,0,0
1/11/2020,Pakistan,Melaka,0,0,0
1/11/2020,Pakistan,Negeri Sembilan,0,0,0
1/11/2020,Pakistan,Pahang,0,0,0
1/11/2020,Pakistan,Perak,0,0,0
1/11/2020,Pakistan,Perlis,0,0,0
1/11/2020,Pakistan,Pulau Pinang,0,0,0
1/11/2020,Pakistan,Sabah,0,0,0
1/11/2020,Pakistan,Sarawak,1,1,0
1/11/2020,Pakistan,Selangor,73,69,4
1/11/2020,Pakistan,W.P. Labuan,0,0,0
1/11/2020,Panama,Johor,0,0,0
1/11/2020,Panama,Kedah,0,0,0
1/11/2020,Panama,Perak,0,0,0
1/11/2020,Panama,Perlis,0,0,0
1/11/2020,Panama,Pulau Pinang,0,0,0
1/11/2020,Panama,Sabah,0,0,0
1/11/2020,Panama,Sarawak,0,0,0
1/11/2020,Panama,Selangor,0,0,0
1/11/2020,Peru,Johor,0,0,0
1/11/2020,Peru,Kedah,0,0,0
1/11/2020,Peru,Kelantan,0,0,0
1/11/2020,Peru,Pahang,0,0,0
1/11/2020,Peru,Perak,0,0,0
1/11/2020,Peru,Perlis,0,0,0
1/11/2020,Peru,Pulau Pinang,0,0,0
1/11/2020,Peru,Sabah,0,0,0
1/11/2020,Peru,Sarawak,0,0,0
1/11/2020,Peru,Selangor,1,1,0
1/11/2020,Peru,W.P. Labuan,0,0,0
1/11/2020,Philippines,Johor,45,42,3
1/11/2020,Philippines,Kedah,0,0,0
1/11/2020,Philippines,Kelantan,0,0,0
1/11/2020,Philippines,Melaka,0,0,0
1/11/2020,Philippines,Negeri Sembilan,0,0,0
1/11/2020,Philippines,Pahang,0,0,0
1/11/2020,Philippines,Perak,1,1,0
1/11/2020,Philippines,Perlis,0,0,0
1/11/2020,Philippines,Pulau Pinang,0,0,0
1/11/2020,Philippines,Sabah,0,0,0
1/11/2020,Philippines,Sarawak,62,62,0
1/11/2020,Philippines,Selangor,261,227,34
1/11/2020,Philippines,Terengganu,0,0,0
1/11/2020,Philippines,W.P. Labuan,5,5,0
1/11/2020,Palau,Johor,0,0,0
1/11/2020,Palau,Pulau Pinang,0,0,0
1/11/2020,Palau,Selangor,0,0,0
1/11/2020,Papua New Guinea,Johor,0,0,0
1/11/2020,Papua New Guinea,Kedah,0,0,0
1/11/2020,Papua New Guinea,Kelantan,0,0,0
1/11/2020,Papua New Guinea,Perak,0,0,0
1/11/2020,Papua New Guinea,Pulau Pinang,0,0,0
1/11/2020,Papua New Guinea,Sabah,0,0,0
1/11/2020,Papua New Guinea,Sarawak,0,0,0
1/11/2020,Papua New Guinea,Selangor,0,0,0
1/11/2020,Poland,Johor,0,0,0
1/11/2020,Poland,Kedah,0,0,0
1/11/2020,Poland,Kelantan,0,0,0
1/11/2020,Poland,Melaka,0,0,0
1/11/2020,Poland,Negeri Sembilan,0,0,0
1/11/2020,Poland,Pahang,0,0,0
1/11/2020,Poland,Perak,0,0,0
1/11/2020,Poland,Perlis,0,0,0
1/11/2020,Poland,Pulau Pinang,0,0,0
1/11/2020,Poland,Sabah,0,0,0
1/11/2020,Poland,Sarawak,0,0,0
1/11/2020,Poland,Selangor,19,18,1
1/11/2020,Poland,Terengganu,0,0,0
1/11/2020,Poland,W.P. Labuan,0,0,0
1/11/2020,"North Korea, Democratic People's Republic of",Selangor,0,0,0
1/11/2020,Portugal,Johor,1,1,0
1/11/2020,Portugal,Kedah,0,0,0
1/11/2020,Portugal,Kelantan,0,0,0
1/11/2020,Portugal,Melaka,0,0,0
1/11/2020,Portugal,Pahang,0,0,0
1/11/2020,Portugal,Perak,0,0,0
1/11/2020,Portugal,Perlis,0,0,0
1/11/2020,Portugal,Pulau Pinang,0,0,0
1/11/2020,Portugal,Sabah,0,0,0
1/11/2020,Portugal,Sarawak,0,0,0
1/11/2020,Portugal,Selangor,8,5,3
1/11/2020,Portugal,W.P. Labuan,0,0,0
1/11/2020,Paraguay,Johor,0,0,0
1/11/2020,Paraguay,Kedah,0,0,0
1/11/2020,Paraguay,Perak,0,0,0
1/11/2020,Paraguay,Perlis,0,0,0
1/11/2020,Paraguay,Pulau Pinang,0,0,0
1/11/2020,Paraguay,Sabah,0,0,0
1/11/2020,Paraguay,Sarawak,0,0,0
1/11/2020,Paraguay,Selangor,0,0,0
1/11/2020,"Palestine, State of",Johor,0,0,0
1/11/2020,"Palestine, State of",Kedah,0,0,0
1/11/2020,"Palestine, State of",Kelantan,0,0,0
1/11/2020,"Palestine, State of",Melaka,0,0,0
1/11/2020,"Palestine, State of",Perak,0,0,0
1/11/2020,"Palestine, State of",Perlis,0,0,0
1/11/2020,"Palestine, State of",Pulau Pinang,0,0,0
1/11/2020,"Palestine, State of",Sabah,0,0,0
1/11/2020,"Palestine, State of",Sarawak,0,0,0
1/11/2020,"Palestine, State of",Selangor,3,1,2
1/11/2020,Qatar,Johor,0,0,0
1/11/2020,Qatar,Kedah,0,0,0
1/11/2020,Qatar,Perlis,0,0,0
1/11/2020,Qatar,Pulau Pinang,0,0,0
1/11/2020,Qatar,Sabah,0,0,0
1/11/2020,Qatar,Sarawak,0,0,0
1/11/2020,Qatar,Selangor,2,2,0
1/11/2020,Réunion,Johor,0,0,0
1/11/2020,Réunion,Sarawak,0,0,0
1/11/2020,Romania,Johor,0,0,0
1/11/2020,Romania,Kedah,0,0,0
1/11/2020,Romania,Kelantan,0,0,0
1/11/2020,Romania,Negeri Sembilan,0,0,0
1/11/2020,Romania,Pahang,0,0,0
1/11/2020,Romania,Perak,0,0,0
1/11/2020,Romania,Perlis,0,0,0
1/11/2020,Romania,Pulau Pinang,0,0,0
1/11/2020,Romania,Sabah,0,0,0
1/11/2020,Romania,Sarawak,0,0,0
1/11/2020,Romania,Selangor,15,15,0
1/11/2020,Romania,W.P. Labuan,0,0,0
1/11/2020,Russian Federation (Russia),Johor,1,1,0
1/11/2020,Russian Federation (Russia),Kedah,0,0,0
1/11/2020,Russian Federation (Russia),Kelantan,0,0,0
1/11/2020,Russian Federation (Russia),Melaka,0,0,0
1/11/2020,Russian Federation (Russia),Negeri Sembilan,0,0,0
1/11/2020,Russian Federation (Russia),Pahang,0,0,0
1/11/2020,Russian Federation (Russia),Perak,0,0,0
1/11/2020,Russian Federation (Russia),Perlis,0,0,0
1/11/2020,Russian Federation (Russia),Pulau Pinang,0,0,0
1/11/2020,Russian Federation (Russia),Sabah,0,0,0
1/11/2020,Russian Federation (Russia),Sarawak,0,0,0
1/11/2020,Russian Federation (Russia),Selangor,53,47,6
1/11/2020,Russian Federation (Russia),W.P. Labuan,0,0,0
1/11/2020,Rwanda,Johor,0,0,0
1/11/2020,Rwanda,Kedah,0,0,0
1/11/2020,Rwanda,Pulau Pinang,0,0,0
1/11/2020,Rwanda,Selangor,0,0,0
1/11/2020,Saudi Arabia,Johor,0,0,0
1/11/2020,Saudi Arabia,Kedah,0,0,0
1/11/2020,Saudi Arabia,Kelantan,0,0,0
1/11/2020,Saudi Arabia,Melaka,0,0,0
1/11/2020,Saudi Arabia,Perak,0,0,0
1/11/2020,Saudi Arabia,Perlis,0,0,0
1/11/2020,Saudi Arabia,Pulau Pinang,0,0,0
1/11/2020,Saudi Arabia,Sabah,0,0,0
1/11/2020,Saudi Arabia,Sarawak,0,0,0
1/11/2020,Saudi Arabia,Selangor,28,16,12
1/11/2020,Saudi Arabia,W.P. Labuan,0,0,0
1/11/2020,Sudan,Johor,0,0,0
1/11/2020,Sudan,Kedah,0,0,0
1/11/2020,Sudan,Kelantan,0,0,0
1/11/2020,Sudan,Perlis,0,0,0
1/11/2020,Sudan,Pulau Pinang,0,0,0
1/11/2020,Sudan,Sabah,0,0,0
1/11/2020,Sudan,Sarawak,0,0,0
1/11/2020,Sudan,Selangor,5,4,1
1/11/2020,Sudan,W.P. Labuan,0,0,0
1/11/2020,Senegal,Johor,0,0,0
1/11/2020,Senegal,Kedah,0,0,0
1/11/2020,Senegal,Kelantan,0,0,0
1/11/2020,Senegal,Perak,0,0,0
1/11/2020,Senegal,Perlis,0,0,0
1/11/2020,Senegal,Pulau Pinang,0,0,0
1/11/2020,Senegal,Sabah,0,0,0
1/11/2020,Senegal,Sarawak,0,0,0
1/11/2020,Senegal,Selangor,2,1,1
1/11/2020,Singapore,Johor,467,400,67
1/11/2020,Singapore,Kedah,1,1,0
1/11/2020,Singapore,Kelantan,3,2,1
1/11/2020,Singapore,Melaka,0,0,0
1/11/2020,Singapore,Negeri Sembilan,0,0,0
1/11/2020,Singapore,Pahang,0,0,0
1/11/2020,Singapore,Perak,6,3,3
1/11/2020,Singapore,Perlis,0,0,0
1/11/2020,Singapore,Pulau Pinang,37,28,9
1/11/2020,Singapore,Sabah,0,0,0
1/11/2020,Singapore,Sarawak,15,11,4
1/11/2020,Singapore,Selangor,211,147,64
1/11/2020,Singapore,Terengganu,0,0,0
1/11/2020,Singapore,W.P. Labuan,0,0,0
1/11/2020,South Georgia and the South Sandwich Islands,Johor,0,0,0
1/11/2020,South Georgia and the South Sandwich Islands,Sabah,0,0,0
1/11/2020,South Georgia and the South Sandwich Islands,Selangor,0,0,0
1/11/2020,Saint Helena,Sarawak,0,0,0
1/11/2020,Solomon Islands,Johor,0,0,0
1/11/2020,Solomon Islands,Perlis,0,0,0
1/11/2020,Solomon Islands,Pulau Pinang,0,0,0
1/11/2020,Solomon Islands,Sabah,0,0,0
1/11/2020,Solomon Islands,Sarawak,0,0,0
1/11/2020,Solomon Islands,Selangor,0,0,0
1/11/2020,Solomon Islands,W.P. Labuan,0,0,0
1/11/2020,Sierra Leone,Johor,0,0,0
1/11/2020,Sierra Leone,Kedah,0,0,0
1/11/2020,Sierra Leone,Perak,0,0,0
1/11/2020,Sierra Leone,Pulau Pinang,0,0,0
1/11/2020,Sierra Leone,Sabah,0,0,0
1/11/2020,Sierra Leone,Selangor,0,0,0
1/11/2020,El Salvador,Johor,0,0,0
1/11/2020,El Salvador,Kedah,0,0,0
1/11/2020,El Salvador,Perak,0,0,0
1/11/2020,El Salvador,Perlis,0,0,0
1/11/2020,El Salvador,Pulau Pinang,0,0,0
1/11/2020,El Salvador,Sabah,0,0,0
1/11/2020,El Salvador,Selangor,0,0,0
1/11/2020,El Salvador,W.P. Labuan,0,0,0
1/11/2020,San Marino,Johor,0,0,0
1/11/2020,San Marino,Selangor,0,0,0
1/11/2020,Somalia,Johor,0,0,0
1/11/2020,Somalia,Kedah,0,0,0
1/11/2020,Somalia,Kelantan,0,0,0
1/11/2020,Somalia,Perlis,0,0,0
1/11/2020,Somalia,Sabah,0,0,0
1/11/2020,Somalia,Sarawak,0,0,0
1/11/2020,Somalia,Selangor,1,0,1
1/11/2020,Serbia,Johor,0,0,0
1/11/2020,Serbia,Kedah,0,0,0
1/11/2020,Serbia,Kelantan,0,0,0
1/11/2020,Serbia,Pahang,0,0,0
1/11/2020,Serbia,Perak,0,0,0
1/11/2020,Serbia,Perlis,0,0,0
1/11/2020,Serbia,Pulau Pinang,0,0,0
1/11/2020,Serbia,Sabah,0,0,0
1/11/2020,Serbia,Sarawak,0,0,0
1/11/2020,Serbia,Selangor,1,1,0
1/11/2020,South Sudan,Johor,0,0,0
1/11/2020,South Sudan,Kedah,0,0,0
1/11/2020,South Sudan,Sarawak,0,0,0
1/11/2020,South Sudan,Selangor,0,0,0
1/11/2020,South Sudan,W.P. Labuan,0,0,0
1/11/2020,Sao Tome and Principe,Selangor,0,0,0
1/11/2020,Suriname,Johor,0,0,0
1/11/2020,Suriname,Kedah,0,0,0
1/11/2020,Suriname,Kelantan,0,0,0
1/11/2020,Suriname,Perak,0,0,0
1/11/2020,Suriname,Perlis,0,0,0
1/11/2020,Suriname,Pulau Pinang,0,0,0
1/11/2020,Suriname,Sabah,0,0,0
1/11/2020,Suriname,Sarawak,0,0,0
1/11/2020,Suriname,Selangor,0,0,0
1/11/2020,Slovakia,Johor,0,0,0
1/11/2020,Slovakia,Kedah,0,0,0
1/11/2020,Slovakia,Kelantan,0,0,0
1/11/2020,Slovakia,Negeri Sembilan,0,0,0
1/11/2020,Slovakia,Pahang,0,0,0
1/11/2020,Slovakia,Perak,0,0,0
1/11/2020,Slovakia,Perlis,0,0,0
1/11/2020,Slovakia,Pulau Pinang,0,0,0
1/11/2020,Slovakia,Sabah,0,0,0
1/11/2020,Slovakia,Sarawak,0,0,0
1/11/2020,Slovakia,Selangor,4,4,0
1/11/2020,Slovakia,W.P. Labuan,0,0,0
1/11/2020,Slovenia,Johor,0,0,0
1/11/2020,Slovenia,Kedah,0,0,0
1/11/2020,Slovenia,Kelantan,0,0,0
1/11/2020,Slovenia,Perak,0,0,0
1/11/2020,Slovenia,Perlis,0,0,0
1/11/2020,Slovenia,Pulau Pinang,0,0,0
1/11/2020,Slovenia,Sabah,0,0,0
1/11/2020,Slovenia,Sarawak,0,0,0
1/11/2020,Slovenia,Selangor,4,4,0
1/11/2020,Slovenia,W.P. Labuan,0,0,0
1/11/2020,Sweden,Johor,1,1,0
1/11/2020,Sweden,Kedah,0,0,0
1/11/2020,Sweden,Kelantan,0,0,0
1/11/2020,Sweden,Melaka,0,0,0
1/11/2020,Sweden,Negeri Sembilan,0,0,0
1/11/2020,Sweden,Pahang,0,0,0
1/11/2020,Sweden,Perak,0,0,0
1/11/2020,Sweden,Perlis,0,0,0
1/11/2020,Sweden,Pulau Pinang,0,0,0
1/11/2020,Sweden,Sabah,0,0,0
1/11/2020,Sweden,Sarawak,0,0,0
1/11/2020,Sweden,Selangor,24,19,5
1/11/2020,Sweden,W.P. Labuan,0,0,0
1/11/2020,Eswatini,Johor,0,0,0
1/11/2020,Eswatini,Kedah,0,0,0
1/11/2020,Eswatini,Pulau Pinang,0,0,0
1/11/2020,Eswatini,Sabah,0,0,0
1/11/2020,Eswatini,Selangor,1,1,0
1/11/2020,Seychelles,Johor,0,0,0
1/11/2020,Seychelles,Kedah,0,0,0
1/11/2020,Seychelles,Pulau Pinang,0,0,0
1/11/2020,Seychelles,Sabah,0,0,0
1/11/2020,Seychelles,Sarawak,0,0,0
1/11/2020,Seychelles,Selangor,1,0,1
1/11/2020,Syrian Arab Republic,Johor,0,0,0
1/11/2020,Syrian Arab Republic,Kedah,0,0,0
1/11/2020,Syrian Arab Republic,Kelantan,0,0,0
1/11/2020,Syrian Arab Republic,Pahang,0,0,0
1/11/2020,Syrian Arab Republic,Perlis,0,0,0
1/11/2020,Syrian Arab Republic,Pulau Pinang,0,0,0
1/11/2020,Syrian Arab Republic,Sabah,0,0,0
1/11/2020,Syrian Arab Republic,Sarawak,0,0,0
1/11/2020,Syrian Arab Republic,Selangor,8,6,2
1/11/2020,Syrian Arab Republic,W.P. Labuan,0,0,0
1/11/2020,Turks and Caicos Islands,Perlis,0,0,0
1/11/2020,TCD,Johor,0,0,0
1/11/2020,TCD,Kedah,0,0,0
1/11/2020,TCD,Perlis,0,0,0
1/11/2020,TCD,Selangor,0,0,0
1/11/2020,Togo,Johor,0,0,0
1/11/2020,Togo,Perak,0,0,0
1/11/2020,Togo,Pulau Pinang,0,0,0
1/11/2020,Togo,Selangor,0,0,0
1/11/2020,Thailand,Johor,74,74,0
1/11/2020,Thailand,Kedah,10589,9805,784
1/11/2020,Thailand,Kelantan,2,0,2
1/11/2020,Thailand,Melaka,0,0,0
1/11/2020,Thailand,Negeri Sembilan,0,0,0
1/11/2020,Thailand,Pahang,0,0,0
1/11/2020,Thailand,Perak,5,2,3
1/11/2020,Thailand,Perlis,6790,6462,328
1/11/2020,Thailand,Pulau Pinang,0,0,0
1/11/2020,Thailand,Sabah,0,0,0
1/11/2020,Thailand,Sarawak,12,12,0
1/11/2020,Thailand,Selangor,161,75,86
1/11/2020,Thailand,Terengganu,0,0,0
1/11/2020,Thailand,W.P. Labuan,1,0,1
1/11/2020,Tajikistan,Johor,0,0,0
1/11/2020,Tajikistan,Kedah,0,0,0
1/11/2020,Tajikistan,Perlis,0,0,0
1/11/2020,Tajikistan,Pulau Pinang,0,0,0
1/11/2020,Tajikistan,Sabah,0,0,0
1/11/2020,Tajikistan,Selangor,2,2,0
1/11/2020,Tokelau,Selangor,0,0,0
1/11/2020,Turkmenistan,Johor,0,0,0
1/11/2020,Turkmenistan,Kedah,0,0,0
1/11/2020,Turkmenistan,Kelantan,0,0,0
1/11/2020,Turkmenistan,Perlis,0,0,0
1/11/2020,Turkmenistan,Pulau Pinang,0,0,0
1/11/2020,Turkmenistan,Sabah,0,0,0
1/11/2020,Turkmenistan,Sarawak,0,0,0
1/11/2020,Turkmenistan,Selangor,0,0,0
1/11/2020,Timor-Leste,Johor,0,0,0
1/11/2020,Timor-Leste,Kedah,0,0,0
1/11/2020,Timor-Leste,Perlis,0,0,0
1/11/2020,Timor-Leste,Pulau Pinang,0,0,0
1/11/2020,Timor-Leste,Sabah,0,0,0
1/11/2020,Timor-Leste,Sarawak,0,0,0
1/11/2020,Timor-Leste,Selangor,1,0,1
1/11/2020,Tonga,Johor,0,0,0
1/11/2020,Tonga,Pulau Pinang,0,0,0
1/11/2020,Tonga,Sarawak,0,0,0
1/11/2020,Tonga,Selangor,0,0,0
1/11/2020,Trinidad and Tobago,Johor,0,0,0
1/11/2020,Trinidad and Tobago,Kedah,0,0,0
1/11/2020,Trinidad and Tobago,Pahang,0,0,0
1/11/2020,Trinidad and Tobago,Pulau Pinang,0,0,0
1/11/2020,Trinidad and Tobago,Sabah,0,0,0
1/11/2020,Trinidad and Tobago,Sarawak,0,0,0
1/11/2020,Trinidad and Tobago,Selangor,1,1,0
1/11/2020,Tunisia,Johor,0,0,0
1/11/2020,Tunisia,Kedah,0,0,0
1/11/2020,Tunisia,Kelantan,0,0,0
1/11/2020,Tunisia,Melaka,0,0,0
1/11/2020,Tunisia,Perak,0,0,0
1/11/2020,Tunisia,Perlis,0,0,0
1/11/2020,Tunisia,Pulau Pinang,0,0,0
1/11/2020,Tunisia,Sabah,0,0,0
1/11/2020,Tunisia,Sarawak,0,0,0
1/11/2020,Tunisia,Selangor,2,2,0
1/11/2020,Tunisia,W.P. Labuan,0,0,0
1/11/2020,Türkiye,Johor,0,0,0
1/11/2020,Türkiye,Kedah,0,0,0
1/11/2020,Türkiye,Kelantan,0,0,0
1/11/2020,Türkiye,Melaka,0,0,0
1/11/2020,Türkiye,Negeri Sembilan,0,0,0
1/11/2020,Türkiye,Pahang,0,0,0
1/11/2020,Türkiye,Perak,0,0,0
1/11/2020,Türkiye,Perlis,0,0,0
1/11/2020,Türkiye,Pulau Pinang,0,0,0
1/11/2020,Türkiye,Sabah,0,0,0
1/11/2020,Türkiye,Sarawak,0,0,0
1/11/2020,Türkiye,Selangor,16,14,2
1/11/2020,Türkiye,W.P. Labuan,0,0,0
1/11/2020,Tuvalu,Selangor,0,0,0
1/11/2020,"Taiwan, Province of China",Johor,1,1,0
1/11/2020,"Taiwan, Province of China",Kedah,0,0,0
1/11/2020,"Taiwan, Province of China",Kelantan,0,0,0
1/11/2020,"Taiwan, Province of China",Melaka,0,0,0
1/11/2020,"Taiwan, Province of China",Negeri Sembilan,0,0,0
1/11/2020,"Taiwan, Province of China",Pahang,0,0,0
1/11/2020,"Taiwan, Province of China",Perak,0,0,0
1/11/2020,"Taiwan, Province of China",Perlis,0,0,0
1/11/2020,"Taiwan, Province of China",Pulau Pinang,12,7,5
1/11/2020,"Taiwan, Province of China",Sabah,0,0,0
1/11/2020,"Taiwan, Province of China",Sarawak,1,1,0
1/11/2020,"Taiwan, Province of China",Selangor,89,71,18
1/11/2020,"Taiwan, Province of China",W.P. Labuan,0,0,0
1/11/2020,"Tanzania, United Republic of",Johor,0,0,0
1/11/2020,"Tanzania, United Republic of",Kedah,0,0,0
1/11/2020,"Tanzania, United Republic of",Perak,0,0,0
1/11/2020,"Tanzania, United Republic of",Perlis,0,0,0
1/11/2020,"Tanzania, United Republic of",Pulau Pinang,0,0,0
1/11/2020,"Tanzania, United Republic of",Sabah,0,0,0
1/11/2020,"Tanzania, United Republic of",Sarawak,0,0,0
1/11/2020,"Tanzania, United Republic of",Selangor,3,2,1
1/11/2020,Uganda,Johor,0,0,0
1/11/2020,Uganda,Kedah,0,0,0
1/11/2020,Uganda,Perak,0,0,0
1/11/2020,Uganda,Perlis,0,0,0
1/11/2020,Uganda,Pulau Pinang,0,0,0
1/11/2020,Uganda,Sabah,0,0,0
1/11/2020,Uganda,Sarawak,0,0,0
1/11/2020,Uganda,Selangor,1,1,0
1/11/2020,Ukraine,Johor,0,0,0
1/11/2020,Ukraine,Kedah,0,0,0
1/11/2020,Ukraine,Kelantan,0,0,0
1/11/2020,Ukraine,Melaka,0,0,0
1/11/2020,Ukraine,Negeri Sembilan,0,0,0
1/11/2020,Ukraine,Pahang,0,0,0
1/11/2020,Ukraine,Perak,0,0,0
1/11/2020,Ukraine,Perlis,0,0,0
1/11/2020,Ukraine,Pulau Pinang,0,0,0
1/11/2020,Ukraine,Sabah,0,0,0
1/11/2020,Ukraine,Sarawak,0,0,0
1/11/2020,Ukraine,Selangor,47,47,0
1/11/2020,Ukraine,W.P. Labuan,0,0,0
1/11/2020,Uruguay,Johor,0,0,0
1/11/2020,Uruguay,Kedah,0,0,0
1/11/2020,Uruguay,Kelantan,0,0,0
1/11/2020,Uruguay,Perak,0,0,0
1/11/2020,Uruguay,Perlis,0,0,0
1/11/2020,Uruguay,Pulau Pinang,0,0,0
1/11/2020,Uruguay,Sabah,0,0,0
1/11/2020,Uruguay,Sarawak,0,0,0
1/11/2020,Uruguay,Selangor,1,1,0
1/11/2020,Uruguay,W.P. Labuan,0,0,0
1/11/2020,United States of America,Johor,0,0,0
1/11/2020,United States of America,Kedah,0,0,0
1/11/2020,United States of America,Kelantan,0,0,0
1/11/2020,United States of America,Melaka,0,0,0
1/11/2020,United States of America,Negeri Sembilan,0,0,0
1/11/2020,United States of America,Pahang,0,0,0
1/11/2020,United States of America,Perak,0,0,0
1/11/2020,United States of America,Perlis,0,0,0
1/11/2020,United States of America,Pulau Pinang,11,6,5
1/11/2020,United States of America,Sabah,0,0,0
1/11/2020,United States of America,Sarawak,0,0,0
1/11/2020,United States of America,Selangor,105,79,26
1/11/2020,United States of America,Terengganu,0,0,0
1/11/2020,United States of America,W.P. Labuan,0,0,0
1/11/2020,Uzbekistan,Johor,0,0,0
1/11/2020,Uzbekistan,Kedah,0,0,0
1/11/2020,Uzbekistan,Kelantan,0,0,0
1/11/2020,Uzbekistan,Perak,0,0,0
1/11/2020,Uzbekistan,Perlis,0,0,0
1/11/2020,Uzbekistan,Pulau Pinang,0,0,0
1/11/2020,Uzbekistan,Sabah,0,0,0
1/11/2020,Uzbekistan,Sarawak,0,0,0
1/11/2020,Uzbekistan,Selangor,1,0,1
1/11/2020,Holy See,Johor,0,0,0
1/11/2020,Holy See,Sarawak,0,0,0
1/11/2020,Holy See,Selangor,0,0,0
1/11/2020,Saint Vincent and the Grenadines,Johor,0,0,0
1/11/2020,Saint Vincent and the Grenadines,Kedah,0,0,0
1/11/2020,Saint Vincent and the Grenadines,Pulau Pinang,0,0,0
1/11/2020,Saint Vincent and the Grenadines,Sarawak,0,0,0
1/11/2020,Saint Vincent and the Grenadines,Selangor,0,0,0
1/11/2020,"Venezuela, Bolivarian Republic of",Johor,0,0,0
1/11/2020,"Venezuela, Bolivarian Republic of",Kedah,0,0,0
1/11/2020,"Venezuela, Bolivarian Republic of",Kelantan,0,0,0
1/11/2020,"Venezuela, Bolivarian Republic of",Melaka,0,0,0
1/11/2020,"Venezuela, Bolivarian Republic of",Perak,0,0,0
1/11/2020,"Venezuela, Bolivarian Republic of",Perlis,0,0,0
1/11/2020,"Venezuela, Bolivarian Republic of",Pulau Pinang,0,0,0
1/11/2020,"Venezuela, Bolivarian Republic of",Sabah,0,0,0
1/11/2020,"Venezuela, Bolivarian Republic of",Sarawak,0,0,0
1/11/2020,"Venezuela, Bolivarian Republic of",Selangor,0,0,0
1/11/2020,"Venezuela, Bolivarian Republic of",W.P. Labuan,0,0,0
1/11/2020,Viet Nam,Johor,1,0,1
1/11/2020,Viet Nam,Kedah,2,0,2
1/11/2020,Viet Nam,Kelantan,0,0,0
1/11/2020,Viet Nam,Melaka,0,0,0
1/11/2020,Viet Nam,Negeri Sembilan,0,0,0
1/11/2020,Viet Nam,Pahang,0,0,0
1/11/2020,Viet Nam,Perak,0,0,0
1/11/2020,Viet Nam,Perlis,0,0,0
1/11/2020,Viet Nam,Pulau Pinang,0,0,0
1/11/2020,Viet Nam,Sabah,0,0,0
1/11/2020,Viet Nam,Sarawak,0,0,0
1/11/2020,Viet Nam,Selangor,170,44,126
1/11/2020,Viet Nam,Terengganu,0,0,0
1/11/2020,Viet Nam,W.P. Labuan,0,0,0
1/11/2020,Vanuatu,Johor,0,0,0
1/11/2020,Vanuatu,Kedah,0,0,0
1/11/2020,Vanuatu,Pulau Pinang,0,0,0
1/11/2020,Vanuatu,Sabah,0,0,0
1/11/2020,Vanuatu,Sarawak,0,0,0
1/11/2020,Vanuatu,Selangor,0,0,0
1/11/2020, Samoa,Johor,0,0,0
1/11/2020, Samoa,Sarawak,0,0,0
1/11/2020, Samoa,Selangor,0,0,0
1/11/2020,Yemen,Johor,0,0,0
1/11/2020,Yemen,Kedah,0,0,0
1/11/2020,Yemen,Kelantan,0,0,0
1/11/2020,Yemen,Melaka,0,0,0
1/11/2020,Yemen,Pahang,0,0,0
1/11/2020,Yemen,Perak,0,0,0
1/11/2020,Yemen,Perlis,0,0,0
1/11/2020,Yemen,Pulau Pinang,0,0,0
1/11/2020,Yemen,Sabah,0,0,0
1/11/2020,Yemen,Sarawak,0,0,0
1/11/2020,Yemen,Selangor,14,12,2
1/11/2020,Yemen,W.P. Labuan,0,0,0
1/11/2020,South Africa,Johor,1,1,0
1/11/2020,South Africa,Kedah,0,0,0
1/11/2020,South Africa,Kelantan,0,0,0
1/11/2020,South Africa,Melaka,0,0,0
1/11/2020,South Africa,Pahang,0,0,0
1/11/2020,South Africa,Perak,0,0,0
1/11/2020,South Africa,Perlis,0,0,0
1/11/2020,South Africa,Pulau Pinang,0,0,0
1/11/2020,South Africa,Sabah,0,0,0
1/11/2020,South Africa,Sarawak,1,0,1
1/11/2020,South Africa,Selangor,15,14,1
1/11/2020,South Africa,Terengganu,0,0,0
1/11/2020,South Africa,W.P. Labuan,0,0,0
1/11/2020,ZAR,Selangor,0,0,0
1/11/2020,Zambia,Johor,0,0,0
1/11/2020,Zambia,Kedah,0,0,0
1/11/2020,Zambia,Perak,0,0,0
1/11/2020,Zambia,Perlis,0,0,0
1/11/2020,Zambia,Pulau Pinang,0,0,0
1/11/2020,Zambia,Sabah,0,0,0
1/11/2020,Zambia,Sarawak,0,0,0
1/11/2020,Zambia,Selangor,2,2,0
1/11/2020,Zimbabwe,Johor,0,0,0
1/11/2020,Zimbabwe,Kedah,0,0,0
1/11/2020,Zimbabwe,Kelantan,0,0,0
1/11/2020,Zimbabwe,Perak,0,0,0
1/11/2020,Zimbabwe,Perlis,0,0,0
1/11/2020,Zimbabwe,Pulau Pinang,0,0,0
1/11/2020,Zimbabwe,Sabah,0,0,0
1/11/2020,Zimbabwe,Sarawak,0,0,0
1/11/2020,Zimbabwe,Selangor,1,0,1
1/12/2020,Aruba,Kedah,0,0,0
1/12/2020,Aruba,Pulau Pinang,0,0,0
1/12/2020,Afghanistan,Johor,0,0,0
1/12/2020,Afghanistan,Kedah,0,0,0
1/12/2020,Afghanistan,Perlis,0,0,0
1/12/2020,Afghanistan,Pulau Pinang,0,0,0
1/12/2020,Afghanistan,Sarawak,0,0,0
1/12/2020,Afghanistan,Selangor,2,2,0
1/12/2020,Angola,Johor,0,0,0
1/12/2020,Angola,Kedah,0,0,0
1/12/2020,Angola,Sabah,0,0,0
1/12/2020,Angola,Selangor,0,0,0
1/12/2020,Anguilla,Selangor,0,0,0
1/12/2020,Albania,Johor,1,1,0
1/12/2020,Albania,Kedah,0,0,0
1/12/2020,Albania,Perak,0,0,0
1/12/2020,Albania,Perlis,0,0,0
1/12/2020,Albania,Pulau Pinang,0,0,0
1/12/2020,Albania,Sabah,0,0,0
1/12/2020,Albania,Sarawak,0,0,0
1/12/2020,Albania,Selangor,0,0,0
1/12/2020,Andorra,Johor,0,0,0
1/12/2020,Andorra,Kedah,0,0,0
1/12/2020,Andorra,Perlis,0,0,0
1/12/2020,Andorra,Pulau Pinang,0,0,0
1/12/2020,Andorra,Selangor,0,0,0
1/12/2020,Antigua and Barbuda,Selangor,0,0,0
1/12/2020,United Arab Emirates,Johor,0,0,0
1/12/2020,United Arab Emirates,Kedah,0,0,0
1/12/2020,United Arab Emirates,Kelantan,0,0,0
1/12/2020,United Arab Emirates,Perak,0,0,0
1/12/2020,United Arab Emirates,Perlis,0,0,0
1/12/2020,United Arab Emirates,Pulau Pinang,0,0,0
1/12/2020,United Arab Emirates,Sabah,0,0,0
1/12/2020,United Arab Emirates,Sarawak,0,0,0
1/12/2020,United Arab Emirates,Selangor,10,5,5
1/12/2020,Argentina,Johor,0,0,0
1/12/2020,Argentina,Kedah,0,0,0
1/12/2020,Argentina,Kelantan,0,0,0
1/12/2020,Argentina,Melaka,0,0,0
1/12/2020,Argentina,Perak,0,0,0
1/12/2020,Argentina,Perlis,0,0,0
1/12/2020,Argentina,Pulau Pinang,0,0,0
1/12/2020,Argentina,Sabah,0,0,0
1/12/2020,Argentina,Sarawak,0,0,0
1/12/2020,Argentina,Selangor,10,5,5
1/12/2020,Argentina,W.P. Labuan,0,0,0
1/12/2020,Armenia,Johor,0,0,0
1/12/2020,Armenia,Kedah,0,0,0
1/12/2020,Armenia,Kelantan,0,0,0
1/12/2020,Armenia,Perak,0,0,0
1/12/2020,Armenia,Perlis,0,0,0
1/12/2020,Armenia,Pulau Pinang,0,0,0
1/12/2020,Armenia,Sabah,0,0,0
1/12/2020,Armenia,Sarawak,0,0,0
1/12/2020,Armenia,Selangor,0,0,0
1/12/2020,Antarctica,Selangor,0,0,0
1/12/2020,Antigua and Barbuda,Johor,0,0,0
1/12/2020,Antigua and Barbuda,Kedah,0,0,0
1/12/2020,Antigua and Barbuda,Pulau Pinang,0,0,0
1/12/2020,Antigua and Barbuda,Sarawak,0,0,0
1/12/2020,Antigua and Barbuda,Selangor,0,0,0
1/12/2020,Australia,Johor,11,8,3
1/12/2020,Australia,Kedah,0,0,0
1/12/2020,Australia,Kelantan,0,0,0
1/12/2020,Australia,Melaka,0,0,0
1/12/2020,Australia,Negeri Sembilan,0,0,0
1/12/2020,Australia,Pahang,0,0,0
1/12/2020,Australia,Perak,4,2,2
1/12/2020,Australia,Perlis,0,0,0
1/12/2020,Australia,Pulau Pinang,5,2,3
1/12/2020,Australia,Sabah,0,0,0
1/12/2020,Australia,Sarawak,1,1,0
1/12/2020,Australia,Selangor,102,68,34
1/12/2020,Australia,Terengganu,0,0,0
1/12/2020,Australia,W.P. Labuan,0,0,0
1/12/2020,Austria,Johor,0,0,0
1/12/2020,Austria,Kedah,0,0,0
1/12/2020,Austria,Kelantan,0,0,0
1/12/2020,Austria,Melaka,0,0,0
1/12/2020,Austria,Negeri Sembilan,0,0,0
1/12/2020,Austria,Pahang,0,0,0
1/12/2020,Austria,Perak,0,0,0
1/12/2020,Austria,Perlis,0,0,0
1/12/2020,Austria,Pulau Pinang,0,0,0
1/12/2020,Austria,Sabah,0,0,0
1/12/2020,Austria,Sarawak,0,0,0
1/12/2020,Austria,Selangor,5,5,0
1/12/2020,Austria,Terengganu,0,0,0
1/12/2020,Austria,W.P. Labuan,0,0,0
1/12/2020,Azerbaijan,Johor,0,0,0
1/12/2020,Azerbaijan,Kedah,0,0,0
1/12/2020,Azerbaijan,Kelantan,0,0,0
1/12/2020,Azerbaijan,Melaka,0,0,0
1/12/2020,Azerbaijan,Perlis,0,0,0
1/12/2020,Azerbaijan,Pulau Pinang,0,0,0
1/12/2020,Azerbaijan,Sabah,0,0,0
1/12/2020,Azerbaijan,Sarawak,0,0,0
1/12/2020,Azerbaijan,Selangor,1,1,0
1/12/2020,Azerbaijan,W.P. Labuan,0,0,0
1/12/2020,Burundi,Pulau Pinang,0,0,0
1/12/2020,Burundi,Sarawak,0,0,0
1/12/2020,Burundi,Selangor,0,0,0
1/12/2020,Belgium,Johor,1,1,0
1/12/2020,Belgium,Kedah,0,0,0
1/12/2020,Belgium,Kelantan,0,0,0
1/12/2020,Belgium,Melaka,0,0,0
1/12/2020,Belgium,Negeri Sembilan,0,0,0
1/12/2020,Belgium,Pahang,0,0,0
1/12/2020,Belgium,Perak,0,0,0
1/12/2020,Belgium,Perlis,0,0,0
1/12/2020,Belgium,Pulau Pinang,0,0,0
1/12/2020,Belgium,Sabah,0,0,0
1/12/2020,Belgium,Sarawak,0,0,0
1/12/2020,Belgium,Selangor,13,8,5
1/12/2020,Belgium,W.P. Labuan,0,0,0
1/12/2020,Benin,Johor,0,0,0
1/12/2020,Benin,Kedah,0,0,0
1/12/2020,Benin,Perak,0,0,0
1/12/2020,Benin,Pulau Pinang,0,0,0
1/12/2020,Benin,Sabah,0,0,0
1/12/2020,Benin,Sarawak,0,0,0
1/12/2020,Benin,Selangor,1,0,1
1/12/2020,Burkina Faso,Perak,0,0,0
1/12/2020,Burkina Faso,Pulau Pinang,0,0,0
1/12/2020,Burkina Faso,Selangor,0,0,0
1/12/2020,Bangladesh,Johor,2,2,0
1/12/2020,Bangladesh,Kedah,0,0,0
1/12/2020,Bangladesh,Kelantan,0,0,0
1/12/2020,Bangladesh,Melaka,0,0,0
1/12/2020,Bangladesh,Negeri Sembilan,0,0,0
1/12/2020,Bangladesh,Pahang,0,0,0
1/12/2020,Bangladesh,Perak,0,0,0
1/12/2020,Bangladesh,Perlis,0,0,0
1/12/2020,Bangladesh,Pulau Pinang,0,0,0
1/12/2020,Bangladesh,Sabah,0,0,0
1/12/2020,Bangladesh,Sarawak,0,0,0
1/12/2020,Bangladesh,Selangor,58,44,14
1/12/2020,Bangladesh,W.P. Labuan,0,0,0
1/12/2020,Bulgaria,Johor,0,0,0
1/12/2020,Bulgaria,Kedah,0,0,0
1/12/2020,Bulgaria,Kelantan,0,0,0
1/12/2020,Bulgaria,Pahang,0,0,0
1/12/2020,Bulgaria,Perak,0,0,0
1/12/2020,Bulgaria,Perlis,0,0,0
1/12/2020,Bulgaria,Pulau Pinang,0,0,0
1/12/2020,Bulgaria,Sabah,0,0,0
1/12/2020,Bulgaria,Sarawak,0,0,0
1/12/2020,Bulgaria,Selangor,5,5,0
1/12/2020,Bulgaria,W.P. Labuan,0,0,0
1/12/2020,Bahrain,Johor,0,0,0
1/12/2020,Bahrain,Kedah,0,0,0
1/12/2020,Bahrain,Kelantan,0,0,0
1/12/2020,Bahrain,Perlis,0,0,0
1/12/2020,Bahrain,Pulau Pinang,0,0,0
1/12/2020,Bahrain,Sabah,0,0,0
1/12/2020,Bahrain,Sarawak,0,0,0
1/12/2020,Bahrain,Selangor,2,1,1
1/12/2020,Bahamas,Johor,0,0,0
1/12/2020,Bahamas,Kedah,0,0,0
1/12/2020,Bahamas,Perak,0,0,0
1/12/2020,Bahamas,Sabah,0,0,0
1/12/2020,Bahamas,Sarawak,0,0,0
1/12/2020,Bahamas,Selangor,0,0,0
1/12/2020,Bosnia and Herzegovina,Johor,0,0,0
1/12/2020,Bosnia and Herzegovina,Kedah,0,0,0
1/12/2020,Bosnia and Herzegovina,Perlis,0,0,0
1/12/2020,Bosnia and Herzegovina,Pulau Pinang,0,0,0
1/12/2020,Bosnia and Herzegovina,Sabah,0,0,0
1/12/2020,Bosnia and Herzegovina,Sarawak,0,0,0
1/12/2020,Bosnia and Herzegovina,Selangor,1,1,0
1/12/2020,Belarus,Johor,0,0,0
1/12/2020,Belarus,Kedah,0,0,0
1/12/2020,Belarus,Kelantan,0,0,0
1/12/2020,Belarus,Pahang,0,0,0
1/12/2020,Belarus,Perak,0,0,0
1/12/2020,Belarus,Perlis,0,0,0
1/12/2020,Belarus,Pulau Pinang,0,0,0
1/12/2020,Belarus,Sabah,0,0,0
1/12/2020,Belarus,Sarawak,0,0,0
1/12/2020,Belarus,Selangor,0,0,0
1/12/2020,Belarus,W.P. Labuan,0,0,0
1/12/2020,Belize,Johor,0,0,0
1/12/2020,Belize,Pulau Pinang,0,0,0
1/12/2020,Belize,Sarawak,0,0,0
1/12/2020,Belize,Selangor,0,0,0
1/12/2020,Bermuda,Selangor,0,0,0
1/12/2020,Bolivia,Johor,0,0,0
1/12/2020,Bolivia,Kedah,0,0,0
1/12/2020,Bolivia,Melaka,0,0,0
1/12/2020,Bolivia,Perak,0,0,0
1/12/2020,Bolivia,Perlis,0,0,0
1/12/2020,Bolivia,Pulau Pinang,0,0,0
1/12/2020,Bolivia,Sabah,0,0,0
1/12/2020,Bolivia,Sarawak,0,0,0
1/12/2020,Bolivia,Selangor,0,0,0
1/12/2020,Brazil,Johor,0,0,0
1/12/2020,Brazil,Kedah,0,0,0
1/12/2020,Brazil,Kelantan,0,0,0
1/12/2020,Brazil,Melaka,0,0,0
1/12/2020,Brazil,Pahang,0,0,0
1/12/2020,Brazil,Perak,0,0,0
1/12/2020,Brazil,Perlis,0,0,0
1/12/2020,Brazil,Pulau Pinang,1,0,1
1/12/2020,Brazil,Sabah,0,0,0
1/12/2020,Brazil,Sarawak,0,0,0
1/12/2020,Brazil,Selangor,12,9,3
1/12/2020,Brazil,W.P. Labuan,0,0,0
1/12/2020,Barbados,Johor,0,0,0
1/12/2020,Barbados,Kedah,0,0,0
1/12/2020,Barbados,Perlis,0,0,0
1/12/2020,Barbados,Pulau Pinang,0,0,0
1/12/2020,Barbados,Selangor,0,0,0
1/12/2020,Brunei Darussalam,Johor,0,0,0
1/12/2020,Brunei Darussalam,Kedah,0,0,0
1/12/2020,Brunei Darussalam,Kelantan,0,0,0
1/12/2020,Brunei Darussalam,Melaka,0,0,0
1/12/2020,Brunei Darussalam,Pahang,0,0,0
1/12/2020,Brunei Darussalam,Perak,0,0,0
1/12/2020,Brunei Darussalam,Perlis,0,0,0
1/12/2020,Brunei Darussalam,Pulau Pinang,0,0,0
1/12/2020,Brunei Darussalam,Sabah,0,0,0
1/12/2020,Brunei Darussalam,Sarawak,367,360,7
1/12/2020,Brunei Darussalam,Selangor,19,10,9
1/12/2020,Brunei Darussalam,W.P. Labuan,0,0,0
1/12/2020,Bhutan,Johor,0,0,0
1/12/2020,Bhutan,Kedah,0,0,0
1/12/2020,Bhutan,Perak,0,0,0
1/12/2020,Bhutan,Perlis,0,0,0
1/12/2020,Bhutan,Pulau Pinang,0,0,0
1/12/2020,Bhutan,Sabah,0,0,0
1/12/2020,Bhutan,Sarawak,0,0,0
1/12/2020,Bhutan,Selangor,0,0,0
1/12/2020,Botswana,Johor,0,0,0
1/12/2020,Botswana,Kedah,0,0,0
1/12/2020,Botswana,Perlis,0,0,0
1/12/2020,Botswana,Pulau Pinang,0,0,0
1/12/2020,Botswana,Sabah,0,0,0
1/12/2020,Botswana,Sarawak,0,0,0
1/12/2020,Botswana,Selangor,0,0,0
1/12/2020,Central African Republic,Kedah,0,0,0
1/12/2020,Central African Republic,Selangor,0,0,0
1/12/2020,Canada,Johor,0,0,0
1/12/2020,Canada,Kedah,0,0,0
1/12/2020,Canada,Kelantan,0,0,0
1/12/2020,Canada,Melaka,0,0,0
1/12/2020,Canada,Negeri Sembilan,0,0,0
1/12/2020,Canada,Pahang,0,0,0
1/12/2020,Canada,Perak,0,0,0
1/12/2020,Canada,Perlis,0,0,0
1/12/2020,Canada,Pulau Pinang,1,1,0
1/12/2020,Canada,Sabah,0,0,0
1/12/2020,Canada,Sarawak,1,1,0
1/12/2020,Canada,Selangor,33,21,12
1/12/2020,Canada,Terengganu,0,0,0
1/12/2020,Canada,W.P. Labuan,0,0,0
1/12/2020,Cocos (Keeling) Islands,Selangor,0,0,0
1/12/2020,Switzerland,Johor,0,0,0
1/12/2020,Switzerland,Kedah,0,0,0
1/12/2020,Switzerland,Kelantan,0,0,0
1/12/2020,Switzerland,Melaka,0,0,0
1/12/2020,Switzerland,Negeri Sembilan,0,0,0
1/12/2020,Switzerland,Pahang,0,0,0
1/12/2020,Switzerland,Perak,0,0,0
1/12/2020,Switzerland,Perlis,0,0,0
1/12/2020,Switzerland,Pulau Pinang,0,0,0
1/12/2020,Switzerland,Sabah,0,0,0
1/12/2020,Switzerland,Sarawak,0,0,0
1/12/2020,Switzerland,Selangor,7,4,3
1/12/2020,Switzerland,W.P. Labuan,0,0,0
1/12/2020,Chile,Johor,0,0,0
1/12/2020,Chile,Kedah,0,0,0
1/12/2020,Chile,Kelantan,0,0,0
1/12/2020,Chile,Melaka,0,0,0
1/12/2020,Chile,Pahang,0,0,0
1/12/2020,Chile,Perak,0,0,0
1/12/2020,Chile,Perlis,0,0,0
1/12/2020,Chile,Pulau Pinang,0,0,0
1/12/2020,Chile,Sabah,0,0,0
1/12/2020,Chile,Sarawak,0,0,0
1/12/2020,Chile,Selangor,1,1,0
1/12/2020,China,Johor,46,40,6
1/12/2020,China,Kedah,0,0,0
1/12/2020,China,Kelantan,0,0,0
1/12/2020,China,Melaka,0,0,0
1/12/2020,China,Pahang,0,0,0
1/12/2020,China,Perak,0,0,0
1/12/2020,China,Perlis,0,0,0
1/12/2020,China,Pulau Pinang,2,2,0
1/12/2020,China,Sabah,5,5,0
1/12/2020,China,Sarawak,106,105,1
1/12/2020,China,Selangor,875,695,180
1/12/2020,China,Terengganu,0,0,0
1/12/2020,China,W.P. Labuan,0,0,0
1/12/2020,Côte d'Ivoire,Johor,0,0,0
1/12/2020,Côte d'Ivoire,Kedah,0,0,0
1/12/2020,Côte d'Ivoire,Pulau Pinang,0,0,0
1/12/2020,Côte d'Ivoire,Sabah,0,0,0
1/12/2020,Côte d'Ivoire,Sarawak,0,0,0
1/12/2020,Côte d'Ivoire,Selangor,2,2,0
1/12/2020,Cameroon,Johor,0,0,0
1/12/2020,Cameroon,Kedah,0,0,0
1/12/2020,Cameroon,Pulau Pinang,0,0,0
1/12/2020,Cameroon,Sabah,0,0,0
1/12/2020,Cameroon,Sarawak,0,0,0
1/12/2020,Cameroon,Selangor,0,0,0
1/12/2020,Congo,Johor,0,0,0
1/12/2020,Congo,Pulau Pinang,0,0,0
1/12/2020,Congo,Sarawak,0,0,0
1/12/2020,Congo,Selangor,0,0,0
1/12/2020,Congo,Johor,0,0,0
1/12/2020,Congo,Kedah,0,0,0
1/12/2020,Congo,Selangor,0,0,0
1/12/2020,Cook Islands,Selangor,0,0,0
1/12/2020,Colombia,Johor,0,0,0
1/12/2020,Colombia,Kedah,0,0,0
1/12/2020,Colombia,Perak,0,0,0
1/12/2020,Colombia,Pulau Pinang,0,0,0
1/12/2020,Colombia,Sabah,0,0,0
1/12/2020,Colombia,Sarawak,0,0,0
1/12/2020,Colombia,Selangor,4,2,2
1/12/2020,Colombia,W.P. Labuan,0,0,0
1/12/2020,Comoros,Johor,0,0,0
1/12/2020,Comoros,Kedah,0,0,0
1/12/2020,Comoros,Selangor,0,0,0
1/12/2020,Cabo Verde,Johor,0,0,0
1/12/2020,Cabo Verde,Kedah,0,0,0
1/12/2020,Cabo Verde,Pulau Pinang,0,0,0
1/12/2020,Cabo Verde,Sabah,0,0,0
1/12/2020,Cabo Verde,Selangor,0,0,0
1/12/2020,Costa Rica,Johor,0,0,0
1/12/2020,Costa Rica,Kedah,0,0,0
1/12/2020,Costa Rica,Perak,0,0,0
1/12/2020,Costa Rica,Perlis,0,0,0
1/12/2020,Costa Rica,Pulau Pinang,0,0,0
1/12/2020,Costa Rica,Sabah,0,0,0
1/12/2020,Costa Rica,Sarawak,0,0,0
1/12/2020,Costa Rica,Selangor,1,1,0
1/12/2020,Cuba,Johor,0,0,0
1/12/2020,Cuba,Kedah,0,0,0
1/12/2020,Cuba,Perlis,0,0,0
1/12/2020,Cuba,Pulau Pinang,0,0,0
1/12/2020,Cuba,Sabah,0,0,0
1/12/2020,Cuba,Sarawak,0,0,0
1/12/2020,Cuba,Selangor,0,0,0
1/12/2020,Cyprus,Johor,0,0,0
1/12/2020,Cyprus,Kedah,0,0,0
1/12/2020,Cyprus,Perak,0,0,0
1/12/2020,Cyprus,Perlis,0,0,0
1/12/2020,Cyprus,Pulau Pinang,0,0,0
1/12/2020,Cyprus,Sabah,0,0,0
1/12/2020,Cyprus,Sarawak,0,0,0
1/12/2020,Cyprus,Selangor,0,0,0
1/12/2020,Czechia,Johor,0,0,0
1/12/2020,Czechia,Kedah,0,0,0
1/12/2020,Czechia,Kelantan,0,0,0
1/12/2020,Czechia,Melaka,0,0,0
1/12/2020,Czechia,Negeri Sembilan,0,0,0
1/12/2020,Czechia,Perak,0,0,0
1/12/2020,Czechia,Perlis,0,0,0
1/12/2020,Czechia,Pulau Pinang,0,0,0
1/12/2020,Czechia,Sabah,0,0,0
1/12/2020,Czechia,Sarawak,0,0,0
1/12/2020,Czechia,Selangor,4,3,1
1/12/2020,Czechia,W.P. Labuan,0,0,0
1/12/2020,Germany,Johor,1,1,0
1/12/2020,Germany,Kedah,0,0,0
1/12/2020,Germany,Kelantan,0,0,0
1/12/2020,Germany,Melaka,0,0,0
1/12/2020,Germany,Negeri Sembilan,0,0,0
1/12/2020,Germany,Pahang,0,0,0
1/12/2020,Germany,Perak,0,0,0
1/12/2020,Germany,Perlis,0,0,0
1/12/2020,Germany,Pulau Pinang,0,0,0
1/12/2020,Germany,Sabah,0,0,0
1/12/2020,Germany,Sarawak,0,0,0
1/12/2020,Germany,Selangor,34,25,9
1/12/2020,Germany,Terengganu,0,0,0
1/12/2020,Germany,W.P. Labuan,0,0,0
1/12/2020,Djibouti,Johor,0,0,0
1/12/2020,Djibouti,Selangor,0,0,0
1/12/2020,Dominica,Johor,0,0,0
1/12/2020,Dominica,Kedah,0,0,0
1/12/2020,Dominica,Pulau Pinang,0,0,0
1/12/2020,Dominica,Sabah,0,0,0
1/12/2020,Dominica,Sarawak,0,0,0
1/12/2020,Dominica,Selangor,0,0,0
1/12/2020,Dominica,W.P. Labuan,0,0,0
1/12/2020,Denmark,Johor,1,1,0
1/12/2020,Denmark,Kedah,0,0,0
1/12/2020,Denmark,Kelantan,0,0,0
1/12/2020,Denmark,Melaka,0,0,0
1/12/2020,Denmark,Negeri Sembilan,0,0,0
1/12/2020,Denmark,Pahang,0,0,0
1/12/2020,Denmark,Perak,0,0,0
1/12/2020,Denmark,Perlis,0,0,0
1/12/2020,Denmark,Pulau Pinang,0,0,0
1/12/2020,Denmark,Sabah,0,0,0
1/12/2020,Denmark,Sarawak,0,0,0
1/12/2020,Denmark,Selangor,11,5,6
1/12/2020,Denmark,W.P. Labuan,0,0,0
1/12/2020,Dominican Republic,Johor,0,0,0
1/12/2020,Dominican Republic,Kedah,0,0,0
1/12/2020,Dominican Republic,Perak,0,0,0
1/12/2020,Dominican Republic,Perlis,0,0,0
1/12/2020,Dominican Republic,Pulau Pinang,0,0,0
1/12/2020,Dominican Republic,Sabah,0,0,0
1/12/2020,Dominican Republic,Sarawak,0,0,0
1/12/2020,Dominican Republic,Selangor,0,0,0
1/12/2020,Algeria,Johor,0,0,0
1/12/2020,Algeria,Kedah,0,0,0
1/12/2020,Algeria,Kelantan,0,0,0
1/12/2020,Algeria,Melaka,0,0,0
1/12/2020,Algeria,Perak,0,0,0
1/12/2020,Algeria,Perlis,0,0,0
1/12/2020,Algeria,Pulau Pinang,0,0,0
1/12/2020,Algeria,Sabah,0,0,0
1/12/2020,Algeria,Sarawak,0,0,0
1/12/2020,Algeria,Selangor,9,7,2
1/12/2020,Algeria,W.P. Labuan,0,0,0
1/12/2020,Ecuador,Johor,0,0,0
1/12/2020,Ecuador,Kedah,0,0,0
1/12/2020,Ecuador,Perak,0,0,0
1/12/2020,Ecuador,Perlis,0,0,0
1/12/2020,Ecuador,Pulau Pinang,0,0,0
1/12/2020,Ecuador,Sabah,0,0,0
1/12/2020,Ecuador,Sarawak,0,0,0
1/12/2020,Ecuador,Selangor,1,1,0
1/12/2020,Egypt,Johor,0,0,0
1/12/2020,Egypt,Kedah,0,0,0
1/12/2020,Egypt,Kelantan,0,0,0
1/12/2020,Egypt,Melaka,0,0,0
1/12/2020,Egypt,Pahang,0,0,0
1/12/2020,Egypt,Perak,0,0,0
1/12/2020,Egypt,Perlis,0,0,0
1/12/2020,Egypt,Pulau Pinang,0,0,0
1/12/2020,Egypt,Sabah,0,0,0
1/12/2020,Egypt,Sarawak,0,0,0
1/12/2020,Egypt,Selangor,50,39,11
1/12/2020,Egypt,Terengganu,0,0,0
1/12/2020,Egypt,W.P. Labuan,0,0,0
1/12/2020,Eritrea,Johor,0,0,0
1/12/2020,Eritrea,Pulau Pinang,0,0,0
1/12/2020,Eritrea,Sabah,0,0,0
1/12/2020,Eritrea,Selangor,0,0,0
1/12/2020,Spain,Johor,0,0,0
1/12/2020,Spain,Kedah,0,0,0
1/12/2020,Spain,Kelantan,0,0,0
1/12/2020,Spain,Melaka,0,0,0
1/12/2020,Spain,Negeri Sembilan,0,0,0
1/12/2020,Spain,Pahang,0,0,0
1/12/2020,Spain,Perak,0,0,0
1/12/2020,Spain,Perlis,0,0,0
1/12/2020,Spain,Pulau Pinang,0,0,0
1/12/2020,Spain,Sabah,0,0,0
1/12/2020,Spain,Sarawak,0,0,0
1/12/2020,Spain,Selangor,28,17,11
1/12/2020,Spain,W.P. Labuan,0,0,0
1/12/2020,Estonia,Johor,0,0,0
1/12/2020,Estonia,Kedah,0,0,0
1/12/2020,Estonia,Kelantan,0,0,0
1/12/2020,Estonia,Pahang,0,0,0
1/12/2020,Estonia,Perak,0,0,0
1/12/2020,Estonia,Perlis,0,0,0
1/12/2020,Estonia,Pulau Pinang,0,0,0
1/12/2020,Estonia,Sabah,0,0,0
1/12/2020,Estonia,Sarawak,0,0,0
1/12/2020,Estonia,Selangor,1,1,0
1/12/2020,Estonia,W.P. Labuan,0,0,0
1/12/2020,Ethiopia,Johor,0,0,0
1/12/2020,Ethiopia,Kedah,0,0,0
1/12/2020,Ethiopia,Pulau Pinang,0,0,0
1/12/2020,Ethiopia,Sarawak,0,0,0
1/12/2020,Ethiopia,Selangor,3,3,0
1/12/2020,Finland,Johor,1,1,0
1/12/2020,Finland,Kedah,0,0,0
1/12/2020,Finland,Kelantan,0,0,0
1/12/2020,Finland,Melaka,0,0,0
1/12/2020,Finland,Negeri Sembilan,0,0,0
1/12/2020,Finland,Pahang,0,0,0
1/12/2020,Finland,Perak,0,0,0
1/12/2020,Finland,Perlis,0,0,0
1/12/2020,Finland,Pulau Pinang,0,0,0
1/12/2020,Finland,Sabah,0,0,0
1/12/2020,Finland,Sarawak,0,0,0
1/12/2020,Finland,Selangor,7,6,1
1/12/2020,Finland,W.P. Labuan,0,0,0
1/12/2020,Fiji,Johor,0,0,0
1/12/2020,Fiji,Kedah,0,0,0
1/12/2020,Fiji,Kelantan,0,0,0
1/12/2020,Fiji,Perak,0,0,0
1/12/2020,Fiji,Perlis,0,0,0
1/12/2020,Fiji,Pulau Pinang,0,0,0
1/12/2020,Fiji,Sabah,0,0,0
1/12/2020,Fiji,Sarawak,0,0,0
1/12/2020,Fiji,Selangor,5,3,2
1/12/2020,France,Johor,1,0,1
1/12/2020,France,Kedah,0,0,0
1/12/2020,France,Kelantan,0,0,0
1/12/2020,France,Melaka,0,0,0
1/12/2020,France,Negeri Sembilan,0,0,0
1/12/2020,France,Pahang,0,0,0
1/12/2020,France,Perak,0,0,0
1/12/2020,France,Perlis,0,0,0
1/12/2020,France,Pulau Pinang,4,1,3
1/12/2020,France,Sabah,0,0,0
1/12/2020,France,Sarawak,0,0,0
1/12/2020,France,Selangor,53,37,16
1/12/2020,France,Terengganu,0,0,0
1/12/2020,France,W.P. Labuan,0,0,0
1/12/2020,"Micronesia, Federated States of",Johor,0,0,0
1/12/2020,"Micronesia, Federated States of",Pulau Pinang,0,0,0
1/12/2020,"Micronesia, Federated States of",Selangor,0,0,0
1/12/2020,Gabon,Johor,0,0,0
1/12/2020,Gabon,Pulau Pinang,0,0,0
1/12/2020,Gabon,Sarawak,0,0,0
1/12/2020,Gabon,Selangor,0,0,0
1/12/2020,United Kingdom of Great Britain and Northern Ireland,Johor,2,2,0
1/12/2020,United Kingdom of Great Britain and Northern Ireland,Kedah,0,0,0
1/12/2020,United Kingdom of Great Britain and Northern Ireland,Kelantan,0,0,0
1/12/2020,United Kingdom of Great Britain and Northern Ireland,Melaka,0,0,0
1/12/2020,United Kingdom of Great Britain and Northern Ireland,Negeri Sembilan,0,0,0
1/12/2020,United Kingdom of Great Britain and Northern Ireland,Pahang,0,0,0
1/12/2020,United Kingdom of Great Britain and Northern Ireland,Perak,0,0,0
1/12/2020,United Kingdom of Great Britain and Northern Ireland,Perlis,0,0,0
1/12/2020,United Kingdom of Great Britain and Northern Ireland,Pulau Pinang,1,1,0
1/12/2020,United Kingdom of Great Britain and Northern Ireland,Sabah,1,1,0
1/12/2020,United Kingdom of Great Britain and Northern Ireland,Sarawak,1,1,0
1/12/2020,United Kingdom of Great Britain and Northern Ireland,Selangor,185,135,50
1/12/2020,United Kingdom of Great Britain and Northern Ireland,Terengganu,0,0,0
1/12/2020,United Kingdom of Great Britain and Northern Ireland,W.P. Labuan,0,0,0
1/12/2020,Georgia,Johor,2,2,0
1/12/2020,Georgia,Kedah,0,0,0
1/12/2020,Georgia,Melaka,0,0,0
1/12/2020,Georgia,Perak,0,0,0
1/12/2020,Georgia,Perlis,0,0,0
1/12/2020,Georgia,Pulau Pinang,0,0,0
1/12/2020,Georgia,Sabah,0,0,0
1/12/2020,Georgia,Sarawak,0,0,0
1/12/2020,Georgia,Selangor,3,3,0
1/12/2020,Ghana,Johor,0,0,0
1/12/2020,Ghana,Kedah,0,0,0
1/12/2020,Ghana,Kelantan,0,0,0
1/12/2020,Ghana,Pulau Pinang,0,0,0
1/12/2020,Ghana,Sabah,0,0,0
1/12/2020,Ghana,Sarawak,0,0,0
1/12/2020,Ghana,Selangor,6,5,1
1/12/2020,Gibraltar,Johor,0,0,0
1/12/2020,Gibraltar,Sarawak,0,0,0
1/12/2020,Guinea,Johor,0,0,0
1/12/2020,Guinea,Kedah,0,0,0
1/12/2020,Guinea,Kelantan,0,0,0
1/12/2020,Guinea,Perlis,0,0,0
1/12/2020,Guinea,Pulau Pinang,0,0,0
1/12/2020,Guinea,Sabah,0,0,0
1/12/2020,Guinea,Sarawak,0,0,0
1/12/2020,Guinea,Selangor,1,0,1
1/12/2020,Guadeloupe,Selangor,0,0,0
1/12/2020,Gambia,Johor,0,0,0
1/12/2020,Gambia,Kedah,0,0,0
1/12/2020,Gambia,Kelantan,0,0,0
1/12/2020,Gambia,Pulau Pinang,0,0,0
1/12/2020,Gambia,Sabah,0,0,0
1/12/2020,Gambia,Sarawak,0,0,0
1/12/2020,Gambia,Selangor,1,0,1
1/12/2020,Guinea-Bissau,Johor,0,0,0
1/12/2020,Guinea-Bissau,Selangor,0,0,0
1/12/2020,Equatorial Guinea,Johor,0,0,0
1/12/2020,Equatorial Guinea,Selangor,1,0,1
1/12/2020,Greece,Johor,2,2,0
1/12/2020,Greece,Kedah,0,0,0
1/12/2020,Greece,Kelantan,0,0,0
1/12/2020,Greece,Melaka,0,0,0
1/12/2020,Greece,Negeri Sembilan,0,0,0
1/12/2020,Greece,Pahang,0,0,0
1/12/2020,Greece,Perak,0,0,0
1/12/2020,Greece,Perlis,0,0,0
1/12/2020,Greece,Pulau Pinang,0,0,0
1/12/2020,Greece,Sabah,0,0,0
1/12/2020,Greece,Sarawak,0,0,0
1/12/2020,Greece,Selangor,4,4,0
1/12/2020,Grenada,Johor,0,0,0
1/12/2020,Grenada,Kedah,0,0,0
1/12/2020,Grenada,Pulau Pinang,0,0,0
1/12/2020,Grenada,Sabah,0,0,0
1/12/2020,Grenada,Sarawak,0,0,0
1/12/2020,Grenada,Selangor,0,0,0
1/12/2020,Greenland,Johor,0,0,0
1/12/2020,Greenland,Selangor,0,0,0
1/12/2020,Guatemala,Johor,0,0,0
1/12/2020,Guatemala,Kedah,0,0,0
1/12/2020,Guatemala,Pahang,0,0,0
1/12/2020,Guatemala,Perak,0,0,0
1/12/2020,Guatemala,Pulau Pinang,0,0,0
1/12/2020,Guatemala,Sabah,0,0,0
1/12/2020,Guatemala,Sarawak,0,0,0
1/12/2020,Guatemala,Selangor,0,0,0
1/12/2020,Guatemala,W.P. Labuan,0,0,0
1/12/2020,Guyana,Johor,0,0,0
1/12/2020,Guyana,Kedah,0,0,0
1/12/2020,Guyana,Pulau Pinang,0,0,0
1/12/2020,Guyana,Sarawak,0,0,0
1/12/2020,Guyana,Selangor,0,0,0
1/12/2020,Hong Kong,Johor,0,0,0
1/12/2020,Hong Kong,Kedah,0,0,0
1/12/2020,Hong Kong,Kelantan,0,0,0
1/12/2020,Hong Kong,Pahang,0,0,0
1/12/2020,Hong Kong,Perak,0,0,0
1/12/2020,Hong Kong,Perlis,0,0,0
1/12/2020,Hong Kong,Pulau Pinang,3,1,2
1/12/2020,Hong Kong,Sabah,0,0,0
1/12/2020,Hong Kong,Sarawak,0,0,0
1/12/2020,Hong Kong,Selangor,11,9,2
1/12/2020,Hong Kong,Terengganu,0,0,0
1/12/2020,Heard Island and McDonald Islands,Johor,0,0,0
1/12/2020,Honduras,Johor,0,0,0
1/12/2020,Honduras,Kedah,0,0,0
1/12/2020,Honduras,Perak,0,0,0
1/12/2020,Honduras,Pulau Pinang,0,0,0
1/12/2020,Honduras,Sabah,0,0,0
1/12/2020,Honduras,Sarawak,0,0,0
1/12/2020,Honduras,Selangor,5,5,0
1/12/2020,Croatia,Johor,3,3,0
1/12/2020,Croatia,Kedah,0,0,0
1/12/2020,Croatia,Kelantan,0,0,0
1/12/2020,Croatia,Melaka,0,0,0
1/12/2020,Croatia,Pahang,0,0,0
1/12/2020,Croatia,Perak,0,0,0
1/12/2020,Croatia,Perlis,0,0,0
1/12/2020,Croatia,Pulau Pinang,0,0,0
1/12/2020,Croatia,Sabah,0,0,0
1/12/2020,Croatia,Sarawak,0,0,0
1/12/2020,Croatia,Selangor,15,15,0
1/12/2020,Haiti,Johor,0,0,0
1/12/2020,Haiti,Kedah,0,0,0
1/12/2020,Haiti,Kelantan,0,0,0
1/12/2020,Haiti,Perak,0,0,0
1/12/2020,Haiti,Pulau Pinang,0,0,0
1/12/2020,Haiti,Sabah,0,0,0
1/12/2020,Haiti,Selangor,0,0,0
1/12/2020,Hungary,Johor,0,0,0
1/12/2020,Hungary,Kedah,0,0,0
1/12/2020,Hungary,Kelantan,0,0,0
1/12/2020,Hungary,Pahang,0,0,0
1/12/2020,Hungary,Perak,0,0,0
1/12/2020,Hungary,Perlis,0,0,0
1/12/2020,Hungary,Pulau Pinang,0,0,0
1/12/2020,Hungary,Sabah,0,0,0
1/12/2020,Hungary,Sarawak,0,0,0
1/12/2020,Hungary,Selangor,1,1,0
1/12/2020,Hungary,W.P. Labuan,0,0,0
1/12/2020,Indonesia,Johor,250,206,44
1/12/2020,Indonesia,Kedah,3,3,0
1/12/2020,Indonesia,Kelantan,0,0,0
1/12/2020,Indonesia,Melaka,0,0,0
1/12/2020,Indonesia,Negeri Sembilan,0,0,0
1/12/2020,Indonesia,Pahang,1,1,0
1/12/2020,Indonesia,Perak,0,0,0
1/12/2020,Indonesia,Perlis,8,6,2
1/12/2020,Indonesia,Pulau Pinang,4,1,3
1/12/2020,Indonesia,Sabah,2,0,2
1/12/2020,Indonesia,Sarawak,286,277,9
1/12/2020,Indonesia,Selangor,479,312,167
1/12/2020,Indonesia,Terengganu,0,0,0
1/12/2020,Indonesia,W.P. Labuan,3,3,0
1/12/2020,India,Johor,16,16,0
1/12/2020,India,Kedah,0,0,0
1/12/2020,India,Kelantan,0,0,0
1/12/2020,India,Melaka,0,0,0
1/12/2020,India,Negeri Sembilan,0,0,0
1/12/2020,India,Pahang,0,0,0
1/12/2020,India,Perak,0,0,0
1/12/2020,India,Perlis,0,0,0
1/12/2020,India,Pulau Pinang,3,2,1
1/12/2020,India,Sabah,0,0,0
1/12/2020,India,Sarawak,0,0,0
1/12/2020,India,Selangor,470,376,94
1/12/2020,India,Terengganu,0,0,0
1/12/2020,India,W.P. Labuan,1,1,0
1/12/2020, British Indian Ocean Territory,Pulau Pinang,0,0,0
1/12/2020, British Indian Ocean Territory,Selangor,0,0,0
1/12/2020,Ireland,Johor,1,1,0
1/12/2020,Ireland,Kedah,0,0,0
1/12/2020,Ireland,Kelantan,0,0,0
1/12/2020,Ireland,Negeri Sembilan,0,0,0
1/12/2020,Ireland,Pahang,0,0,0
1/12/2020,Ireland,Perak,0,0,0
1/12/2020,Ireland,Perlis,0,0,0
1/12/2020,Ireland,Pulau Pinang,0,0,0
1/12/2020,Ireland,Sabah,0,0,0
1/12/2020,Ireland,Sarawak,0,0,0
1/12/2020,Ireland,Selangor,11,9,2
1/12/2020,Ireland,Terengganu,0,0,0
1/12/2020,Ireland,W.P. Labuan,0,0,0
1/12/2020,"Iran, Islamic Republic of",Johor,0,0,0
1/12/2020,"Iran, Islamic Republic of",Kedah,0,0,0
1/12/2020,"Iran, Islamic Republic of",Kelantan,0,0,0
1/12/2020,"Iran, Islamic Republic of",Perak,0,0,0
1/12/2020,"Iran, Islamic Republic of",Perlis,0,0,0
1/12/2020,"Iran, Islamic Republic of",Pulau Pinang,0,0,0
1/12/2020,"Iran, Islamic Republic of",Sabah,0,0,0
1/12/2020,"Iran, Islamic Republic of",Sarawak,0,0,0
1/12/2020,"Iran, Islamic Republic of",Selangor,12,6,6
1/12/2020,"Iran, Islamic Republic of",W.P. Labuan,0,0,0
1/12/2020,Iraq,Johor,0,0,0
1/12/2020,Iraq,Kedah,0,0,0
1/12/2020,Iraq,Kelantan,0,0,0
1/12/2020,Iraq,Melaka,0,0,0
1/12/2020,Iraq,Pahang,0,0,0
1/12/2020,Iraq,Perak,0,0,0
1/12/2020,Iraq,Perlis,0,0,0
1/12/2020,Iraq,Pulau Pinang,0,0,0
1/12/2020,Iraq,Sabah,0,0,0
1/12/2020,Iraq,Sarawak,0,0,0
1/12/2020,Iraq,Selangor,8,6,2
1/12/2020,Iceland,Johor,0,0,0
1/12/2020,Iceland,Kedah,0,0,0
1/12/2020,Iceland,Kelantan,0,0,0
1/12/2020,Iceland,Perak,0,0,0
1/12/2020,Iceland,Perlis,0,0,0
1/12/2020,Iceland,Pulau Pinang,0,0,0
1/12/2020,Iceland,Sabah,0,0,0
1/12/2020,Iceland,Sarawak,0,0,0
1/12/2020,Iceland,Selangor,0,0,0
1/12/2020,Iceland,W.P. Labuan,0,0,0
1/12/2020,Israel,Pulau Pinang,0,0,0
1/12/2020,Italy,Johor,0,0,0
1/12/2020,Italy,Kedah,0,0,0
1/12/2020,Italy,Kelantan,0,0,0
1/12/2020,Italy,Melaka,0,0,0
1/12/2020,Italy,Negeri Sembilan,0,0,0
1/12/2020,Italy,Pahang,0,0,0
1/12/2020,Italy,Perak,0,0,0
1/12/2020,Italy,Perlis,0,0,0
1/12/2020,Italy,Pulau Pinang,0,0,0
1/12/2020,Italy,Sabah,0,0,0
1/12/2020,Italy,Sarawak,1,1,0
1/12/2020,Italy,Selangor,15,13,2
1/12/2020,Italy,W.P. Labuan,0,0,0
1/12/2020,Jamaica,Johor,0,0,0
1/12/2020,Jamaica,Kedah,0,0,0
1/12/2020,Jamaica,Perak,0,0,0
1/12/2020,Jamaica,Pulau Pinang,0,0,0
1/12/2020,Jamaica,Sabah,0,0,0
1/12/2020,Jamaica,Sarawak,0,0,0
1/12/2020,Jamaica,Selangor,0,0,0
1/12/2020,Jamaica,W.P. Labuan,0,0,0
1/12/2020,Jordan,Johor,0,0,0
1/12/2020,Jordan,Kedah,0,0,0
1/12/2020,Jordan,Kelantan,0,0,0
1/12/2020,Jordan,Melaka,0,0,0
1/12/2020,Jordan,Perlis,0,0,0
1/12/2020,Jordan,Pulau Pinang,0,0,0
1/12/2020,Jordan,Sabah,0,0,0
1/12/2020,Jordan,Sarawak,0,0,0
1/12/2020,Jordan,Selangor,7,5,2
1/12/2020,Jordan,W.P. Labuan,0,0,0
1/12/2020,Japan,Johor,3,3,0
1/12/2020,Japan,Kedah,0,0,0
1/12/2020,Japan,Kelantan,0,0,0
1/12/2020,Japan,Melaka,0,0,0
1/12/2020,Japan,Negeri Sembilan,0,0,0
1/12/2020,Japan,Pahang,0,0,0
1/12/2020,Japan,Perak,0,0,0
1/12/2020,Japan,Perlis,0,0,0
1/12/2020,Japan,Pulau Pinang,25,20,5
1/12/2020,Japan,Sabah,0,0,0
1/12/2020,Japan,Sarawak,2,2,0
1/12/2020,Japan,Selangor,387,252,135
1/12/2020,Japan,W.P. Labuan,0,0,0
1/12/2020,Kazakhstan,Johor,0,0,0
1/12/2020,Kazakhstan,Kedah,0,0,0
1/12/2020,Kazakhstan,Kelantan,0,0,0
1/12/2020,Kazakhstan,Melaka,0,0,0
1/12/2020,Kazakhstan,Perak,0,0,0
1/12/2020,Kazakhstan,Perlis,0,0,0
1/12/2020,Kazakhstan,Pulau Pinang,0,0,0
1/12/2020,Kazakhstan,Sabah,0,0,0
1/12/2020,Kazakhstan,Sarawak,0,0,0
1/12/2020,Kazakhstan,Selangor,3,2,1
1/12/2020,Kazakhstan,W.P. Labuan,0,0,0
1/12/2020,Kenya,Johor,0,0,0
1/12/2020,Kenya,Kedah,0,0,0
1/12/2020,Kenya,Kelantan,0,0,0
1/12/2020,Kenya,Perak,0,0,0
1/12/2020,Kenya,Perlis,0,0,0
1/12/2020,Kenya,Pulau Pinang,0,0,0
1/12/2020,Kenya,Sabah,0,0,0
1/12/2020,Kenya,Sarawak,0,0,0
1/12/2020,Kenya,Selangor,4,4,0
1/12/2020,Kyrgyzstan,Johor,0,0,0
1/12/2020,Kyrgyzstan,Kedah,0,0,0
1/12/2020,Kyrgyzstan,Kelantan,0,0,0
1/12/2020,Kyrgyzstan,Perak,0,0,0
1/12/2020,Kyrgyzstan,Perlis,0,0,0
1/12/2020,Kyrgyzstan,Pulau Pinang,0,0,0
1/12/2020,Kyrgyzstan,Sabah,0,0,0
1/12/2020,Kyrgyzstan,Sarawak,0,0,0
1/12/2020,Kyrgyzstan,Selangor,3,3,0
1/12/2020,Cambodia,Johor,0,0,0
1/12/2020,Cambodia,Kedah,0,0,0
1/12/2020,Cambodia,Kelantan,0,0,0
1/12/2020,Cambodia,Melaka,0,0,0
1/12/2020,Cambodia,Negeri Sembilan,0,0,0
1/12/2020,Cambodia,Pahang,0,0,0
1/12/2020,Cambodia,Perak,0,0,0
1/12/2020,Cambodia,Perlis,0,0,0
1/12/2020,Cambodia,Pulau Pinang,0,0,0
1/12/2020,Cambodia,Sabah,1,1,0
1/12/2020,Cambodia,Sarawak,0,0,0
1/12/2020,Cambodia,Selangor,8,2,6
1/12/2020,Cambodia,W.P. Labuan,0,0,0
1/12/2020,Kiribati,Johor,0,0,0
1/12/2020,Kiribati,Sabah,0,0,0
1/12/2020,Kiribati,Selangor,8,8,0
1/12/2020,Saint Kitts and Nevis,Johor,0,0,0
1/12/2020,Saint Kitts and Nevis,Kedah,0,0,0
1/12/2020,Saint Kitts and Nevis,Perlis,0,0,0
1/12/2020,Saint Kitts and Nevis,Pulau Pinang,0,0,0
1/12/2020,Saint Kitts and Nevis,Sabah,0,0,0
1/12/2020,Saint Kitts and Nevis,Selangor,1,0,1
1/12/2020,Saint Kitts and Nevis,W.P. Labuan,0,0,0
1/12/2020,"Korea, Republic of",Johor,1,1,0
1/12/2020,"Korea, Republic of",Kedah,0,0,0
1/12/2020,"Korea, Republic of",Kelantan,0,0,0
1/12/2020,"Korea, Republic of",Melaka,0,0,0
1/12/2020,"Korea, Republic of",Negeri Sembilan,0,0,0
1/12/2020,"Korea, Republic of",Pahang,0,0,0
1/12/2020,"Korea, Republic of",Perak,0,0,0
1/12/2020,"Korea, Republic of",Perlis,0,0,0
1/12/2020,"Korea, Republic of",Pulau Pinang,3,3,0
1/12/2020,"Korea, Republic of",Sabah,0,0,0
1/12/2020,"Korea, Republic of",Sarawak,2,2,0
1/12/2020,"Korea, Republic of",Selangor,268,191,77
1/12/2020,"Korea, Republic of",Terengganu,0,0,0
1/12/2020,"Korea, Republic of",W.P. Labuan,0,0,0
1/12/2020,Kuwait,Johor,0,0,0
1/12/2020,Kuwait,Kedah,0,0,0
1/12/2020,Kuwait,Kelantan,0,0,0
1/12/2020,Kuwait,Perak,0,0,0
1/12/2020,Kuwait,Perlis,0,0,0
1/12/2020,Kuwait,Pulau Pinang,0,0,0
1/12/2020,Kuwait,Sabah,0,0,0
1/12/2020,Kuwait,Sarawak,0,0,0
1/12/2020,Kuwait,Selangor,3,2,1
1/12/2020,Kuwait,W.P. Labuan,0,0,0
1/12/2020, Lao People's Democratic Republic,Johor,0,0,0
1/12/2020, Lao People's Democratic Republic,Kedah,0,0,0
1/12/2020, Lao People's Democratic Republic,Kelantan,0,0,0
1/12/2020, Lao People's Democratic Republic,Melaka,0,0,0
1/12/2020, Lao People's Democratic Republic,Perak,0,0,0
1/12/2020, Lao People's Democratic Republic,Perlis,0,0,0
1/12/2020, Lao People's Democratic Republic,Pulau Pinang,0,0,0
1/12/2020, Lao People's Democratic Republic,Sabah,0,0,0
1/12/2020, Lao People's Democratic Republic,Sarawak,0,0,0
1/12/2020, Lao People's Democratic Republic,Selangor,3,1,2
1/12/2020, Lao People's Democratic Republic,W.P. Labuan,0,0,0
1/12/2020,Lebanon,Johor,0,0,0
1/12/2020,Lebanon,Kedah,0,0,0
1/12/2020,Lebanon,Kelantan,0,0,0
1/12/2020,Lebanon,Pahang,0,0,0
1/12/2020,Lebanon,Perak,0,0,0
1/12/2020,Lebanon,Perlis,0,0,0
1/12/2020,Lebanon,Pulau Pinang,0,0,0
1/12/2020,Lebanon,Sabah,0,0,0
1/12/2020,Lebanon,Sarawak,0,0,0
1/12/2020,Lebanon,Selangor,6,4,2
1/12/2020,Lebanon,W.P. Labuan,0,0,0
1/12/2020,Liberia,Johor,0,0,0
1/12/2020,Liberia,Kedah,0,0,0
1/12/2020,Liberia,Sabah,0,0,0
1/12/2020,Liberia,Sarawak,0,0,0
1/12/2020,Liberia,Selangor,1,1,0
1/12/2020,Libya,Johor,0,0,0
1/12/2020,Libya,Kedah,0,0,0
1/12/2020,Libya,Perlis,0,0,0
1/12/2020,Libya,Pulau Pinang,0,0,0
1/12/2020,Libya,Sabah,0,0,0
1/12/2020,Libya,Sarawak,0,0,0
1/12/2020,Libya,Selangor,3,3,0
1/12/2020,Saint Lucia,Johor,0,0,0
1/12/2020,Saint Lucia,Kedah,0,0,0
1/12/2020,Saint Lucia,Pulau Pinang,0,0,0
1/12/2020,Saint Lucia,Sarawak,0,0,0
1/12/2020,Saint Lucia,Selangor,0,0,0
1/12/2020,Liechtenstein,Johor,0,0,0
1/12/2020,Liechtenstein,Kedah,0,0,0
1/12/2020,Liechtenstein,Perlis,0,0,0
1/12/2020,Liechtenstein,Pulau Pinang,0,0,0
1/12/2020,Liechtenstein,Sabah,0,0,0
1/12/2020,Liechtenstein,Sarawak,0,0,0
1/12/2020,Liechtenstein,Selangor,0,0,0
1/12/2020,LKA,Johor,0,0,0
1/12/2020,LKA,Kedah,0,0,0
1/12/2020,LKA,Kelantan,0,0,0
1/12/2020,LKA,Melaka,0,0,0
1/12/2020,LKA,Pahang,0,0,0
1/12/2020,LKA,Perak,0,0,0
1/12/2020,LKA,Perlis,0,0,0
1/12/2020,LKA,Pulau Pinang,0,0,0
1/12/2020,LKA,Sabah,0,0,0
1/12/2020,LKA,Sarawak,0,0,0
1/12/2020,LKA,Selangor,37,32,5
1/12/2020,LKA,W.P. Labuan,0,0,0
1/12/2020,Lesotho,Johor,0,0,0
1/12/2020,Lesotho,Kedah,0,0,0
1/12/2020,Lesotho,Pulau Pinang,0,0,0
1/12/2020,Lesotho,Sarawak,0,0,0
1/12/2020,Lesotho,Selangor,1,1,0
1/12/2020,Lithuania,Johor,0,0,0
1/12/2020,Lithuania,Kedah,0,0,0
1/12/2020,Lithuania,Kelantan,0,0,0
1/12/2020,Lithuania,Pahang,0,0,0
1/12/2020,Lithuania,Perak,0,0,0
1/12/2020,Lithuania,Perlis,0,0,0
1/12/2020,Lithuania,Pulau Pinang,0,0,0
1/12/2020,Lithuania,Sabah,0,0,0
1/12/2020,Lithuania,Sarawak,0,0,0
1/12/2020,Lithuania,Selangor,3,3,0
1/12/2020,Lithuania,W.P. Labuan,0,0,0
1/12/2020,Luxembourg,Johor,0,0,0
1/12/2020,Luxembourg,Kedah,0,0,0
1/12/2020,Luxembourg,Kelantan,0,0,0
1/12/2020,Luxembourg,Perak,0,0,0
1/12/2020,Luxembourg,Perlis,0,0,0
1/12/2020,Luxembourg,Pulau Pinang,0,0,0
1/12/2020,Luxembourg,Sabah,0,0,0
1/12/2020,Luxembourg,Sarawak,0,0,0
1/12/2020,Luxembourg,Selangor,0,0,0
1/12/2020,Latvia,Johor,0,0,0
1/12/2020,Latvia,Kedah,0,0,0
1/12/2020,Latvia,Kelantan,0,0,0
1/12/2020,Latvia,Pahang,0,0,0
1/12/2020,Latvia,Perak,0,0,0
1/12/2020,Latvia,Perlis,0,0,0
1/12/2020,Latvia,Pulau Pinang,0,0,0
1/12/2020,Latvia,Sabah,0,0,0
1/12/2020,Latvia,Sarawak,0,0,0
1/12/2020,Latvia,Selangor,1,1,0
1/12/2020,Latvia,W.P. Labuan,0,0,0
1/12/2020,Macao,Johor,0,0,0
1/12/2020,Macao,Pahang,0,0,0
1/12/2020,Macao,Perak,0,0,0
1/12/2020,Macao,Selangor,0,0,0
1/12/2020,Macao,W.P. Labuan,0,0,0
1/12/2020,Morocco,Johor,0,0,0
1/12/2020,Morocco,Kedah,0,0,0
1/12/2020,Morocco,Kelantan,0,0,0
1/12/2020,Morocco,Melaka,0,0,0
1/12/2020,Morocco,Pahang,0,0,0
1/12/2020,Morocco,Perak,0,0,0
1/12/2020,Morocco,Perlis,0,0,0
1/12/2020,Morocco,Pulau Pinang,0,0,0
1/12/2020,Morocco,Sabah,0,0,0
1/12/2020,Morocco,Sarawak,0,0,0
1/12/2020,Morocco,Selangor,4,2,2
1/12/2020,Morocco,W.P. Labuan,0,0,0
1/12/2020,Monaco,Johor,0,0,0
1/12/2020,Monaco,Kedah,0,0,0
1/12/2020,Monaco,Sabah,0,0,0
1/12/2020,Monaco,Selangor,0,0,0
1/12/2020,"Moldova, Republic of",Johor,0,0,0
1/12/2020,"Moldova, Republic of",Kedah,0,0,0
1/12/2020,"Moldova, Republic of",Kelantan,0,0,0
1/12/2020,"Moldova, Republic of",Negeri Sembilan,0,0,0
1/12/2020,"Moldova, Republic of",Perlis,0,0,0
1/12/2020,"Moldova, Republic of",Pulau Pinang,0,0,0
1/12/2020,"Moldova, Republic of",Sabah,0,0,0
1/12/2020,"Moldova, Republic of",Sarawak,0,0,0
1/12/2020,"Moldova, Republic of",Selangor,0,0,0
1/12/2020,Madagascar,Johor,0,0,0
1/12/2020,Madagascar,Kedah,0,0,0
1/12/2020,Madagascar,Perak,0,0,0
1/12/2020,Madagascar,Perlis,0,0,0
1/12/2020,Madagascar,Pulau Pinang,0,0,0
1/12/2020,Madagascar,Sabah,0,0,0
1/12/2020,Madagascar,Sarawak,0,0,0
1/12/2020,Madagascar,Selangor,0,0,0
1/12/2020,Maldives,Johor,0,0,0
1/12/2020,Maldives,Kedah,0,0,0
1/12/2020,Maldives,Kelantan,0,0,0
1/12/2020,Maldives,Perak,0,0,0
1/12/2020,Maldives,Perlis,0,0,0
1/12/2020,Maldives,Pulau Pinang,0,0,0
1/12/2020,Maldives,Sabah,0,0,0
1/12/2020,Maldives,Sarawak,0,0,0
1/12/2020,Maldives,Selangor,17,11,6
1/12/2020,Mexico,Johor,0,0,0
1/12/2020,Mexico,Kedah,0,0,0
1/12/2020,Mexico,Kelantan,0,0,0
1/12/2020,Mexico,Pahang,0,0,0
1/12/2020,Mexico,Perak,0,0,0
1/12/2020,Mexico,Perlis,0,0,0
1/12/2020,Mexico,Pulau Pinang,0,0,0
1/12/2020,Mexico,Sabah,0,0,0
1/12/2020,Mexico,Sarawak,0,0,0
1/12/2020,Mexico,Selangor,1,1,0
1/12/2020,Mexico,W.P. Labuan,0,0,0
1/12/2020,Marshall Islands,Johor,0,0,0
1/12/2020,Marshall Islands,Kedah,0,0,0
1/12/2020,Marshall Islands,Perak,0,0,0
1/12/2020,Marshall Islands,Pulau Pinang,0,0,0
1/12/2020,Marshall Islands,Sabah,0,0,0
1/12/2020,Marshall Islands,Selangor,0,0,0
1/12/2020,North Macedonia,Johor,0,0,0
1/12/2020,North Macedonia,Kedah,0,0,0
1/12/2020,North Macedonia,Perak,0,0,0
1/12/2020,North Macedonia,Pulau Pinang,0,0,0
1/12/2020,North Macedonia,Sabah,0,0,0
1/12/2020,North Macedonia,Sarawak,0,0,0
1/12/2020,North Macedonia,Selangor,0,0,0
1/12/2020,Mali,Johor,0,0,0
1/12/2020,Mali,Sabah,0,0,0
1/12/2020,Mali,Selangor,0,0,0
1/12/2020,Malta,Johor,0,0,0
1/12/2020,Malta,Kedah,0,0,0
1/12/2020,Malta,Kelantan,0,0,0
1/12/2020,Malta,Perak,0,0,0
1/12/2020,Malta,Perlis,0,0,0
1/12/2020,Malta,Pulau Pinang,0,0,0
1/12/2020,Malta,Sabah,0,0,0
1/12/2020,Malta,Sarawak,0,0,0
1/12/2020,Malta,Selangor,0,0,0
1/12/2020,Malta,W.P. Labuan,0,0,0
1/12/2020,Myanmar,Johor,33,33,0
1/12/2020,Myanmar,Kedah,0,0,0
1/12/2020,Myanmar,Kelantan,0,0,0
1/12/2020,Myanmar,Negeri Sembilan,0,0,0
1/12/2020,Myanmar,Pahang,0,0,0
1/12/2020,Myanmar,Perak,0,0,0
1/12/2020,Myanmar,Perlis,0,0,0
1/12/2020,Myanmar,Pulau Pinang,1,1,0
1/12/2020,Myanmar,Sabah,0,0,0
1/12/2020,Myanmar,Sarawak,0,0,0
1/12/2020,Myanmar,Selangor,105,96,9
1/12/2020,Myanmar,Terengganu,0,0,0
1/12/2020,Myanmar,W.P. Labuan,0,0,0
1/12/2020,Montenegro,Johor,0,0,0
1/12/2020,Montenegro,Kedah,0,0,0
1/12/2020,Montenegro,Pulau Pinang,0,0,0
1/12/2020,Montenegro,Sabah,0,0,0
1/12/2020,Montenegro,Sarawak,0,0,0
1/12/2020,Montenegro,Selangor,5,5,0
1/12/2020,Mongolia,Johor,0,0,0
1/12/2020,Mongolia,Kedah,0,0,0
1/12/2020,Mongolia,Kelantan,0,0,0
1/12/2020,Mongolia,Perak,0,0,0
1/12/2020,Mongolia,Perlis,0,0,0
1/12/2020,Mongolia,Pulau Pinang,0,0,0
1/12/2020,Mongolia,Sabah,0,0,0
1/12/2020,Mongolia,Sarawak,0,0,0
1/12/2020,Mongolia,Selangor,0,0,0
1/12/2020,Northern Mariana Islands,Selangor,0,0,0
1/12/2020,Mozambique,Johor,0,0,0
1/12/2020,Mozambique,Kedah,0,0,0
1/12/2020,Mozambique,Perak,0,0,0
1/12/2020,Mozambique,Pulau Pinang,0,0,0
1/12/2020,Mozambique,Sabah,0,0,0
1/12/2020,Mozambique,Sarawak,0,0,0
1/12/2020,Mozambique,Selangor,3,3,0
1/12/2020,Mauritania,Johor,0,0,0
1/12/2020,Mauritania,Kedah,0,0,0
1/12/2020,Mauritania,Pulau Pinang,0,0,0
1/12/2020,Mauritania,Sabah,0,0,0
1/12/2020,Mauritania,Sarawak,0,0,0
1/12/2020,Mauritania,Selangor,0,0,0
1/12/2020,Mauritius,Johor,0,0,0
1/12/2020,Mauritius,Kedah,0,0,0
1/12/2020,Mauritius,Kelantan,0,0,0
1/12/2020,Mauritius,Pahang,0,0,0
1/12/2020,Mauritius,Perak,0,0,0
1/12/2020,Mauritius,Perlis,0,0,0
1/12/2020,Mauritius,Pulau Pinang,0,0,0
1/12/2020,Mauritius,Sabah,0,0,0
1/12/2020,Mauritius,Sarawak,0,0,0
1/12/2020,Mauritius,Selangor,5,0,5
1/12/2020,Malawi,Johor,0,0,0
1/12/2020,Malawi,Pulau Pinang,0,0,0
1/12/2020,Malawi,Sabah,0,0,0
1/12/2020,Malawi,Sarawak,0,0,0
1/12/2020,Malawi,Selangor,1,1,0
1/12/2020,Mayotte,Selangor,0,0,0
1/12/2020,Namibia,Johor,0,0,0
1/12/2020,Namibia,Kedah,0,0,0
1/12/2020,Namibia,Perak,0,0,0
1/12/2020,Namibia,Perlis,0,0,0
1/12/2020,Namibia,Pulau Pinang,0,0,0
1/12/2020,Namibia,Sabah,0,0,0
1/12/2020,Namibia,Sarawak,0,0,0
1/12/2020,Namibia,Selangor,2,2,0
1/12/2020,New Caledonia,Selangor,0,0,0
1/12/2020,Niger,Johor,0,0,0
1/12/2020,Niger,Sabah,0,0,0
1/12/2020,Niger,Selangor,0,0,0
1/12/2020,Nigeria,Johor,0,0,0
1/12/2020,Nigeria,Kedah,0,0,0
1/12/2020,Nigeria,Perlis,0,0,0
1/12/2020,Nigeria,Pulau Pinang,0,0,0
1/12/2020,Nigeria,Sabah,0,0,0
1/12/2020,Nigeria,Sarawak,0,0,0
1/12/2020,Nigeria,Selangor,36,30,6
1/12/2020,Nicaragua,Johor,0,0,0
1/12/2020,Nicaragua,Kedah,0,0,0
1/12/2020,Nicaragua,Pulau Pinang,0,0,0
1/12/2020,Nicaragua,Sabah,0,0,0
1/12/2020,Nicaragua,Selangor,0,0,0
1/12/2020,Netherlands,Johor,1,1,0
1/12/2020,Netherlands,Kedah,0,0,0
1/12/2020,Netherlands,Kelantan,0,0,0
1/12/2020,Netherlands,Melaka,0,0,0
1/12/2020,Netherlands,Negeri Sembilan,0,0,0
1/12/2020,Netherlands,Pahang,0,0,0
1/12/2020,Netherlands,Perak,0,0,0
1/12/2020,Netherlands,Perlis,0,0,0
1/12/2020,Netherlands,Pulau Pinang,1,1,0
1/12/2020,Netherlands,Sabah,0,0,0
1/12/2020,Netherlands,Sarawak,1,1,0
1/12/2020,Netherlands,Selangor,22,19,3
1/12/2020,Netherlands,Terengganu,0,0,0
1/12/2020,Netherlands,W.P. Labuan,0,0,0
1/12/2020,Norway,Johor,0,0,0
1/12/2020,Norway,Kedah,0,0,0
1/12/2020,Norway,Kelantan,0,0,0
1/12/2020,Norway,Melaka,0,0,0
1/12/2020,Norway,Pahang,0,0,0
1/12/2020,Norway,Perak,0,0,0
1/12/2020,Norway,Perlis,0,0,0
1/12/2020,Norway,Pulau Pinang,0,0,0
1/12/2020,Norway,Sabah,0,0,0
1/12/2020,Norway,Sarawak,0,0,0
1/12/2020,Norway,Selangor,6,5,1
1/12/2020,Norway,W.P. Labuan,0,0,0
1/12/2020,Nepal,Johor,0,0,0
1/12/2020,Nepal,Kedah,0,0,0
1/12/2020,Nepal,Pahang,0,0,0
1/12/2020,Nepal,Perak,0,0,0
1/12/2020,Nepal,Perlis,0,0,0
1/12/2020,Nepal,Pulau Pinang,0,0,0
1/12/2020,Nepal,Sabah,0,0,0
1/12/2020,Nepal,Sarawak,0,0,0
1/12/2020,Nepal,Selangor,189,185,4
1/12/2020,Nepal,W.P. Labuan,0,0,0
1/12/2020,Nauru,Johor,0,0,0
1/12/2020,Nauru,Pulau Pinang,0,0,0
1/12/2020,Nauru,Selangor,0,0,0
1/12/2020,New Zealand,Johor,1,1,0
1/12/2020,New Zealand,Kedah,0,0,0
1/12/2020,New Zealand,Kelantan,0,0,0
1/12/2020,New Zealand,Melaka,0,0,0
1/12/2020,New Zealand,Negeri Sembilan,0,0,0
1/12/2020,New Zealand,Pahang,0,0,0
1/12/2020,New Zealand,Perak,2,1,1
1/12/2020,New Zealand,Perlis,0,0,0
1/12/2020,New Zealand,Pulau Pinang,0,0,0
1/12/2020,New Zealand,Sabah,0,0,0
1/12/2020,New Zealand,Sarawak,0,0,0
1/12/2020,New Zealand,Selangor,19,15,4
1/12/2020,New Zealand,Terengganu,0,0,0
1/12/2020,New Zealand,W.P. Labuan,0,0,0
1/12/2020,Oman,Johor,0,0,0
1/12/2020,Oman,Kedah,0,0,0
1/12/2020,Oman,Kelantan,0,0,0
1/12/2020,Oman,Melaka,0,0,0
1/12/2020,Oman,Perak,0,0,0
1/12/2020,Oman,Perlis,0,0,0
1/12/2020,Oman,Pulau Pinang,0,0,0
1/12/2020,Oman,Sabah,0,0,0
1/12/2020,Oman,Sarawak,0,0,0
1/12/2020,Oman,Selangor,5,0,5
1/12/2020,Pakistan,Johor,3,3,0
1/12/2020,Pakistan,Kedah,0,0,0
1/12/2020,Pakistan,Kelantan,0,0,0
1/12/2020,Pakistan,Melaka,0,0,0
1/12/2020,Pakistan,Negeri Sembilan,0,0,0
1/12/2020,Pakistan,Pahang,0,0,0
1/12/2020,Pakistan,Perak,0,0,0
1/12/2020,Pakistan,Perlis,0,0,0
1/12/2020,Pakistan,Pulau Pinang,0,0,0
1/12/2020,Pakistan,Sabah,0,0,0
1/12/2020,Pakistan,Sarawak,0,0,0
1/12/2020,Pakistan,Selangor,115,99,16
1/12/2020,Pakistan,W.P. Labuan,0,0,0
1/12/2020,Panama,Johor,0,0,0
1/12/2020,Panama,Kedah,0,0,0
1/12/2020,Panama,Perak,0,0,0
1/12/2020,Panama,Perlis,0,0,0
1/12/2020,Panama,Pulau Pinang,0,0,0
1/12/2020,Panama,Sabah,0,0,0
1/12/2020,Panama,Sarawak,0,0,0
1/12/2020,Panama,Selangor,0,0,0
1/12/2020,Peru,Johor,0,0,0
1/12/2020,Peru,Kedah,0,0,0
1/12/2020,Peru,Kelantan,0,0,0
1/12/2020,Peru,Pahang,0,0,0
1/12/2020,Peru,Perak,0,0,0
1/12/2020,Peru,Perlis,0,0,0
1/12/2020,Peru,Pulau Pinang,0,0,0
1/12/2020,Peru,Sabah,0,0,0
1/12/2020,Peru,Sarawak,0,0,0
1/12/2020,Peru,Selangor,13,8,5
1/12/2020,Peru,W.P. Labuan,0,0,0
1/12/2020,Philippines,Johor,85,80,5
1/12/2020,Philippines,Kedah,0,0,0
1/12/2020,Philippines,Kelantan,0,0,0
1/12/2020,Philippines,Melaka,0,0,0
1/12/2020,Philippines,Negeri Sembilan,0,0,0
1/12/2020,Philippines,Pahang,0,0,0
1/12/2020,Philippines,Perak,0,0,0
1/12/2020,Philippines,Perlis,0,0,0
1/12/2020,Philippines,Pulau Pinang,0,0,0
1/12/2020,Philippines,Sabah,2,1,1
1/12/2020,Philippines,Sarawak,61,58,3
1/12/2020,Philippines,Selangor,255,209,46
1/12/2020,Philippines,Terengganu,0,0,0
1/12/2020,Philippines,W.P. Labuan,4,4,0
1/12/2020,Palau,Johor,0,0,0
1/12/2020,Palau,Pulau Pinang,0,0,0
1/12/2020,Palau,Selangor,0,0,0
1/12/2020,Papua New Guinea,Johor,0,0,0
1/12/2020,Papua New Guinea,Kedah,0,0,0
1/12/2020,Papua New Guinea,Kelantan,0,0,0
1/12/2020,Papua New Guinea,Perak,0,0,0
1/12/2020,Papua New Guinea,Pulau Pinang,0,0,0
1/12/2020,Papua New Guinea,Sabah,0,0,0
1/12/2020,Papua New Guinea,Sarawak,1,1,0
1/12/2020,Papua New Guinea,Selangor,0,0,0
1/12/2020,Poland,Johor,4,4,0
1/12/2020,Poland,Kedah,0,0,0
1/12/2020,Poland,Kelantan,0,0,0
1/12/2020,Poland,Melaka,0,0,0
1/12/2020,Poland,Negeri Sembilan,0,0,0
1/12/2020,Poland,Pahang,0,0,0
1/12/2020,Poland,Perak,0,0,0
1/12/2020,Poland,Perlis,0,0,0
1/12/2020,Poland,Pulau Pinang,0,0,0
1/12/2020,Poland,Sabah,0,0,0
1/12/2020,Poland,Sarawak,0,0,0
1/12/2020,Poland,Selangor,8,7,1
1/12/2020,Poland,Terengganu,0,0,0
1/12/2020,Poland,W.P. Labuan,0,0,0
1/12/2020,"North Korea, Democratic People's Republic of",Selangor,0,0,0
1/12/2020,Portugal,Johor,0,0,0
1/12/2020,Portugal,Kedah,0,0,0
1/12/2020,Portugal,Kelantan,0,0,0
1/12/2020,Portugal,Melaka,0,0,0
1/12/2020,Portugal,Pahang,0,0,0
1/12/2020,Portugal,Perak,0,0,0
1/12/2020,Portugal,Perlis,0,0,0
1/12/2020,Portugal,Pulau Pinang,0,0,0
1/12/2020,Portugal,Sabah,0,0,0
1/12/2020,Portugal,Sarawak,0,0,0
1/12/2020,Portugal,Selangor,1,0,1
1/12/2020,Portugal,W.P. Labuan,0,0,0
1/12/2020,Paraguay,Johor,0,0,0
1/12/2020,Paraguay,Kedah,0,0,0
1/12/2020,Paraguay,Perak,0,0,0
1/12/2020,Paraguay,Perlis,0,0,0
1/12/2020,Paraguay,Pulau Pinang,0,0,0
1/12/2020,Paraguay,Sabah,0,0,0
1/12/2020,Paraguay,Sarawak,0,0,0
1/12/2020,Paraguay,Selangor,0,0,0
1/12/2020,"Palestine, State of",Johor,0,0,0
1/12/2020,"Palestine, State of",Kedah,0,0,0
1/12/2020,"Palestine, State of",Kelantan,0,0,0
1/12/2020,"Palestine, State of",Melaka,0,0,0
1/12/2020,"Palestine, State of",Perak,0,0,0
1/12/2020,"Palestine, State of",Perlis,0,0,0
1/12/2020,"Palestine, State of",Pulau Pinang,0,0,0
1/12/2020,"Palestine, State of",Sabah,0,0,0
1/12/2020,"Palestine, State of",Sarawak,0,0,0
1/12/2020,"Palestine, State of",Selangor,4,3,1
1/12/2020,Qatar,Johor,0,0,0
1/12/2020,Qatar,Kedah,0,0,0
1/12/2020,Qatar,Perlis,0,0,0
1/12/2020,Qatar,Pulau Pinang,0,0,0
1/12/2020,Qatar,Sabah,0,0,0
1/12/2020,Qatar,Sarawak,0,0,0
1/12/2020,Qatar,Selangor,2,2,0
1/12/2020,Réunion,Johor,0,0,0
1/12/2020,Réunion,Sarawak,0,0,0
1/12/2020,Romania,Johor,0,0,0
1/12/2020,Romania,Kedah,0,0,0
1/12/2020,Romania,Kelantan,0,0,0
1/12/2020,Romania,Negeri Sembilan,0,0,0
1/12/2020,Romania,Pahang,0,0,0
1/12/2020,Romania,Perak,0,0,0
1/12/2020,Romania,Perlis,0,0,0
1/12/2020,Romania,Pulau Pinang,0,0,0
1/12/2020,Romania,Sabah,0,0,0
1/12/2020,Romania,Sarawak,0,0,0
1/12/2020,Romania,Selangor,10,8,2
1/12/2020,Romania,W.P. Labuan,0,0,0
1/12/2020,Russian Federation (Russia),Johor,7,7,0
1/12/2020,Russian Federation (Russia),Kedah,0,0,0
1/12/2020,Russian Federation (Russia),Kelantan,0,0,0
1/12/2020,Russian Federation (Russia),Melaka,0,0,0
1/12/2020,Russian Federation (Russia),Negeri Sembilan,0,0,0
1/12/2020,Russian Federation (Russia),Pahang,0,0,0
1/12/2020,Russian Federation (Russia),Perak,0,0,0
1/12/2020,Russian Federation (Russia),Perlis,0,0,0
1/12/2020,Russian Federation (Russia),Pulau Pinang,0,0,0
1/12/2020,Russian Federation (Russia),Sabah,0,0,0
1/12/2020,Russian Federation (Russia),Sarawak,0,0,0
1/12/2020,Russian Federation (Russia),Selangor,28,24,4
1/12/2020,Russian Federation (Russia),W.P. Labuan,0,0,0
1/12/2020,Rwanda,Johor,0,0,0
1/12/2020,Rwanda,Kedah,0,0,0
1/12/2020,Rwanda,Pulau Pinang,0,0,0
1/12/2020,Rwanda,Selangor,0,0,0
1/12/2020,Saudi Arabia,Johor,0,0,0
1/12/2020,Saudi Arabia,Kedah,0,0,0
1/12/2020,Saudi Arabia,Kelantan,0,0,0
1/12/2020,Saudi Arabia,Melaka,0,0,0
1/12/2020,Saudi Arabia,Perak,0,0,0
1/12/2020,Saudi Arabia,Perlis,0,0,0
1/12/2020,Saudi Arabia,Pulau Pinang,0,0,0
1/12/2020,Saudi Arabia,Sabah,0,0,0
1/12/2020,Saudi Arabia,Sarawak,0,0,0
1/12/2020,Saudi Arabia,Selangor,14,6,8
1/12/2020,Saudi Arabia,W.P. Labuan,0,0,0
1/12/2020,Sudan,Johor,0,0,0
1/12/2020,Sudan,Kedah,0,0,0
1/12/2020,Sudan,Kelantan,0,0,0
1/12/2020,Sudan,Perlis,0,0,0
1/12/2020,Sudan,Pulau Pinang,0,0,0
1/12/2020,Sudan,Sabah,0,0,0
1/12/2020,Sudan,Sarawak,0,0,0
1/12/2020,Sudan,Selangor,7,6,1
1/12/2020,Sudan,W.P. Labuan,0,0,0
1/12/2020,Senegal,Johor,0,0,0
1/12/2020,Senegal,Kedah,0,0,0
1/12/2020,Senegal,Kelantan,0,0,0
1/12/2020,Senegal,Perak,0,0,0
1/12/2020,Senegal,Perlis,0,0,0
1/12/2020,Senegal,Pulau Pinang,0,0,0
1/12/2020,Senegal,Sabah,0,0,0
1/12/2020,Senegal,Sarawak,0,0,0
1/12/2020,Senegal,Selangor,1,0,1
1/12/2020,Singapore,Johor,304,244,60
1/12/2020,Singapore,Kedah,1,1,0
1/12/2020,Singapore,Kelantan,0,0,0
1/12/2020,Singapore,Melaka,0,0,0
1/12/2020,Singapore,Negeri Sembilan,0,0,0
1/12/2020,Singapore,Pahang,0,0,0
1/12/2020,Singapore,Perak,0,0,0
1/12/2020,Singapore,Perlis,0,0,0
1/12/2020,Singapore,Pulau Pinang,24,17,7
1/12/2020,Singapore,Sabah,0,0,0
1/12/2020,Singapore,Sarawak,5,2,3
1/12/2020,Singapore,Selangor,112,71,41
1/12/2020,Singapore,Terengganu,0,0,0
1/12/2020,Singapore,W.P. Labuan,0,0,0
1/12/2020,South Georgia and the South Sandwich Islands,Johor,0,0,0
1/12/2020,South Georgia and the South Sandwich Islands,Sabah,0,0,0
1/12/2020,South Georgia and the South Sandwich Islands,Selangor,0,0,0
1/12/2020,Saint Helena,Sarawak,0,0,0
1/12/2020,Solomon Islands,Johor,0,0,0
1/12/2020,Solomon Islands,Perlis,0,0,0
1/12/2020,Solomon Islands,Pulau Pinang,0,0,0
1/12/2020,Solomon Islands,Sabah,0,0,0
1/12/2020,Solomon Islands,Sarawak,0,0,0
1/12/2020,Solomon Islands,Selangor,0,0,0
1/12/2020,Solomon Islands,W.P. Labuan,0,0,0
1/12/2020,Sierra Leone,Johor,0,0,0
1/12/2020,Sierra Leone,Kedah,0,0,0
1/12/2020,Sierra Leone,Perak,0,0,0
1/12/2020,Sierra Leone,Pulau Pinang,0,0,0
1/12/2020,Sierra Leone,Sabah,0,0,0
1/12/2020,Sierra Leone,Selangor,0,0,0
1/12/2020,El Salvador,Johor,0,0,0
1/12/2020,El Salvador,Kedah,0,0,0
1/12/2020,El Salvador,Perak,0,0,0
1/12/2020,El Salvador,Perlis,0,0,0
1/12/2020,El Salvador,Pulau Pinang,0,0,0
1/12/2020,El Salvador,Sabah,0,0,0
1/12/2020,El Salvador,Selangor,0,0,0
1/12/2020,El Salvador,W.P. Labuan,0,0,0
1/12/2020,San Marino,Johor,0,0,0
1/12/2020,San Marino,Selangor,0,0,0
1/12/2020,Somalia,Johor,0,0,0
1/12/2020,Somalia,Kedah,0,0,0
1/12/2020,Somalia,Kelantan,0,0,0
1/12/2020,Somalia,Perlis,0,0,0
1/12/2020,Somalia,Sabah,0,0,0
1/12/2020,Somalia,Sarawak,0,0,0
1/12/2020,Somalia,Selangor,3,2,1
1/12/2020,Serbia,Johor,0,0,0
1/12/2020,Serbia,Kedah,0,0,0
1/12/2020,Serbia,Kelantan,0,0,0
1/12/2020,Serbia,Pahang,0,0,0
1/12/2020,Serbia,Perak,0,0,0
1/12/2020,Serbia,Perlis,0,0,0
1/12/2020,Serbia,Pulau Pinang,0,0,0
1/12/2020,Serbia,Sabah,0,0,0
1/12/2020,Serbia,Sarawak,0,0,0
1/12/2020,Serbia,Selangor,0,0,0
1/12/2020,South Sudan,Johor,0,0,0
1/12/2020,South Sudan,Kedah,0,0,0
1/12/2020,South Sudan,Sarawak,0,0,0
1/12/2020,South Sudan,Selangor,0,0,0
1/12/2020,South Sudan,W.P. Labuan,0,0,0
1/12/2020,Sao Tome and Principe,Selangor,0,0,0
1/12/2020,Suriname,Johor,0,0,0
1/12/2020,Suriname,Kedah,0,0,0
1/12/2020,Suriname,Kelantan,0,0,0
1/12/2020,Suriname,Perak,0,0,0
1/12/2020,Suriname,Perlis,0,0,0
1/12/2020,Suriname,Pulau Pinang,0,0,0
1/12/2020,Suriname,Sabah,0,0,0
1/12/2020,Suriname,Sarawak,0,0,0
1/12/2020,Suriname,Selangor,0,0,0
1/12/2020,Slovakia,Johor,0,0,0
1/12/2020,Slovakia,Kedah,0,0,0
1/12/2020,Slovakia,Kelantan,0,0,0
1/12/2020,Slovakia,Negeri Sembilan,0,0,0
1/12/2020,Slovakia,Pahang,0,0,0
1/12/2020,Slovakia,Perak,0,0,0
1/12/2020,Slovakia,Perlis,0,0,0
1/12/2020,Slovakia,Pulau Pinang,0,0,0
1/12/2020,Slovakia,Sabah,0,0,0
1/12/2020,Slovakia,Sarawak,0,0,0
1/12/2020,Slovakia,Selangor,0,0,0
1/12/2020,Slovakia,W.P. Labuan,0,0,0
1/12/2020,Slovenia,Johor,0,0,0
1/12/2020,Slovenia,Kedah,0,0,0
1/12/2020,Slovenia,Kelantan,0,0,0
1/12/2020,Slovenia,Perak,0,0,0
1/12/2020,Slovenia,Perlis,0,0,0
1/12/2020,Slovenia,Pulau Pinang,0,0,0
1/12/2020,Slovenia,Sabah,0,0,0
1/12/2020,Slovenia,Sarawak,0,0,0
1/12/2020,Slovenia,Selangor,0,0,0
1/12/2020,Slovenia,W.P. Labuan,0,0,0
1/12/2020,Sweden,Johor,2,2,0
1/12/2020,Sweden,Kedah,0,0,0
1/12/2020,Sweden,Kelantan,0,0,0
1/12/2020,Sweden,Melaka,0,0,0
1/12/2020,Sweden,Negeri Sembilan,0,0,0
1/12/2020,Sweden,Pahang,0,0,0
1/12/2020,Sweden,Perak,0,0,0
1/12/2020,Sweden,Perlis,0,0,0
1/12/2020,Sweden,Pulau Pinang,0,0,0
1/12/2020,Sweden,Sabah,0,0,0
1/12/2020,Sweden,Sarawak,0,0,0
1/12/2020,Sweden,Selangor,20,15,5
1/12/2020,Sweden,W.P. Labuan,0,0,0
1/12/2020,Eswatini,Johor,0,0,0
1/12/2020,Eswatini,Kedah,0,0,0
1/12/2020,Eswatini,Pulau Pinang,0,0,0
1/12/2020,Eswatini,Sabah,0,0,0
1/12/2020,Eswatini,Selangor,1,1,0
1/12/2020,Seychelles,Johor,0,0,0
1/12/2020,Seychelles,Kedah,0,0,0
1/12/2020,Seychelles,Pulau Pinang,0,0,0
1/12/2020,Seychelles,Sabah,0,0,0
1/12/2020,Seychelles,Sarawak,0,0,0
1/12/2020,Seychelles,Selangor,0,0,0
1/12/2020,Syrian Arab Republic,Johor,0,0,0
1/12/2020,Syrian Arab Republic,Kedah,0,0,0
1/12/2020,Syrian Arab Republic,Kelantan,0,0,0
1/12/2020,Syrian Arab Republic,Pahang,0,0,0
1/12/2020,Syrian Arab Republic,Perlis,0,0,0
1/12/2020,Syrian Arab Republic,Pulau Pinang,0,0,0
1/12/2020,Syrian Arab Republic,Sabah,0,0,0
1/12/2020,Syrian Arab Republic,Sarawak,0,0,0
1/12/2020,Syrian Arab Republic,Selangor,6,6,0
1/12/2020,Syrian Arab Republic,W.P. Labuan,0,0,0
1/12/2020,Turks and Caicos Islands,Perlis,0,0,0
1/12/2020,TCD,Johor,0,0,0
1/12/2020,TCD,Kedah,0,0,0
1/12/2020,TCD,Perlis,0,0,0
1/12/2020,TCD,Selangor,0,0,0
1/12/2020,Togo,Johor,0,0,0
1/12/2020,Togo,Perak,0,0,0
1/12/2020,Togo,Pulau Pinang,0,0,0
1/12/2020,Togo,Selangor,0,0,0
1/12/2020,Thailand,Johor,115,115,0
1/12/2020,Thailand,Kedah,14203,13891,312
1/12/2020,Thailand,Kelantan,2,1,1
1/12/2020,Thailand,Melaka,0,0,0
1/12/2020,Thailand,Negeri Sembilan,0,0,0
1/12/2020,Thailand,Pahang,0,0,0
1/12/2020,Thailand,Perak,0,0,0
1/12/2020,Thailand,Perlis,8789,8405,384
1/12/2020,Thailand,Pulau Pinang,0,0,0
1/12/2020,Thailand,Sabah,0,0,0
1/12/2020,Thailand,Sarawak,12,12,0
1/12/2020,Thailand,Selangor,203,110,93
1/12/2020,Thailand,Terengganu,0,0,0
1/12/2020,Thailand,W.P. Labuan,0,0,0
1/12/2020,Tajikistan,Johor,0,0,0
1/12/2020,Tajikistan,Kedah,0,0,0
1/12/2020,Tajikistan,Perlis,0,0,0
1/12/2020,Tajikistan,Pulau Pinang,0,0,0
1/12/2020,Tajikistan,Sabah,0,0,0
1/12/2020,Tajikistan,Selangor,2,2,0
1/12/2020,Tokelau,Selangor,0,0,0
1/12/2020,Turkmenistan,Johor,0,0,0
1/12/2020,Turkmenistan,Kedah,0,0,0
1/12/2020,Turkmenistan,Kelantan,0,0,0
1/12/2020,Turkmenistan,Perlis,0,0,0
1/12/2020,Turkmenistan,Pulau Pinang,0,0,0
1/12/2020,Turkmenistan,Sabah,0,0,0
1/12/2020,Turkmenistan,Sarawak,0,0,0
1/12/2020,Turkmenistan,Selangor,0,0,0
1/12/2020,Timor-Leste,Johor,0,0,0
1/12/2020,Timor-Leste,Kedah,0,0,0
1/12/2020,Timor-Leste,Perlis,0,0,0
1/12/2020,Timor-Leste,Pulau Pinang,0,0,0
1/12/2020,Timor-Leste,Sabah,0,0,0
1/12/2020,Timor-Leste,Sarawak,0,0,0
1/12/2020,Timor-Leste,Selangor,3,2,1
1/12/2020,Tonga,Johor,0,0,0
1/12/2020,Tonga,Pulau Pinang,0,0,0
1/12/2020,Tonga,Sarawak,0,0,0
1/12/2020,Tonga,Selangor,0,0,0
1/12/2020,Trinidad and Tobago,Johor,0,0,0
1/12/2020,Trinidad and Tobago,Kedah,0,0,0
1/12/2020,Trinidad and Tobago,Pahang,0,0,0
1/12/2020,Trinidad and Tobago,Pulau Pinang,0,0,0
1/12/2020,Trinidad and Tobago,Sabah,0,0,0
1/12/2020,Trinidad and Tobago,Sarawak,0,0,0
1/12/2020,Trinidad and Tobago,Selangor,0,0,0
1/12/2020,Tunisia,Johor,0,0,0
1/12/2020,Tunisia,Kedah,0,0,0
1/12/2020,Tunisia,Kelantan,0,0,0
1/12/2020,Tunisia,Melaka,0,0,0
1/12/2020,Tunisia,Perak,0,0,0
1/12/2020,Tunisia,Perlis,0,0,0
1/12/2020,Tunisia,Pulau Pinang,0,0,0
1/12/2020,Tunisia,Sabah,0,0,0
1/12/2020,Tunisia,Sarawak,0,0,0
1/12/2020,Tunisia,Selangor,1,1,0
1/12/2020,Tunisia,W.P. Labuan,0,0,0
1/12/2020,Türkiye,Johor,0,0,0
1/12/2020,Türkiye,Kedah,0,0,0
1/12/2020,Türkiye,Kelantan,0,0,0
1/12/2020,Türkiye,Melaka,0,0,0
1/12/2020,Türkiye,Negeri Sembilan,0,0,0
1/12/2020,Türkiye,Pahang,0,0,0
1/12/2020,Türkiye,Perak,0,0,0
1/12/2020,Türkiye,Perlis,0,0,0
1/12/2020,Türkiye,Pulau Pinang,0,0,0
1/12/2020,Türkiye,Sabah,0,0,0
1/12/2020,Türkiye,Sarawak,0,0,0
1/12/2020,Türkiye,Selangor,5,4,1
1/12/2020,Türkiye,W.P. Labuan,0,0,0
1/12/2020,Tuvalu,Selangor,0,0,0
1/12/2020,"Taiwan, Province of China",Johor,0,0,0
1/12/2020,"Taiwan, Province of China",Kedah,0,0,0
1/12/2020,"Taiwan, Province of China",Kelantan,0,0,0
1/12/2020,"Taiwan, Province of China",Melaka,0,0,0
1/12/2020,"Taiwan, Province of China",Negeri Sembilan,0,0,0
1/12/2020,"Taiwan, Province of China",Pahang,0,0,0
1/12/2020,"Taiwan, Province of China",Perak,0,0,0
1/12/2020,"Taiwan, Province of China",Perlis,0,0,0
1/12/2020,"Taiwan, Province of China",Pulau Pinang,10,5,5
1/12/2020,"Taiwan, Province of China",Sabah,0,0,0
1/12/2020,"Taiwan, Province of China",Sarawak,4,4,0
1/12/2020,"Taiwan, Province of China",Selangor,71,51,20
1/12/2020,"Taiwan, Province of China",W.P. Labuan,0,0,0
1/12/2020,"Tanzania, United Republic of",Johor,0,0,0
1/12/2020,"Tanzania, United Republic of",Kedah,0,0,0
1/12/2020,"Tanzania, United Republic of",Perak,0,0,0
1/12/2020,"Tanzania, United Republic of",Perlis,0,0,0
1/12/2020,"Tanzania, United Republic of",Pulau Pinang,0,0,0
1/12/2020,"Tanzania, United Republic of",Sabah,0,0,0
1/12/2020,"Tanzania, United Republic of",Sarawak,0,0,0
1/12/2020,"Tanzania, United Republic of",Selangor,4,1,3
1/12/2020,Uganda,Johor,0,0,0
1/12/2020,Uganda,Kedah,0,0,0
1/12/2020,Uganda,Perak,0,0,0
1/12/2020,Uganda,Perlis,0,0,0
1/12/2020,Uganda,Pulau Pinang,0,0,0
1/12/2020,Uganda,Sabah,0,0,0
1/12/2020,Uganda,Sarawak,0,0,0
1/12/2020,Uganda,Selangor,1,1,0
1/12/2020,Ukraine,Johor,34,34,0
1/12/2020,Ukraine,Kedah,0,0,0
1/12/2020,Ukraine,Kelantan,0,0,0
1/12/2020,Ukraine,Melaka,10,10,0
1/12/2020,Ukraine,Negeri Sembilan,0,0,0
1/12/2020,Ukraine,Pahang,0,0,0
1/12/2020,Ukraine,Perak,0,0,0
1/12/2020,Ukraine,Perlis,0,0,0
1/12/2020,Ukraine,Pulau Pinang,0,0,0
1/12/2020,Ukraine,Sabah,0,0,0
1/12/2020,Ukraine,Sarawak,0,0,0
1/12/2020,Ukraine,Selangor,31,30,1
1/12/2020,Ukraine,W.P. Labuan,0,0,0
1/12/2020,Uruguay,Johor,0,0,0
1/12/2020,Uruguay,Kedah,0,0,0
1/12/2020,Uruguay,Kelantan,0,0,0
1/12/2020,Uruguay,Perak,0,0,0
1/12/2020,Uruguay,Perlis,0,0,0
1/12/2020,Uruguay,Pulau Pinang,0,0,0
1/12/2020,Uruguay,Sabah,0,0,0
1/12/2020,Uruguay,Sarawak,0,0,0
1/12/2020,Uruguay,Selangor,0,0,0
1/12/2020,Uruguay,W.P. Labuan,0,0,0
1/12/2020,United States of America,Johor,1,1,0
1/12/2020,United States of America,Kedah,0,0,0
1/12/2020,United States of America,Kelantan,0,0,0
1/12/2020,United States of America,Melaka,0,0,0
1/12/2020,United States of America,Negeri Sembilan,0,0,0
1/12/2020,United States of America,Pahang,0,0,0
1/12/2020,United States of America,Perak,0,0,0
1/12/2020,United States of America,Perlis,0,0,0
1/12/2020,United States of America,Pulau Pinang,8,5,3
1/12/2020,United States of America,Sabah,0,0,0
1/12/2020,United States of America,Sarawak,0,0,0
1/12/2020,United States of America,Selangor,113,74,39
1/12/2020,United States of America,Terengganu,0,0,0
1/12/2020,United States of America,W.P. Labuan,0,0,0
1/12/2020,Uzbekistan,Johor,1,0,1
1/12/2020,Uzbekistan,Kedah,0,0,0
1/12/2020,Uzbekistan,Kelantan,0,0,0
1/12/2020,Uzbekistan,Perak,0,0,0
1/12/2020,Uzbekistan,Perlis,0,0,0
1/12/2020,Uzbekistan,Pulau Pinang,0,0,0
1/12/2020,Uzbekistan,Sabah,0,0,0
1/12/2020,Uzbekistan,Sarawak,0,0,0
1/12/2020,Uzbekistan,Selangor,3,2,1
1/12/2020,Holy See,Johor,0,0,0
1/12/2020,Holy See,Sarawak,0,0,0
1/12/2020,Holy See,Selangor,0,0,0
1/12/2020,Saint Vincent and the Grenadines,Johor,0,0,0
1/12/2020,Saint Vincent and the Grenadines,Kedah,0,0,0
1/12/2020,Saint Vincent and the Grenadines,Pulau Pinang,0,0,0
1/12/2020,Saint Vincent and the Grenadines,Sarawak,0,0,0
1/12/2020,Saint Vincent and the Grenadines,Selangor,0,0,0
1/12/2020,"Venezuela, Bolivarian Republic of",Johor,0,0,0
1/12/2020,"Venezuela, Bolivarian Republic of",Kedah,0,0,0
1/12/2020,"Venezuela, Bolivarian Republic of",Kelantan,0,0,0
1/12/2020,"Venezuela, Bolivarian Republic of",Melaka,0,0,0
1/12/2020,"Venezuela, Bolivarian Republic of",Perak,0,0,0
1/12/2020,"Venezuela, Bolivarian Republic of",Perlis,0,0,0
1/12/2020,"Venezuela, Bolivarian Republic of",Pulau Pinang,0,0,0
1/12/2020,"Venezuela, Bolivarian Republic of",Sabah,0,0,0
1/12/2020,"Venezuela, Bolivarian Republic of",Sarawak,0,0,0
1/12/2020,"Venezuela, Bolivarian Republic of",Selangor,1,1,0
1/12/2020,"Venezuela, Bolivarian Republic of",W.P. Labuan,0,0,0
1/12/2020,Viet Nam,Johor,2,0,2
1/12/2020,Viet Nam,Kedah,0,0,0
1/12/2020,Viet Nam,Kelantan,0,0,0
1/12/2020,Viet Nam,Melaka,0,0,0
1/12/2020,Viet Nam,Negeri Sembilan,0,0,0
1/12/2020,Viet Nam,Pahang,0,0,0
1/12/2020,Viet Nam,Perak,0,0,0
1/12/2020,Viet Nam,Perlis,0,0,0
1/12/2020,Viet Nam,Pulau Pinang,0,0,0
1/12/2020,Viet Nam,Sabah,0,0,0
1/12/2020,Viet Nam,Sarawak,1,1,0
1/12/2020,Viet Nam,Selangor,73,32,41
1/12/2020,Viet Nam,Terengganu,20,20,0
1/12/2020,Viet Nam,W.P. Labuan,0,0,0
1/12/2020,Vanuatu,Johor,0,0,0
1/12/2020,Vanuatu,Kedah,0,0,0
1/12/2020,Vanuatu,Pulau Pinang,0,0,0
1/12/2020,Vanuatu,Sabah,0,0,0
1/12/2020,Vanuatu,Sarawak,0,0,0
1/12/2020,Vanuatu,Selangor,0,0,0
1/12/2020, Samoa,Johor,0,0,0
1/12/2020, Samoa,Sarawak,0,0,0
1/12/2020, Samoa,Selangor,0,0,0
1/12/2020,Yemen,Johor,4,4,0
1/12/2020,Yemen,Kedah,0,0,0
1/12/2020,Yemen,Kelantan,0,0,0
1/12/2020,Yemen,Melaka,0,0,0
1/12/2020,Yemen,Pahang,0,0,0
1/12/2020,Yemen,Perak,0,0,0
1/12/2020,Yemen,Perlis,0,0,0
1/12/2020,Yemen,Pulau Pinang,0,0,0
1/12/2020,Yemen,Sabah,0,0,0
1/12/2020,Yemen,Sarawak,0,0,0
1/12/2020,Yemen,Selangor,24,19,5
1/12/2020,Yemen,W.P. Labuan,0,0,0
1/12/2020,South Africa,Johor,5,5,0
1/12/2020,South Africa,Kedah,0,0,0
1/12/2020,South Africa,Kelantan,0,0,0
1/12/2020,South Africa,Melaka,0,0,0
1/12/2020,South Africa,Pahang,0,0,0
1/12/2020,South Africa,Perak,0,0,0
1/12/2020,South Africa,Perlis,0,0,0
1/12/2020,South Africa,Pulau Pinang,0,0,0
1/12/2020,South Africa,Sabah,0,0,0
1/12/2020,South Africa,Sarawak,1,0,1
1/12/2020,South Africa,Selangor,20,12,8
1/12/2020,South Africa,Terengganu,0,0,0
1/12/2020,South Africa,W.P. Labuan,0,0,0
1/12/2020,ZAR,Selangor,0,0,0
1/12/2020,Zambia,Johor,0,0,0
1/12/2020,Zambia,Kedah,0,0,0
1/12/2020,Zambia,Perak,0,0,0
1/12/2020,Zambia,Perlis,0,0,0
1/12/2020,Zambia,Pulau Pinang,0,0,0
1/12/2020,Zambia,Sabah,0,0,0
1/12/2020,Zambia,Sarawak,0,0,0
1/12/2020,Zambia,Selangor,4,3,1
1/12/2020,Zimbabwe,Johor,0,0,0
1/12/2020,Zimbabwe,Kedah,0,0,0
1/12/2020,Zimbabwe,Kelantan,0,0,0
1/12/2020,Zimbabwe,Perak,0,0,0
1/12/2020,Zimbabwe,Perlis,0,0,0
1/12/2020,Zimbabwe,Pulau Pinang,0,0,0
1/12/2020,Zimbabwe,Sabah,0,0,0
1/12/2020,Zimbabwe,Sarawak,0,0,0
1/12/2020,Zimbabwe,Selangor,2,1,1
1/01/2021,Aruba,Kedah,0,0,0
1/01/2021,Aruba,Pulau Pinang,0,0,0
1/01/2021,Afghanistan,Johor,0,0,0
1/01/2021,Afghanistan,Kedah,0,0,0
1/01/2021,Afghanistan,Perlis,0,0,0
1/01/2021,Afghanistan,Pulau Pinang,0,0,0
1/01/2021,Afghanistan,Sarawak,0,0,0
1/01/2021,Afghanistan,Selangor,15,10,5
1/01/2021,Angola,Johor,0,0,0
1/01/2021,Angola,Kedah,0,0,0
1/01/2021,Angola,Sabah,0,0,0
1/01/2021,Angola,Selangor,0,0,0
1/01/2021,Anguilla,Selangor,0,0,0
1/01/2021,Albania,Johor,0,0,0
1/01/2021,Albania,Kedah,0,0,0
1/01/2021,Albania,Perak,0,0,0
1/01/2021,Albania,Perlis,0,0,0
1/01/2021,Albania,Pulau Pinang,0,0,0
1/01/2021,Albania,Sabah,0,0,0
1/01/2021,Albania,Sarawak,0,0,0
1/01/2021,Albania,Selangor,1,1,0
1/01/2021,Andorra,Johor,0,0,0
1/01/2021,Andorra,Kedah,0,0,0
1/01/2021,Andorra,Perlis,0,0,0
1/01/2021,Andorra,Pulau Pinang,0,0,0
1/01/2021,Andorra,Selangor,0,0,0
1/01/2021,Antigua and Barbuda,Selangor,0,0,0
1/01/2021,United Arab Emirates,Johor,0,0,0
1/01/2021,United Arab Emirates,Kedah,0,0,0
1/01/2021,United Arab Emirates,Kelantan,0,0,0
1/01/2021,United Arab Emirates,Perak,0,0,0
1/01/2021,United Arab Emirates,Perlis,0,0,0
1/01/2021,United Arab Emirates,Pulau Pinang,0,0,0
1/01/2021,United Arab Emirates,Sabah,0,0,0
1/01/2021,United Arab Emirates,Sarawak,0,0,0
1/01/2021,United Arab Emirates,Selangor,8,7,1
1/01/2021,Argentina,Johor,0,0,0
1/01/2021,Argentina,Kedah,0,0,0
1/01/2021,Argentina,Kelantan,0,0,0
1/01/2021,Argentina,Melaka,0,0,0
1/01/2021,Argentina,Perak,0,0,0
1/01/2021,Argentina,Perlis,0,0,0
1/01/2021,Argentina,Pulau Pinang,0,0,0
1/01/2021,Argentina,Sabah,0,0,0
1/01/2021,Argentina,Sarawak,0,0,0
1/01/2021,Argentina,Selangor,13,4,9
1/01/2021,Argentina,W.P. Labuan,0,0,0
1/01/2021,Armenia,Johor,0,0,0
1/01/2021,Armenia,Kedah,0,0,0
1/01/2021,Armenia,Kelantan,0,0,0
1/01/2021,Armenia,Perak,0,0,0
1/01/2021,Armenia,Perlis,0,0,0
1/01/2021,Armenia,Pulau Pinang,0,0,0
1/01/2021,Armenia,Sabah,0,0,0
1/01/2021,Armenia,Sarawak,0,0,0
1/01/2021,Armenia,Selangor,0,0,0
1/01/2021,Antarctica,Selangor,0,0,0
1/01/2021,Antigua and Barbuda,Johor,0,0,0
1/01/2021,Antigua and Barbuda,Kedah,0,0,0
1/01/2021,Antigua and Barbuda,Pulau Pinang,0,0,0
1/01/2021,Antigua and Barbuda,Sarawak,0,0,0
1/01/2021,Antigua and Barbuda,Selangor,0,0,0
1/01/2021,Australia,Johor,9,5,4
1/01/2021,Australia,Kedah,0,0,0
1/01/2021,Australia,Kelantan,0,0,0
1/01/2021,Australia,Melaka,0,0,0
1/01/2021,Australia,Negeri Sembilan,0,0,0
1/01/2021,Australia,Pahang,0,0,0
1/01/2021,Australia,Perak,1,1,0
1/01/2021,Australia,Perlis,0,0,0
1/01/2021,Australia,Pulau Pinang,5,2,3
1/01/2021,Australia,Sabah,0,0,0
1/01/2021,Australia,Sarawak,2,2,0
1/01/2021,Australia,Selangor,135,89,46
1/01/2021,Australia,Terengganu,0,0,0
1/01/2021,Australia,W.P. Labuan,0,0,0
1/01/2021,Austria,Johor,0,0,0
1/01/2021,Austria,Kedah,0,0,0
1/01/2021,Austria,Kelantan,0,0,0
1/01/2021,Austria,Melaka,0,0,0
1/01/2021,Austria,Negeri Sembilan,0,0,0
1/01/2021,Austria,Pahang,0,0,0
1/01/2021,Austria,Perak,0,0,0
1/01/2021,Austria,Perlis,0,0,0
1/01/2021,Austria,Pulau Pinang,0,0,0
1/01/2021,Austria,Sabah,0,0,0
1/01/2021,Austria,Sarawak,0,0,0
1/01/2021,Austria,Selangor,19,14,5
1/01/2021,Austria,Terengganu,0,0,0
1/01/2021,Austria,W.P. Labuan,0,0,0
1/01/2021,Azerbaijan,Johor,0,0,0
1/01/2021,Azerbaijan,Kedah,0,0,0
1/01/2021,Azerbaijan,Kelantan,0,0,0
1/01/2021,Azerbaijan,Melaka,0,0,0
1/01/2021,Azerbaijan,Perlis,0,0,0
1/01/2021,Azerbaijan,Pulau Pinang,0,0,0
1/01/2021,Azerbaijan,Sabah,0,0,0
1/01/2021,Azerbaijan,Sarawak,0,0,0
1/01/2021,Azerbaijan,Selangor,1,1,0
1/01/2021,Azerbaijan,W.P. Labuan,0,0,0
1/01/2021,Burundi,Pulau Pinang,0,0,0
1/01/2021,Burundi,Sarawak,0,0,0
1/01/2021,Burundi,Selangor,0,0,0
1/01/2021,Belgium,Johor,0,0,0
1/01/2021,Belgium,Kedah,0,0,0
1/01/2021,Belgium,Kelantan,0,0,0
1/01/2021,Belgium,Melaka,0,0,0
1/01/2021,Belgium,Negeri Sembilan,0,0,0
1/01/2021,Belgium,Pahang,0,0,0
1/01/2021,Belgium,Perak,0,0,0
1/01/2021,Belgium,Perlis,0,0,0
1/01/2021,Belgium,Pulau Pinang,0,0,0
1/01/2021,Belgium,Sabah,0,0,0
1/01/2021,Belgium,Sarawak,0,0,0
1/01/2021,Belgium,Selangor,21,14,7
1/01/2021,Belgium,W.P. Labuan,0,0,0
1/01/2021,Benin,Johor,0,0,0
1/01/2021,Benin,Kedah,0,0,0
1/01/2021,Benin,Perak,0,0,0
1/01/2021,Benin,Pulau Pinang,0,0,0
1/01/2021,Benin,Sabah,0,0,0
1/01/2021,Benin,Sarawak,0,0,0
1/01/2021,Benin,Selangor,0,0,0
1/01/2021,Burkina Faso,Perak,0,0,0
1/01/2021,Burkina Faso,Pulau Pinang,0,0,0
1/01/2021,Burkina Faso,Selangor,0,0,0
1/01/2021,Bangladesh,Johor,7,7,0
1/01/2021,Bangladesh,Kedah,0,0,0
1/01/2021,Bangladesh,Kelantan,0,0,0
1/01/2021,Bangladesh,Melaka,0,0,0
1/01/2021,Bangladesh,Negeri Sembilan,0,0,0
1/01/2021,Bangladesh,Pahang,0,0,0
1/01/2021,Bangladesh,Perak,0,0,0
1/01/2021,Bangladesh,Perlis,0,0,0
1/01/2021,Bangladesh,Pulau Pinang,0,0,0
1/01/2021,Bangladesh,Sabah,0,0,0
1/01/2021,Bangladesh,Sarawak,0,0,0
1/01/2021,Bangladesh,Selangor,99,94,5
1/01/2021,Bangladesh,W.P. Labuan,0,0,0
1/01/2021,Bulgaria,Johor,0,0,0
1/01/2021,Bulgaria,Kedah,0,0,0
1/01/2021,Bulgaria,Kelantan,0,0,0
1/01/2021,Bulgaria,Pahang,0,0,0
1/01/2021,Bulgaria,Perak,0,0,0
1/01/2021,Bulgaria,Perlis,0,0,0
1/01/2021,Bulgaria,Pulau Pinang,0,0,0
1/01/2021,Bulgaria,Sabah,0,0,0
1/01/2021,Bulgaria,Sarawak,0,0,0
1/01/2021,Bulgaria,Selangor,17,15,2
1/01/2021,Bulgaria,W.P. Labuan,0,0,0
1/01/2021,Bahrain,Johor,0,0,0
1/01/2021,Bahrain,Kedah,0,0,0
1/01/2021,Bahrain,Kelantan,0,0,0
1/01/2021,Bahrain,Perlis,0,0,0
1/01/2021,Bahrain,Pulau Pinang,0,0,0
1/01/2021,Bahrain,Sabah,0,0,0
1/01/2021,Bahrain,Sarawak,0,0,0
1/01/2021,Bahrain,Selangor,0,0,0
1/01/2021,Bahamas,Johor,0,0,0
1/01/2021,Bahamas,Kedah,0,0,0
1/01/2021,Bahamas,Perak,0,0,0
1/01/2021,Bahamas,Sabah,0,0,0
1/01/2021,Bahamas,Sarawak,0,0,0
1/01/2021,Bahamas,Selangor,0,0,0
1/01/2021,Bosnia and Herzegovina,Johor,0,0,0
1/01/2021,Bosnia and Herzegovina,Kedah,0,0,0
1/01/2021,Bosnia and Herzegovina,Perlis,0,0,0
1/01/2021,Bosnia and Herzegovina,Pulau Pinang,0,0,0
1/01/2021,Bosnia and Herzegovina,Sabah,0,0,0
1/01/2021,Bosnia and Herzegovina,Sarawak,0,0,0
1/01/2021,Bosnia and Herzegovina,Selangor,10,7,3
1/01/2021,Belarus,Johor,0,0,0
1/01/2021,Belarus,Kedah,0,0,0
1/01/2021,Belarus,Kelantan,0,0,0
1/01/2021,Belarus,Pahang,0,0,0
1/01/2021,Belarus,Perak,0,0,0
1/01/2021,Belarus,Perlis,0,0,0
1/01/2021,Belarus,Pulau Pinang,0,0,0
1/01/2021,Belarus,Sabah,0,0,0
1/01/2021,Belarus,Sarawak,0,0,0
1/01/2021,Belarus,Selangor,2,1,1
1/01/2021,Belarus,W.P. Labuan,0,0,0
1/01/2021,Belize,Johor,0,0,0
1/01/2021,Belize,Pulau Pinang,0,0,0
1/01/2021,Belize,Sarawak,0,0,0
1/01/2021,Belize,Selangor,1,1,0
1/01/2021,Bermuda,Selangor,0,0,0
1/01/2021,Bolivia,Johor,0,0,0
1/01/2021,Bolivia,Kedah,0,0,0
1/01/2021,Bolivia,Melaka,0,0,0
1/01/2021,Bolivia,Perak,0,0,0
1/01/2021,Bolivia,Perlis,0,0,0
1/01/2021,Bolivia,Pulau Pinang,0,0,0
1/01/2021,Bolivia,Sabah,0,0,0
1/01/2021,Bolivia,Sarawak,0,0,0
1/01/2021,Bolivia,Selangor,0,0,0
1/01/2021,Brazil,Johor,0,0,0
1/01/2021,Brazil,Kedah,0,0,0
1/01/2021,Brazil,Kelantan,0,0,0
1/01/2021,Brazil,Melaka,0,0,0
1/01/2021,Brazil,Pahang,0,0,0
1/01/2021,Brazil,Perak,0,0,0
1/01/2021,Brazil,Perlis,0,0,0
1/01/2021,Brazil,Pulau Pinang,0,0,0
1/01/2021,Brazil,Sabah,0,0,0
1/01/2021,Brazil,Sarawak,0,0,0
1/01/2021,Brazil,Selangor,35,25,10
1/01/2021,Brazil,W.P. Labuan,0,0,0
1/01/2021,Barbados,Johor,0,0,0
1/01/2021,Barbados,Kedah,0,0,0
1/01/2021,Barbados,Perlis,0,0,0
1/01/2021,Barbados,Pulau Pinang,0,0,0
1/01/2021,Barbados,Selangor,1,1,0
1/01/2021,Brunei Darussalam,Johor,1,1,0
1/01/2021,Brunei Darussalam,Kedah,0,0,0
1/01/2021,Brunei Darussalam,Kelantan,0,0,0
1/01/2021,Brunei Darussalam,Melaka,0,0,0
1/01/2021,Brunei Darussalam,Pahang,0,0,0
1/01/2021,Brunei Darussalam,Perak,0,0,0
1/01/2021,Brunei Darussalam,Perlis,0,0,0
1/01/2021,Brunei Darussalam,Pulau Pinang,0,0,0
1/01/2021,Brunei Darussalam,Sabah,0,0,0
1/01/2021,Brunei Darussalam,Sarawak,326,322,4
1/01/2021,Brunei Darussalam,Selangor,8,7,1
1/01/2021,Brunei Darussalam,W.P. Labuan,2,2,0
1/01/2021,Bhutan,Johor,0,0,0
1/01/2021,Bhutan,Kedah,0,0,0
1/01/2021,Bhutan,Perak,0,0,0
1/01/2021,Bhutan,Perlis,0,0,0
1/01/2021,Bhutan,Pulau Pinang,0,0,0
1/01/2021,Bhutan,Sabah,0,0,0
1/01/2021,Bhutan,Sarawak,0,0,0
1/01/2021,Bhutan,Selangor,0,0,0
1/01/2021,Botswana,Johor,0,0,0
1/01/2021,Botswana,Kedah,0,0,0
1/01/2021,Botswana,Perlis,0,0,0
1/01/2021,Botswana,Pulau Pinang,0,0,0
1/01/2021,Botswana,Sabah,0,0,0
1/01/2021,Botswana,Sarawak,0,0,0
1/01/2021,Botswana,Selangor,0,0,0
1/01/2021,Central African Republic,Kedah,0,0,0
1/01/2021,Central African Republic,Selangor,0,0,0
1/01/2021,Canada,Johor,2,2,0
1/01/2021,Canada,Kedah,0,0,0
1/01/2021,Canada,Kelantan,0,0,0
1/01/2021,Canada,Melaka,0,0,0
1/01/2021,Canada,Negeri Sembilan,0,0,0
1/01/2021,Canada,Pahang,0,0,0
1/01/2021,Canada,Perak,0,0,0
1/01/2021,Canada,Perlis,0,0,0
1/01/2021,Canada,Pulau Pinang,0,0,0
1/01/2021,Canada,Sabah,0,0,0
1/01/2021,Canada,Sarawak,0,0,0
1/01/2021,Canada,Selangor,81,53,28
1/01/2021,Canada,Terengganu,0,0,0
1/01/2021,Canada,W.P. Labuan,0,0,0
1/01/2021,Cocos (Keeling) Islands,Selangor,0,0,0
1/01/2021,Switzerland,Johor,1,0,1
1/01/2021,Switzerland,Kedah,0,0,0
1/01/2021,Switzerland,Kelantan,0,0,0
1/01/2021,Switzerland,Melaka,0,0,0
1/01/2021,Switzerland,Negeri Sembilan,0,0,0
1/01/2021,Switzerland,Pahang,0,0,0
1/01/2021,Switzerland,Perak,0,0,0
1/01/2021,Switzerland,Perlis,0,0,0
1/01/2021,Switzerland,Pulau Pinang,1,1,0
1/01/2021,Switzerland,Sabah,0,0,0
1/01/2021,Switzerland,Sarawak,0,0,0
1/01/2021,Switzerland,Selangor,14,6,8
1/01/2021,Switzerland,W.P. Labuan,0,0,0
1/01/2021,Chile,Johor,0,0,0
1/01/2021,Chile,Kedah,0,0,0
1/01/2021,Chile,Kelantan,0,0,0
1/01/2021,Chile,Melaka,0,0,0
1/01/2021,Chile,Pahang,0,0,0
1/01/2021,Chile,Perak,0,0,0
1/01/2021,Chile,Perlis,0,0,0
1/01/2021,Chile,Pulau Pinang,0,0,0
1/01/2021,Chile,Sabah,0,0,0
1/01/2021,Chile,Sarawak,0,0,0
1/01/2021,Chile,Selangor,1,1,0
1/01/2021,China,Johor,24,22,2
1/01/2021,China,Kedah,0,0,0
1/01/2021,China,Kelantan,0,0,0
1/01/2021,China,Melaka,0,0,0
1/01/2021,China,Pahang,0,0,0
1/01/2021,China,Perak,0,0,0
1/01/2021,China,Perlis,0,0,0
1/01/2021,China,Pulau Pinang,3,3,0
1/01/2021,China,Sabah,0,0,0
1/01/2021,China,Sarawak,209,200,9
1/01/2021,China,Selangor,870,717,153
1/01/2021,China,Terengganu,0,0,0
1/01/2021,China,W.P. Labuan,0,0,0
1/01/2021,Côte d'Ivoire,Johor,0,0,0
1/01/2021,Côte d'Ivoire,Kedah,0,0,0
1/01/2021,Côte d'Ivoire,Pulau Pinang,0,0,0
1/01/2021,Côte d'Ivoire,Sabah,0,0,0
1/01/2021,Côte d'Ivoire,Sarawak,0,0,0
1/01/2021,Côte d'Ivoire,Selangor,1,1,0
1/01/2021,Cameroon,Johor,0,0,0
1/01/2021,Cameroon,Kedah,0,0,0
1/01/2021,Cameroon,Pulau Pinang,0,0,0
1/01/2021,Cameroon,Sabah,0,0,0
1/01/2021,Cameroon,Sarawak,0,0,0
1/01/2021,Cameroon,Selangor,2,1,1
1/01/2021,Congo,Johor,0,0,0
1/01/2021,Congo,Pulau Pinang,0,0,0
1/01/2021,Congo,Sarawak,0,0,0
1/01/2021,Congo,Selangor,0,0,0
1/01/2021,Congo,Johor,0,0,0
1/01/2021,Congo,Kedah,0,0,0
1/01/2021,Congo,Selangor,0,0,0
1/01/2021,Cook Islands,Selangor,0,0,0
1/01/2021,Colombia,Johor,0,0,0
1/01/2021,Colombia,Kedah,0,0,0
1/01/2021,Colombia,Perak,0,0,0
1/01/2021,Colombia,Pulau Pinang,0,0,0
1/01/2021,Colombia,Sabah,0,0,0
1/01/2021,Colombia,Sarawak,0,0,0
1/01/2021,Colombia,Selangor,6,1,5
1/01/2021,Colombia,W.P. Labuan,0,0,0
1/01/2021,Comoros,Johor,0,0,0
1/01/2021,Comoros,Kedah,0,0,0
1/01/2021,Comoros,Selangor,0,0,0
1/01/2021,Cabo Verde,Johor,0,0,0
1/01/2021,Cabo Verde,Kedah,0,0,0
1/01/2021,Cabo Verde,Pulau Pinang,0,0,0
1/01/2021,Cabo Verde,Sabah,0,0,0
1/01/2021,Cabo Verde,Selangor,0,0,0
1/01/2021,Costa Rica,Johor,0,0,0
1/01/2021,Costa Rica,Kedah,0,0,0
1/01/2021,Costa Rica,Perak,0,0,0
1/01/2021,Costa Rica,Perlis,0,0,0
1/01/2021,Costa Rica,Pulau Pinang,0,0,0
1/01/2021,Costa Rica,Sabah,0,0,0
1/01/2021,Costa Rica,Sarawak,0,0,0
1/01/2021,Costa Rica,Selangor,21,11,10
1/01/2021,Cuba,Johor,0,0,0
1/01/2021,Cuba,Kedah,0,0,0
1/01/2021,Cuba,Perlis,0,0,0
1/01/2021,Cuba,Pulau Pinang,0,0,0
1/01/2021,Cuba,Sabah,0,0,0
1/01/2021,Cuba,Sarawak,0,0,0
1/01/2021,Cuba,Selangor,0,0,0
1/01/2021,Cyprus,Johor,0,0,0
1/01/2021,Cyprus,Kedah,0,0,0
1/01/2021,Cyprus,Perak,0,0,0
1/01/2021,Cyprus,Perlis,0,0,0
1/01/2021,Cyprus,Pulau Pinang,0,0,0
1/01/2021,Cyprus,Sabah,0,0,0
1/01/2021,Cyprus,Sarawak,0,0,0
1/01/2021,Cyprus,Selangor,0,0,0
1/01/2021,Czechia,Johor,0,0,0
1/01/2021,Czechia,Kedah,0,0,0
1/01/2021,Czechia,Kelantan,0,0,0
1/01/2021,Czechia,Melaka,0,0,0
1/01/2021,Czechia,Negeri Sembilan,0,0,0
1/01/2021,Czechia,Perak,0,0,0
1/01/2021,Czechia,Perlis,0,0,0
1/01/2021,Czechia,Pulau Pinang,0,0,0
1/01/2021,Czechia,Sabah,0,0,0
1/01/2021,Czechia,Sarawak,0,0,0
1/01/2021,Czechia,Selangor,11,11,0
1/01/2021,Czechia,W.P. Labuan,0,0,0
1/01/2021,Germany,Johor,1,1,0
1/01/2021,Germany,Kedah,0,0,0
1/01/2021,Germany,Kelantan,0,0,0
1/01/2021,Germany,Melaka,0,0,0
1/01/2021,Germany,Negeri Sembilan,0,0,0
1/01/2021,Germany,Pahang,0,0,0
1/01/2021,Germany,Perak,0,0,0
1/01/2021,Germany,Perlis,0,0,0
1/01/2021,Germany,Pulau Pinang,0,0,0
1/01/2021,Germany,Sabah,0,0,0
1/01/2021,Germany,Sarawak,0,0,0
1/01/2021,Germany,Selangor,96,79,17
1/01/2021,Germany,Terengganu,0,0,0
1/01/2021,Germany,W.P. Labuan,0,0,0
1/01/2021,Djibouti,Johor,0,0,0
1/01/2021,Djibouti,Selangor,0,0,0
1/01/2021,Dominica,Johor,0,0,0
1/01/2021,Dominica,Kedah,0,0,0
1/01/2021,Dominica,Pulau Pinang,0,0,0
1/01/2021,Dominica,Sabah,0,0,0
1/01/2021,Dominica,Sarawak,0,0,0
1/01/2021,Dominica,Selangor,1,1,0
1/01/2021,Dominica,W.P. Labuan,0,0,0
1/01/2021,Denmark,Johor,0,0,0
1/01/2021,Denmark,Kedah,0,0,0
1/01/2021,Denmark,Kelantan,0,0,0
1/01/2021,Denmark,Melaka,0,0,0
1/01/2021,Denmark,Negeri Sembilan,0,0,0
1/01/2021,Denmark,Pahang,0,0,0
1/01/2021,Denmark,Perak,0,0,0
1/01/2021,Denmark,Perlis,0,0,0
1/01/2021,Denmark,Pulau Pinang,0,0,0
1/01/2021,Denmark,Sabah,0,0,0
1/01/2021,Denmark,Sarawak,0,0,0
1/01/2021,Denmark,Selangor,26,18,8
1/01/2021,Denmark,W.P. Labuan,0,0,0
1/01/2021,Dominican Republic,Johor,0,0,0
1/01/2021,Dominican Republic,Kedah,0,0,0
1/01/2021,Dominican Republic,Perak,0,0,0
1/01/2021,Dominican Republic,Perlis,0,0,0
1/01/2021,Dominican Republic,Pulau Pinang,0,0,0
1/01/2021,Dominican Republic,Sabah,0,0,0
1/01/2021,Dominican Republic,Sarawak,0,0,0
1/01/2021,Dominican Republic,Selangor,0,0,0
1/01/2021,Algeria,Johor,0,0,0
1/01/2021,Algeria,Kedah,0,0,0
1/01/2021,Algeria,Kelantan,0,0,0
1/01/2021,Algeria,Melaka,0,0,0
1/01/2021,Algeria,Perak,0,0,0
1/01/2021,Algeria,Perlis,0,0,0
1/01/2021,Algeria,Pulau Pinang,0,0,0
1/01/2021,Algeria,Sabah,0,0,0
1/01/2021,Algeria,Sarawak,0,0,0
1/01/2021,Algeria,Selangor,9,5,4
1/01/2021,Algeria,W.P. Labuan,0,0,0
1/01/2021,Ecuador,Johor,0,0,0
1/01/2021,Ecuador,Kedah,0,0,0
1/01/2021,Ecuador,Perak,0,0,0
1/01/2021,Ecuador,Perlis,0,0,0
1/01/2021,Ecuador,Pulau Pinang,0,0,0
1/01/2021,Ecuador,Sabah,0,0,0
1/01/2021,Ecuador,Sarawak,0,0,0
1/01/2021,Ecuador,Selangor,0,0,0
1/01/2021,Egypt,Johor,0,0,0
1/01/2021,Egypt,Kedah,0,0,0
1/01/2021,Egypt,Kelantan,0,0,0
1/01/2021,Egypt,Melaka,0,0,0
1/01/2021,Egypt,Pahang,0,0,0
1/01/2021,Egypt,Perak,0,0,0
1/01/2021,Egypt,Perlis,0,0,0
1/01/2021,Egypt,Pulau Pinang,0,0,0
1/01/2021,Egypt,Sabah,0,0,0
1/01/2021,Egypt,Sarawak,0,0,0
1/01/2021,Egypt,Selangor,40,30,10
1/01/2021,Egypt,Terengganu,0,0,0
1/01/2021,Egypt,W.P. Labuan,0,0,0
1/01/2021,Eritrea,Johor,0,0,0
1/01/2021,Eritrea,Pulau Pinang,0,0,0
1/01/2021,Eritrea,Sabah,0,0,0
1/01/2021,Eritrea,Selangor,0,0,0
1/01/2021,Spain,Johor,0,0,0
1/01/2021,Spain,Kedah,0,0,0
1/01/2021,Spain,Kelantan,0,0,0
1/01/2021,Spain,Melaka,0,0,0
1/01/2021,Spain,Negeri Sembilan,0,0,0
1/01/2021,Spain,Pahang,0,0,0
1/01/2021,Spain,Perak,0,0,0
1/01/2021,Spain,Perlis,0,0,0
1/01/2021,Spain,Pulau Pinang,1,1,0
1/01/2021,Spain,Sabah,0,0,0
1/01/2021,Spain,Sarawak,0,0,0
1/01/2021,Spain,Selangor,19,12,7
1/01/2021,Spain,W.P. Labuan,0,0,0
1/01/2021,Estonia,Johor,0,0,0
1/01/2021,Estonia,Kedah,0,0,0
1/01/2021,Estonia,Kelantan,0,0,0
1/01/2021,Estonia,Pahang,0,0,0
1/01/2021,Estonia,Perak,0,0,0
1/01/2021,Estonia,Perlis,0,0,0
1/01/2021,Estonia,Pulau Pinang,0,0,0
1/01/2021,Estonia,Sabah,0,0,0
1/01/2021,Estonia,Sarawak,0,0,0
1/01/2021,Estonia,Selangor,1,1,0
1/01/2021,Estonia,W.P. Labuan,0,0,0
1/01/2021,Ethiopia,Johor,0,0,0
1/01/2021,Ethiopia,Kedah,0,0,0
1/01/2021,Ethiopia,Pulau Pinang,0,0,0
1/01/2021,Ethiopia,Sarawak,0,0,0
1/01/2021,Ethiopia,Selangor,0,0,0
1/01/2021,Finland,Johor,0,0,0
1/01/2021,Finland,Kedah,0,0,0
1/01/2021,Finland,Kelantan,0,0,0
1/01/2021,Finland,Melaka,0,0,0
1/01/2021,Finland,Negeri Sembilan,0,0,0
1/01/2021,Finland,Pahang,0,0,0
1/01/2021,Finland,Perak,0,0,0
1/01/2021,Finland,Perlis,0,0,0
1/01/2021,Finland,Pulau Pinang,0,0,0
1/01/2021,Finland,Sabah,0,0,0
1/01/2021,Finland,Sarawak,0,0,0
1/01/2021,Finland,Selangor,9,6,3
1/01/2021,Finland,W.P. Labuan,0,0,0
1/01/2021,Fiji,Johor,0,0,0
1/01/2021,Fiji,Kedah,0,0,0
1/01/2021,Fiji,Kelantan,0,0,0
1/01/2021,Fiji,Perak,0,0,0
1/01/2021,Fiji,Perlis,0,0,0
1/01/2021,Fiji,Pulau Pinang,0,0,0
1/01/2021,Fiji,Sabah,0,0,0
1/01/2021,Fiji,Sarawak,0,0,0
1/01/2021,Fiji,Selangor,0,0,0
1/01/2021,France,Johor,2,2,0
1/01/2021,France,Kedah,0,0,0
1/01/2021,France,Kelantan,0,0,0
1/01/2021,France,Melaka,0,0,0
1/01/2021,France,Negeri Sembilan,0,0,0
1/01/2021,France,Pahang,0,0,0
1/01/2021,France,Perak,0,0,0
1/01/2021,France,Perlis,0,0,0
1/01/2021,France,Pulau Pinang,0,0,0
1/01/2021,France,Sabah,0,0,0
1/01/2021,France,Sarawak,0,0,0
1/01/2021,France,Selangor,117,86,31
1/01/2021,France,Terengganu,0,0,0
1/01/2021,France,W.P. Labuan,0,0,0
1/01/2021,"Micronesia, Federated States of",Johor,0,0,0
1/01/2021,"Micronesia, Federated States of",Pulau Pinang,0,0,0
1/01/2021,"Micronesia, Federated States of",Selangor,0,0,0
1/01/2021,Gabon,Johor,0,0,0
1/01/2021,Gabon,Pulau Pinang,0,0,0
1/01/2021,Gabon,Sarawak,0,0,0
1/01/2021,Gabon,Selangor,1,1,0
1/01/2021,United Kingdom of Great Britain and Northern Ireland,Johor,10,9,1
1/01/2021,United Kingdom of Great Britain and Northern Ireland,Kedah,0,0,0
1/01/2021,United Kingdom of Great Britain and Northern Ireland,Kelantan,0,0,0
1/01/2021,United Kingdom of Great Britain and Northern Ireland,Melaka,0,0,0
1/01/2021,United Kingdom of Great Britain and Northern Ireland,Negeri Sembilan,0,0,0
1/01/2021,United Kingdom of Great Britain and Northern Ireland,Pahang,0,0,0
1/01/2021,United Kingdom of Great Britain and Northern Ireland,Perak,1,0,1
1/01/2021,United Kingdom of Great Britain and Northern Ireland,Perlis,0,0,0
1/01/2021,United Kingdom of Great Britain and Northern Ireland,Pulau Pinang,3,3,0
1/01/2021,United Kingdom of Great Britain and Northern Ireland,Sabah,0,0,0
1/01/2021,United Kingdom of Great Britain and Northern Ireland,Sarawak,1,1,0
1/01/2021,United Kingdom of Great Britain and Northern Ireland,Selangor,228,179,49
1/01/2021,United Kingdom of Great Britain and Northern Ireland,Terengganu,0,0,0
1/01/2021,United Kingdom of Great Britain and Northern Ireland,W.P. Labuan,0,0,0
1/01/2021,Georgia,Johor,0,0,0
1/01/2021,Georgia,Kedah,0,0,0
1/01/2021,Georgia,Melaka,0,0,0
1/01/2021,Georgia,Perak,0,0,0
1/01/2021,Georgia,Perlis,0,0,0
1/01/2021,Georgia,Pulau Pinang,0,0,0
1/01/2021,Georgia,Sabah,0,0,0
1/01/2021,Georgia,Sarawak,0,0,0
1/01/2021,Georgia,Selangor,2,2,0
1/01/2021,Ghana,Johor,0,0,0
1/01/2021,Ghana,Kedah,0,0,0
1/01/2021,Ghana,Kelantan,0,0,0
1/01/2021,Ghana,Pulau Pinang,0,0,0
1/01/2021,Ghana,Sabah,0,0,0
1/01/2021,Ghana,Sarawak,0,0,0
1/01/2021,Ghana,Selangor,7,7,0
1/01/2021,Gibraltar,Johor,0,0,0
1/01/2021,Gibraltar,Sarawak,0,0,0
1/01/2021,Guinea,Johor,0,0,0
1/01/2021,Guinea,Kedah,0,0,0
1/01/2021,Guinea,Kelantan,0,0,0
1/01/2021,Guinea,Perlis,0,0,0
1/01/2021,Guinea,Pulau Pinang,0,0,0
1/01/2021,Guinea,Sabah,0,0,0
1/01/2021,Guinea,Sarawak,0,0,0
1/01/2021,Guinea,Selangor,0,0,0
1/01/2021,Guadeloupe,Selangor,0,0,0
1/01/2021,Gambia,Johor,0,0,0
1/01/2021,Gambia,Kedah,0,0,0
1/01/2021,Gambia,Kelantan,0,0,0
1/01/2021,Gambia,Pulau Pinang,0,0,0
1/01/2021,Gambia,Sabah,0,0,0
1/01/2021,Gambia,Sarawak,0,0,0
1/01/2021,Gambia,Selangor,1,0,1
1/01/2021,Guinea-Bissau,Johor,0,0,0
1/01/2021,Guinea-Bissau,Selangor,0,0,0
1/01/2021,Equatorial Guinea,Johor,0,0,0
1/01/2021,Equatorial Guinea,Selangor,0,0,0
1/01/2021,Greece,Johor,0,0,0
1/01/2021,Greece,Kedah,0,0,0
1/01/2021,Greece,Kelantan,0,0,0
1/01/2021,Greece,Melaka,0,0,0
1/01/2021,Greece,Negeri Sembilan,0,0,0
1/01/2021,Greece,Pahang,0,0,0
1/01/2021,Greece,Perak,0,0,0
1/01/2021,Greece,Perlis,0,0,0
1/01/2021,Greece,Pulau Pinang,0,0,0
1/01/2021,Greece,Sabah,0,0,0
1/01/2021,Greece,Sarawak,0,0,0
1/01/2021,Greece,Selangor,1,1,0
1/01/2021,Grenada,Johor,0,0,0
1/01/2021,Grenada,Kedah,0,0,0
1/01/2021,Grenada,Pulau Pinang,0,0,0
1/01/2021,Grenada,Sabah,0,0,0
1/01/2021,Grenada,Sarawak,0,0,0
1/01/2021,Grenada,Selangor,0,0,0
1/01/2021,Greenland,Johor,0,0,0
1/01/2021,Greenland,Selangor,0,0,0
1/01/2021,Guatemala,Johor,0,0,0
1/01/2021,Guatemala,Kedah,0,0,0
1/01/2021,Guatemala,Pahang,0,0,0
1/01/2021,Guatemala,Perak,0,0,0
1/01/2021,Guatemala,Pulau Pinang,0,0,0
1/01/2021,Guatemala,Sabah,0,0,0
1/01/2021,Guatemala,Sarawak,0,0,0
1/01/2021,Guatemala,Selangor,0,0,0
1/01/2021,Guatemala,W.P. Labuan,0,0,0
1/01/2021,Guyana,Johor,0,0,0
1/01/2021,Guyana,Kedah,0,0,0
1/01/2021,Guyana,Pulau Pinang,0,0,0
1/01/2021,Guyana,Sarawak,0,0,0
1/01/2021,Guyana,Selangor,0,0,0
1/01/2021,Hong Kong,Johor,0,0,0
1/01/2021,Hong Kong,Kedah,0,0,0
1/01/2021,Hong Kong,Kelantan,0,0,0
1/01/2021,Hong Kong,Pahang,0,0,0
1/01/2021,Hong Kong,Perak,0,0,0
1/01/2021,Hong Kong,Perlis,0,0,0
1/01/2021,Hong Kong,Pulau Pinang,5,3,2
1/01/2021,Hong Kong,Sabah,0,0,0
1/01/2021,Hong Kong,Sarawak,0,0,0
1/01/2021,Hong Kong,Selangor,2,2,0
1/01/2021,Hong Kong,Terengganu,0,0,0
1/01/2021,Heard Island and McDonald Islands,Johor,0,0,0
1/01/2021,Honduras,Johor,0,0,0
1/01/2021,Honduras,Kedah,0,0,0
1/01/2021,Honduras,Perak,0,0,0
1/01/2021,Honduras,Pulau Pinang,0,0,0
1/01/2021,Honduras,Sabah,0,0,0
1/01/2021,Honduras,Sarawak,0,0,0
1/01/2021,Honduras,Selangor,1,0,1
1/01/2021,Croatia,Johor,12,12,0
1/01/2021,Croatia,Kedah,0,0,0
1/01/2021,Croatia,Kelantan,0,0,0
1/01/2021,Croatia,Melaka,0,0,0
1/01/2021,Croatia,Pahang,0,0,0
1/01/2021,Croatia,Perak,0,0,0
1/01/2021,Croatia,Perlis,0,0,0
1/01/2021,Croatia,Pulau Pinang,0,0,0
1/01/2021,Croatia,Sabah,0,0,0
1/01/2021,Croatia,Sarawak,0,0,0
1/01/2021,Croatia,Selangor,36,36,0
1/01/2021,Haiti,Johor,0,0,0
1/01/2021,Haiti,Kedah,0,0,0
1/01/2021,Haiti,Kelantan,0,0,0
1/01/2021,Haiti,Perak,0,0,0
1/01/2021,Haiti,Pulau Pinang,0,0,0
1/01/2021,Haiti,Sabah,0,0,0
1/01/2021,Haiti,Selangor,0,0,0
1/01/2021,Hungary,Johor,0,0,0
1/01/2021,Hungary,Kedah,0,0,0
1/01/2021,Hungary,Kelantan,0,0,0
1/01/2021,Hungary,Pahang,0,0,0
1/01/2021,Hungary,Perak,0,0,0
1/01/2021,Hungary,Perlis,0,0,0
1/01/2021,Hungary,Pulau Pinang,0,0,0
1/01/2021,Hungary,Sabah,0,0,0
1/01/2021,Hungary,Sarawak,0,0,0
1/01/2021,Hungary,Selangor,12,9,3
1/01/2021,Hungary,W.P. Labuan,0,0,0
1/01/2021,Indonesia,Johor,236,200,36
1/01/2021,Indonesia,Kedah,5,5,0
1/01/2021,Indonesia,Kelantan,0,0,0
1/01/2021,Indonesia,Melaka,0,0,0
1/01/2021,Indonesia,Negeri Sembilan,0,0,0
1/01/2021,Indonesia,Pahang,0,0,0
1/01/2021,Indonesia,Perak,0,0,0
1/01/2021,Indonesia,Perlis,4,3,1
1/01/2021,Indonesia,Pulau Pinang,16,5,11
1/01/2021,Indonesia,Sabah,4,0,4
1/01/2021,Indonesia,Sarawak,313,309,4
1/01/2021,Indonesia,Selangor,543,378,165
1/01/2021,Indonesia,Terengganu,0,0,0
1/01/2021,Indonesia,W.P. Labuan,2,2,0
1/01/2021,India,Johor,49,48,1
1/01/2021,India,Kedah,0,0,0
1/01/2021,India,Kelantan,0,0,0
1/01/2021,India,Melaka,0,0,0
1/01/2021,India,Negeri Sembilan,0,0,0
1/01/2021,India,Pahang,0,0,0
1/01/2021,India,Perak,0,0,0
1/01/2021,India,Perlis,0,0,0
1/01/2021,India,Pulau Pinang,1,1,0
1/01/2021,India,Sabah,0,0,0
1/01/2021,India,Sarawak,0,0,0
1/01/2021,India,Selangor,707,581,126
1/01/2021,India,Terengganu,0,0,0
1/01/2021,India,W.P. Labuan,0,0,0
1/01/2021, British Indian Ocean Territory,Pulau Pinang,0,0,0
1/01/2021, British Indian Ocean Territory,Selangor,0,0,0
1/01/2021,Ireland,Johor,0,0,0
1/01/2021,Ireland,Kedah,0,0,0
1/01/2021,Ireland,Kelantan,0,0,0
1/01/2021,Ireland,Negeri Sembilan,0,0,0
1/01/2021,Ireland,Pahang,0,0,0
1/01/2021,Ireland,Perak,0,0,0
1/01/2021,Ireland,Perlis,0,0,0
1/01/2021,Ireland,Pulau Pinang,0,0,0
1/01/2021,Ireland,Sabah,0,0,0
1/01/2021,Ireland,Sarawak,0,0,0
1/01/2021,Ireland,Selangor,15,12,3
1/01/2021,Ireland,Terengganu,0,0,0
1/01/2021,Ireland,W.P. Labuan,0,0,0
1/01/2021,"Iran, Islamic Republic of",Johor,0,0,0
1/01/2021,"Iran, Islamic Republic of",Kedah,0,0,0
1/01/2021,"Iran, Islamic Republic of",Kelantan,0,0,0
1/01/2021,"Iran, Islamic Republic of",Perak,0,0,0
1/01/2021,"Iran, Islamic Republic of",Perlis,0,0,0
1/01/2021,"Iran, Islamic Republic of",Pulau Pinang,0,0,0
1/01/2021,"Iran, Islamic Republic of",Sabah,0,0,0
1/01/2021,"Iran, Islamic Republic of",Sarawak,0,0,0
1/01/2021,"Iran, Islamic Republic of",Selangor,49,41,8
1/01/2021,"Iran, Islamic Republic of",W.P. Labuan,0,0,0
1/01/2021,Iraq,Johor,0,0,0
1/01/2021,Iraq,Kedah,0,0,0
1/01/2021,Iraq,Kelantan,0,0,0
1/01/2021,Iraq,Melaka,0,0,0
1/01/2021,Iraq,Pahang,0,0,0
1/01/2021,Iraq,Perak,0,0,0
1/01/2021,Iraq,Perlis,0,0,0
1/01/2021,Iraq,Pulau Pinang,0,0,0
1/01/2021,Iraq,Sabah,0,0,0
1/01/2021,Iraq,Sarawak,0,0,0
1/01/2021,Iraq,Selangor,11,9,2
1/01/2021,Iceland,Johor,0,0,0
1/01/2021,Iceland,Kedah,0,0,0
1/01/2021,Iceland,Kelantan,0,0,0
1/01/2021,Iceland,Perak,0,0,0
1/01/2021,Iceland,Perlis,0,0,0
1/01/2021,Iceland,Pulau Pinang,0,0,0
1/01/2021,Iceland,Sabah,0,0,0
1/01/2021,Iceland,Sarawak,0,0,0
1/01/2021,Iceland,Selangor,2,1,1
1/01/2021,Iceland,W.P. Labuan,0,0,0
1/01/2021,Israel,Pulau Pinang,0,0,0
1/01/2021,Italy,Johor,0,0,0
1/01/2021,Italy,Kedah,0,0,0
1/01/2021,Italy,Kelantan,0,0,0
1/01/2021,Italy,Melaka,0,0,0
1/01/2021,Italy,Negeri Sembilan,0,0,0
1/01/2021,Italy,Pahang,0,0,0
1/01/2021,Italy,Perak,0,0,0
1/01/2021,Italy,Perlis,0,0,0
1/01/2021,Italy,Pulau Pinang,0,0,0
1/01/2021,Italy,Sabah,0,0,0
1/01/2021,Italy,Sarawak,0,0,0
1/01/2021,Italy,Selangor,47,39,8
1/01/2021,Italy,W.P. Labuan,0,0,0
1/01/2021,Jamaica,Johor,0,0,0
1/01/2021,Jamaica,Kedah,0,0,0
1/01/2021,Jamaica,Perak,0,0,0
1/01/2021,Jamaica,Pulau Pinang,0,0,0
1/01/2021,Jamaica,Sabah,0,0,0
1/01/2021,Jamaica,Sarawak,0,0,0
1/01/2021,Jamaica,Selangor,0,0,0
1/01/2021,Jamaica,W.P. Labuan,0,0,0
1/01/2021,Jordan,Johor,0,0,0
1/01/2021,Jordan,Kedah,0,0,0
1/01/2021,Jordan,Kelantan,0,0,0
1/01/2021,Jordan,Melaka,0,0,0
1/01/2021,Jordan,Perlis,0,0,0
1/01/2021,Jordan,Pulau Pinang,0,0,0
1/01/2021,Jordan,Sabah,0,0,0
1/01/2021,Jordan,Sarawak,0,0,0
1/01/2021,Jordan,Selangor,8,6,2
1/01/2021,Jordan,W.P. Labuan,0,0,0
1/01/2021,Japan,Johor,3,3,0
1/01/2021,Japan,Kedah,0,0,0
1/01/2021,Japan,Kelantan,0,0,0
1/01/2021,Japan,Melaka,0,0,0
1/01/2021,Japan,Negeri Sembilan,0,0,0
1/01/2021,Japan,Pahang,0,0,0
1/01/2021,Japan,Perak,0,0,0
1/01/2021,Japan,Perlis,0,0,0
1/01/2021,Japan,Pulau Pinang,18,15,3
1/01/2021,Japan,Sabah,0,0,0
1/01/2021,Japan,Sarawak,6,6,0
1/01/2021,Japan,Selangor,369,256,113
1/01/2021,Japan,W.P. Labuan,0,0,0
1/01/2021,Kazakhstan,Johor,0,0,0
1/01/2021,Kazakhstan,Kedah,0,0,0
1/01/2021,Kazakhstan,Kelantan,0,0,0
1/01/2021,Kazakhstan,Melaka,0,0,0
1/01/2021,Kazakhstan,Perak,0,0,0
1/01/2021,Kazakhstan,Perlis,0,0,0
1/01/2021,Kazakhstan,Pulau Pinang,0,0,0
1/01/2021,Kazakhstan,Sabah,0,0,0
1/01/2021,Kazakhstan,Sarawak,0,0,0
1/01/2021,Kazakhstan,Selangor,5,1,4
1/01/2021,Kazakhstan,W.P. Labuan,0,0,0
1/01/2021,Kenya,Johor,0,0,0
1/01/2021,Kenya,Kedah,0,0,0
1/01/2021,Kenya,Kelantan,0,0,0
1/01/2021,Kenya,Perak,0,0,0
1/01/2021,Kenya,Perlis,0,0,0
1/01/2021,Kenya,Pulau Pinang,0,0,0
1/01/2021,Kenya,Sabah,0,0,0
1/01/2021,Kenya,Sarawak,0,0,0
1/01/2021,Kenya,Selangor,9,7,2
1/01/2021,Kyrgyzstan,Johor,0,0,0
1/01/2021,Kyrgyzstan,Kedah,0,0,0
1/01/2021,Kyrgyzstan,Kelantan,0,0,0
1/01/2021,Kyrgyzstan,Perak,0,0,0
1/01/2021,Kyrgyzstan,Perlis,0,0,0
1/01/2021,Kyrgyzstan,Pulau Pinang,0,0,0
1/01/2021,Kyrgyzstan,Sabah,0,0,0
1/01/2021,Kyrgyzstan,Sarawak,0,0,0
1/01/2021,Kyrgyzstan,Selangor,4,1,3
1/01/2021,Cambodia,Johor,0,0,0
1/01/2021,Cambodia,Kedah,0,0,0
1/01/2021,Cambodia,Kelantan,0,0,0
1/01/2021,Cambodia,Melaka,0,0,0
1/01/2021,Cambodia,Negeri Sembilan,0,0,0
1/01/2021,Cambodia,Pahang,0,0,0
1/01/2021,Cambodia,Perak,0,0,0
1/01/2021,Cambodia,Perlis,0,0,0
1/01/2021,Cambodia,Pulau Pinang,0,0,0
1/01/2021,Cambodia,Sabah,0,0,0
1/01/2021,Cambodia,Sarawak,0,0,0
1/01/2021,Cambodia,Selangor,9,4,5
1/01/2021,Cambodia,W.P. Labuan,0,0,0
1/01/2021,Kiribati,Johor,0,0,0
1/01/2021,Kiribati,Sabah,0,0,0
1/01/2021,Kiribati,Selangor,6,6,0
1/01/2021,Saint Kitts and Nevis,Johor,0,0,0
1/01/2021,Saint Kitts and Nevis,Kedah,0,0,0
1/01/2021,Saint Kitts and Nevis,Perlis,0,0,0
1/01/2021,Saint Kitts and Nevis,Pulau Pinang,0,0,0
1/01/2021,Saint Kitts and Nevis,Sabah,0,0,0
1/01/2021,Saint Kitts and Nevis,Selangor,0,0,0
1/01/2021,Saint Kitts and Nevis,W.P. Labuan,0,0,0
1/01/2021,"Korea, Republic of",Johor,6,6,0
1/01/2021,"Korea, Republic of",Kedah,0,0,0
1/01/2021,"Korea, Republic of",Kelantan,0,0,0
1/01/2021,"Korea, Republic of",Melaka,0,0,0
1/01/2021,"Korea, Republic of",Negeri Sembilan,0,0,0
1/01/2021,"Korea, Republic of",Pahang,0,0,0
1/01/2021,"Korea, Republic of",Perak,0,0,0
1/01/2021,"Korea, Republic of",Perlis,0,0,0
1/01/2021,"Korea, Republic of",Pulau Pinang,2,1,1
1/01/2021,"Korea, Republic of",Sabah,0,0,0
1/01/2021,"Korea, Republic of",Sarawak,3,3,0
1/01/2021,"Korea, Republic of",Selangor,226,145,81
1/01/2021,"Korea, Republic of",Terengganu,0,0,0
1/01/2021,"Korea, Republic of",W.P. Labuan,0,0,0
1/01/2021,Kuwait,Johor,0,0,0
1/01/2021,Kuwait,Kedah,0,0,0
1/01/2021,Kuwait,Kelantan,0,0,0
1/01/2021,Kuwait,Perak,0,0,0
1/01/2021,Kuwait,Perlis,0,0,0
1/01/2021,Kuwait,Pulau Pinang,0,0,0
1/01/2021,Kuwait,Sabah,0,0,0
1/01/2021,Kuwait,Sarawak,0,0,0
1/01/2021,Kuwait,Selangor,9,6,3
1/01/2021,Kuwait,W.P. Labuan,0,0,0
1/01/2021, Lao People's Democratic Republic,Johor,0,0,0
1/01/2021, Lao People's Democratic Republic,Kedah,0,0,0
1/01/2021, Lao People's Democratic Republic,Kelantan,0,0,0
1/01/2021, Lao People's Democratic Republic,Melaka,0,0,0
1/01/2021, Lao People's Democratic Republic,Perak,0,0,0
1/01/2021, Lao People's Democratic Republic,Perlis,0,0,0
1/01/2021, Lao People's Democratic Republic,Pulau Pinang,0,0,0
1/01/2021, Lao People's Democratic Republic,Sabah,0,0,0
1/01/2021, Lao People's Democratic Republic,Sarawak,0,0,0
1/01/2021, Lao People's Democratic Republic,Selangor,3,1,2
1/01/2021, Lao People's Democratic Republic,W.P. Labuan,0,0,0
1/01/2021,Lebanon,Johor,0,0,0
1/01/2021,Lebanon,Kedah,0,0,0
1/01/2021,Lebanon,Kelantan,0,0,0
1/01/2021,Lebanon,Pahang,0,0,0
1/01/2021,Lebanon,Perak,0,0,0
1/01/2021,Lebanon,Perlis,0,0,0
1/01/2021,Lebanon,Pulau Pinang,0,0,0
1/01/2021,Lebanon,Sabah,0,0,0
1/01/2021,Lebanon,Sarawak,0,0,0
1/01/2021,Lebanon,Selangor,2,2,0
1/01/2021,Lebanon,W.P. Labuan,0,0,0
1/01/2021,Liberia,Johor,0,0,0
1/01/2021,Liberia,Kedah,0,0,0
1/01/2021,Liberia,Sabah,0,0,0
1/01/2021,Liberia,Sarawak,0,0,0
1/01/2021,Liberia,Selangor,0,0,0
1/01/2021,Libya,Johor,0,0,0
1/01/2021,Libya,Kedah,0,0,0
1/01/2021,Libya,Perlis,0,0,0
1/01/2021,Libya,Pulau Pinang,0,0,0
1/01/2021,Libya,Sabah,0,0,0
1/01/2021,Libya,Sarawak,0,0,0
1/01/2021,Libya,Selangor,13,11,2
1/01/2021,Saint Lucia,Johor,0,0,0
1/01/2021,Saint Lucia,Kedah,0,0,0
1/01/2021,Saint Lucia,Pulau Pinang,0,0,0
1/01/2021,Saint Lucia,Sarawak,0,0,0
1/01/2021,Saint Lucia,Selangor,1,1,0
1/01/2021,Liechtenstein,Johor,0,0,0
1/01/2021,Liechtenstein,Kedah,0,0,0
1/01/2021,Liechtenstein,Perlis,0,0,0
1/01/2021,Liechtenstein,Pulau Pinang,0,0,0
1/01/2021,Liechtenstein,Sabah,0,0,0
1/01/2021,Liechtenstein,Sarawak,0,0,0
1/01/2021,Liechtenstein,Selangor,0,0,0
1/01/2021,LKA,Johor,9,9,0
1/01/2021,LKA,Kedah,0,0,0
1/01/2021,LKA,Kelantan,0,0,0
1/01/2021,LKA,Melaka,0,0,0
1/01/2021,LKA,Pahang,0,0,0
1/01/2021,LKA,Perak,0,0,0
1/01/2021,LKA,Perlis,0,0,0
1/01/2021,LKA,Pulau Pinang,0,0,0
1/01/2021,LKA,Sabah,0,0,0
1/01/2021,LKA,Sarawak,0,0,0
1/01/2021,LKA,Selangor,39,32,7
1/01/2021,LKA,W.P. Labuan,0,0,0
1/01/2021,Lesotho,Johor,0,0,0
1/01/2021,Lesotho,Kedah,0,0,0
1/01/2021,Lesotho,Pulau Pinang,0,0,0
1/01/2021,Lesotho,Sarawak,0,0,0
1/01/2021,Lesotho,Selangor,0,0,0
1/01/2021,Lithuania,Johor,2,2,0
1/01/2021,Lithuania,Kedah,0,0,0
1/01/2021,Lithuania,Kelantan,0,0,0
1/01/2021,Lithuania,Pahang,0,0,0
1/01/2021,Lithuania,Perak,0,0,0
1/01/2021,Lithuania,Perlis,0,0,0
1/01/2021,Lithuania,Pulau Pinang,0,0,0
1/01/2021,Lithuania,Sabah,0,0,0
1/01/2021,Lithuania,Sarawak,0,0,0
1/01/2021,Lithuania,Selangor,6,5,1
1/01/2021,Lithuania,W.P. Labuan,0,0,0
1/01/2021,Luxembourg,Johor,0,0,0
1/01/2021,Luxembourg,Kedah,0,0,0
1/01/2021,Luxembourg,Kelantan,0,0,0
1/01/2021,Luxembourg,Perak,0,0,0
1/01/2021,Luxembourg,Perlis,0,0,0
1/01/2021,Luxembourg,Pulau Pinang,0,0,0
1/01/2021,Luxembourg,Sabah,0,0,0
1/01/2021,Luxembourg,Sarawak,0,0,0
1/01/2021,Luxembourg,Selangor,0,0,0
1/01/2021,Latvia,Johor,0,0,0
1/01/2021,Latvia,Kedah,0,0,0
1/01/2021,Latvia,Kelantan,0,0,0
1/01/2021,Latvia,Pahang,0,0,0
1/01/2021,Latvia,Perak,0,0,0
1/01/2021,Latvia,Perlis,0,0,0
1/01/2021,Latvia,Pulau Pinang,0,0,0
1/01/2021,Latvia,Sabah,0,0,0
1/01/2021,Latvia,Sarawak,0,0,0
1/01/2021,Latvia,Selangor,1,0,1
1/01/2021,Latvia,W.P. Labuan,0,0,0
1/01/2021,Macao,Johor,0,0,0
1/01/2021,Macao,Pahang,0,0,0
1/01/2021,Macao,Perak,0,0,0
1/01/2021,Macao,Selangor,0,0,0
1/01/2021,Macao,W.P. Labuan,0,0,0
1/01/2021,Morocco,Johor,0,0,0
1/01/2021,Morocco,Kedah,0,0,0
1/01/2021,Morocco,Kelantan,0,0,0
1/01/2021,Morocco,Melaka,0,0,0
1/01/2021,Morocco,Pahang,0,0,0
1/01/2021,Morocco,Perak,0,0,0
1/01/2021,Morocco,Perlis,0,0,0
1/01/2021,Morocco,Pulau Pinang,0,0,0
1/01/2021,Morocco,Sabah,0,0,0
1/01/2021,Morocco,Sarawak,0,0,0
1/01/2021,Morocco,Selangor,8,4,4
1/01/2021,Morocco,W.P. Labuan,0,0,0
1/01/2021,Monaco,Johor,0,0,0
1/01/2021,Monaco,Kedah,0,0,0
1/01/2021,Monaco,Sabah,0,0,0
1/01/2021,Monaco,Selangor,0,0,0
1/01/2021,"Moldova, Republic of",Johor,0,0,0
1/01/2021,"Moldova, Republic of",Kedah,0,0,0
1/01/2021,"Moldova, Republic of",Kelantan,0,0,0
1/01/2021,"Moldova, Republic of",Negeri Sembilan,0,0,0
1/01/2021,"Moldova, Republic of",Perlis,0,0,0
1/01/2021,"Moldova, Republic of",Pulau Pinang,0,0,0
1/01/2021,"Moldova, Republic of",Sabah,0,0,0
1/01/2021,"Moldova, Republic of",Sarawak,0,0,0
1/01/2021,"Moldova, Republic of",Selangor,0,0,0
1/01/2021,Madagascar,Johor,0,0,0
1/01/2021,Madagascar,Kedah,0,0,0
1/01/2021,Madagascar,Perak,0,0,0
1/01/2021,Madagascar,Perlis,0,0,0
1/01/2021,Madagascar,Pulau Pinang,0,0,0
1/01/2021,Madagascar,Sabah,0,0,0
1/01/2021,Madagascar,Sarawak,0,0,0
1/01/2021,Madagascar,Selangor,0,0,0
1/01/2021,Maldives,Johor,0,0,0
1/01/2021,Maldives,Kedah,0,0,0
1/01/2021,Maldives,Kelantan,0,0,0
1/01/2021,Maldives,Perak,0,0,0
1/01/2021,Maldives,Perlis,0,0,0
1/01/2021,Maldives,Pulau Pinang,0,0,0
1/01/2021,Maldives,Sabah,0,0,0
1/01/2021,Maldives,Sarawak,0,0,0
1/01/2021,Maldives,Selangor,40,19,21
1/01/2021,Mexico,Johor,0,0,0
1/01/2021,Mexico,Kedah,0,0,0
1/01/2021,Mexico,Kelantan,0,0,0
1/01/2021,Mexico,Pahang,0,0,0
1/01/2021,Mexico,Perak,0,0,0
1/01/2021,Mexico,Perlis,0,0,0
1/01/2021,Mexico,Pulau Pinang,0,0,0
1/01/2021,Mexico,Sabah,0,0,0
1/01/2021,Mexico,Sarawak,0,0,0
1/01/2021,Mexico,Selangor,7,7,0
1/01/2021,Mexico,W.P. Labuan,0,0,0
1/01/2021,Marshall Islands,Johor,0,0,0
1/01/2021,Marshall Islands,Kedah,0,0,0
1/01/2021,Marshall Islands,Perak,0,0,0
1/01/2021,Marshall Islands,Pulau Pinang,0,0,0
1/01/2021,Marshall Islands,Sabah,0,0,0
1/01/2021,Marshall Islands,Selangor,0,0,0
1/01/2021,North Macedonia,Johor,0,0,0
1/01/2021,North Macedonia,Kedah,0,0,0
1/01/2021,North Macedonia,Perak,0,0,0
1/01/2021,North Macedonia,Pulau Pinang,0,0,0
1/01/2021,North Macedonia,Sabah,0,0,0
1/01/2021,North Macedonia,Sarawak,0,0,0
1/01/2021,North Macedonia,Selangor,0,0,0
1/01/2021,Mali,Johor,0,0,0
1/01/2021,Mali,Sabah,0,0,0
1/01/2021,Mali,Selangor,1,1,0
1/01/2021,Malta,Johor,0,0,0
1/01/2021,Malta,Kedah,0,0,0
1/01/2021,Malta,Kelantan,0,0,0
1/01/2021,Malta,Perak,0,0,0
1/01/2021,Malta,Perlis,0,0,0
1/01/2021,Malta,Pulau Pinang,0,0,0
1/01/2021,Malta,Sabah,0,0,0
1/01/2021,Malta,Sarawak,0,0,0
1/01/2021,Malta,Selangor,1,1,0
1/01/2021,Malta,W.P. Labuan,0,0,0
1/01/2021,Myanmar,Johor,9,9,0
1/01/2021,Myanmar,Kedah,0,0,0
1/01/2021,Myanmar,Kelantan,0,0,0
1/01/2021,Myanmar,Negeri Sembilan,0,0,0
1/01/2021,Myanmar,Pahang,0,0,0
1/01/2021,Myanmar,Perak,0,0,0
1/01/2021,Myanmar,Perlis,0,0,0
1/01/2021,Myanmar,Pulau Pinang,0,0,0
1/01/2021,Myanmar,Sabah,0,0,0
1/01/2021,Myanmar,Sarawak,0,0,0
1/01/2021,Myanmar,Selangor,121,114,7
1/01/2021,Myanmar,Terengganu,0,0,0
1/01/2021,Myanmar,W.P. Labuan,0,0,0
1/01/2021,Montenegro,Johor,6,6,0
1/01/2021,Montenegro,Kedah,0,0,0
1/01/2021,Montenegro,Pulau Pinang,0,0,0
1/01/2021,Montenegro,Sabah,0,0,0
1/01/2021,Montenegro,Sarawak,0,0,0
1/01/2021,Montenegro,Selangor,1,1,0
1/01/2021,Mongolia,Johor,0,0,0
1/01/2021,Mongolia,Kedah,0,0,0
1/01/2021,Mongolia,Kelantan,0,0,0
1/01/2021,Mongolia,Perak,0,0,0
1/01/2021,Mongolia,Perlis,0,0,0
1/01/2021,Mongolia,Pulau Pinang,0,0,0
1/01/2021,Mongolia,Sabah,0,0,0
1/01/2021,Mongolia,Sarawak,0,0,0
1/01/2021,Mongolia,Selangor,0,0,0
1/01/2021,Northern Mariana Islands,Selangor,0,0,0
1/01/2021,Mozambique,Johor,0,0,0
1/01/2021,Mozambique,Kedah,0,0,0
1/01/2021,Mozambique,Perak,0,0,0
1/01/2021,Mozambique,Pulau Pinang,0,0,0
1/01/2021,Mozambique,Sabah,0,0,0
1/01/2021,Mozambique,Sarawak,0,0,0
1/01/2021,Mozambique,Selangor,2,1,1
1/01/2021,Mauritania,Johor,0,0,0
1/01/2021,Mauritania,Kedah,0,0,0
1/01/2021,Mauritania,Pulau Pinang,0,0,0
1/01/2021,Mauritania,Sabah,0,0,0
1/01/2021,Mauritania,Sarawak,0,0,0
1/01/2021,Mauritania,Selangor,5,4,1
1/01/2021,Mauritius,Johor,0,0,0
1/01/2021,Mauritius,Kedah,0,0,0
1/01/2021,Mauritius,Kelantan,0,0,0
1/01/2021,Mauritius,Pahang,0,0,0
1/01/2021,Mauritius,Perak,0,0,0
1/01/2021,Mauritius,Perlis,0,0,0
1/01/2021,Mauritius,Pulau Pinang,0,0,0
1/01/2021,Mauritius,Sabah,0,0,0
1/01/2021,Mauritius,Sarawak,0,0,0
1/01/2021,Mauritius,Selangor,8,5,3
1/01/2021,Malawi,Johor,0,0,0
1/01/2021,Malawi,Pulau Pinang,0,0,0
1/01/2021,Malawi,Sabah,0,0,0
1/01/2021,Malawi,Sarawak,0,0,0
1/01/2021,Malawi,Selangor,0,0,0
1/01/2021,Mayotte,Selangor,0,0,0
1/01/2021,Namibia,Johor,0,0,0
1/01/2021,Namibia,Kedah,0,0,0
1/01/2021,Namibia,Perak,0,0,0
1/01/2021,Namibia,Perlis,0,0,0
1/01/2021,Namibia,Pulau Pinang,0,0,0
1/01/2021,Namibia,Sabah,0,0,0
1/01/2021,Namibia,Sarawak,0,0,0
1/01/2021,Namibia,Selangor,0,0,0
1/01/2021,New Caledonia,Selangor,0,0,0
1/01/2021,Niger,Johor,0,0,0
1/01/2021,Niger,Sabah,0,0,0
1/01/2021,Niger,Selangor,0,0,0
1/01/2021,Nigeria,Johor,0,0,0
1/01/2021,Nigeria,Kedah,0,0,0
1/01/2021,Nigeria,Perlis,0,0,0
1/01/2021,Nigeria,Pulau Pinang,0,0,0
1/01/2021,Nigeria,Sabah,0,0,0
1/01/2021,Nigeria,Sarawak,0,0,0
1/01/2021,Nigeria,Selangor,39,36,3
1/01/2021,Nicaragua,Johor,0,0,0
1/01/2021,Nicaragua,Kedah,0,0,0
1/01/2021,Nicaragua,Pulau Pinang,0,0,0
1/01/2021,Nicaragua,Sabah,0,0,0
1/01/2021,Nicaragua,Selangor,0,0,0
1/01/2021,Netherlands,Johor,2,2,0
1/01/2021,Netherlands,Kedah,0,0,0
1/01/2021,Netherlands,Kelantan,0,0,0
1/01/2021,Netherlands,Melaka,0,0,0
1/01/2021,Netherlands,Negeri Sembilan,0,0,0
1/01/2021,Netherlands,Pahang,0,0,0
1/01/2021,Netherlands,Perak,0,0,0
1/01/2021,Netherlands,Perlis,0,0,0
1/01/2021,Netherlands,Pulau Pinang,0,0,0
1/01/2021,Netherlands,Sabah,0,0,0
1/01/2021,Netherlands,Sarawak,0,0,0
1/01/2021,Netherlands,Selangor,56,44,12
1/01/2021,Netherlands,Terengganu,0,0,0
1/01/2021,Netherlands,W.P. Labuan,0,0,0
1/01/2021,Norway,Johor,0,0,0
1/01/2021,Norway,Kedah,0,0,0
1/01/2021,Norway,Kelantan,0,0,0
1/01/2021,Norway,Melaka,0,0,0
1/01/2021,Norway,Pahang,0,0,0
1/01/2021,Norway,Perak,0,0,0
1/01/2021,Norway,Perlis,0,0,0
1/01/2021,Norway,Pulau Pinang,0,0,0
1/01/2021,Norway,Sabah,0,0,0
1/01/2021,Norway,Sarawak,0,0,0
1/01/2021,Norway,Selangor,24,21,3
1/01/2021,Norway,W.P. Labuan,0,0,0
1/01/2021,Nepal,Johor,0,0,0
1/01/2021,Nepal,Kedah,0,0,0
1/01/2021,Nepal,Pahang,0,0,0
1/01/2021,Nepal,Perak,0,0,0
1/01/2021,Nepal,Perlis,0,0,0
1/01/2021,Nepal,Pulau Pinang,0,0,0
1/01/2021,Nepal,Sabah,0,0,0
1/01/2021,Nepal,Sarawak,0,0,0
1/01/2021,Nepal,Selangor,75,73,2
1/01/2021,Nepal,W.P. Labuan,0,0,0
1/01/2021,Nauru,Johor,0,0,0
1/01/2021,Nauru,Pulau Pinang,0,0,0
1/01/2021,Nauru,Selangor,0,0,0
1/01/2021,New Zealand,Johor,1,0,1
1/01/2021,New Zealand,Kedah,0,0,0
1/01/2021,New Zealand,Kelantan,0,0,0
1/01/2021,New Zealand,Melaka,0,0,0
1/01/2021,New Zealand,Negeri Sembilan,0,0,0
1/01/2021,New Zealand,Pahang,0,0,0
1/01/2021,New Zealand,Perak,0,0,0
1/01/2021,New Zealand,Perlis,0,0,0
1/01/2021,New Zealand,Pulau Pinang,4,2,2
1/01/2021,New Zealand,Sabah,0,0,0
1/01/2021,New Zealand,Sarawak,0,0,0
1/01/2021,New Zealand,Selangor,23,15,8
1/01/2021,New Zealand,Terengganu,0,0,0
1/01/2021,New Zealand,W.P. Labuan,0,0,0
1/01/2021,Oman,Johor,0,0,0
1/01/2021,Oman,Kedah,0,0,0
1/01/2021,Oman,Kelantan,0,0,0
1/01/2021,Oman,Melaka,0,0,0
1/01/2021,Oman,Perak,0,0,0
1/01/2021,Oman,Perlis,0,0,0
1/01/2021,Oman,Pulau Pinang,0,0,0
1/01/2021,Oman,Sabah,0,0,0
1/01/2021,Oman,Sarawak,0,0,0
1/01/2021,Oman,Selangor,6,3,3
1/01/2021,Pakistan,Johor,0,0,0
1/01/2021,Pakistan,Kedah,0,0,0
1/01/2021,Pakistan,Kelantan,0,0,0
1/01/2021,Pakistan,Melaka,0,0,0
1/01/2021,Pakistan,Negeri Sembilan,0,0,0
1/01/2021,Pakistan,Pahang,0,0,0
1/01/2021,Pakistan,Perak,0,0,0
1/01/2021,Pakistan,Perlis,0,0,0
1/01/2021,Pakistan,Pulau Pinang,0,0,0
1/01/2021,Pakistan,Sabah,2,2,0
1/01/2021,Pakistan,Sarawak,0,0,0
1/01/2021,Pakistan,Selangor,187,162,25
1/01/2021,Pakistan,W.P. Labuan,0,0,0
1/01/2021,Panama,Johor,0,0,0
1/01/2021,Panama,Kedah,0,0,0
1/01/2021,Panama,Perak,0,0,0
1/01/2021,Panama,Perlis,0,0,0
1/01/2021,Panama,Pulau Pinang,0,0,0
1/01/2021,Panama,Sabah,0,0,0
1/01/2021,Panama,Sarawak,0,0,0
1/01/2021,Panama,Selangor,3,1,2
1/01/2021,Peru,Johor,0,0,0
1/01/2021,Peru,Kedah,0,0,0
1/01/2021,Peru,Kelantan,0,0,0
1/01/2021,Peru,Pahang,0,0,0
1/01/2021,Peru,Perak,0,0,0
1/01/2021,Peru,Perlis,0,0,0
1/01/2021,Peru,Pulau Pinang,0,0,0
1/01/2021,Peru,Sabah,0,0,0
1/01/2021,Peru,Sarawak,0,0,0
1/01/2021,Peru,Selangor,1,1,0
1/01/2021,Peru,W.P. Labuan,0,0,0
1/01/2021,Philippines,Johor,57,56,1
1/01/2021,Philippines,Kedah,0,0,0
1/01/2021,Philippines,Kelantan,0,0,0
1/01/2021,Philippines,Melaka,0,0,0
1/01/2021,Philippines,Negeri Sembilan,0,0,0
1/01/2021,Philippines,Pahang,0,0,0
1/01/2021,Philippines,Perak,1,0,1
1/01/2021,Philippines,Perlis,0,0,0
1/01/2021,Philippines,Pulau Pinang,3,1,2
1/01/2021,Philippines,Sabah,3,3,0
1/01/2021,Philippines,Sarawak,56,55,1
1/01/2021,Philippines,Selangor,436,357,79
1/01/2021,Philippines,Terengganu,0,0,0
1/01/2021,Philippines,W.P. Labuan,2,2,0
1/01/2021,Palau,Johor,0,0,0
1/01/2021,Palau,Pulau Pinang,0,0,0
1/01/2021,Palau,Selangor,0,0,0
1/01/2021,Papua New Guinea,Johor,0,0,0
1/01/2021,Papua New Guinea,Kedah,0,0,0
1/01/2021,Papua New Guinea,Kelantan,0,0,0
1/01/2021,Papua New Guinea,Perak,0,0,0
1/01/2021,Papua New Guinea,Pulau Pinang,0,0,0
1/01/2021,Papua New Guinea,Sabah,0,0,0
1/01/2021,Papua New Guinea,Sarawak,0,0,0
1/01/2021,Papua New Guinea,Selangor,2,2,0
1/01/2021,Poland,Johor,1,1,0
1/01/2021,Poland,Kedah,0,0,0
1/01/2021,Poland,Kelantan,0,0,0
1/01/2021,Poland,Melaka,0,0,0
1/01/2021,Poland,Negeri Sembilan,0,0,0
1/01/2021,Poland,Pahang,0,0,0
1/01/2021,Poland,Perak,0,0,0
1/01/2021,Poland,Perlis,0,0,0
1/01/2021,Poland,Pulau Pinang,0,0,0
1/01/2021,Poland,Sabah,0,0,0
1/01/2021,Poland,Sarawak,0,0,0
1/01/2021,Poland,Selangor,28,25,3
1/01/2021,Poland,Terengganu,0,0,0
1/01/2021,Poland,W.P. Labuan,0,0,0
1/01/2021,"North Korea, Democratic People's Republic of",Selangor,0,0,0
1/01/2021,Portugal,Johor,0,0,0
1/01/2021,Portugal,Kedah,0,0,0
1/01/2021,Portugal,Kelantan,0,0,0
1/01/2021,Portugal,Melaka,0,0,0
1/01/2021,Portugal,Pahang,0,0,0
1/01/2021,Portugal,Perak,0,0,0
1/01/2021,Portugal,Perlis,0,0,0
1/01/2021,Portugal,Pulau Pinang,0,0,0
1/01/2021,Portugal,Sabah,0,0,0
1/01/2021,Portugal,Sarawak,0,0,0
1/01/2021,Portugal,Selangor,13,7,6
1/01/2021,Portugal,W.P. Labuan,0,0,0
1/01/2021,Paraguay,Johor,0,0,0
1/01/2021,Paraguay,Kedah,0,0,0
1/01/2021,Paraguay,Perak,0,0,0
1/01/2021,Paraguay,Perlis,0,0,0
1/01/2021,Paraguay,Pulau Pinang,0,0,0
1/01/2021,Paraguay,Sabah,0,0,0
1/01/2021,Paraguay,Sarawak,0,0,0
1/01/2021,Paraguay,Selangor,0,0,0
1/01/2021,"Palestine, State of",Johor,0,0,0
1/01/2021,"Palestine, State of",Kedah,0,0,0
1/01/2021,"Palestine, State of",Kelantan,0,0,0
1/01/2021,"Palestine, State of",Melaka,0,0,0
1/01/2021,"Palestine, State of",Perak,0,0,0
1/01/2021,"Palestine, State of",Perlis,0,0,0
1/01/2021,"Palestine, State of",Pulau Pinang,0,0,0
1/01/2021,"Palestine, State of",Sabah,0,0,0
1/01/2021,"Palestine, State of",Sarawak,0,0,0
1/01/2021,"Palestine, State of",Selangor,9,8,1
1/01/2021,Qatar,Johor,0,0,0
1/01/2021,Qatar,Kedah,0,0,0
1/01/2021,Qatar,Perlis,0,0,0
1/01/2021,Qatar,Pulau Pinang,0,0,0
1/01/2021,Qatar,Sabah,0,0,0
1/01/2021,Qatar,Sarawak,0,0,0
1/01/2021,Qatar,Selangor,5,2,3
1/01/2021,Réunion,Johor,0,0,0
1/01/2021,Réunion,Sarawak,0,0,0
1/01/2021,Romania,Johor,3,3,0
1/01/2021,Romania,Kedah,0,0,0
1/01/2021,Romania,Kelantan,0,0,0
1/01/2021,Romania,Negeri Sembilan,0,0,0
1/01/2021,Romania,Pahang,0,0,0
1/01/2021,Romania,Perak,0,0,0
1/01/2021,Romania,Perlis,0,0,0
1/01/2021,Romania,Pulau Pinang,0,0,0
1/01/2021,Romania,Sabah,0,0,0
1/01/2021,Romania,Sarawak,0,0,0
1/01/2021,Romania,Selangor,20,18,2
1/01/2021,Romania,W.P. Labuan,0,0,0
1/01/2021,Russian Federation (Russia),Johor,4,4,0
1/01/2021,Russian Federation (Russia),Kedah,0,0,0
1/01/2021,Russian Federation (Russia),Kelantan,0,0,0
1/01/2021,Russian Federation (Russia),Melaka,0,0,0
1/01/2021,Russian Federation (Russia),Negeri Sembilan,0,0,0
1/01/2021,Russian Federation (Russia),Pahang,0,0,0
1/01/2021,Russian Federation (Russia),Perak,0,0,0
1/01/2021,Russian Federation (Russia),Perlis,0,0,0
1/01/2021,Russian Federation (Russia),Pulau Pinang,0,0,0
1/01/2021,Russian Federation (Russia),Sabah,0,0,0
1/01/2021,Russian Federation (Russia),Sarawak,0,0,0
1/01/2021,Russian Federation (Russia),Selangor,47,40,7
1/01/2021,Russian Federation (Russia),W.P. Labuan,0,0,0
1/01/2021,Rwanda,Johor,0,0,0
1/01/2021,Rwanda,Kedah,0,0,0
1/01/2021,Rwanda,Pulau Pinang,0,0,0
1/01/2021,Rwanda,Selangor,0,0,0
1/01/2021,Saudi Arabia,Johor,0,0,0
1/01/2021,Saudi Arabia,Kedah,0,0,0
1/01/2021,Saudi Arabia,Kelantan,0,0,0
1/01/2021,Saudi Arabia,Melaka,0,0,0
1/01/2021,Saudi Arabia,Perak,0,0,0
1/01/2021,Saudi Arabia,Perlis,0,0,0
1/01/2021,Saudi Arabia,Pulau Pinang,0,0,0
1/01/2021,Saudi Arabia,Sabah,0,0,0
1/01/2021,Saudi Arabia,Sarawak,0,0,0
1/01/2021,Saudi Arabia,Selangor,52,28,24
1/01/2021,Saudi Arabia,W.P. Labuan,0,0,0
1/01/2021,Sudan,Johor,0,0,0
1/01/2021,Sudan,Kedah,0,0,0
1/01/2021,Sudan,Kelantan,0,0,0
1/01/2021,Sudan,Perlis,0,0,0
1/01/2021,Sudan,Pulau Pinang,0,0,0
1/01/2021,Sudan,Sabah,0,0,0
1/01/2021,Sudan,Sarawak,0,0,0
1/01/2021,Sudan,Selangor,23,21,2
1/01/2021,Sudan,W.P. Labuan,0,0,0
1/01/2021,Senegal,Johor,0,0,0
1/01/2021,Senegal,Kedah,0,0,0
1/01/2021,Senegal,Kelantan,0,0,0
1/01/2021,Senegal,Perak,0,0,0
1/01/2021,Senegal,Perlis,0,0,0
1/01/2021,Senegal,Pulau Pinang,0,0,0
1/01/2021,Senegal,Sabah,0,0,0
1/01/2021,Senegal,Sarawak,0,0,0
1/01/2021,Senegal,Selangor,2,1,1
1/01/2021,Singapore,Johor,271,232,39
1/01/2021,Singapore,Kedah,3,3,0
1/01/2021,Singapore,Kelantan,0,0,0
1/01/2021,Singapore,Melaka,0,0,0
1/01/2021,Singapore,Negeri Sembilan,0,0,0
1/01/2021,Singapore,Pahang,0,0,0
1/01/2021,Singapore,Perak,2,1,1
1/01/2021,Singapore,Perlis,3,3,0
1/01/2021,Singapore,Pulau Pinang,11,3,8
1/01/2021,Singapore,Sabah,0,0,0
1/01/2021,Singapore,Sarawak,18,5,13
1/01/2021,Singapore,Selangor,131,81,50
1/01/2021,Singapore,Terengganu,0,0,0
1/01/2021,Singapore,W.P. Labuan,0,0,0
1/01/2021,South Georgia and the South Sandwich Islands,Johor,0,0,0
1/01/2021,South Georgia and the South Sandwich Islands,Sabah,0,0,0
1/01/2021,South Georgia and the South Sandwich Islands,Selangor,0,0,0
1/01/2021,Saint Helena,Sarawak,0,0,0
1/01/2021,Solomon Islands,Johor,0,0,0
1/01/2021,Solomon Islands,Perlis,0,0,0
1/01/2021,Solomon Islands,Pulau Pinang,0,0,0
1/01/2021,Solomon Islands,Sabah,0,0,0
1/01/2021,Solomon Islands,Sarawak,0,0,0
1/01/2021,Solomon Islands,Selangor,0,0,0
1/01/2021,Solomon Islands,W.P. Labuan,0,0,0
1/01/2021,Sierra Leone,Johor,0,0,0
1/01/2021,Sierra Leone,Kedah,0,0,0
1/01/2021,Sierra Leone,Perak,0,0,0
1/01/2021,Sierra Leone,Pulau Pinang,0,0,0
1/01/2021,Sierra Leone,Sabah,0,0,0
1/01/2021,Sierra Leone,Selangor,1,1,0
1/01/2021,El Salvador,Johor,0,0,0
1/01/2021,El Salvador,Kedah,0,0,0
1/01/2021,El Salvador,Perak,0,0,0
1/01/2021,El Salvador,Perlis,0,0,0
1/01/2021,El Salvador,Pulau Pinang,0,0,0
1/01/2021,El Salvador,Sabah,0,0,0
1/01/2021,El Salvador,Selangor,0,0,0
1/01/2021,El Salvador,W.P. Labuan,0,0,0
1/01/2021,San Marino,Johor,0,0,0
1/01/2021,San Marino,Selangor,1,1,0
1/01/2021,Somalia,Johor,0,0,0
1/01/2021,Somalia,Kedah,0,0,0
1/01/2021,Somalia,Kelantan,0,0,0
1/01/2021,Somalia,Perlis,0,0,0
1/01/2021,Somalia,Sabah,0,0,0
1/01/2021,Somalia,Sarawak,0,0,0
1/01/2021,Somalia,Selangor,3,2,1
1/01/2021,Serbia,Johor,0,0,0
1/01/2021,Serbia,Kedah,0,0,0
1/01/2021,Serbia,Kelantan,0,0,0
1/01/2021,Serbia,Pahang,0,0,0
1/01/2021,Serbia,Perak,0,0,0
1/01/2021,Serbia,Perlis,0,0,0
1/01/2021,Serbia,Pulau Pinang,0,0,0
1/01/2021,Serbia,Sabah,0,0,0
1/01/2021,Serbia,Sarawak,0,0,0
1/01/2021,Serbia,Selangor,3,2,1
1/01/2021,South Sudan,Johor,0,0,0
1/01/2021,South Sudan,Kedah,0,0,0
1/01/2021,South Sudan,Sarawak,0,0,0
1/01/2021,South Sudan,Selangor,1,0,1
1/01/2021,South Sudan,W.P. Labuan,0,0,0
1/01/2021,Sao Tome and Principe,Selangor,2,2,0
1/01/2021,Suriname,Johor,0,0,0
1/01/2021,Suriname,Kedah,0,0,0
1/01/2021,Suriname,Kelantan,0,0,0
1/01/2021,Suriname,Perak,0,0,0
1/01/2021,Suriname,Perlis,0,0,0
1/01/2021,Suriname,Pulau Pinang,0,0,0
1/01/2021,Suriname,Sabah,0,0,0
1/01/2021,Suriname,Sarawak,0,0,0
1/01/2021,Suriname,Selangor,0,0,0
1/01/2021,Slovakia,Johor,0,0,0
1/01/2021,Slovakia,Kedah,0,0,0
1/01/2021,Slovakia,Kelantan,0,0,0
1/01/2021,Slovakia,Negeri Sembilan,0,0,0
1/01/2021,Slovakia,Pahang,0,0,0
1/01/2021,Slovakia,Perak,0,0,0
1/01/2021,Slovakia,Perlis,0,0,0
1/01/2021,Slovakia,Pulau Pinang,0,0,0
1/01/2021,Slovakia,Sabah,0,0,0
1/01/2021,Slovakia,Sarawak,0,0,0
1/01/2021,Slovakia,Selangor,9,8,1
1/01/2021,Slovakia,W.P. Labuan,0,0,0
1/01/2021,Slovenia,Johor,0,0,0
1/01/2021,Slovenia,Kedah,0,0,0
1/01/2021,Slovenia,Kelantan,0,0,0
1/01/2021,Slovenia,Perak,0,0,0
1/01/2021,Slovenia,Perlis,0,0,0
1/01/2021,Slovenia,Pulau Pinang,0,0,0
1/01/2021,Slovenia,Sabah,0,0,0
1/01/2021,Slovenia,Sarawak,0,0,0
1/01/2021,Slovenia,Selangor,2,1,1
1/01/2021,Slovenia,W.P. Labuan,0,0,0
1/01/2021,Sweden,Johor,0,0,0
1/01/2021,Sweden,Kedah,0,0,0
1/01/2021,Sweden,Kelantan,0,0,0
1/01/2021,Sweden,Melaka,0,0,0
1/01/2021,Sweden,Negeri Sembilan,0,0,0
1/01/2021,Sweden,Pahang,0,0,0
1/01/2021,Sweden,Perak,0,0,0
1/01/2021,Sweden,Perlis,0,0,0
1/01/2021,Sweden,Pulau Pinang,1,1,0
1/01/2021,Sweden,Sabah,0,0,0
1/01/2021,Sweden,Sarawak,0,0,0
1/01/2021,Sweden,Selangor,29,25,4
1/01/2021,Sweden,W.P. Labuan,0,0,0
1/01/2021,Eswatini,Johor,0,0,0
1/01/2021,Eswatini,Kedah,0,0,0
1/01/2021,Eswatini,Pulau Pinang,0,0,0
1/01/2021,Eswatini,Sabah,0,0,0
1/01/2021,Eswatini,Selangor,5,2,3
1/01/2021,Seychelles,Johor,0,0,0
1/01/2021,Seychelles,Kedah,0,0,0
1/01/2021,Seychelles,Pulau Pinang,0,0,0
1/01/2021,Seychelles,Sabah,0,0,0
1/01/2021,Seychelles,Sarawak,0,0,0
1/01/2021,Seychelles,Selangor,2,0,2
1/01/2021,Syrian Arab Republic,Johor,0,0,0
1/01/2021,Syrian Arab Republic,Kedah,0,0,0
1/01/2021,Syrian Arab Republic,Kelantan,0,0,0
1/01/2021,Syrian Arab Republic,Pahang,0,0,0
1/01/2021,Syrian Arab Republic,Perlis,0,0,0
1/01/2021,Syrian Arab Republic,Pulau Pinang,0,0,0
1/01/2021,Syrian Arab Republic,Sabah,0,0,0
1/01/2021,Syrian Arab Republic,Sarawak,0,0,0
1/01/2021,Syrian Arab Republic,Selangor,10,5,5
1/01/2021,Syrian Arab Republic,W.P. Labuan,0,0,0
1/01/2021,Turks and Caicos Islands,Perlis,0,0,0
1/01/2021,TCD,Johor,0,0,0
1/01/2021,TCD,Kedah,0,0,0
1/01/2021,TCD,Perlis,0,0,0
1/01/2021,TCD,Selangor,0,0,0
1/01/2021,Togo,Johor,0,0,0
1/01/2021,Togo,Perak,0,0,0
1/01/2021,Togo,Pulau Pinang,0,0,0
1/01/2021,Togo,Selangor,0,0,0
1/01/2021,Thailand,Johor,0,0,0
1/01/2021,Thailand,Kedah,17920,17905,15
1/01/2021,Thailand,Kelantan,0,0,0
1/01/2021,Thailand,Melaka,0,0,0
1/01/2021,Thailand,Negeri Sembilan,0,0,0
1/01/2021,Thailand,Pahang,0,0,0
1/01/2021,Thailand,Perak,0,0,0
1/01/2021,Thailand,Perlis,9926,9477,449
1/01/2021,Thailand,Pulau Pinang,4,2,2
1/01/2021,Thailand,Sabah,0,0,0
1/01/2021,Thailand,Sarawak,11,11,0
1/01/2021,Thailand,Selangor,93,38,55
1/01/2021,Thailand,Terengganu,7,7,0
1/01/2021,Thailand,W.P. Labuan,0,0,0
1/01/2021,Tajikistan,Johor,0,0,0
1/01/2021,Tajikistan,Kedah,0,0,0
1/01/2021,Tajikistan,Perlis,0,0,0
1/01/2021,Tajikistan,Pulau Pinang,0,0,0
1/01/2021,Tajikistan,Sabah,0,0,0
1/01/2021,Tajikistan,Selangor,0,0,0
1/01/2021,Tokelau,Selangor,0,0,0
1/01/2021,Turkmenistan,Johor,0,0,0
1/01/2021,Turkmenistan,Kedah,0,0,0
1/01/2021,Turkmenistan,Kelantan,0,0,0
1/01/2021,Turkmenistan,Perlis,0,0,0
1/01/2021,Turkmenistan,Pulau Pinang,0,0,0
1/01/2021,Turkmenistan,Sabah,0,0,0
1/01/2021,Turkmenistan,Sarawak,0,0,0
1/01/2021,Turkmenistan,Selangor,0,0,0
1/01/2021,Timor-Leste,Johor,0,0,0
1/01/2021,Timor-Leste,Kedah,0,0,0
1/01/2021,Timor-Leste,Perlis,0,0,0
1/01/2021,Timor-Leste,Pulau Pinang,0,0,0
1/01/2021,Timor-Leste,Sabah,0,0,0
1/01/2021,Timor-Leste,Sarawak,0,0,0
1/01/2021,Timor-Leste,Selangor,0,0,0
1/01/2021,Tonga,Johor,0,0,0
1/01/2021,Tonga,Pulau Pinang,0,0,0
1/01/2021,Tonga,Sarawak,0,0,0
1/01/2021,Tonga,Selangor,0,0,0
1/01/2021,Trinidad and Tobago,Johor,0,0,0
1/01/2021,Trinidad and Tobago,Kedah,0,0,0
1/01/2021,Trinidad and Tobago,Pahang,0,0,0
1/01/2021,Trinidad and Tobago,Pulau Pinang,0,0,0
1/01/2021,Trinidad and Tobago,Sabah,0,0,0
1/01/2021,Trinidad and Tobago,Sarawak,0,0,0
1/01/2021,Trinidad and Tobago,Selangor,3,1,2
1/01/2021,Tunisia,Johor,0,0,0
1/01/2021,Tunisia,Kedah,0,0,0
1/01/2021,Tunisia,Kelantan,0,0,0
1/01/2021,Tunisia,Melaka,0,0,0
1/01/2021,Tunisia,Perak,0,0,0
1/01/2021,Tunisia,Perlis,0,0,0
1/01/2021,Tunisia,Pulau Pinang,0,0,0
1/01/2021,Tunisia,Sabah,0,0,0
1/01/2021,Tunisia,Sarawak,0,0,0
1/01/2021,Tunisia,Selangor,4,2,2
1/01/2021,Tunisia,W.P. Labuan,0,0,0
1/01/2021,Türkiye,Johor,0,0,0
1/01/2021,Türkiye,Kedah,0,0,0
1/01/2021,Türkiye,Kelantan,0,0,0
1/01/2021,Türkiye,Melaka,0,0,0
1/01/2021,Türkiye,Negeri Sembilan,0,0,0
1/01/2021,Türkiye,Pahang,0,0,0
1/01/2021,Türkiye,Perak,0,0,0
1/01/2021,Türkiye,Perlis,0,0,0
1/01/2021,Türkiye,Pulau Pinang,0,0,0
1/01/2021,Türkiye,Sabah,0,0,0
1/01/2021,Türkiye,Sarawak,0,0,0
1/01/2021,Türkiye,Selangor,18,15,3
1/01/2021,Türkiye,W.P. Labuan,0,0,0
1/01/2021,Tuvalu,Selangor,0,0,0
1/01/2021,"Taiwan, Province of China",Johor,1,1,0
1/01/2021,"Taiwan, Province of China",Kedah,0,0,0
1/01/2021,"Taiwan, Province of China",Kelantan,0,0,0
1/01/2021,"Taiwan, Province of China",Melaka,0,0,0
1/01/2021,"Taiwan, Province of China",Negeri Sembilan,0,0,0
1/01/2021,"Taiwan, Province of China",Pahang,0,0,0
1/01/2021,"Taiwan, Province of China",Perak,0,0,0
1/01/2021,"Taiwan, Province of China",Perlis,0,0,0
1/01/2021,"Taiwan, Province of China",Pulau Pinang,8,3,5
1/01/2021,"Taiwan, Province of China",Sabah,0,0,0
1/01/2021,"Taiwan, Province of China",Sarawak,1,1,0
1/01/2021,"Taiwan, Province of China",Selangor,80,47,33
1/01/2021,"Taiwan, Province of China",W.P. Labuan,0,0,0
1/01/2021,"Tanzania, United Republic of",Johor,0,0,0
1/01/2021,"Tanzania, United Republic of",Kedah,0,0,0
1/01/2021,"Tanzania, United Republic of",Perak,0,0,0
1/01/2021,"Tanzania, United Republic of",Perlis,0,0,0
1/01/2021,"Tanzania, United Republic of",Pulau Pinang,0,0,0
1/01/2021,"Tanzania, United Republic of",Sabah,0,0,0
1/01/2021,"Tanzania, United Republic of",Sarawak,0,0,0
1/01/2021,"Tanzania, United Republic of",Selangor,7,2,5
1/01/2021,Uganda,Johor,0,0,0
1/01/2021,Uganda,Kedah,0,0,0
1/01/2021,Uganda,Perak,0,0,0
1/01/2021,Uganda,Perlis,0,0,0
1/01/2021,Uganda,Pulau Pinang,0,0,0
1/01/2021,Uganda,Sabah,0,0,0
1/01/2021,Uganda,Sarawak,0,0,0
1/01/2021,Uganda,Selangor,3,3,0
1/01/2021,Ukraine,Johor,13,13,0
1/01/2021,Ukraine,Kedah,0,0,0
1/01/2021,Ukraine,Kelantan,0,0,0
1/01/2021,Ukraine,Melaka,0,0,0
1/01/2021,Ukraine,Negeri Sembilan,0,0,0
1/01/2021,Ukraine,Pahang,0,0,0
1/01/2021,Ukraine,Perak,0,0,0
1/01/2021,Ukraine,Perlis,0,0,0
1/01/2021,Ukraine,Pulau Pinang,0,0,0
1/01/2021,Ukraine,Sabah,0,0,0
1/01/2021,Ukraine,Sarawak,0,0,0
1/01/2021,Ukraine,Selangor,80,71,9
1/01/2021,Ukraine,W.P. Labuan,0,0,0
1/01/2021,Uruguay,Johor,0,0,0
1/01/2021,Uruguay,Kedah,0,0,0
1/01/2021,Uruguay,Kelantan,0,0,0
1/01/2021,Uruguay,Perak,0,0,0
1/01/2021,Uruguay,Perlis,0,0,0
1/01/2021,Uruguay,Pulau Pinang,0,0,0
1/01/2021,Uruguay,Sabah,0,0,0
1/01/2021,Uruguay,Sarawak,0,0,0
1/01/2021,Uruguay,Selangor,0,0,0
1/01/2021,Uruguay,W.P. Labuan,0,0,0
1/01/2021,United States of America,Johor,5,5,0
1/01/2021,United States of America,Kedah,0,0,0
1/01/2021,United States of America,Kelantan,0,0,0
1/01/2021,United States of America,Melaka,0,0,0
1/01/2021,United States of America,Negeri Sembilan,0,0,0
1/01/2021,United States of America,Pahang,0,0,0
1/01/2021,United States of America,Perak,4,2,2
1/01/2021,United States of America,Perlis,0,0,0
1/01/2021,United States of America,Pulau Pinang,2,1,1
1/01/2021,United States of America,Sabah,1,1,0
1/01/2021,United States of America,Sarawak,0,0,0
1/01/2021,United States of America,Selangor,176,131,45
1/01/2021,United States of America,Terengganu,0,0,0
1/01/2021,United States of America,W.P. Labuan,0,0,0
1/01/2021,Uzbekistan,Johor,0,0,0
1/01/2021,Uzbekistan,Kedah,0,0,0
1/01/2021,Uzbekistan,Kelantan,0,0,0
1/01/2021,Uzbekistan,Perak,0,0,0
1/01/2021,Uzbekistan,Perlis,0,0,0
1/01/2021,Uzbekistan,Pulau Pinang,0,0,0
1/01/2021,Uzbekistan,Sabah,0,0,0
1/01/2021,Uzbekistan,Sarawak,0,0,0
1/01/2021,Uzbekistan,Selangor,14,7,7
1/01/2021,Holy See,Johor,0,0,0
1/01/2021,Holy See,Sarawak,0,0,0
1/01/2021,Holy See,Selangor,1,1,0
1/01/2021,Saint Vincent and the Grenadines,Johor,0,0,0
1/01/2021,Saint Vincent and the Grenadines,Kedah,0,0,0
1/01/2021,Saint Vincent and the Grenadines,Pulau Pinang,0,0,0
1/01/2021,Saint Vincent and the Grenadines,Sarawak,0,0,0
1/01/2021,Saint Vincent and the Grenadines,Selangor,0,0,0
1/01/2021,"Venezuela, Bolivarian Republic of",Johor,0,0,0
1/01/2021,"Venezuela, Bolivarian Republic of",Kedah,0,0,0
1/01/2021,"Venezuela, Bolivarian Republic of",Kelantan,0,0,0
1/01/2021,"Venezuela, Bolivarian Republic of",Melaka,0,0,0
1/01/2021,"Venezuela, Bolivarian Republic of",Perak,0,0,0
1/01/2021,"Venezuela, Bolivarian Republic of",Perlis,0,0,0
1/01/2021,"Venezuela, Bolivarian Republic of",Pulau Pinang,0,0,0
1/01/2021,"Venezuela, Bolivarian Republic of",Sabah,0,0,0
1/01/2021,"Venezuela, Bolivarian Republic of",Sarawak,0,0,0
1/01/2021,"Venezuela, Bolivarian Republic of",Selangor,4,4,0
1/01/2021,"Venezuela, Bolivarian Republic of",W.P. Labuan,0,0,0
1/01/2021,Viet Nam,Johor,3,0,3
1/01/2021,Viet Nam,Kedah,0,0,0
1/01/2021,Viet Nam,Kelantan,0,0,0
1/01/2021,Viet Nam,Melaka,0,0,0
1/01/2021,Viet Nam,Negeri Sembilan,0,0,0
1/01/2021,Viet Nam,Pahang,0,0,0
1/01/2021,Viet Nam,Perak,0,0,0
1/01/2021,Viet Nam,Perlis,0,0,0
1/01/2021,Viet Nam,Pulau Pinang,1,0,1
1/01/2021,Viet Nam,Sabah,0,0,0
1/01/2021,Viet Nam,Sarawak,0,0,0
1/01/2021,Viet Nam,Selangor,93,23,70
1/01/2021,Viet Nam,Terengganu,6,6,0
1/01/2021,Viet Nam,W.P. Labuan,0,0,0
1/01/2021,Vanuatu,Johor,0,0,0
1/01/2021,Vanuatu,Kedah,0,0,0
1/01/2021,Vanuatu,Pulau Pinang,0,0,0
1/01/2021,Vanuatu,Sabah,0,0,0
1/01/2021,Vanuatu,Sarawak,0,0,0
1/01/2021,Vanuatu,Selangor,0,0,0
1/01/2021, Samoa,Johor,0,0,0
1/01/2021, Samoa,Sarawak,0,0,0
1/01/2021, Samoa,Selangor,0,0,0
1/01/2021,Yemen,Johor,0,0,0
1/01/2021,Yemen,Kedah,0,0,0
1/01/2021,Yemen,Kelantan,0,0,0
1/01/2021,Yemen,Melaka,0,0,0
1/01/2021,Yemen,Pahang,0,0,0
1/01/2021,Yemen,Perak,0,0,0
1/01/2021,Yemen,Perlis,0,0,0
1/01/2021,Yemen,Pulau Pinang,0,0,0
1/01/2021,Yemen,Sabah,0,0,0
1/01/2021,Yemen,Sarawak,0,0,0
1/01/2021,Yemen,Selangor,23,19,4
1/01/2021,Yemen,W.P. Labuan,0,0,0
1/01/2021,South Africa,Johor,2,2,0
1/01/2021,South Africa,Kedah,0,0,0
1/01/2021,South Africa,Kelantan,0,0,0
1/01/2021,South Africa,Melaka,0,0,0
1/01/2021,South Africa,Pahang,0,0,0
1/01/2021,South Africa,Perak,0,0,0
1/01/2021,South Africa,Perlis,0,0,0
1/01/2021,South Africa,Pulau Pinang,0,0,0
1/01/2021,South Africa,Sabah,0,0,0
1/01/2021,South Africa,Sarawak,0,0,0
1/01/2021,South Africa,Selangor,26,19,7
1/01/2021,South Africa,Terengganu,0,0,0
1/01/2021,South Africa,W.P. Labuan,0,0,0
1/01/2021,ZAR,Selangor,0,0,0
1/01/2021,Zambia,Johor,0,0,0
1/01/2021,Zambia,Kedah,0,0,0
1/01/2021,Zambia,Perak,0,0,0
1/01/2021,Zambia,Perlis,0,0,0
1/01/2021,Zambia,Pulau Pinang,0,0,0
1/01/2021,Zambia,Sabah,0,0,0
1/01/2021,Zambia,Sarawak,0,0,0
1/01/2021,Zambia,Selangor,5,4,1
1/01/2021,Zimbabwe,Johor,0,0,0
1/01/2021,Zimbabwe,Kedah,0,0,0
1/01/2021,Zimbabwe,Kelantan,0,0,0
1/01/2021,Zimbabwe,Perak,0,0,0
1/01/2021,Zimbabwe,Perlis,0,0,0
1/01/2021,Zimbabwe,Pulau Pinang,0,0,0
1/01/2021,Zimbabwe,Sabah,0,0,0
1/01/2021,Zimbabwe,Sarawak,0,0,0
1/01/2021,Zimbabwe,Selangor,1,1,0
1/02/2021,Aruba,Kedah,0,0,0
1/02/2021,Aruba,Pulau Pinang,0,0,0
1/02/2021,Afghanistan,Johor,0,0,0
1/02/2021,Afghanistan,Kedah,0,0,0
1/02/2021,Afghanistan,Perlis,0,0,0
1/02/2021,Afghanistan,Pulau Pinang,0,0,0
1/02/2021,Afghanistan,Sarawak,0,0,0
1/02/2021,Afghanistan,Selangor,17,15,2
1/02/2021,Angola,Johor,0,0,0
1/02/2021,Angola,Kedah,0,0,0
1/02/2021,Angola,Sabah,0,0,0
1/02/2021,Angola,Selangor,0,0,0
1/02/2021,Anguilla,Selangor,0,0,0
1/02/2021,Albania,Johor,0,0,0
1/02/2021,Albania,Kedah,0,0,0
1/02/2021,Albania,Perak,0,0,0
1/02/2021,Albania,Perlis,0,0,0
1/02/2021,Albania,Pulau Pinang,0,0,0
1/02/2021,Albania,Sabah,0,0,0
1/02/2021,Albania,Sarawak,0,0,0
1/02/2021,Albania,Selangor,0,0,0
1/02/2021,Andorra,Johor,0,0,0
1/02/2021,Andorra,Kedah,0,0,0
1/02/2021,Andorra,Perlis,0,0,0
1/02/2021,Andorra,Pulau Pinang,0,0,0
1/02/2021,Andorra,Selangor,0,0,0
1/02/2021,Antigua and Barbuda,Selangor,0,0,0
1/02/2021,United Arab Emirates,Johor,0,0,0
1/02/2021,United Arab Emirates,Kedah,0,0,0
1/02/2021,United Arab Emirates,Kelantan,0,0,0
1/02/2021,United Arab Emirates,Perak,0,0,0
1/02/2021,United Arab Emirates,Perlis,0,0,0
1/02/2021,United Arab Emirates,Pulau Pinang,0,0,0
1/02/2021,United Arab Emirates,Sabah,0,0,0
1/02/2021,United Arab Emirates,Sarawak,0,0,0
1/02/2021,United Arab Emirates,Selangor,2,1,1
1/02/2021,Argentina,Johor,0,0,0
1/02/2021,Argentina,Kedah,0,0,0
1/02/2021,Argentina,Kelantan,0,0,0
1/02/2021,Argentina,Melaka,0,0,0
1/02/2021,Argentina,Perak,0,0,0
1/02/2021,Argentina,Perlis,0,0,0
1/02/2021,Argentina,Pulau Pinang,0,0,0
1/02/2021,Argentina,Sabah,0,0,0
1/02/2021,Argentina,Sarawak,0,0,0
1/02/2021,Argentina,Selangor,4,4,0
1/02/2021,Argentina,W.P. Labuan,0,0,0
1/02/2021,Armenia,Johor,0,0,0
1/02/2021,Armenia,Kedah,0,0,0
1/02/2021,Armenia,Kelantan,0,0,0
1/02/2021,Armenia,Perak,0,0,0
1/02/2021,Armenia,Perlis,0,0,0
1/02/2021,Armenia,Pulau Pinang,1,0,1
1/02/2021,Armenia,Sabah,0,0,0
1/02/2021,Armenia,Sarawak,0,0,0
1/02/2021,Armenia,Selangor,0,0,0
1/02/2021,Antarctica,Selangor,0,0,0
1/02/2021,Antigua and Barbuda,Johor,0,0,0
1/02/2021,Antigua and Barbuda,Kedah,0,0,0
1/02/2021,Antigua and Barbuda,Pulau Pinang,0,0,0
1/02/2021,Antigua and Barbuda,Sarawak,0,0,0
1/02/2021,Antigua and Barbuda,Selangor,0,0,0
1/02/2021,Australia,Johor,1,1,0
1/02/2021,Australia,Kedah,0,0,0
1/02/2021,Australia,Kelantan,0,0,0
1/02/2021,Australia,Melaka,0,0,0
1/02/2021,Australia,Negeri Sembilan,0,0,0
1/02/2021,Australia,Pahang,0,0,0
1/02/2021,Australia,Perak,2,1,1
1/02/2021,Australia,Perlis,0,0,0
1/02/2021,Australia,Pulau Pinang,4,3,1
1/02/2021,Australia,Sabah,0,0,0
1/02/2021,Australia,Sarawak,0,0,0
1/02/2021,Australia,Selangor,80,50,30
1/02/2021,Australia,Terengganu,0,0,0
1/02/2021,Australia,W.P. Labuan,0,0,0
1/02/2021,Austria,Johor,0,0,0
1/02/2021,Austria,Kedah,0,0,0
1/02/2021,Austria,Kelantan,0,0,0
1/02/2021,Austria,Melaka,0,0,0
1/02/2021,Austria,Negeri Sembilan,0,0,0
1/02/2021,Austria,Pahang,0,0,0
1/02/2021,Austria,Perak,0,0,0
1/02/2021,Austria,Perlis,0,0,0
1/02/2021,Austria,Pulau Pinang,0,0,0
1/02/2021,Austria,Sabah,0,0,0
1/02/2021,Austria,Sarawak,0,0,0
1/02/2021,Austria,Selangor,13,13,0
1/02/2021,Austria,Terengganu,0,0,0
1/02/2021,Austria,W.P. Labuan,0,0,0
1/02/2021,Azerbaijan,Johor,0,0,0
1/02/2021,Azerbaijan,Kedah,0,0,0
1/02/2021,Azerbaijan,Kelantan,0,0,0
1/02/2021,Azerbaijan,Melaka,0,0,0
1/02/2021,Azerbaijan,Perlis,0,0,0
1/02/2021,Azerbaijan,Pulau Pinang,0,0,0
1/02/2021,Azerbaijan,Sabah,0,0,0
1/02/2021,Azerbaijan,Sarawak,0,0,0
1/02/2021,Azerbaijan,Selangor,0,0,0
1/02/2021,Azerbaijan,W.P. Labuan,0,0,0
1/02/2021,Burundi,Pulau Pinang,0,0,0
1/02/2021,Burundi,Sarawak,0,0,0
1/02/2021,Burundi,Selangor,0,0,0
1/02/2021,Belgium,Johor,0,0,0
1/02/2021,Belgium,Kedah,0,0,0
1/02/2021,Belgium,Kelantan,0,0,0
1/02/2021,Belgium,Melaka,0,0,0
1/02/2021,Belgium,Negeri Sembilan,0,0,0
1/02/2021,Belgium,Pahang,0,0,0
1/02/2021,Belgium,Perak,0,0,0
1/02/2021,Belgium,Perlis,0,0,0
1/02/2021,Belgium,Pulau Pinang,0,0,0
1/02/2021,Belgium,Sabah,0,0,0
1/02/2021,Belgium,Sarawak,0,0,0
1/02/2021,Belgium,Selangor,13,9,4
1/02/2021,Belgium,W.P. Labuan,0,0,0
1/02/2021,Benin,Johor,0,0,0
1/02/2021,Benin,Kedah,0,0,0
1/02/2021,Benin,Perak,0,0,0
1/02/2021,Benin,Pulau Pinang,0,0,0
1/02/2021,Benin,Sabah,0,0,0
1/02/2021,Benin,Sarawak,0,0,0
1/02/2021,Benin,Selangor,0,0,0
1/02/2021,Burkina Faso,Perak,0,0,0
1/02/2021,Burkina Faso,Pulau Pinang,0,0,0
1/02/2021,Burkina Faso,Selangor,0,0,0
1/02/2021,Bangladesh,Johor,4,4,0
1/02/2021,Bangladesh,Kedah,0,0,0
1/02/2021,Bangladesh,Kelantan,0,0,0
1/02/2021,Bangladesh,Melaka,0,0,0
1/02/2021,Bangladesh,Negeri Sembilan,0,0,0
1/02/2021,Bangladesh,Pahang,0,0,0
1/02/2021,Bangladesh,Perak,0,0,0
1/02/2021,Bangladesh,Perlis,0,0,0
1/02/2021,Bangladesh,Pulau Pinang,0,0,0
1/02/2021,Bangladesh,Sabah,0,0,0
1/02/2021,Bangladesh,Sarawak,0,0,0
1/02/2021,Bangladesh,Selangor,143,101,42
1/02/2021,Bangladesh,W.P. Labuan,0,0,0
1/02/2021,Bulgaria,Johor,0,0,0
1/02/2021,Bulgaria,Kedah,0,0,0
1/02/2021,Bulgaria,Kelantan,0,0,0
1/02/2021,Bulgaria,Pahang,0,0,0
1/02/2021,Bulgaria,Perak,0,0,0
1/02/2021,Bulgaria,Perlis,0,0,0
1/02/2021,Bulgaria,Pulau Pinang,0,0,0
1/02/2021,Bulgaria,Sabah,0,0,0
1/02/2021,Bulgaria,Sarawak,0,0,0
1/02/2021,Bulgaria,Selangor,18,18,0
1/02/2021,Bulgaria,W.P. Labuan,0,0,0
1/02/2021,Bahrain,Johor,0,0,0
1/02/2021,Bahrain,Kedah,0,0,0
1/02/2021,Bahrain,Kelantan,0,0,0
1/02/2021,Bahrain,Perlis,0,0,0
1/02/2021,Bahrain,Pulau Pinang,0,0,0
1/02/2021,Bahrain,Sabah,0,0,0
1/02/2021,Bahrain,Sarawak,0,0,0
1/02/2021,Bahrain,Selangor,1,1,0
1/02/2021,Bahamas,Johor,0,0,0
1/02/2021,Bahamas,Kedah,0,0,0
1/02/2021,Bahamas,Perak,0,0,0
1/02/2021,Bahamas,Sabah,0,0,0
1/02/2021,Bahamas,Sarawak,0,0,0
1/02/2021,Bahamas,Selangor,0,0,0
1/02/2021,Bosnia and Herzegovina,Johor,0,0,0
1/02/2021,Bosnia and Herzegovina,Kedah,0,0,0
1/02/2021,Bosnia and Herzegovina,Perlis,0,0,0
1/02/2021,Bosnia and Herzegovina,Pulau Pinang,0,0,0
1/02/2021,Bosnia and Herzegovina,Sabah,0,0,0
1/02/2021,Bosnia and Herzegovina,Sarawak,0,0,0
1/02/2021,Bosnia and Herzegovina,Selangor,1,0,1
1/02/2021,Belarus,Johor,0,0,0
1/02/2021,Belarus,Kedah,0,0,0
1/02/2021,Belarus,Kelantan,0,0,0
1/02/2021,Belarus,Pahang,0,0,0
1/02/2021,Belarus,Perak,0,0,0
1/02/2021,Belarus,Perlis,0,0,0
1/02/2021,Belarus,Pulau Pinang,0,0,0
1/02/2021,Belarus,Sabah,0,0,0
1/02/2021,Belarus,Sarawak,0,0,0
1/02/2021,Belarus,Selangor,0,0,0
1/02/2021,Belarus,W.P. Labuan,0,0,0
1/02/2021,Belize,Johor,0,0,0
1/02/2021,Belize,Pulau Pinang,0,0,0
1/02/2021,Belize,Sarawak,0,0,0
1/02/2021,Belize,Selangor,0,0,0
1/02/2021,Bermuda,Selangor,0,0,0
1/02/2021,Bolivia,Johor,0,0,0
1/02/2021,Bolivia,Kedah,0,0,0
1/02/2021,Bolivia,Melaka,0,0,0
1/02/2021,Bolivia,Perak,0,0,0
1/02/2021,Bolivia,Perlis,0,0,0
1/02/2021,Bolivia,Pulau Pinang,0,0,0
1/02/2021,Bolivia,Sabah,0,0,0
1/02/2021,Bolivia,Sarawak,0,0,0
1/02/2021,Bolivia,Selangor,0,0,0
1/02/2021,Brazil,Johor,12,12,0
1/02/2021,Brazil,Kedah,0,0,0
1/02/2021,Brazil,Kelantan,0,0,0
1/02/2021,Brazil,Melaka,0,0,0
1/02/2021,Brazil,Pahang,0,0,0
1/02/2021,Brazil,Perak,0,0,0
1/02/2021,Brazil,Perlis,0,0,0
1/02/2021,Brazil,Pulau Pinang,0,0,0
1/02/2021,Brazil,Sabah,0,0,0
1/02/2021,Brazil,Sarawak,0,0,0
1/02/2021,Brazil,Selangor,30,20,10
1/02/2021,Brazil,W.P. Labuan,0,0,0
1/02/2021,Barbados,Johor,0,0,0
1/02/2021,Barbados,Kedah,0,0,0
1/02/2021,Barbados,Perlis,0,0,0
1/02/2021,Barbados,Pulau Pinang,0,0,0
1/02/2021,Barbados,Selangor,0,0,0
1/02/2021,Brunei Darussalam,Johor,0,0,0
1/02/2021,Brunei Darussalam,Kedah,0,0,0
1/02/2021,Brunei Darussalam,Kelantan,0,0,0
1/02/2021,Brunei Darussalam,Melaka,0,0,0
1/02/2021,Brunei Darussalam,Pahang,0,0,0
1/02/2021,Brunei Darussalam,Perak,0,0,0
1/02/2021,Brunei Darussalam,Perlis,0,0,0
1/02/2021,Brunei Darussalam,Pulau Pinang,0,0,0
1/02/2021,Brunei Darussalam,Sabah,0,0,0
1/02/2021,Brunei Darussalam,Sarawak,355,347,8
1/02/2021,Brunei Darussalam,Selangor,6,4,2
1/02/2021,Brunei Darussalam,W.P. Labuan,1,1,0
1/02/2021,Bhutan,Johor,0,0,0
1/02/2021,Bhutan,Kedah,0,0,0
1/02/2021,Bhutan,Perak,0,0,0
1/02/2021,Bhutan,Perlis,0,0,0
1/02/2021,Bhutan,Pulau Pinang,0,0,0
1/02/2021,Bhutan,Sabah,0,0,0
1/02/2021,Bhutan,Sarawak,0,0,0
1/02/2021,Bhutan,Selangor,2,0,2
1/02/2021,Botswana,Johor,0,0,0
1/02/2021,Botswana,Kedah,0,0,0
1/02/2021,Botswana,Perlis,0,0,0
1/02/2021,Botswana,Pulau Pinang,0,0,0
1/02/2021,Botswana,Sabah,0,0,0
1/02/2021,Botswana,Sarawak,0,0,0
1/02/2021,Botswana,Selangor,0,0,0
1/02/2021,Central African Republic,Kedah,0,0,0
1/02/2021,Central African Republic,Selangor,0,0,0
1/02/2021,Canada,Johor,0,0,0
1/02/2021,Canada,Kedah,0,0,0
1/02/2021,Canada,Kelantan,0,0,0
1/02/2021,Canada,Melaka,0,0,0
1/02/2021,Canada,Negeri Sembilan,0,0,0
1/02/2021,Canada,Pahang,0,0,0
1/02/2021,Canada,Perak,0,0,0
1/02/2021,Canada,Perlis,0,0,0
1/02/2021,Canada,Pulau Pinang,1,1,0
1/02/2021,Canada,Sabah,0,0,0
1/02/2021,Canada,Sarawak,0,0,0
1/02/2021,Canada,Selangor,31,24,7
1/02/2021,Canada,Terengganu,0,0,0
1/02/2021,Canada,W.P. Labuan,0,0,0
1/02/2021,Cocos (Keeling) Islands,Selangor,0,0,0
1/02/2021,Switzerland,Johor,0,0,0
1/02/2021,Switzerland,Kedah,0,0,0
1/02/2021,Switzerland,Kelantan,0,0,0
1/02/2021,Switzerland,Melaka,0,0,0
1/02/2021,Switzerland,Negeri Sembilan,0,0,0
1/02/2021,Switzerland,Pahang,0,0,0
1/02/2021,Switzerland,Perak,0,0,0
1/02/2021,Switzerland,Perlis,0,0,0
1/02/2021,Switzerland,Pulau Pinang,0,0,0
1/02/2021,Switzerland,Sabah,0,0,0
1/02/2021,Switzerland,Sarawak,0,0,0
1/02/2021,Switzerland,Selangor,9,5,4
1/02/2021,Switzerland,W.P. Labuan,0,0,0
1/02/2021,Chile,Johor,0,0,0
1/02/2021,Chile,Kedah,0,0,0
1/02/2021,Chile,Kelantan,0,0,0
1/02/2021,Chile,Melaka,0,0,0
1/02/2021,Chile,Pahang,0,0,0
1/02/2021,Chile,Perak,0,0,0
1/02/2021,Chile,Perlis,0,0,0
1/02/2021,Chile,Pulau Pinang,0,0,0
1/02/2021,Chile,Sabah,0,0,0
1/02/2021,Chile,Sarawak,0,0,0
1/02/2021,Chile,Selangor,2,1,1
1/02/2021,China,Johor,32,17,15
1/02/2021,China,Kedah,0,0,0
1/02/2021,China,Kelantan,0,0,0
1/02/2021,China,Melaka,0,0,0
1/02/2021,China,Pahang,0,0,0
1/02/2021,China,Perak,0,0,0
1/02/2021,China,Perlis,0,0,0
1/02/2021,China,Pulau Pinang,6,1,5
1/02/2021,China,Sabah,0,0,0
1/02/2021,China,Sarawak,48,46,2
1/02/2021,China,Selangor,768,623,145
1/02/2021,China,Terengganu,0,0,0
1/02/2021,China,W.P. Labuan,0,0,0
1/02/2021,Côte d'Ivoire,Johor,0,0,0
1/02/2021,Côte d'Ivoire,Kedah,0,0,0
1/02/2021,Côte d'Ivoire,Pulau Pinang,0,0,0
1/02/2021,Côte d'Ivoire,Sabah,0,0,0
1/02/2021,Côte d'Ivoire,Sarawak,0,0,0
1/02/2021,Côte d'Ivoire,Selangor,0,0,0
1/02/2021,Cameroon,Johor,0,0,0
1/02/2021,Cameroon,Kedah,0,0,0
1/02/2021,Cameroon,Pulau Pinang,0,0,0
1/02/2021,Cameroon,Sabah,0,0,0
1/02/2021,Cameroon,Sarawak,0,0,0
1/02/2021,Cameroon,Selangor,2,2,0
1/02/2021,Congo,Johor,0,0,0
1/02/2021,Congo,Pulau Pinang,0,0,0
1/02/2021,Congo,Sarawak,0,0,0
1/02/2021,Congo,Selangor,0,0,0
1/02/2021,Congo,Johor,0,0,0
1/02/2021,Congo,Kedah,0,0,0
1/02/2021,Congo,Selangor,0,0,0
1/02/2021,Cook Islands,Selangor,0,0,0
1/02/2021,Colombia,Johor,0,0,0
1/02/2021,Colombia,Kedah,0,0,0
1/02/2021,Colombia,Perak,0,0,0
1/02/2021,Colombia,Pulau Pinang,0,0,0
1/02/2021,Colombia,Sabah,0,0,0
1/02/2021,Colombia,Sarawak,0,0,0
1/02/2021,Colombia,Selangor,5,3,2
1/02/2021,Colombia,W.P. Labuan,0,0,0
1/02/2021,Comoros,Johor,0,0,0
1/02/2021,Comoros,Kedah,0,0,0
1/02/2021,Comoros,Selangor,3,2,1
1/02/2021,Cabo Verde,Johor,0,0,0
1/02/2021,Cabo Verde,Kedah,0,0,0
1/02/2021,Cabo Verde,Pulau Pinang,0,0,0
1/02/2021,Cabo Verde,Sabah,0,0,0
1/02/2021,Cabo Verde,Selangor,0,0,0
1/02/2021,Costa Rica,Johor,0,0,0
1/02/2021,Costa Rica,Kedah,0,0,0
1/02/2021,Costa Rica,Perak,0,0,0
1/02/2021,Costa Rica,Perlis,0,0,0
1/02/2021,Costa Rica,Pulau Pinang,0,0,0
1/02/2021,Costa Rica,Sabah,0,0,0
1/02/2021,Costa Rica,Sarawak,0,0,0
1/02/2021,Costa Rica,Selangor,18,14,4
1/02/2021,Cuba,Johor,0,0,0
1/02/2021,Cuba,Kedah,0,0,0
1/02/2021,Cuba,Perlis,0,0,0
1/02/2021,Cuba,Pulau Pinang,0,0,0
1/02/2021,Cuba,Sabah,0,0,0
1/02/2021,Cuba,Sarawak,0,0,0
1/02/2021,Cuba,Selangor,0,0,0
1/02/2021,Cyprus,Johor,0,0,0
1/02/2021,Cyprus,Kedah,0,0,0
1/02/2021,Cyprus,Perak,0,0,0
1/02/2021,Cyprus,Perlis,0,0,0
1/02/2021,Cyprus,Pulau Pinang,0,0,0
1/02/2021,Cyprus,Sabah,0,0,0
1/02/2021,Cyprus,Sarawak,0,0,0
1/02/2021,Cyprus,Selangor,3,2,1
1/02/2021,Czechia,Johor,2,2,0
1/02/2021,Czechia,Kedah,0,0,0
1/02/2021,Czechia,Kelantan,0,0,0
1/02/2021,Czechia,Melaka,0,0,0
1/02/2021,Czechia,Negeri Sembilan,0,0,0
1/02/2021,Czechia,Perak,0,0,0
1/02/2021,Czechia,Perlis,0,0,0
1/02/2021,Czechia,Pulau Pinang,0,0,0
1/02/2021,Czechia,Sabah,0,0,0
1/02/2021,Czechia,Sarawak,0,0,0
1/02/2021,Czechia,Selangor,4,4,0
1/02/2021,Czechia,W.P. Labuan,0,0,0
1/02/2021,Germany,Johor,0,0,0
1/02/2021,Germany,Kedah,0,0,0
1/02/2021,Germany,Kelantan,0,0,0
1/02/2021,Germany,Melaka,0,0,0
1/02/2021,Germany,Negeri Sembilan,0,0,0
1/02/2021,Germany,Pahang,0,0,0
1/02/2021,Germany,Perak,0,0,0
1/02/2021,Germany,Perlis,0,0,0
1/02/2021,Germany,Pulau Pinang,1,1,0
1/02/2021,Germany,Sabah,0,0,0
1/02/2021,Germany,Sarawak,0,0,0
1/02/2021,Germany,Selangor,65,56,9
1/02/2021,Germany,Terengganu,0,0,0
1/02/2021,Germany,W.P. Labuan,0,0,0
1/02/2021,Djibouti,Johor,0,0,0
1/02/2021,Djibouti,Selangor,0,0,0
1/02/2021,Dominica,Johor,0,0,0
1/02/2021,Dominica,Kedah,0,0,0
1/02/2021,Dominica,Pulau Pinang,0,0,0
1/02/2021,Dominica,Sabah,0,0,0
1/02/2021,Dominica,Sarawak,0,0,0
1/02/2021,Dominica,Selangor,1,1,0
1/02/2021,Dominica,W.P. Labuan,0,0,0
1/02/2021,Denmark,Johor,9,9,0
1/02/2021,Denmark,Kedah,0,0,0
1/02/2021,Denmark,Kelantan,0,0,0
1/02/2021,Denmark,Melaka,0,0,0
1/02/2021,Denmark,Negeri Sembilan,0,0,0
1/02/2021,Denmark,Pahang,0,0,0
1/02/2021,Denmark,Perak,0,0,0
1/02/2021,Denmark,Perlis,0,0,0
1/02/2021,Denmark,Pulau Pinang,0,0,0
1/02/2021,Denmark,Sabah,0,0,0
1/02/2021,Denmark,Sarawak,0,0,0
1/02/2021,Denmark,Selangor,8,8,0
1/02/2021,Denmark,W.P. Labuan,0,0,0
1/02/2021,Dominican Republic,Johor,0,0,0
1/02/2021,Dominican Republic,Kedah,0,0,0
1/02/2021,Dominican Republic,Perak,0,0,0
1/02/2021,Dominican Republic,Perlis,0,0,0
1/02/2021,Dominican Republic,Pulau Pinang,0,0,0
1/02/2021,Dominican Republic,Sabah,0,0,0
1/02/2021,Dominican Republic,Sarawak,0,0,0
1/02/2021,Dominican Republic,Selangor,0,0,0
1/02/2021,Algeria,Johor,0,0,0
1/02/2021,Algeria,Kedah,0,0,0
1/02/2021,Algeria,Kelantan,0,0,0
1/02/2021,Algeria,Melaka,0,0,0
1/02/2021,Algeria,Perak,0,0,0
1/02/2021,Algeria,Perlis,0,0,0
1/02/2021,Algeria,Pulau Pinang,0,0,0
1/02/2021,Algeria,Sabah,0,0,0
1/02/2021,Algeria,Sarawak,0,0,0
1/02/2021,Algeria,Selangor,4,3,1
1/02/2021,Algeria,W.P. Labuan,0,0,0
1/02/2021,Ecuador,Johor,0,0,0
1/02/2021,Ecuador,Kedah,0,0,0
1/02/2021,Ecuador,Perak,0,0,0
1/02/2021,Ecuador,Perlis,0,0,0
1/02/2021,Ecuador,Pulau Pinang,0,0,0
1/02/2021,Ecuador,Sabah,0,0,0
1/02/2021,Ecuador,Sarawak,0,0,0
1/02/2021,Ecuador,Selangor,0,0,0
1/02/2021,Egypt,Johor,0,0,0
1/02/2021,Egypt,Kedah,0,0,0
1/02/2021,Egypt,Kelantan,0,0,0
1/02/2021,Egypt,Melaka,0,0,0
1/02/2021,Egypt,Pahang,0,0,0
1/02/2021,Egypt,Perak,0,0,0
1/02/2021,Egypt,Perlis,0,0,0
1/02/2021,Egypt,Pulau Pinang,0,0,0
1/02/2021,Egypt,Sabah,0,0,0
1/02/2021,Egypt,Sarawak,0,0,0
1/02/2021,Egypt,Selangor,56,44,12
1/02/2021,Egypt,Terengganu,0,0,0
1/02/2021,Egypt,W.P. Labuan,0,0,0
1/02/2021,Eritrea,Johor,0,0,0
1/02/2021,Eritrea,Pulau Pinang,0,0,0
1/02/2021,Eritrea,Sabah,0,0,0
1/02/2021,Eritrea,Selangor,1,1,0
1/02/2021,Spain,Johor,2,2,0
1/02/2021,Spain,Kedah,0,0,0
1/02/2021,Spain,Kelantan,0,0,0
1/02/2021,Spain,Melaka,0,0,0
1/02/2021,Spain,Negeri Sembilan,0,0,0
1/02/2021,Spain,Pahang,0,0,0
1/02/2021,Spain,Perak,0,0,0
1/02/2021,Spain,Perlis,0,0,0
1/02/2021,Spain,Pulau Pinang,0,0,0
1/02/2021,Spain,Sabah,0,0,0
1/02/2021,Spain,Sarawak,0,0,0
1/02/2021,Spain,Selangor,16,13,3
1/02/2021,Spain,W.P. Labuan,0,0,0
1/02/2021,Estonia,Johor,0,0,0
1/02/2021,Estonia,Kedah,0,0,0
1/02/2021,Estonia,Kelantan,0,0,0
1/02/2021,Estonia,Pahang,0,0,0
1/02/2021,Estonia,Perak,0,0,0
1/02/2021,Estonia,Perlis,0,0,0
1/02/2021,Estonia,Pulau Pinang,0,0,0
1/02/2021,Estonia,Sabah,0,0,0
1/02/2021,Estonia,Sarawak,0,0,0
1/02/2021,Estonia,Selangor,0,0,0
1/02/2021,Estonia,W.P. Labuan,0,0,0
1/02/2021,Ethiopia,Johor,0,0,0
1/02/2021,Ethiopia,Kedah,0,0,0
1/02/2021,Ethiopia,Pulau Pinang,0,0,0
1/02/2021,Ethiopia,Sarawak,0,0,0
1/02/2021,Ethiopia,Selangor,0,0,0
1/02/2021,Finland,Johor,0,0,0
1/02/2021,Finland,Kedah,0,0,0
1/02/2021,Finland,Kelantan,0,0,0
1/02/2021,Finland,Melaka,0,0,0
1/02/2021,Finland,Negeri Sembilan,0,0,0
1/02/2021,Finland,Pahang,0,0,0
1/02/2021,Finland,Perak,0,0,0
1/02/2021,Finland,Perlis,0,0,0
1/02/2021,Finland,Pulau Pinang,0,0,0
1/02/2021,Finland,Sabah,0,0,0
1/02/2021,Finland,Sarawak,0,0,0
1/02/2021,Finland,Selangor,12,8,4
1/02/2021,Finland,W.P. Labuan,0,0,0
1/02/2021,Fiji,Johor,0,0,0
1/02/2021,Fiji,Kedah,0,0,0
1/02/2021,Fiji,Kelantan,0,0,0
1/02/2021,Fiji,Perak,0,0,0
1/02/2021,Fiji,Perlis,0,0,0
1/02/2021,Fiji,Pulau Pinang,0,0,0
1/02/2021,Fiji,Sabah,0,0,0
1/02/2021,Fiji,Sarawak,0,0,0
1/02/2021,Fiji,Selangor,0,0,0
1/02/2021,France,Johor,0,0,0
1/02/2021,France,Kedah,0,0,0
1/02/2021,France,Kelantan,0,0,0
1/02/2021,France,Melaka,0,0,0
1/02/2021,France,Negeri Sembilan,0,0,0
1/02/2021,France,Pahang,0,0,0
1/02/2021,France,Perak,0,0,0
1/02/2021,France,Perlis,0,0,0
1/02/2021,France,Pulau Pinang,0,0,0
1/02/2021,France,Sabah,0,0,0
1/02/2021,France,Sarawak,0,0,0
1/02/2021,France,Selangor,52,38,14
1/02/2021,France,Terengganu,0,0,0
1/02/2021,France,W.P. Labuan,0,0,0
1/02/2021,"Micronesia, Federated States of",Johor,0,0,0
1/02/2021,"Micronesia, Federated States of",Pulau Pinang,0,0,0
1/02/2021,"Micronesia, Federated States of",Selangor,0,0,0
1/02/2021,Gabon,Johor,0,0,0
1/02/2021,Gabon,Pulau Pinang,0,0,0
1/02/2021,Gabon,Sarawak,0,0,0
1/02/2021,Gabon,Selangor,0,0,0
1/02/2021,United Kingdom of Great Britain and Northern Ireland,Johor,3,3,0
1/02/2021,United Kingdom of Great Britain and Northern Ireland,Kedah,0,0,0
1/02/2021,United Kingdom of Great Britain and Northern Ireland,Kelantan,0,0,0
1/02/2021,United Kingdom of Great Britain and Northern Ireland,Melaka,0,0,0
1/02/2021,United Kingdom of Great Britain and Northern Ireland,Negeri Sembilan,0,0,0
1/02/2021,United Kingdom of Great Britain and Northern Ireland,Pahang,0,0,0
1/02/2021,United Kingdom of Great Britain and Northern Ireland,Perak,0,0,0
1/02/2021,United Kingdom of Great Britain and Northern Ireland,Perlis,0,0,0
1/02/2021,United Kingdom of Great Britain and Northern Ireland,Pulau Pinang,2,2,0
1/02/2021,United Kingdom of Great Britain and Northern Ireland,Sabah,0,0,0
1/02/2021,United Kingdom of Great Britain and Northern Ireland,Sarawak,3,2,1
1/02/2021,United Kingdom of Great Britain and Northern Ireland,Selangor,248,218,30
1/02/2021,United Kingdom of Great Britain and Northern Ireland,Terengganu,0,0,0
1/02/2021,United Kingdom of Great Britain and Northern Ireland,W.P. Labuan,0,0,0
1/02/2021,Georgia,Johor,0,0,0
1/02/2021,Georgia,Kedah,0,0,0
1/02/2021,Georgia,Melaka,0,0,0
1/02/2021,Georgia,Perak,0,0,0
1/02/2021,Georgia,Perlis,0,0,0
1/02/2021,Georgia,Pulau Pinang,0,0,0
1/02/2021,Georgia,Sabah,0,0,0
1/02/2021,Georgia,Sarawak,0,0,0
1/02/2021,Georgia,Selangor,1,1,0
1/02/2021,Ghana,Johor,1,1,0
1/02/2021,Ghana,Kedah,0,0,0
1/02/2021,Ghana,Kelantan,0,0,0
1/02/2021,Ghana,Pulau Pinang,0,0,0
1/02/2021,Ghana,Sabah,0,0,0
1/02/2021,Ghana,Sarawak,0,0,0
1/02/2021,Ghana,Selangor,8,8,0
1/02/2021,Gibraltar,Johor,0,0,0
1/02/2021,Gibraltar,Sarawak,0,0,0
1/02/2021,Guinea,Johor,0,0,0
1/02/2021,Guinea,Kedah,0,0,0
1/02/2021,Guinea,Kelantan,0,0,0
1/02/2021,Guinea,Perlis,0,0,0
1/02/2021,Guinea,Pulau Pinang,0,0,0
1/02/2021,Guinea,Sabah,0,0,0
1/02/2021,Guinea,Sarawak,0,0,0
1/02/2021,Guinea,Selangor,10,5,5
1/02/2021,Guadeloupe,Selangor,0,0,0
1/02/2021,Gambia,Johor,0,0,0
1/02/2021,Gambia,Kedah,0,0,0
1/02/2021,Gambia,Kelantan,0,0,0
1/02/2021,Gambia,Pulau Pinang,0,0,0
1/02/2021,Gambia,Sabah,0,0,0
1/02/2021,Gambia,Sarawak,0,0,0
1/02/2021,Gambia,Selangor,0,0,0
1/02/2021,Guinea-Bissau,Johor,0,0,0
1/02/2021,Guinea-Bissau,Selangor,0,0,0
1/02/2021,Equatorial Guinea,Johor,0,0,0
1/02/2021,Equatorial Guinea,Selangor,0,0,0
1/02/2021,Greece,Johor,0,0,0
1/02/2021,Greece,Kedah,0,0,0
1/02/2021,Greece,Kelantan,0,0,0
1/02/2021,Greece,Melaka,0,0,0
1/02/2021,Greece,Negeri Sembilan,0,0,0
1/02/2021,Greece,Pahang,0,0,0
1/02/2021,Greece,Perak,0,0,0
1/02/2021,Greece,Perlis,0,0,0
1/02/2021,Greece,Pulau Pinang,0,0,0
1/02/2021,Greece,Sabah,0,0,0
1/02/2021,Greece,Sarawak,0,0,0
1/02/2021,Greece,Selangor,6,5,1
1/02/2021,Grenada,Johor,0,0,0
1/02/2021,Grenada,Kedah,0,0,0
1/02/2021,Grenada,Pulau Pinang,0,0,0
1/02/2021,Grenada,Sabah,0,0,0
1/02/2021,Grenada,Sarawak,0,0,0
1/02/2021,Grenada,Selangor,0,0,0
1/02/2021,Greenland,Johor,0,0,0
1/02/2021,Greenland,Selangor,0,0,0
1/02/2021,Guatemala,Johor,0,0,0
1/02/2021,Guatemala,Kedah,0,0,0
1/02/2021,Guatemala,Pahang,0,0,0
1/02/2021,Guatemala,Perak,0,0,0
1/02/2021,Guatemala,Pulau Pinang,0,0,0
1/02/2021,Guatemala,Sabah,0,0,0
1/02/2021,Guatemala,Sarawak,0,0,0
1/02/2021,Guatemala,Selangor,0,0,0
1/02/2021,Guatemala,W.P. Labuan,0,0,0
1/02/2021,Guyana,Johor,0,0,0
1/02/2021,Guyana,Kedah,0,0,0
1/02/2021,Guyana,Pulau Pinang,0,0,0
1/02/2021,Guyana,Sarawak,0,0,0
1/02/2021,Guyana,Selangor,0,0,0
1/02/2021,Hong Kong,Johor,0,0,0
1/02/2021,Hong Kong,Kedah,0,0,0
1/02/2021,Hong Kong,Kelantan,0,0,0
1/02/2021,Hong Kong,Pahang,0,0,0
1/02/2021,Hong Kong,Perak,1,0,1
1/02/2021,Hong Kong,Perlis,0,0,0
1/02/2021,Hong Kong,Pulau Pinang,0,0,0
1/02/2021,Hong Kong,Sabah,0,0,0
1/02/2021,Hong Kong,Sarawak,0,0,0
1/02/2021,Hong Kong,Selangor,2,2,0
1/02/2021,Hong Kong,Terengganu,0,0,0
1/02/2021,Heard Island and McDonald Islands,Johor,0,0,0
1/02/2021,Honduras,Johor,0,0,0
1/02/2021,Honduras,Kedah,0,0,0
1/02/2021,Honduras,Perak,0,0,0
1/02/2021,Honduras,Pulau Pinang,0,0,0
1/02/2021,Honduras,Sabah,0,0,0
1/02/2021,Honduras,Sarawak,0,0,0
1/02/2021,Honduras,Selangor,1,1,0
1/02/2021,Croatia,Johor,3,3,0
1/02/2021,Croatia,Kedah,0,0,0
1/02/2021,Croatia,Kelantan,0,0,0
1/02/2021,Croatia,Melaka,0,0,0
1/02/2021,Croatia,Pahang,0,0,0
1/02/2021,Croatia,Perak,0,0,0
1/02/2021,Croatia,Perlis,0,0,0
1/02/2021,Croatia,Pulau Pinang,0,0,0
1/02/2021,Croatia,Sabah,0,0,0
1/02/2021,Croatia,Sarawak,0,0,0
1/02/2021,Croatia,Selangor,60,59,1
1/02/2021,Haiti,Johor,0,0,0
1/02/2021,Haiti,Kedah,0,0,0
1/02/2021,Haiti,Kelantan,0,0,0
1/02/2021,Haiti,Perak,0,0,0
1/02/2021,Haiti,Pulau Pinang,0,0,0
1/02/2021,Haiti,Sabah,0,0,0
1/02/2021,Haiti,Selangor,1,1,0
1/02/2021,Hungary,Johor,0,0,0
1/02/2021,Hungary,Kedah,0,0,0
1/02/2021,Hungary,Kelantan,0,0,0
1/02/2021,Hungary,Pahang,0,0,0
1/02/2021,Hungary,Perak,0,0,0
1/02/2021,Hungary,Perlis,0,0,0
1/02/2021,Hungary,Pulau Pinang,0,0,0
1/02/2021,Hungary,Sabah,0,0,0
1/02/2021,Hungary,Sarawak,0,0,0
1/02/2021,Hungary,Selangor,1,0,1
1/02/2021,Hungary,W.P. Labuan,0,0,0
1/02/2021,Indonesia,Johor,228,188,40
1/02/2021,Indonesia,Kedah,1,1,0
1/02/2021,Indonesia,Kelantan,0,0,0
1/02/2021,Indonesia,Melaka,0,0,0
1/02/2021,Indonesia,Negeri Sembilan,0,0,0
1/02/2021,Indonesia,Pahang,0,0,0
1/02/2021,Indonesia,Perak,0,0,0
1/02/2021,Indonesia,Perlis,9,9,0
1/02/2021,Indonesia,Pulau Pinang,18,9,9
1/02/2021,Indonesia,Sabah,12,5,7
1/02/2021,Indonesia,Sarawak,285,284,1
1/02/2021,Indonesia,Selangor,676,468,208
1/02/2021,Indonesia,Terengganu,0,0,0
1/02/2021,Indonesia,W.P. Labuan,0,0,0
1/02/2021,India,Johor,85,82,3
1/02/2021,India,Kedah,0,0,0
1/02/2021,India,Kelantan,0,0,0
1/02/2021,India,Melaka,0,0,0
1/02/2021,India,Negeri Sembilan,0,0,0
1/02/2021,India,Pahang,0,0,0
1/02/2021,India,Perak,0,0,0
1/02/2021,India,Perlis,0,0,0
1/02/2021,India,Pulau Pinang,0,0,0
1/02/2021,India,Sabah,0,0,0
1/02/2021,India,Sarawak,0,0,0
1/02/2021,India,Selangor,876,692,184
1/02/2021,India,Terengganu,0,0,0
1/02/2021,India,W.P. Labuan,0,0,0
1/02/2021, British Indian Ocean Territory,Pulau Pinang,0,0,0
1/02/2021, British Indian Ocean Territory,Selangor,0,0,0
1/02/2021,Ireland,Johor,0,0,0
1/02/2021,Ireland,Kedah,0,0,0
1/02/2021,Ireland,Kelantan,0,0,0
1/02/2021,Ireland,Negeri Sembilan,0,0,0
1/02/2021,Ireland,Pahang,0,0,0
1/02/2021,Ireland,Perak,0,0,0
1/02/2021,Ireland,Perlis,0,0,0
1/02/2021,Ireland,Pulau Pinang,0,0,0
1/02/2021,Ireland,Sabah,0,0,0
1/02/2021,Ireland,Sarawak,0,0,0
1/02/2021,Ireland,Selangor,3,3,0
1/02/2021,Ireland,Terengganu,0,0,0
1/02/2021,Ireland,W.P. Labuan,0,0,0
1/02/2021,"Iran, Islamic Republic of",Johor,1,1,0
1/02/2021,"Iran, Islamic Republic of",Kedah,0,0,0
1/02/2021,"Iran, Islamic Republic of",Kelantan,0,0,0
1/02/2021,"Iran, Islamic Republic of",Perak,0,0,0
1/02/2021,"Iran, Islamic Republic of",Perlis,0,0,0
1/02/2021,"Iran, Islamic Republic of",Pulau Pinang,0,0,0
1/02/2021,"Iran, Islamic Republic of",Sabah,0,0,0
1/02/2021,"Iran, Islamic Republic of",Sarawak,0,0,0
1/02/2021,"Iran, Islamic Republic of",Selangor,75,66,9
1/02/2021,"Iran, Islamic Republic of",W.P. Labuan,0,0,0
1/02/2021,Iraq,Johor,0,0,0
1/02/2021,Iraq,Kedah,0,0,0
1/02/2021,Iraq,Kelantan,0,0,0
1/02/2021,Iraq,Melaka,0,0,0
1/02/2021,Iraq,Pahang,0,0,0
1/02/2021,Iraq,Perak,0,0,0
1/02/2021,Iraq,Perlis,0,0,0
1/02/2021,Iraq,Pulau Pinang,0,0,0
1/02/2021,Iraq,Sabah,0,0,0
1/02/2021,Iraq,Sarawak,0,0,0
1/02/2021,Iraq,Selangor,29,22,7
1/02/2021,Iceland,Johor,0,0,0
1/02/2021,Iceland,Kedah,0,0,0
1/02/2021,Iceland,Kelantan,0,0,0
1/02/2021,Iceland,Perak,0,0,0
1/02/2021,Iceland,Perlis,0,0,0
1/02/2021,Iceland,Pulau Pinang,0,0,0
1/02/2021,Iceland,Sabah,0,0,0
1/02/2021,Iceland,Sarawak,0,0,0
1/02/2021,Iceland,Selangor,0,0,0
1/02/2021,Iceland,W.P. Labuan,0,0,0
1/02/2021,Israel,Pulau Pinang,0,0,0
1/02/2021,Italy,Johor,1,1,0
1/02/2021,Italy,Kedah,0,0,0
1/02/2021,Italy,Kelantan,0,0,0
1/02/2021,Italy,Melaka,0,0,0
1/02/2021,Italy,Negeri Sembilan,0,0,0
1/02/2021,Italy,Pahang,0,0,0
1/02/2021,Italy,Perak,0,0,0
1/02/2021,Italy,Perlis,0,0,0
1/02/2021,Italy,Pulau Pinang,0,0,0
1/02/2021,Italy,Sabah,0,0,0
1/02/2021,Italy,Sarawak,0,0,0
1/02/2021,Italy,Selangor,42,39,3
1/02/2021,Italy,W.P. Labuan,0,0,0
1/02/2021,Jamaica,Johor,0,0,0
1/02/2021,Jamaica,Kedah,0,0,0
1/02/2021,Jamaica,Perak,0,0,0
1/02/2021,Jamaica,Pulau Pinang,0,0,0
1/02/2021,Jamaica,Sabah,0,0,0
1/02/2021,Jamaica,Sarawak,0,0,0
1/02/2021,Jamaica,Selangor,1,0,1
1/02/2021,Jamaica,W.P. Labuan,0,0,0
1/02/2021,Jordan,Johor,0,0,0
1/02/2021,Jordan,Kedah,0,0,0
1/02/2021,Jordan,Kelantan,0,0,0
1/02/2021,Jordan,Melaka,0,0,0
1/02/2021,Jordan,Perlis,0,0,0
1/02/2021,Jordan,Pulau Pinang,0,0,0
1/02/2021,Jordan,Sabah,0,0,0
1/02/2021,Jordan,Sarawak,0,0,0
1/02/2021,Jordan,Selangor,23,21,2
1/02/2021,Jordan,W.P. Labuan,0,0,0
1/02/2021,Japan,Johor,1,1,0
1/02/2021,Japan,Kedah,0,0,0
1/02/2021,Japan,Kelantan,0,0,0
1/02/2021,Japan,Melaka,0,0,0
1/02/2021,Japan,Negeri Sembilan,0,0,0
1/02/2021,Japan,Pahang,0,0,0
1/02/2021,Japan,Perak,0,0,0
1/02/2021,Japan,Perlis,0,0,0
1/02/2021,Japan,Pulau Pinang,13,11,2
1/02/2021,Japan,Sabah,0,0,0
1/02/2021,Japan,Sarawak,9,9,0
1/02/2021,Japan,Selangor,336,228,108
1/02/2021,Japan,W.P. Labuan,0,0,0
1/02/2021,Kazakhstan,Johor,0,0,0
1/02/2021,Kazakhstan,Kedah,0,0,0
1/02/2021,Kazakhstan,Kelantan,0,0,0
1/02/2021,Kazakhstan,Melaka,0,0,0
1/02/2021,Kazakhstan,Perak,0,0,0
1/02/2021,Kazakhstan,Perlis,0,0,0
1/02/2021,Kazakhstan,Pulau Pinang,0,0,0
1/02/2021,Kazakhstan,Sabah,0,0,0
1/02/2021,Kazakhstan,Sarawak,0,0,0
1/02/2021,Kazakhstan,Selangor,20,10,10
1/02/2021,Kazakhstan,W.P. Labuan,0,0,0
1/02/2021,Kenya,Johor,0,0,0
1/02/2021,Kenya,Kedah,0,0,0
1/02/2021,Kenya,Kelantan,0,0,0
1/02/2021,Kenya,Perak,0,0,0
1/02/2021,Kenya,Perlis,0,0,0
1/02/2021,Kenya,Pulau Pinang,0,0,0
1/02/2021,Kenya,Sabah,0,0,0
1/02/2021,Kenya,Sarawak,0,0,0
1/02/2021,Kenya,Selangor,8,5,3
1/02/2021,Kyrgyzstan,Johor,0,0,0
1/02/2021,Kyrgyzstan,Kedah,0,0,0
1/02/2021,Kyrgyzstan,Kelantan,0,0,0
1/02/2021,Kyrgyzstan,Perak,0,0,0
1/02/2021,Kyrgyzstan,Perlis,0,0,0
1/02/2021,Kyrgyzstan,Pulau Pinang,0,0,0
1/02/2021,Kyrgyzstan,Sabah,0,0,0
1/02/2021,Kyrgyzstan,Sarawak,0,0,0
1/02/2021,Kyrgyzstan,Selangor,2,2,0
1/02/2021,Cambodia,Johor,0,0,0
1/02/2021,Cambodia,Kedah,0,0,0
1/02/2021,Cambodia,Kelantan,0,0,0
1/02/2021,Cambodia,Melaka,0,0,0
1/02/2021,Cambodia,Negeri Sembilan,0,0,0
1/02/2021,Cambodia,Pahang,0,0,0
1/02/2021,Cambodia,Perak,0,0,0
1/02/2021,Cambodia,Perlis,0,0,0
1/02/2021,Cambodia,Pulau Pinang,0,0,0
1/02/2021,Cambodia,Sabah,0,0,0
1/02/2021,Cambodia,Sarawak,0,0,0
1/02/2021,Cambodia,Selangor,2,0,2
1/02/2021,Cambodia,W.P. Labuan,0,0,0
1/02/2021,Kiribati,Johor,0,0,0
1/02/2021,Kiribati,Sabah,0,0,0
1/02/2021,Kiribati,Selangor,10,10,0
1/02/2021,Saint Kitts and Nevis,Johor,0,0,0
1/02/2021,Saint Kitts and Nevis,Kedah,0,0,0
1/02/2021,Saint Kitts and Nevis,Perlis,0,0,0
1/02/2021,Saint Kitts and Nevis,Pulau Pinang,0,0,0
1/02/2021,Saint Kitts and Nevis,Sabah,0,0,0
1/02/2021,Saint Kitts and Nevis,Selangor,1,1,0
1/02/2021,Saint Kitts and Nevis,W.P. Labuan,0,0,0
1/02/2021,"Korea, Republic of",Johor,0,0,0
1/02/2021,"Korea, Republic of",Kedah,0,0,0
1/02/2021,"Korea, Republic of",Kelantan,0,0,0
1/02/2021,"Korea, Republic of",Melaka,0,0,0
1/02/2021,"Korea, Republic of",Negeri Sembilan,0,0,0
1/02/2021,"Korea, Republic of",Pahang,0,0,0
1/02/2021,"Korea, Republic of",Perak,0,0,0
1/02/2021,"Korea, Republic of",Perlis,0,0,0
1/02/2021,"Korea, Republic of",Pulau Pinang,2,1,1
1/02/2021,"Korea, Republic of",Sabah,1,1,0
1/02/2021,"Korea, Republic of",Sarawak,9,9,0
1/02/2021,"Korea, Republic of",Selangor,202,146,56
1/02/2021,"Korea, Republic of",Terengganu,0,0,0
1/02/2021,"Korea, Republic of",W.P. Labuan,0,0,0
1/02/2021,Kuwait,Johor,0,0,0
1/02/2021,Kuwait,Kedah,0,0,0
1/02/2021,Kuwait,Kelantan,0,0,0
1/02/2021,Kuwait,Perak,0,0,0
1/02/2021,Kuwait,Perlis,0,0,0
1/02/2021,Kuwait,Pulau Pinang,0,0,0
1/02/2021,Kuwait,Sabah,0,0,0
1/02/2021,Kuwait,Sarawak,0,0,0
1/02/2021,Kuwait,Selangor,5,3,2
1/02/2021,Kuwait,W.P. Labuan,0,0,0
1/02/2021, Lao People's Democratic Republic,Johor,0,0,0
1/02/2021, Lao People's Democratic Republic,Kedah,1,0,1
1/02/2021, Lao People's Democratic Republic,Kelantan,0,0,0
1/02/2021, Lao People's Democratic Republic,Melaka,0,0,0
1/02/2021, Lao People's Democratic Republic,Perak,0,0,0
1/02/2021, Lao People's Democratic Republic,Perlis,0,0,0
1/02/2021, Lao People's Democratic Republic,Pulau Pinang,0,0,0
1/02/2021, Lao People's Democratic Republic,Sabah,0,0,0
1/02/2021, Lao People's Democratic Republic,Sarawak,0,0,0
1/02/2021, Lao People's Democratic Republic,Selangor,0,0,0
1/02/2021, Lao People's Democratic Republic,W.P. Labuan,0,0,0
1/02/2021,Lebanon,Johor,0,0,0
1/02/2021,Lebanon,Kedah,0,0,0
1/02/2021,Lebanon,Kelantan,0,0,0
1/02/2021,Lebanon,Pahang,0,0,0
1/02/2021,Lebanon,Perak,0,0,0
1/02/2021,Lebanon,Perlis,0,0,0
1/02/2021,Lebanon,Pulau Pinang,0,0,0
1/02/2021,Lebanon,Sabah,0,0,0
1/02/2021,Lebanon,Sarawak,0,0,0
1/02/2021,Lebanon,Selangor,2,1,1
1/02/2021,Lebanon,W.P. Labuan,0,0,0
1/02/2021,Liberia,Johor,0,0,0
1/02/2021,Liberia,Kedah,0,0,0
1/02/2021,Liberia,Sabah,0,0,0
1/02/2021,Liberia,Sarawak,0,0,0
1/02/2021,Liberia,Selangor,0,0,0
1/02/2021,Libya,Johor,0,0,0
1/02/2021,Libya,Kedah,0,0,0
1/02/2021,Libya,Perlis,0,0,0
1/02/2021,Libya,Pulau Pinang,0,0,0
1/02/2021,Libya,Sabah,0,0,0
1/02/2021,Libya,Sarawak,0,0,0
1/02/2021,Libya,Selangor,8,8,0
1/02/2021,Saint Lucia,Johor,0,0,0
1/02/2021,Saint Lucia,Kedah,0,0,0
1/02/2021,Saint Lucia,Pulau Pinang,0,0,0
1/02/2021,Saint Lucia,Sarawak,0,0,0
1/02/2021,Saint Lucia,Selangor,0,0,0
1/02/2021,Liechtenstein,Johor,0,0,0
1/02/2021,Liechtenstein,Kedah,0,0,0
1/02/2021,Liechtenstein,Perlis,0,0,0
1/02/2021,Liechtenstein,Pulau Pinang,0,0,0
1/02/2021,Liechtenstein,Sabah,0,0,0
1/02/2021,Liechtenstein,Sarawak,0,0,0
1/02/2021,Liechtenstein,Selangor,0,0,0
1/02/2021,LKA,Johor,2,2,0
1/02/2021,LKA,Kedah,0,0,0
1/02/2021,LKA,Kelantan,0,0,0
1/02/2021,LKA,Melaka,0,0,0
1/02/2021,LKA,Pahang,0,0,0
1/02/2021,LKA,Perak,0,0,0
1/02/2021,LKA,Perlis,0,0,0
1/02/2021,LKA,Pulau Pinang,0,0,0
1/02/2021,LKA,Sabah,0,0,0
1/02/2021,LKA,Sarawak,0,0,0
1/02/2021,LKA,Selangor,80,51,29
1/02/2021,LKA,W.P. Labuan,0,0,0
1/02/2021,Lesotho,Johor,0,0,0
1/02/2021,Lesotho,Kedah,0,0,0
1/02/2021,Lesotho,Pulau Pinang,0,0,0
1/02/2021,Lesotho,Sarawak,0,0,0
1/02/2021,Lesotho,Selangor,0,0,0
1/02/2021,Lithuania,Johor,1,1,0
1/02/2021,Lithuania,Kedah,0,0,0
1/02/2021,Lithuania,Kelantan,0,0,0
1/02/2021,Lithuania,Pahang,0,0,0
1/02/2021,Lithuania,Perak,0,0,0
1/02/2021,Lithuania,Perlis,0,0,0
1/02/2021,Lithuania,Pulau Pinang,0,0,0
1/02/2021,Lithuania,Sabah,0,0,0
1/02/2021,Lithuania,Sarawak,0,0,0
1/02/2021,Lithuania,Selangor,2,2,0
1/02/2021,Lithuania,W.P. Labuan,0,0,0
1/02/2021,Luxembourg,Johor,0,0,0
1/02/2021,Luxembourg,Kedah,0,0,0
1/02/2021,Luxembourg,Kelantan,0,0,0
1/02/2021,Luxembourg,Perak,0,0,0
1/02/2021,Luxembourg,Perlis,0,0,0
1/02/2021,Luxembourg,Pulau Pinang,0,0,0
1/02/2021,Luxembourg,Sabah,0,0,0
1/02/2021,Luxembourg,Sarawak,0,0,0
1/02/2021,Luxembourg,Selangor,2,1,1
1/02/2021,Latvia,Johor,0,0,0
1/02/2021,Latvia,Kedah,0,0,0
1/02/2021,Latvia,Kelantan,0,0,0
1/02/2021,Latvia,Pahang,0,0,0
1/02/2021,Latvia,Perak,0,0,0
1/02/2021,Latvia,Perlis,0,0,0
1/02/2021,Latvia,Pulau Pinang,0,0,0
1/02/2021,Latvia,Sabah,0,0,0
1/02/2021,Latvia,Sarawak,0,0,0
1/02/2021,Latvia,Selangor,8,7,1
1/02/2021,Latvia,W.P. Labuan,0,0,0
1/02/2021,Macao,Johor,0,0,0
1/02/2021,Macao,Pahang,0,0,0
1/02/2021,Macao,Perak,0,0,0
1/02/2021,Macao,Selangor,0,0,0
1/02/2021,Macao,W.P. Labuan,0,0,0
1/02/2021,Morocco,Johor,0,0,0
1/02/2021,Morocco,Kedah,0,0,0
1/02/2021,Morocco,Kelantan,0,0,0
1/02/2021,Morocco,Melaka,0,0,0
1/02/2021,Morocco,Pahang,0,0,0
1/02/2021,Morocco,Perak,0,0,0
1/02/2021,Morocco,Perlis,0,0,0
1/02/2021,Morocco,Pulau Pinang,0,0,0
1/02/2021,Morocco,Sabah,0,0,0
1/02/2021,Morocco,Sarawak,0,0,0
1/02/2021,Morocco,Selangor,3,1,2
1/02/2021,Morocco,W.P. Labuan,0,0,0
1/02/2021,Monaco,Johor,0,0,0
1/02/2021,Monaco,Kedah,0,0,0
1/02/2021,Monaco,Sabah,0,0,0
1/02/2021,Monaco,Selangor,0,0,0
1/02/2021,"Moldova, Republic of",Johor,0,0,0
1/02/2021,"Moldova, Republic of",Kedah,0,0,0
1/02/2021,"Moldova, Republic of",Kelantan,0,0,0
1/02/2021,"Moldova, Republic of",Negeri Sembilan,0,0,0
1/02/2021,"Moldova, Republic of",Perlis,0,0,0
1/02/2021,"Moldova, Republic of",Pulau Pinang,0,0,0
1/02/2021,"Moldova, Republic of",Sabah,0,0,0
1/02/2021,"Moldova, Republic of",Sarawak,0,0,0
1/02/2021,"Moldova, Republic of",Selangor,1,1,0
1/02/2021,Madagascar,Johor,0,0,0
1/02/2021,Madagascar,Kedah,0,0,0
1/02/2021,Madagascar,Perak,0,0,0
1/02/2021,Madagascar,Perlis,0,0,0
1/02/2021,Madagascar,Pulau Pinang,0,0,0
1/02/2021,Madagascar,Sabah,0,0,0
1/02/2021,Madagascar,Sarawak,0,0,0
1/02/2021,Madagascar,Selangor,0,0,0
1/02/2021,Maldives,Johor,0,0,0
1/02/2021,Maldives,Kedah,0,0,0
1/02/2021,Maldives,Kelantan,0,0,0
1/02/2021,Maldives,Perak,0,0,0
1/02/2021,Maldives,Perlis,0,0,0
1/02/2021,Maldives,Pulau Pinang,0,0,0
1/02/2021,Maldives,Sabah,0,0,0
1/02/2021,Maldives,Sarawak,0,0,0
1/02/2021,Maldives,Selangor,54,27,27
1/02/2021,Mexico,Johor,0,0,0
1/02/2021,Mexico,Kedah,0,0,0
1/02/2021,Mexico,Kelantan,0,0,0
1/02/2021,Mexico,Pahang,0,0,0
1/02/2021,Mexico,Perak,0,0,0
1/02/2021,Mexico,Perlis,0,0,0
1/02/2021,Mexico,Pulau Pinang,0,0,0
1/02/2021,Mexico,Sabah,0,0,0
1/02/2021,Mexico,Sarawak,0,0,0
1/02/2021,Mexico,Selangor,3,2,1
1/02/2021,Mexico,W.P. Labuan,0,0,0
1/02/2021,Marshall Islands,Johor,0,0,0
1/02/2021,Marshall Islands,Kedah,0,0,0
1/02/2021,Marshall Islands,Perak,0,0,0
1/02/2021,Marshall Islands,Pulau Pinang,0,0,0
1/02/2021,Marshall Islands,Sabah,0,0,0
1/02/2021,Marshall Islands,Selangor,0,0,0
1/02/2021,North Macedonia,Johor,0,0,0
1/02/2021,North Macedonia,Kedah,0,0,0
1/02/2021,North Macedonia,Perak,0,0,0
1/02/2021,North Macedonia,Pulau Pinang,0,0,0
1/02/2021,North Macedonia,Sabah,0,0,0
1/02/2021,North Macedonia,Sarawak,0,0,0
1/02/2021,North Macedonia,Selangor,0,0,0
1/02/2021,Mali,Johor,0,0,0
1/02/2021,Mali,Sabah,0,0,0
1/02/2021,Mali,Selangor,0,0,0
1/02/2021,Malta,Johor,0,0,0
1/02/2021,Malta,Kedah,0,0,0
1/02/2021,Malta,Kelantan,0,0,0
1/02/2021,Malta,Perak,0,0,0
1/02/2021,Malta,Perlis,0,0,0
1/02/2021,Malta,Pulau Pinang,0,0,0
1/02/2021,Malta,Sabah,0,0,0
1/02/2021,Malta,Sarawak,0,0,0
1/02/2021,Malta,Selangor,1,1,0
1/02/2021,Malta,W.P. Labuan,0,0,0
1/02/2021,Myanmar,Johor,2,2,0
1/02/2021,Myanmar,Kedah,0,0,0
1/02/2021,Myanmar,Kelantan,0,0,0
1/02/2021,Myanmar,Negeri Sembilan,0,0,0
1/02/2021,Myanmar,Pahang,0,0,0
1/02/2021,Myanmar,Perak,0,0,0
1/02/2021,Myanmar,Perlis,0,0,0
1/02/2021,Myanmar,Pulau Pinang,0,0,0
1/02/2021,Myanmar,Sabah,0,0,0
1/02/2021,Myanmar,Sarawak,0,0,0
1/02/2021,Myanmar,Selangor,73,64,9
1/02/2021,Myanmar,Terengganu,0,0,0
1/02/2021,Myanmar,W.P. Labuan,0,0,0
1/02/2021,Montenegro,Johor,0,0,0
1/02/2021,Montenegro,Kedah,0,0,0
1/02/2021,Montenegro,Pulau Pinang,0,0,0
1/02/2021,Montenegro,Sabah,0,0,0
1/02/2021,Montenegro,Sarawak,0,0,0
1/02/2021,Montenegro,Selangor,8,8,0
1/02/2021,Mongolia,Johor,0,0,0
1/02/2021,Mongolia,Kedah,0,0,0
1/02/2021,Mongolia,Kelantan,0,0,0
1/02/2021,Mongolia,Perak,0,0,0
1/02/2021,Mongolia,Perlis,0,0,0
1/02/2021,Mongolia,Pulau Pinang,0,0,0
1/02/2021,Mongolia,Sabah,0,0,0
1/02/2021,Mongolia,Sarawak,0,0,0
1/02/2021,Mongolia,Selangor,0,0,0
1/02/2021,Northern Mariana Islands,Selangor,0,0,0
1/02/2021,Mozambique,Johor,0,0,0
1/02/2021,Mozambique,Kedah,0,0,0
1/02/2021,Mozambique,Perak,0,0,0
1/02/2021,Mozambique,Pulau Pinang,0,0,0
1/02/2021,Mozambique,Sabah,0,0,0
1/02/2021,Mozambique,Sarawak,0,0,0
1/02/2021,Mozambique,Selangor,3,1,2
1/02/2021,Mauritania,Johor,0,0,0
1/02/2021,Mauritania,Kedah,0,0,0
1/02/2021,Mauritania,Pulau Pinang,0,0,0
1/02/2021,Mauritania,Sabah,0,0,0
1/02/2021,Mauritania,Sarawak,0,0,0
1/02/2021,Mauritania,Selangor,4,4,0
1/02/2021,Mauritius,Johor,0,0,0
1/02/2021,Mauritius,Kedah,0,0,0
1/02/2021,Mauritius,Kelantan,0,0,0
1/02/2021,Mauritius,Pahang,0,0,0
1/02/2021,Mauritius,Perak,0,0,0
1/02/2021,Mauritius,Perlis,0,0,0
1/02/2021,Mauritius,Pulau Pinang,0,0,0
1/02/2021,Mauritius,Sabah,0,0,0
1/02/2021,Mauritius,Sarawak,0,0,0
1/02/2021,Mauritius,Selangor,7,1,6
1/02/2021,Malawi,Johor,0,0,0
1/02/2021,Malawi,Pulau Pinang,0,0,0
1/02/2021,Malawi,Sabah,0,0,0
1/02/2021,Malawi,Sarawak,0,0,0
1/02/2021,Malawi,Selangor,0,0,0
1/02/2021,Mayotte,Selangor,0,0,0
1/02/2021,Namibia,Johor,0,0,0
1/02/2021,Namibia,Kedah,0,0,0
1/02/2021,Namibia,Perak,0,0,0
1/02/2021,Namibia,Perlis,0,0,0
1/02/2021,Namibia,Pulau Pinang,0,0,0
1/02/2021,Namibia,Sabah,0,0,0
1/02/2021,Namibia,Sarawak,0,0,0
1/02/2021,Namibia,Selangor,5,3,2
1/02/2021,New Caledonia,Selangor,0,0,0
1/02/2021,Niger,Johor,0,0,0
1/02/2021,Niger,Sabah,0,0,0
1/02/2021,Niger,Selangor,0,0,0
1/02/2021,Nigeria,Johor,0,0,0
1/02/2021,Nigeria,Kedah,0,0,0
1/02/2021,Nigeria,Perlis,0,0,0
1/02/2021,Nigeria,Pulau Pinang,0,0,0
1/02/2021,Nigeria,Sabah,0,0,0
1/02/2021,Nigeria,Sarawak,0,0,0
1/02/2021,Nigeria,Selangor,62,52,10
1/02/2021,Nicaragua,Johor,0,0,0
1/02/2021,Nicaragua,Kedah,0,0,0
1/02/2021,Nicaragua,Pulau Pinang,0,0,0
1/02/2021,Nicaragua,Sabah,0,0,0
1/02/2021,Nicaragua,Selangor,0,0,0
1/02/2021,Netherlands,Johor,2,2,0
1/02/2021,Netherlands,Kedah,0,0,0
1/02/2021,Netherlands,Kelantan,0,0,0
1/02/2021,Netherlands,Melaka,0,0,0
1/02/2021,Netherlands,Negeri Sembilan,0,0,0
1/02/2021,Netherlands,Pahang,0,0,0
1/02/2021,Netherlands,Perak,0,0,0
1/02/2021,Netherlands,Perlis,0,0,0
1/02/2021,Netherlands,Pulau Pinang,0,0,0
1/02/2021,Netherlands,Sabah,0,0,0
1/02/2021,Netherlands,Sarawak,0,0,0
1/02/2021,Netherlands,Selangor,28,20,8
1/02/2021,Netherlands,Terengganu,0,0,0
1/02/2021,Netherlands,W.P. Labuan,0,0,0
1/02/2021,Norway,Johor,0,0,0
1/02/2021,Norway,Kedah,0,0,0
1/02/2021,Norway,Kelantan,0,0,0
1/02/2021,Norway,Melaka,0,0,0
1/02/2021,Norway,Pahang,0,0,0
1/02/2021,Norway,Perak,0,0,0
1/02/2021,Norway,Perlis,0,0,0
1/02/2021,Norway,Pulau Pinang,0,0,0
1/02/2021,Norway,Sabah,0,0,0
1/02/2021,Norway,Sarawak,0,0,0
1/02/2021,Norway,Selangor,10,10,0
1/02/2021,Norway,W.P. Labuan,0,0,0
1/02/2021,Nepal,Johor,0,0,0
1/02/2021,Nepal,Kedah,0,0,0
1/02/2021,Nepal,Pahang,0,0,0
1/02/2021,Nepal,Perak,0,0,0
1/02/2021,Nepal,Perlis,0,0,0
1/02/2021,Nepal,Pulau Pinang,0,0,0
1/02/2021,Nepal,Sabah,0,0,0
1/02/2021,Nepal,Sarawak,0,0,0
1/02/2021,Nepal,Selangor,34,30,4
1/02/2021,Nepal,W.P. Labuan,0,0,0
1/02/2021,Nauru,Johor,0,0,0
1/02/2021,Nauru,Pulau Pinang,0,0,0
1/02/2021,Nauru,Selangor,0,0,0
1/02/2021,New Zealand,Johor,0,0,0
1/02/2021,New Zealand,Kedah,0,0,0
1/02/2021,New Zealand,Kelantan,0,0,0
1/02/2021,New Zealand,Melaka,0,0,0
1/02/2021,New Zealand,Negeri Sembilan,0,0,0
1/02/2021,New Zealand,Pahang,0,0,0
1/02/2021,New Zealand,Perak,0,0,0
1/02/2021,New Zealand,Perlis,0,0,0
1/02/2021,New Zealand,Pulau Pinang,0,0,0
1/02/2021,New Zealand,Sabah,0,0,0
1/02/2021,New Zealand,Sarawak,0,0,0
1/02/2021,New Zealand,Selangor,15,13,2
1/02/2021,New Zealand,Terengganu,0,0,0
1/02/2021,New Zealand,W.P. Labuan,0,0,0
1/02/2021,Oman,Johor,0,0,0
1/02/2021,Oman,Kedah,0,0,0
1/02/2021,Oman,Kelantan,0,0,0
1/02/2021,Oman,Melaka,0,0,0
1/02/2021,Oman,Perak,0,0,0
1/02/2021,Oman,Perlis,0,0,0
1/02/2021,Oman,Pulau Pinang,0,0,0
1/02/2021,Oman,Sabah,0,0,0
1/02/2021,Oman,Sarawak,0,0,0
1/02/2021,Oman,Selangor,3,3,0
1/02/2021,Pakistan,Johor,13,13,0
1/02/2021,Pakistan,Kedah,0,0,0
1/02/2021,Pakistan,Kelantan,0,0,0
1/02/2021,Pakistan,Melaka,0,0,0
1/02/2021,Pakistan,Negeri Sembilan,0,0,0
1/02/2021,Pakistan,Pahang,0,0,0
1/02/2021,Pakistan,Perak,0,0,0
1/02/2021,Pakistan,Perlis,0,0,0
1/02/2021,Pakistan,Pulau Pinang,0,0,0
1/02/2021,Pakistan,Sabah,0,0,0
1/02/2021,Pakistan,Sarawak,0,0,0
1/02/2021,Pakistan,Selangor,224,194,30
1/02/2021,Pakistan,W.P. Labuan,0,0,0
1/02/2021,Panama,Johor,0,0,0
1/02/2021,Panama,Kedah,0,0,0
1/02/2021,Panama,Perak,0,0,0
1/02/2021,Panama,Perlis,0,0,0
1/02/2021,Panama,Pulau Pinang,0,0,0
1/02/2021,Panama,Sabah,0,0,0
1/02/2021,Panama,Sarawak,0,0,0
1/02/2021,Panama,Selangor,2,2,0
1/02/2021,Peru,Johor,0,0,0
1/02/2021,Peru,Kedah,0,0,0
1/02/2021,Peru,Kelantan,0,0,0
1/02/2021,Peru,Pahang,0,0,0
1/02/2021,Peru,Perak,0,0,0
1/02/2021,Peru,Perlis,0,0,0
1/02/2021,Peru,Pulau Pinang,0,0,0
1/02/2021,Peru,Sabah,0,0,0
1/02/2021,Peru,Sarawak,0,0,0
1/02/2021,Peru,Selangor,0,0,0
1/02/2021,Peru,W.P. Labuan,0,0,0
1/02/2021,Philippines,Johor,78,77,1
1/02/2021,Philippines,Kedah,0,0,0
1/02/2021,Philippines,Kelantan,0,0,0
1/02/2021,Philippines,Melaka,0,0,0
1/02/2021,Philippines,Negeri Sembilan,0,0,0
1/02/2021,Philippines,Pahang,0,0,0
1/02/2021,Philippines,Perak,0,0,0
1/02/2021,Philippines,Perlis,0,0,0
1/02/2021,Philippines,Pulau Pinang,0,0,0
1/02/2021,Philippines,Sabah,4,1,3
1/02/2021,Philippines,Sarawak,32,32,0
1/02/2021,Philippines,Selangor,424,347,77
1/02/2021,Philippines,Terengganu,0,0,0
1/02/2021,Philippines,W.P. Labuan,8,8,0
1/02/2021,Palau,Johor,0,0,0
1/02/2021,Palau,Pulau Pinang,0,0,0
1/02/2021,Palau,Selangor,0,0,0
1/02/2021,Papua New Guinea,Johor,0,0,0
1/02/2021,Papua New Guinea,Kedah,0,0,0
1/02/2021,Papua New Guinea,Kelantan,0,0,0
1/02/2021,Papua New Guinea,Perak,0,0,0
1/02/2021,Papua New Guinea,Pulau Pinang,0,0,0
1/02/2021,Papua New Guinea,Sabah,0,0,0
1/02/2021,Papua New Guinea,Sarawak,0,0,0
1/02/2021,Papua New Guinea,Selangor,0,0,0
1/02/2021,Poland,Johor,6,6,0
1/02/2021,Poland,Kedah,0,0,0
1/02/2021,Poland,Kelantan,0,0,0
1/02/2021,Poland,Melaka,0,0,0
1/02/2021,Poland,Negeri Sembilan,0,0,0
1/02/2021,Poland,Pahang,0,0,0
1/02/2021,Poland,Perak,0,0,0
1/02/2021,Poland,Perlis,0,0,0
1/02/2021,Poland,Pulau Pinang,0,0,0
1/02/2021,Poland,Sabah,0,0,0
1/02/2021,Poland,Sarawak,0,0,0
1/02/2021,Poland,Selangor,27,25,2
1/02/2021,Poland,Terengganu,0,0,0
1/02/2021,Poland,W.P. Labuan,0,0,0
1/02/2021,"North Korea, Democratic People's Republic of",Selangor,0,0,0
1/02/2021,Portugal,Johor,0,0,0
1/02/2021,Portugal,Kedah,0,0,0
1/02/2021,Portugal,Kelantan,0,0,0
1/02/2021,Portugal,Melaka,0,0,0
1/02/2021,Portugal,Pahang,0,0,0
1/02/2021,Portugal,Perak,0,0,0
1/02/2021,Portugal,Perlis,0,0,0
1/02/2021,Portugal,Pulau Pinang,0,0,0
1/02/2021,Portugal,Sabah,0,0,0
1/02/2021,Portugal,Sarawak,0,0,0
1/02/2021,Portugal,Selangor,11,5,6
1/02/2021,Portugal,W.P. Labuan,0,0,0
1/02/2021,Paraguay,Johor,0,0,0
1/02/2021,Paraguay,Kedah,0,0,0
1/02/2021,Paraguay,Perak,0,0,0
1/02/2021,Paraguay,Perlis,0,0,0
1/02/2021,Paraguay,Pulau Pinang,0,0,0
1/02/2021,Paraguay,Sabah,0,0,0
1/02/2021,Paraguay,Sarawak,0,0,0
1/02/2021,Paraguay,Selangor,0,0,0
1/02/2021,"Palestine, State of",Johor,0,0,0
1/02/2021,"Palestine, State of",Kedah,0,0,0
1/02/2021,"Palestine, State of",Kelantan,0,0,0
1/02/2021,"Palestine, State of",Melaka,0,0,0
1/02/2021,"Palestine, State of",Perak,0,0,0
1/02/2021,"Palestine, State of",Perlis,0,0,0
1/02/2021,"Palestine, State of",Pulau Pinang,0,0,0
1/02/2021,"Palestine, State of",Sabah,1,1,0
1/02/2021,"Palestine, State of",Sarawak,0,0,0
1/02/2021,"Palestine, State of",Selangor,7,6,1
1/02/2021,Qatar,Johor,0,0,0
1/02/2021,Qatar,Kedah,0,0,0
1/02/2021,Qatar,Perlis,0,0,0
1/02/2021,Qatar,Pulau Pinang,0,0,0
1/02/2021,Qatar,Sabah,0,0,0
1/02/2021,Qatar,Sarawak,0,0,0
1/02/2021,Qatar,Selangor,1,0,1
1/02/2021,Réunion,Johor,0,0,0
1/02/2021,Réunion,Sarawak,0,0,0
1/02/2021,Romania,Johor,5,5,0
1/02/2021,Romania,Kedah,0,0,0
1/02/2021,Romania,Kelantan,0,0,0
1/02/2021,Romania,Negeri Sembilan,0,0,0
1/02/2021,Romania,Pahang,0,0,0
1/02/2021,Romania,Perak,0,0,0
1/02/2021,Romania,Perlis,0,0,0
1/02/2021,Romania,Pulau Pinang,0,0,0
1/02/2021,Romania,Sabah,0,0,0
1/02/2021,Romania,Sarawak,0,0,0
1/02/2021,Romania,Selangor,55,42,13
1/02/2021,Romania,W.P. Labuan,0,0,0
1/02/2021,Russian Federation (Russia),Johor,44,40,4
1/02/2021,Russian Federation (Russia),Kedah,0,0,0
1/02/2021,Russian Federation (Russia),Kelantan,0,0,0
1/02/2021,Russian Federation (Russia),Melaka,0,0,0
1/02/2021,Russian Federation (Russia),Negeri Sembilan,0,0,0
1/02/2021,Russian Federation (Russia),Pahang,0,0,0
1/02/2021,Russian Federation (Russia),Perak,0,0,0
1/02/2021,Russian Federation (Russia),Perlis,0,0,0
1/02/2021,Russian Federation (Russia),Pulau Pinang,0,0,0
1/02/2021,Russian Federation (Russia),Sabah,0,0,0
1/02/2021,Russian Federation (Russia),Sarawak,0,0,0
1/02/2021,Russian Federation (Russia),Selangor,39,32,7
1/02/2021,Russian Federation (Russia),W.P. Labuan,0,0,0
1/02/2021,Rwanda,Johor,0,0,0
1/02/2021,Rwanda,Kedah,0,0,0
1/02/2021,Rwanda,Pulau Pinang,0,0,0
1/02/2021,Rwanda,Selangor,0,0,0
1/02/2021,Saudi Arabia,Johor,0,0,0
1/02/2021,Saudi Arabia,Kedah,0,0,0
1/02/2021,Saudi Arabia,Kelantan,0,0,0
1/02/2021,Saudi Arabia,Melaka,0,0,0
1/02/2021,Saudi Arabia,Perak,0,0,0
1/02/2021,Saudi Arabia,Perlis,0,0,0
1/02/2021,Saudi Arabia,Pulau Pinang,0,0,0
1/02/2021,Saudi Arabia,Sabah,0,0,0
1/02/2021,Saudi Arabia,Sarawak,0,0,0
1/02/2021,Saudi Arabia,Selangor,39,23,16
1/02/2021,Saudi Arabia,W.P. Labuan,0,0,0
1/02/2021,Sudan,Johor,0,0,0
1/02/2021,Sudan,Kedah,0,0,0
1/02/2021,Sudan,Kelantan,0,0,0
1/02/2021,Sudan,Perlis,0,0,0
1/02/2021,Sudan,Pulau Pinang,0,0,0
1/02/2021,Sudan,Sabah,0,0,0
1/02/2021,Sudan,Sarawak,0,0,0
1/02/2021,Sudan,Selangor,32,17,15
1/02/2021,Sudan,W.P. Labuan,0,0,0
1/02/2021,Senegal,Johor,0,0,0
1/02/2021,Senegal,Kedah,0,0,0
1/02/2021,Senegal,Kelantan,0,0,0
1/02/2021,Senegal,Perak,0,0,0
1/02/2021,Senegal,Perlis,0,0,0
1/02/2021,Senegal,Pulau Pinang,0,0,0
1/02/2021,Senegal,Sabah,0,0,0
1/02/2021,Senegal,Sarawak,0,0,0
1/02/2021,Senegal,Selangor,4,4,0
1/02/2021,Singapore,Johor,232,198,34
1/02/2021,Singapore,Kedah,1,1,0
1/02/2021,Singapore,Kelantan,0,0,0
1/02/2021,Singapore,Melaka,0,0,0
1/02/2021,Singapore,Negeri Sembilan,0,0,0
1/02/2021,Singapore,Pahang,0,0,0
1/02/2021,Singapore,Perak,3,1,2
1/02/2021,Singapore,Perlis,1,1,0
1/02/2021,Singapore,Pulau Pinang,26,17,9
1/02/2021,Singapore,Sabah,0,0,0
1/02/2021,Singapore,Sarawak,5,1,4
1/02/2021,Singapore,Selangor,123,84,39
1/02/2021,Singapore,Terengganu,0,0,0
1/02/2021,Singapore,W.P. Labuan,0,0,0
1/02/2021,South Georgia and the South Sandwich Islands,Johor,1,1,0
1/02/2021,South Georgia and the South Sandwich Islands,Sabah,0,0,0
1/02/2021,South Georgia and the South Sandwich Islands,Selangor,0,0,0
1/02/2021,Saint Helena,Sarawak,0,0,0
1/02/2021,Solomon Islands,Johor,0,0,0
1/02/2021,Solomon Islands,Perlis,0,0,0
1/02/2021,Solomon Islands,Pulau Pinang,0,0,0
1/02/2021,Solomon Islands,Sabah,0,0,0
1/02/2021,Solomon Islands,Sarawak,0,0,0
1/02/2021,Solomon Islands,Selangor,0,0,0
1/02/2021,Solomon Islands,W.P. Labuan,0,0,0
1/02/2021,Sierra Leone,Johor,0,0,0
1/02/2021,Sierra Leone,Kedah,0,0,0
1/02/2021,Sierra Leone,Perak,0,0,0
1/02/2021,Sierra Leone,Pulau Pinang,0,0,0
1/02/2021,Sierra Leone,Sabah,0,0,0
1/02/2021,Sierra Leone,Selangor,0,0,0
1/02/2021,El Salvador,Johor,0,0,0
1/02/2021,El Salvador,Kedah,0,0,0
1/02/2021,El Salvador,Perak,0,0,0
1/02/2021,El Salvador,Perlis,0,0,0
1/02/2021,El Salvador,Pulau Pinang,0,0,0
1/02/2021,El Salvador,Sabah,0,0,0
1/02/2021,El Salvador,Selangor,0,0,0
1/02/2021,El Salvador,W.P. Labuan,0,0,0
1/02/2021,San Marino,Johor,0,0,0
1/02/2021,San Marino,Selangor,0,0,0
1/02/2021,Somalia,Johor,0,0,0
1/02/2021,Somalia,Kedah,0,0,0
1/02/2021,Somalia,Kelantan,0,0,0
1/02/2021,Somalia,Perlis,0,0,0
1/02/2021,Somalia,Sabah,0,0,0
1/02/2021,Somalia,Sarawak,0,0,0
1/02/2021,Somalia,Selangor,15,12,3
1/02/2021,Serbia,Johor,0,0,0
1/02/2021,Serbia,Kedah,0,0,0
1/02/2021,Serbia,Kelantan,0,0,0
1/02/2021,Serbia,Pahang,0,0,0
1/02/2021,Serbia,Perak,0,0,0
1/02/2021,Serbia,Perlis,0,0,0
1/02/2021,Serbia,Pulau Pinang,0,0,0
1/02/2021,Serbia,Sabah,0,0,0
1/02/2021,Serbia,Sarawak,0,0,0
1/02/2021,Serbia,Selangor,3,2,1
1/02/2021,South Sudan,Johor,0,0,0
1/02/2021,South Sudan,Kedah,0,0,0
1/02/2021,South Sudan,Sarawak,0,0,0
1/02/2021,South Sudan,Selangor,0,0,0
1/02/2021,South Sudan,W.P. Labuan,0,0,0
1/02/2021,Sao Tome and Principe,Selangor,0,0,0
1/02/2021,Suriname,Johor,0,0,0
1/02/2021,Suriname,Kedah,0,0,0
1/02/2021,Suriname,Kelantan,0,0,0
1/02/2021,Suriname,Perak,0,0,0
1/02/2021,Suriname,Perlis,0,0,0
1/02/2021,Suriname,Pulau Pinang,0,0,0
1/02/2021,Suriname,Sabah,0,0,0
1/02/2021,Suriname,Sarawak,0,0,0
1/02/2021,Suriname,Selangor,0,0,0
1/02/2021,Slovakia,Johor,0,0,0
1/02/2021,Slovakia,Kedah,0,0,0
1/02/2021,Slovakia,Kelantan,0,0,0
1/02/2021,Slovakia,Negeri Sembilan,0,0,0
1/02/2021,Slovakia,Pahang,0,0,0
1/02/2021,Slovakia,Perak,0,0,0
1/02/2021,Slovakia,Perlis,0,0,0
1/02/2021,Slovakia,Pulau Pinang,0,0,0
1/02/2021,Slovakia,Sabah,0,0,0
1/02/2021,Slovakia,Sarawak,0,0,0
1/02/2021,Slovakia,Selangor,11,11,0
1/02/2021,Slovakia,W.P. Labuan,0,0,0
1/02/2021,Slovenia,Johor,0,0,0
1/02/2021,Slovenia,Kedah,0,0,0
1/02/2021,Slovenia,Kelantan,0,0,0
1/02/2021,Slovenia,Perak,0,0,0
1/02/2021,Slovenia,Perlis,0,0,0
1/02/2021,Slovenia,Pulau Pinang,0,0,0
1/02/2021,Slovenia,Sabah,0,0,0
1/02/2021,Slovenia,Sarawak,0,0,0
1/02/2021,Slovenia,Selangor,0,0,0
1/02/2021,Slovenia,W.P. Labuan,0,0,0
1/02/2021,Sweden,Johor,0,0,0
1/02/2021,Sweden,Kedah,0,0,0
1/02/2021,Sweden,Kelantan,0,0,0
1/02/2021,Sweden,Melaka,0,0,0
1/02/2021,Sweden,Negeri Sembilan,0,0,0
1/02/2021,Sweden,Pahang,0,0,0
1/02/2021,Sweden,Perak,0,0,0
1/02/2021,Sweden,Perlis,0,0,0
1/02/2021,Sweden,Pulau Pinang,0,0,0
1/02/2021,Sweden,Sabah,0,0,0
1/02/2021,Sweden,Sarawak,0,0,0
1/02/2021,Sweden,Selangor,28,25,3
1/02/2021,Sweden,W.P. Labuan,0,0,0
1/02/2021,Eswatini,Johor,0,0,0
1/02/2021,Eswatini,Kedah,0,0,0
1/02/2021,Eswatini,Pulau Pinang,0,0,0
1/02/2021,Eswatini,Sabah,0,0,0
1/02/2021,Eswatini,Selangor,0,0,0
1/02/2021,Seychelles,Johor,0,0,0
1/02/2021,Seychelles,Kedah,0,0,0
1/02/2021,Seychelles,Pulau Pinang,0,0,0
1/02/2021,Seychelles,Sabah,0,0,0
1/02/2021,Seychelles,Sarawak,0,0,0
1/02/2021,Seychelles,Selangor,5,0,5
1/02/2021,Syrian Arab Republic,Johor,0,0,0
1/02/2021,Syrian Arab Republic,Kedah,0,0,0
1/02/2021,Syrian Arab Republic,Kelantan,0,0,0
1/02/2021,Syrian Arab Republic,Pahang,0,0,0
1/02/2021,Syrian Arab Republic,Perlis,0,0,0
1/02/2021,Syrian Arab Republic,Pulau Pinang,0,0,0
1/02/2021,Syrian Arab Republic,Sabah,0,0,0
1/02/2021,Syrian Arab Republic,Sarawak,0,0,0
1/02/2021,Syrian Arab Republic,Selangor,18,16,2
1/02/2021,Syrian Arab Republic,W.P. Labuan,0,0,0
1/02/2021,Turks and Caicos Islands,Perlis,0,0,0
1/02/2021,TCD,Johor,0,0,0
1/02/2021,TCD,Kedah,0,0,0
1/02/2021,TCD,Perlis,0,0,0
1/02/2021,TCD,Selangor,0,0,0
1/02/2021,Togo,Johor,0,0,0
1/02/2021,Togo,Perak,0,0,0
1/02/2021,Togo,Pulau Pinang,0,0,0
1/02/2021,Togo,Selangor,0,0,0
1/02/2021,Thailand,Johor,0,0,0
1/02/2021,Thailand,Kedah,16128,16086,42
1/02/2021,Thailand,Kelantan,3,1,2
1/02/2021,Thailand,Melaka,0,0,0
1/02/2021,Thailand,Negeri Sembilan,0,0,0
1/02/2021,Thailand,Pahang,0,0,0
1/02/2021,Thailand,Perak,0,0,0
1/02/2021,Thailand,Perlis,9325,8941,384
1/02/2021,Thailand,Pulau Pinang,9,4,5
1/02/2021,Thailand,Sabah,0,0,0
1/02/2021,Thailand,Sarawak,10,10,0
1/02/2021,Thailand,Selangor,100,51,49
1/02/2021,Thailand,Terengganu,6,6,0
1/02/2021,Thailand,W.P. Labuan,0,0,0
1/02/2021,Tajikistan,Johor,0,0,0
1/02/2021,Tajikistan,Kedah,0,0,0
1/02/2021,Tajikistan,Perlis,0,0,0
1/02/2021,Tajikistan,Pulau Pinang,0,0,0
1/02/2021,Tajikistan,Sabah,0,0,0
1/02/2021,Tajikistan,Selangor,5,3,2
1/02/2021,Tokelau,Selangor,0,0,0
1/02/2021,Turkmenistan,Johor,0,0,0
1/02/2021,Turkmenistan,Kedah,0,0,0
1/02/2021,Turkmenistan,Kelantan,0,0,0
1/02/2021,Turkmenistan,Perlis,0,0,0
1/02/2021,Turkmenistan,Pulau Pinang,0,0,0
1/02/2021,Turkmenistan,Sabah,0,0,0
1/02/2021,Turkmenistan,Sarawak,0,0,0
1/02/2021,Turkmenistan,Selangor,2,1,1
1/02/2021,Timor-Leste,Johor,0,0,0
1/02/2021,Timor-Leste,Kedah,0,0,0
1/02/2021,Timor-Leste,Perlis,0,0,0
1/02/2021,Timor-Leste,Pulau Pinang,0,0,0
1/02/2021,Timor-Leste,Sabah,0,0,0
1/02/2021,Timor-Leste,Sarawak,0,0,0
1/02/2021,Timor-Leste,Selangor,1,1,0
1/02/2021,Tonga,Johor,0,0,0
1/02/2021,Tonga,Pulau Pinang,0,0,0
1/02/2021,Tonga,Sarawak,0,0,0
1/02/2021,Tonga,Selangor,0,0,0
1/02/2021,Trinidad and Tobago,Johor,0,0,0
1/02/2021,Trinidad and Tobago,Kedah,0,0,0
1/02/2021,Trinidad and Tobago,Pahang,0,0,0
1/02/2021,Trinidad and Tobago,Pulau Pinang,0,0,0
1/02/2021,Trinidad and Tobago,Sabah,0,0,0
1/02/2021,Trinidad and Tobago,Sarawak,0,0,0
1/02/2021,Trinidad and Tobago,Selangor,1,1,0
1/02/2021,Tunisia,Johor,0,0,0
1/02/2021,Tunisia,Kedah,0,0,0
1/02/2021,Tunisia,Kelantan,0,0,0
1/02/2021,Tunisia,Melaka,0,0,0
1/02/2021,Tunisia,Perak,0,0,0
1/02/2021,Tunisia,Perlis,0,0,0
1/02/2021,Tunisia,Pulau Pinang,0,0,0
1/02/2021,Tunisia,Sabah,0,0,0
1/02/2021,Tunisia,Sarawak,0,0,0
1/02/2021,Tunisia,Selangor,3,2,1
1/02/2021,Tunisia,W.P. Labuan,0,0,0
1/02/2021,Türkiye,Johor,2,2,0
1/02/2021,Türkiye,Kedah,0,0,0
1/02/2021,Türkiye,Kelantan,0,0,0
1/02/2021,Türkiye,Melaka,0,0,0
1/02/2021,Türkiye,Negeri Sembilan,0,0,0
1/02/2021,Türkiye,Pahang,0,0,0
1/02/2021,Türkiye,Perak,0,0,0
1/02/2021,Türkiye,Perlis,0,0,0
1/02/2021,Türkiye,Pulau Pinang,0,0,0
1/02/2021,Türkiye,Sabah,0,0,0
1/02/2021,Türkiye,Sarawak,0,0,0
1/02/2021,Türkiye,Selangor,44,39,5
1/02/2021,Türkiye,W.P. Labuan,0,0,0
1/02/2021,Tuvalu,Selangor,0,0,0
1/02/2021,"Taiwan, Province of China",Johor,0,0,0
1/02/2021,"Taiwan, Province of China",Kedah,0,0,0
1/02/2021,"Taiwan, Province of China",Kelantan,0,0,0
1/02/2021,"Taiwan, Province of China",Melaka,0,0,0
1/02/2021,"Taiwan, Province of China",Negeri Sembilan,0,0,0
1/02/2021,"Taiwan, Province of China",Pahang,0,0,0
1/02/2021,"Taiwan, Province of China",Perak,0,0,0
1/02/2021,"Taiwan, Province of China",Perlis,0,0,0
1/02/2021,"Taiwan, Province of China",Pulau Pinang,16,14,2
1/02/2021,"Taiwan, Province of China",Sabah,0,0,0
1/02/2021,"Taiwan, Province of China",Sarawak,0,0,0
1/02/2021,"Taiwan, Province of China",Selangor,70,49,21
1/02/2021,"Taiwan, Province of China",W.P. Labuan,0,0,0
1/02/2021,"Tanzania, United Republic of",Johor,0,0,0
1/02/2021,"Tanzania, United Republic of",Kedah,0,0,0
1/02/2021,"Tanzania, United Republic of",Perak,0,0,0
1/02/2021,"Tanzania, United Republic of",Perlis,0,0,0
1/02/2021,"Tanzania, United Republic of",Pulau Pinang,0,0,0
1/02/2021,"Tanzania, United Republic of",Sabah,0,0,0
1/02/2021,"Tanzania, United Republic of",Sarawak,0,0,0
1/02/2021,"Tanzania, United Republic of",Selangor,3,2,1
1/02/2021,Uganda,Johor,0,0,0
1/02/2021,Uganda,Kedah,0,0,0
1/02/2021,Uganda,Perak,0,0,0
1/02/2021,Uganda,Perlis,0,0,0
1/02/2021,Uganda,Pulau Pinang,0,0,0
1/02/2021,Uganda,Sabah,0,0,0
1/02/2021,Uganda,Sarawak,0,0,0
1/02/2021,Uganda,Selangor,1,0,1
1/02/2021,Ukraine,Johor,38,38,0
1/02/2021,Ukraine,Kedah,0,0,0
1/02/2021,Ukraine,Kelantan,0,0,0
1/02/2021,Ukraine,Melaka,0,0,0
1/02/2021,Ukraine,Negeri Sembilan,0,0,0
1/02/2021,Ukraine,Pahang,0,0,0
1/02/2021,Ukraine,Perak,0,0,0
1/02/2021,Ukraine,Perlis,0,0,0
1/02/2021,Ukraine,Pulau Pinang,0,0,0
1/02/2021,Ukraine,Sabah,0,0,0
1/02/2021,Ukraine,Sarawak,0,0,0
1/02/2021,Ukraine,Selangor,45,42,3
1/02/2021,Ukraine,W.P. Labuan,0,0,0
1/02/2021,Uruguay,Johor,0,0,0
1/02/2021,Uruguay,Kedah,0,0,0
1/02/2021,Uruguay,Kelantan,0,0,0
1/02/2021,Uruguay,Perak,0,0,0
1/02/2021,Uruguay,Perlis,0,0,0
1/02/2021,Uruguay,Pulau Pinang,0,0,0
1/02/2021,Uruguay,Sabah,0,0,0
1/02/2021,Uruguay,Sarawak,0,0,0
1/02/2021,Uruguay,Selangor,0,0,0
1/02/2021,Uruguay,W.P. Labuan,0,0,0
1/02/2021,United States of America,Johor,2,1,1
1/02/2021,United States of America,Kedah,0,0,0
1/02/2021,United States of America,Kelantan,0,0,0
1/02/2021,United States of America,Melaka,0,0,0
1/02/2021,United States of America,Negeri Sembilan,0,0,0
1/02/2021,United States of America,Pahang,0,0,0
1/02/2021,United States of America,Perak,0,0,0
1/02/2021,United States of America,Perlis,0,0,0
1/02/2021,United States of America,Pulau Pinang,2,1,1
1/02/2021,United States of America,Sabah,0,0,0
1/02/2021,United States of America,Sarawak,0,0,0
1/02/2021,United States of America,Selangor,117,81,36
1/02/2021,United States of America,Terengganu,0,0,0
1/02/2021,United States of America,W.P. Labuan,0,0,0
1/02/2021,Uzbekistan,Johor,0,0,0
1/02/2021,Uzbekistan,Kedah,0,0,0
1/02/2021,Uzbekistan,Kelantan,0,0,0
1/02/2021,Uzbekistan,Perak,0,0,0
1/02/2021,Uzbekistan,Perlis,0,0,0
1/02/2021,Uzbekistan,Pulau Pinang,0,0,0
1/02/2021,Uzbekistan,Sabah,0,0,0
1/02/2021,Uzbekistan,Sarawak,0,0,0
1/02/2021,Uzbekistan,Selangor,10,5,5
1/02/2021,Holy See,Johor,0,0,0
1/02/2021,Holy See,Sarawak,0,0,0
1/02/2021,Holy See,Selangor,0,0,0
1/02/2021,Saint Vincent and the Grenadines,Johor,0,0,0
1/02/2021,Saint Vincent and the Grenadines,Kedah,0,0,0
1/02/2021,Saint Vincent and the Grenadines,Pulau Pinang,0,0,0
1/02/2021,Saint Vincent and the Grenadines,Sarawak,0,0,0
1/02/2021,Saint Vincent and the Grenadines,Selangor,0,0,0
1/02/2021,"Venezuela, Bolivarian Republic of",Johor,0,0,0
1/02/2021,"Venezuela, Bolivarian Republic of",Kedah,0,0,0
1/02/2021,"Venezuela, Bolivarian Republic of",Kelantan,0,0,0
1/02/2021,"Venezuela, Bolivarian Republic of",Melaka,0,0,0
1/02/2021,"Venezuela, Bolivarian Republic of",Perak,0,0,0
1/02/2021,"Venezuela, Bolivarian Republic of",Perlis,0,0,0
1/02/2021,"Venezuela, Bolivarian Republic of",Pulau Pinang,0,0,0
1/02/2021,"Venezuela, Bolivarian Republic of",Sabah,0,0,0
1/02/2021,"Venezuela, Bolivarian Republic of",Sarawak,0,0,0
1/02/2021,"Venezuela, Bolivarian Republic of",Selangor,1,1,0
1/02/2021,"Venezuela, Bolivarian Republic of",W.P. Labuan,0,0,0
1/02/2021,Viet Nam,Johor,1,0,1
1/02/2021,Viet Nam,Kedah,0,0,0
1/02/2021,Viet Nam,Kelantan,0,0,0
1/02/2021,Viet Nam,Melaka,0,0,0
1/02/2021,Viet Nam,Negeri Sembilan,0,0,0
1/02/2021,Viet Nam,Pahang,0,0,0
1/02/2021,Viet Nam,Perak,0,0,0
1/02/2021,Viet Nam,Perlis,0,0,0
1/02/2021,Viet Nam,Pulau Pinang,0,0,0
1/02/2021,Viet Nam,Sabah,0,0,0
1/02/2021,Viet Nam,Sarawak,0,0,0
1/02/2021,Viet Nam,Selangor,75,19,56
1/02/2021,Viet Nam,Terengganu,5,5,0
1/02/2021,Viet Nam,W.P. Labuan,0,0,0
1/02/2021,Vanuatu,Johor,0,0,0
1/02/2021,Vanuatu,Kedah,0,0,0
1/02/2021,Vanuatu,Pulau Pinang,0,0,0
1/02/2021,Vanuatu,Sabah,0,0,0
1/02/2021,Vanuatu,Sarawak,0,0,0
1/02/2021,Vanuatu,Selangor,1,1,0
1/02/2021, Samoa,Johor,0,0,0
1/02/2021, Samoa,Sarawak,0,0,0
1/02/2021, Samoa,Selangor,0,0,0
1/02/2021,Yemen,Johor,0,0,0
1/02/2021,Yemen,Kedah,0,0,0
1/02/2021,Yemen,Kelantan,0,0,0
1/02/2021,Yemen,Melaka,0,0,0
1/02/2021,Yemen,Pahang,0,0,0
1/02/2021,Yemen,Perak,0,0,0
1/02/2021,Yemen,Perlis,0,0,0
1/02/2021,Yemen,Pulau Pinang,0,0,0
1/02/2021,Yemen,Sabah,0,0,0
1/02/2021,Yemen,Sarawak,0,0,0
1/02/2021,Yemen,Selangor,48,39,9
1/02/2021,Yemen,W.P. Labuan,0,0,0
1/02/2021,South Africa,Johor,5,5,0
1/02/2021,South Africa,Kedah,0,0,0
1/02/2021,South Africa,Kelantan,0,0,0
1/02/2021,South Africa,Melaka,0,0,0
1/02/2021,South Africa,Pahang,0,0,0
1/02/2021,South Africa,Perak,0,0,0
1/02/2021,South Africa,Perlis,0,0,0
1/02/2021,South Africa,Pulau Pinang,0,0,0
1/02/2021,South Africa,Sabah,0,0,0
1/02/2021,South Africa,Sarawak,0,0,0
1/02/2021,South Africa,Selangor,50,47,3
1/02/2021,South Africa,Terengganu,0,0,0
1/02/2021,South Africa,W.P. Labuan,0,0,0
1/02/2021,ZAR,Selangor,0,0,0
1/02/2021,Zambia,Johor,0,0,0
1/02/2021,Zambia,Kedah,0,0,0
1/02/2021,Zambia,Perak,0,0,0
1/02/2021,Zambia,Perlis,0,0,0
1/02/2021,Zambia,Pulau Pinang,0,0,0
1/02/2021,Zambia,Sabah,0,0,0
1/02/2021,Zambia,Sarawak,0,0,0
1/02/2021,Zambia,Selangor,9,5,4
1/02/2021,Zimbabwe,Johor,0,0,0
1/02/2021,Zimbabwe,Kedah,0,0,0
1/02/2021,Zimbabwe,Kelantan,0,0,0
1/02/2021,Zimbabwe,Perak,0,0,0
1/02/2021,Zimbabwe,Perlis,0,0,0
1/02/2021,Zimbabwe,Pulau Pinang,0,0,0
1/02/2021,Zimbabwe,Sabah,0,0,0
1/02/2021,Zimbabwe,Sarawak,0,0,0
1/02/2021,Zimbabwe,Selangor,1,1,0
1/03/2021,Aruba,Kedah,0,0,0
1/03/2021,Aruba,Pulau Pinang,0,0,0
1/03/2021,Afghanistan,Johor,0,0,0
1/03/2021,Afghanistan,Kedah,0,0,0
1/03/2021,Afghanistan,Perlis,0,0,0
1/03/2021,Afghanistan,Pulau Pinang,0,0,0
1/03/2021,Afghanistan,Sarawak,0,0,0
1/03/2021,Afghanistan,Selangor,36,29,7
1/03/2021,Angola,Johor,0,0,0
1/03/2021,Angola,Kedah,0,0,0
1/03/2021,Angola,Sabah,0,0,0
1/03/2021,Angola,Selangor,0,0,0
1/03/2021,Anguilla,Selangor,0,0,0
1/03/2021,Albania,Johor,0,0,0
1/03/2021,Albania,Kedah,0,0,0
1/03/2021,Albania,Perak,0,0,0
1/03/2021,Albania,Perlis,0,0,0
1/03/2021,Albania,Pulau Pinang,0,0,0
1/03/2021,Albania,Sabah,0,0,0
1/03/2021,Albania,Sarawak,0,0,0
1/03/2021,Albania,Selangor,0,0,0
1/03/2021,Andorra,Johor,0,0,0
1/03/2021,Andorra,Kedah,0,0,0
1/03/2021,Andorra,Perlis,0,0,0
1/03/2021,Andorra,Pulau Pinang,0,0,0
1/03/2021,Andorra,Selangor,0,0,0
1/03/2021,Antigua and Barbuda,Selangor,0,0,0
1/03/2021,United Arab Emirates,Johor,0,0,0
1/03/2021,United Arab Emirates,Kedah,0,0,0
1/03/2021,United Arab Emirates,Kelantan,0,0,0
1/03/2021,United Arab Emirates,Perak,0,0,0
1/03/2021,United Arab Emirates,Perlis,0,0,0
1/03/2021,United Arab Emirates,Pulau Pinang,0,0,0
1/03/2021,United Arab Emirates,Sabah,0,0,0
1/03/2021,United Arab Emirates,Sarawak,0,0,0
1/03/2021,United Arab Emirates,Selangor,4,4,0
1/03/2021,Argentina,Johor,0,0,0
1/03/2021,Argentina,Kedah,0,0,0
1/03/2021,Argentina,Kelantan,0,0,0
1/03/2021,Argentina,Melaka,0,0,0
1/03/2021,Argentina,Perak,0,0,0
1/03/2021,Argentina,Perlis,0,0,0
1/03/2021,Argentina,Pulau Pinang,0,0,0
1/03/2021,Argentina,Sabah,0,0,0
1/03/2021,Argentina,Sarawak,0,0,0
1/03/2021,Argentina,Selangor,8,6,2
1/03/2021,Argentina,W.P. Labuan,0,0,0
1/03/2021,Armenia,Johor,0,0,0
1/03/2021,Armenia,Kedah,0,0,0
1/03/2021,Armenia,Kelantan,0,0,0
1/03/2021,Armenia,Perak,0,0,0
1/03/2021,Armenia,Perlis,0,0,0
1/03/2021,Armenia,Pulau Pinang,0,0,0
1/03/2021,Armenia,Sabah,0,0,0
1/03/2021,Armenia,Sarawak,0,0,0
1/03/2021,Armenia,Selangor,1,0,1
1/03/2021,Antarctica,Selangor,0,0,0
1/03/2021,Antigua and Barbuda,Johor,0,0,0
1/03/2021,Antigua and Barbuda,Kedah,0,0,0
1/03/2021,Antigua and Barbuda,Pulau Pinang,0,0,0
1/03/2021,Antigua and Barbuda,Sarawak,0,0,0
1/03/2021,Antigua and Barbuda,Selangor,0,0,0
1/03/2021,Australia,Johor,2,1,1
1/03/2021,Australia,Kedah,0,0,0
1/03/2021,Australia,Kelantan,0,0,0
1/03/2021,Australia,Melaka,0,0,0
1/03/2021,Australia,Negeri Sembilan,0,0,0
1/03/2021,Australia,Pahang,0,0,0
1/03/2021,Australia,Perak,0,0,0
1/03/2021,Australia,Perlis,0,0,0
1/03/2021,Australia,Pulau Pinang,4,3,1
1/03/2021,Australia,Sabah,2,2,0
1/03/2021,Australia,Sarawak,0,0,0
1/03/2021,Australia,Selangor,86,69,17
1/03/2021,Australia,Terengganu,0,0,0
1/03/2021,Australia,W.P. Labuan,0,0,0
1/03/2021,Austria,Johor,0,0,0
1/03/2021,Austria,Kedah,0,0,0
1/03/2021,Austria,Kelantan,0,0,0
1/03/2021,Austria,Melaka,0,0,0
1/03/2021,Austria,Negeri Sembilan,0,0,0
1/03/2021,Austria,Pahang,0,0,0
1/03/2021,Austria,Perak,0,0,0
1/03/2021,Austria,Perlis,0,0,0
1/03/2021,Austria,Pulau Pinang,0,0,0
1/03/2021,Austria,Sabah,0,0,0
1/03/2021,Austria,Sarawak,0,0,0
1/03/2021,Austria,Selangor,7,7,0
1/03/2021,Austria,Terengganu,0,0,0
1/03/2021,Austria,W.P. Labuan,0,0,0
1/03/2021,Azerbaijan,Johor,0,0,0
1/03/2021,Azerbaijan,Kedah,0,0,0
1/03/2021,Azerbaijan,Kelantan,0,0,0
1/03/2021,Azerbaijan,Melaka,0,0,0
1/03/2021,Azerbaijan,Perlis,0,0,0
1/03/2021,Azerbaijan,Pulau Pinang,0,0,0
1/03/2021,Azerbaijan,Sabah,0,0,0
1/03/2021,Azerbaijan,Sarawak,0,0,0
1/03/2021,Azerbaijan,Selangor,4,2,2
1/03/2021,Azerbaijan,W.P. Labuan,0,0,0
1/03/2021,Burundi,Pulau Pinang,0,0,0
1/03/2021,Burundi,Sarawak,0,0,0
1/03/2021,Burundi,Selangor,1,1,0
1/03/2021,Belgium,Johor,0,0,0
1/03/2021,Belgium,Kedah,0,0,0
1/03/2021,Belgium,Kelantan,0,0,0
1/03/2021,Belgium,Melaka,0,0,0
1/03/2021,Belgium,Negeri Sembilan,0,0,0
1/03/2021,Belgium,Pahang,0,0,0
1/03/2021,Belgium,Perak,0,0,0
1/03/2021,Belgium,Perlis,0,0,0
1/03/2021,Belgium,Pulau Pinang,0,0,0
1/03/2021,Belgium,Sabah,0,0,0
1/03/2021,Belgium,Sarawak,0,0,0
1/03/2021,Belgium,Selangor,22,20,2
1/03/2021,Belgium,W.P. Labuan,0,0,0
1/03/2021,Benin,Johor,0,0,0
1/03/2021,Benin,Kedah,0,0,0
1/03/2021,Benin,Perak,0,0,0
1/03/2021,Benin,Pulau Pinang,0,0,0
1/03/2021,Benin,Sabah,0,0,0
1/03/2021,Benin,Sarawak,0,0,0
1/03/2021,Benin,Selangor,0,0,0
1/03/2021,Burkina Faso,Perak,0,0,0
1/03/2021,Burkina Faso,Pulau Pinang,0,0,0
1/03/2021,Burkina Faso,Selangor,0,0,0
1/03/2021,Bangladesh,Johor,10,10,0
1/03/2021,Bangladesh,Kedah,0,0,0
1/03/2021,Bangladesh,Kelantan,0,0,0
1/03/2021,Bangladesh,Melaka,0,0,0
1/03/2021,Bangladesh,Negeri Sembilan,0,0,0
1/03/2021,Bangladesh,Pahang,0,0,0
1/03/2021,Bangladesh,Perak,0,0,0
1/03/2021,Bangladesh,Perlis,0,0,0
1/03/2021,Bangladesh,Pulau Pinang,1,1,0
1/03/2021,Bangladesh,Sabah,0,0,0
1/03/2021,Bangladesh,Sarawak,0,0,0
1/03/2021,Bangladesh,Selangor,296,205,91
1/03/2021,Bangladesh,W.P. Labuan,0,0,0
1/03/2021,Bulgaria,Johor,0,0,0
1/03/2021,Bulgaria,Kedah,0,0,0
1/03/2021,Bulgaria,Kelantan,0,0,0
1/03/2021,Bulgaria,Pahang,0,0,0
1/03/2021,Bulgaria,Perak,0,0,0
1/03/2021,Bulgaria,Perlis,0,0,0
1/03/2021,Bulgaria,Pulau Pinang,0,0,0
1/03/2021,Bulgaria,Sabah,0,0,0
1/03/2021,Bulgaria,Sarawak,0,0,0
1/03/2021,Bulgaria,Selangor,13,12,1
1/03/2021,Bulgaria,W.P. Labuan,0,0,0
1/03/2021,Bahrain,Johor,0,0,0
1/03/2021,Bahrain,Kedah,0,0,0
1/03/2021,Bahrain,Kelantan,0,0,0
1/03/2021,Bahrain,Perlis,0,0,0
1/03/2021,Bahrain,Pulau Pinang,0,0,0
1/03/2021,Bahrain,Sabah,0,0,0
1/03/2021,Bahrain,Sarawak,0,0,0
1/03/2021,Bahrain,Selangor,5,2,3
1/03/2021,Bahamas,Johor,0,0,0
1/03/2021,Bahamas,Kedah,0,0,0
1/03/2021,Bahamas,Perak,0,0,0
1/03/2021,Bahamas,Sabah,0,0,0
1/03/2021,Bahamas,Sarawak,0,0,0
1/03/2021,Bahamas,Selangor,0,0,0
1/03/2021,Bosnia and Herzegovina,Johor,0,0,0
1/03/2021,Bosnia and Herzegovina,Kedah,0,0,0
1/03/2021,Bosnia and Herzegovina,Perlis,0,0,0
1/03/2021,Bosnia and Herzegovina,Pulau Pinang,0,0,0
1/03/2021,Bosnia and Herzegovina,Sabah,0,0,0
1/03/2021,Bosnia and Herzegovina,Sarawak,0,0,0
1/03/2021,Bosnia and Herzegovina,Selangor,2,0,2
1/03/2021,Belarus,Johor,0,0,0
1/03/2021,Belarus,Kedah,0,0,0
1/03/2021,Belarus,Kelantan,0,0,0
1/03/2021,Belarus,Pahang,0,0,0
1/03/2021,Belarus,Perak,0,0,0
1/03/2021,Belarus,Perlis,0,0,0
1/03/2021,Belarus,Pulau Pinang,0,0,0
1/03/2021,Belarus,Sabah,0,0,0
1/03/2021,Belarus,Sarawak,0,0,0
1/03/2021,Belarus,Selangor,0,0,0
1/03/2021,Belarus,W.P. Labuan,0,0,0
1/03/2021,Belize,Johor,0,0,0
1/03/2021,Belize,Pulau Pinang,0,0,0
1/03/2021,Belize,Sarawak,0,0,0
1/03/2021,Belize,Selangor,0,0,0
1/03/2021,Bermuda,Selangor,0,0,0
1/03/2021,Bolivia,Johor,0,0,0
1/03/2021,Bolivia,Kedah,0,0,0
1/03/2021,Bolivia,Melaka,0,0,0
1/03/2021,Bolivia,Perak,0,0,0
1/03/2021,Bolivia,Perlis,0,0,0
1/03/2021,Bolivia,Pulau Pinang,0,0,0
1/03/2021,Bolivia,Sabah,0,0,0
1/03/2021,Bolivia,Sarawak,0,0,0
1/03/2021,Bolivia,Selangor,0,0,0
1/03/2021,Brazil,Johor,0,0,0
1/03/2021,Brazil,Kedah,0,0,0
1/03/2021,Brazil,Kelantan,0,0,0
1/03/2021,Brazil,Melaka,0,0,0
1/03/2021,Brazil,Pahang,0,0,0
1/03/2021,Brazil,Perak,0,0,0
1/03/2021,Brazil,Perlis,0,0,0
1/03/2021,Brazil,Pulau Pinang,0,0,0
1/03/2021,Brazil,Sabah,0,0,0
1/03/2021,Brazil,Sarawak,0,0,0
1/03/2021,Brazil,Selangor,18,12,6
1/03/2021,Brazil,W.P. Labuan,0,0,0
1/03/2021,Barbados,Johor,0,0,0
1/03/2021,Barbados,Kedah,0,0,0
1/03/2021,Barbados,Perlis,0,0,0
1/03/2021,Barbados,Pulau Pinang,0,0,0
1/03/2021,Barbados,Selangor,0,0,0
1/03/2021,Brunei Darussalam,Johor,1,0,1
1/03/2021,Brunei Darussalam,Kedah,0,0,0
1/03/2021,Brunei Darussalam,Kelantan,0,0,0
1/03/2021,Brunei Darussalam,Melaka,0,0,0
1/03/2021,Brunei Darussalam,Pahang,0,0,0
1/03/2021,Brunei Darussalam,Perak,0,0,0
1/03/2021,Brunei Darussalam,Perlis,0,0,0
1/03/2021,Brunei Darussalam,Pulau Pinang,0,0,0
1/03/2021,Brunei Darussalam,Sabah,0,0,0
1/03/2021,Brunei Darussalam,Sarawak,422,406,16
1/03/2021,Brunei Darussalam,Selangor,27,10,17
1/03/2021,Brunei Darussalam,W.P. Labuan,1,0,1
1/03/2021,Bhutan,Johor,0,0,0
1/03/2021,Bhutan,Kedah,0,0,0
1/03/2021,Bhutan,Perak,0,0,0
1/03/2021,Bhutan,Perlis,0,0,0
1/03/2021,Bhutan,Pulau Pinang,0,0,0
1/03/2021,Bhutan,Sabah,0,0,0
1/03/2021,Bhutan,Sarawak,0,0,0
1/03/2021,Bhutan,Selangor,2,2,0
1/03/2021,Botswana,Johor,0,0,0
1/03/2021,Botswana,Kedah,0,0,0
1/03/2021,Botswana,Perlis,0,0,0
1/03/2021,Botswana,Pulau Pinang,0,0,0
1/03/2021,Botswana,Sabah,0,0,0
1/03/2021,Botswana,Sarawak,0,0,0
1/03/2021,Botswana,Selangor,0,0,0
1/03/2021,Central African Republic,Kedah,0,0,0
1/03/2021,Central African Republic,Selangor,0,0,0
1/03/2021,Canada,Johor,0,0,0
1/03/2021,Canada,Kedah,0,0,0
1/03/2021,Canada,Kelantan,0,0,0
1/03/2021,Canada,Melaka,0,0,0
1/03/2021,Canada,Negeri Sembilan,0,0,0
1/03/2021,Canada,Pahang,0,0,0
1/03/2021,Canada,Perak,0,0,0
1/03/2021,Canada,Perlis,0,0,0
1/03/2021,Canada,Pulau Pinang,1,0,1
1/03/2021,Canada,Sabah,0,0,0
1/03/2021,Canada,Sarawak,0,0,0
1/03/2021,Canada,Selangor,36,27,9
1/03/2021,Canada,Terengganu,0,0,0
1/03/2021,Canada,W.P. Labuan,0,0,0
1/03/2021,Cocos (Keeling) Islands,Selangor,0,0,0
1/03/2021,Switzerland,Johor,0,0,0
1/03/2021,Switzerland,Kedah,0,0,0
1/03/2021,Switzerland,Kelantan,0,0,0
1/03/2021,Switzerland,Melaka,0,0,0
1/03/2021,Switzerland,Negeri Sembilan,0,0,0
1/03/2021,Switzerland,Pahang,0,0,0
1/03/2021,Switzerland,Perak,0,0,0
1/03/2021,Switzerland,Perlis,0,0,0
1/03/2021,Switzerland,Pulau Pinang,3,1,2
1/03/2021,Switzerland,Sabah,0,0,0
1/03/2021,Switzerland,Sarawak,0,0,0
1/03/2021,Switzerland,Selangor,17,10,7
1/03/2021,Switzerland,W.P. Labuan,0,0,0
1/03/2021,Chile,Johor,0,0,0
1/03/2021,Chile,Kedah,0,0,0
1/03/2021,Chile,Kelantan,0,0,0
1/03/2021,Chile,Melaka,0,0,0
1/03/2021,Chile,Pahang,0,0,0
1/03/2021,Chile,Perak,0,0,0
1/03/2021,Chile,Perlis,0,0,0
1/03/2021,Chile,Pulau Pinang,0,0,0
1/03/2021,Chile,Sabah,0,0,0
1/03/2021,Chile,Sarawak,0,0,0
1/03/2021,Chile,Selangor,0,0,0
1/03/2021,China,Johor,12,10,2
1/03/2021,China,Kedah,4,1,3
1/03/2021,China,Kelantan,0,0,0
1/03/2021,China,Melaka,0,0,0
1/03/2021,China,Pahang,0,0,0
1/03/2021,China,Perak,0,0,0
1/03/2021,China,Perlis,0,0,0
1/03/2021,China,Pulau Pinang,14,6,8
1/03/2021,China,Sabah,8,8,0
1/03/2021,China,Sarawak,84,77,7
1/03/2021,China,Selangor,1765,1479,286
1/03/2021,China,Terengganu,0,0,0
1/03/2021,China,W.P. Labuan,0,0,0
1/03/2021,Côte d'Ivoire,Johor,0,0,0
1/03/2021,Côte d'Ivoire,Kedah,0,0,0
1/03/2021,Côte d'Ivoire,Pulau Pinang,0,0,0
1/03/2021,Côte d'Ivoire,Sabah,0,0,0
1/03/2021,Côte d'Ivoire,Sarawak,0,0,0
1/03/2021,Côte d'Ivoire,Selangor,2,1,1
1/03/2021,Cameroon,Johor,0,0,0
1/03/2021,Cameroon,Kedah,0,0,0
1/03/2021,Cameroon,Pulau Pinang,0,0,0
1/03/2021,Cameroon,Sabah,0,0,0
1/03/2021,Cameroon,Sarawak,0,0,0
1/03/2021,Cameroon,Selangor,3,3,0
1/03/2021,Congo,Johor,0,0,0
1/03/2021,Congo,Pulau Pinang,0,0,0
1/03/2021,Congo,Sarawak,0,0,0
1/03/2021,Congo,Selangor,1,1,0
1/03/2021,Congo,Johor,0,0,0
1/03/2021,Congo,Kedah,0,0,0
1/03/2021,Congo,Selangor,0,0,0
1/03/2021,Cook Islands,Selangor,0,0,0
1/03/2021,Colombia,Johor,0,0,0
1/03/2021,Colombia,Kedah,0,0,0
1/03/2021,Colombia,Perak,0,0,0
1/03/2021,Colombia,Pulau Pinang,0,0,0
1/03/2021,Colombia,Sabah,0,0,0
1/03/2021,Colombia,Sarawak,0,0,0
1/03/2021,Colombia,Selangor,10,3,7
1/03/2021,Colombia,W.P. Labuan,0,0,0
1/03/2021,Comoros,Johor,0,0,0
1/03/2021,Comoros,Kedah,0,0,0
1/03/2021,Comoros,Selangor,4,3,1
1/03/2021,Cabo Verde,Johor,0,0,0
1/03/2021,Cabo Verde,Kedah,0,0,0
1/03/2021,Cabo Verde,Pulau Pinang,0,0,0
1/03/2021,Cabo Verde,Sabah,0,0,0
1/03/2021,Cabo Verde,Selangor,0,0,0
1/03/2021,Costa Rica,Johor,0,0,0
1/03/2021,Costa Rica,Kedah,0,0,0
1/03/2021,Costa Rica,Perak,0,0,0
1/03/2021,Costa Rica,Perlis,0,0,0
1/03/2021,Costa Rica,Pulau Pinang,0,0,0
1/03/2021,Costa Rica,Sabah,0,0,0
1/03/2021,Costa Rica,Sarawak,0,0,0
1/03/2021,Costa Rica,Selangor,4,2,2
1/03/2021,Cuba,Johor,0,0,0
1/03/2021,Cuba,Kedah,0,0,0
1/03/2021,Cuba,Perlis,0,0,0
1/03/2021,Cuba,Pulau Pinang,0,0,0
1/03/2021,Cuba,Sabah,0,0,0
1/03/2021,Cuba,Sarawak,0,0,0
1/03/2021,Cuba,Selangor,2,1,1
1/03/2021,Cyprus,Johor,0,0,0
1/03/2021,Cyprus,Kedah,0,0,0
1/03/2021,Cyprus,Perak,0,0,0
1/03/2021,Cyprus,Perlis,0,0,0
1/03/2021,Cyprus,Pulau Pinang,0,0,0
1/03/2021,Cyprus,Sabah,0,0,0
1/03/2021,Cyprus,Sarawak,0,0,0
1/03/2021,Cyprus,Selangor,1,1,0
1/03/2021,Czechia,Johor,0,0,0
1/03/2021,Czechia,Kedah,0,0,0
1/03/2021,Czechia,Kelantan,0,0,0
1/03/2021,Czechia,Melaka,0,0,0
1/03/2021,Czechia,Negeri Sembilan,0,0,0
1/03/2021,Czechia,Perak,0,0,0
1/03/2021,Czechia,Perlis,0,0,0
1/03/2021,Czechia,Pulau Pinang,0,0,0
1/03/2021,Czechia,Sabah,0,0,0
1/03/2021,Czechia,Sarawak,0,0,0
1/03/2021,Czechia,Selangor,7,4,3
1/03/2021,Czechia,W.P. Labuan,0,0,0
1/03/2021,Germany,Johor,0,0,0
1/03/2021,Germany,Kedah,0,0,0
1/03/2021,Germany,Kelantan,0,0,0
1/03/2021,Germany,Melaka,0,0,0
1/03/2021,Germany,Negeri Sembilan,0,0,0
1/03/2021,Germany,Pahang,0,0,0
1/03/2021,Germany,Perak,0,0,0
1/03/2021,Germany,Perlis,0,0,0
1/03/2021,Germany,Pulau Pinang,1,1,0
1/03/2021,Germany,Sabah,0,0,0
1/03/2021,Germany,Sarawak,0,0,0
1/03/2021,Germany,Selangor,93,87,6
1/03/2021,Germany,Terengganu,0,0,0
1/03/2021,Germany,W.P. Labuan,0,0,0
1/03/2021,Djibouti,Johor,0,0,0
1/03/2021,Djibouti,Selangor,10,0,10
1/03/2021,Dominica,Johor,0,0,0
1/03/2021,Dominica,Kedah,0,0,0
1/03/2021,Dominica,Pulau Pinang,0,0,0
1/03/2021,Dominica,Sabah,0,0,0
1/03/2021,Dominica,Sarawak,0,0,0
1/03/2021,Dominica,Selangor,1,1,0
1/03/2021,Dominica,W.P. Labuan,0,0,0
1/03/2021,Denmark,Johor,3,3,0
1/03/2021,Denmark,Kedah,0,0,0
1/03/2021,Denmark,Kelantan,0,0,0
1/03/2021,Denmark,Melaka,0,0,0
1/03/2021,Denmark,Negeri Sembilan,0,0,0
1/03/2021,Denmark,Pahang,0,0,0
1/03/2021,Denmark,Perak,0,0,0
1/03/2021,Denmark,Perlis,0,0,0
1/03/2021,Denmark,Pulau Pinang,0,0,0
1/03/2021,Denmark,Sabah,0,0,0
1/03/2021,Denmark,Sarawak,0,0,0
1/03/2021,Denmark,Selangor,18,15,3
1/03/2021,Denmark,W.P. Labuan,0,0,0
1/03/2021,Dominican Republic,Johor,0,0,0
1/03/2021,Dominican Republic,Kedah,0,0,0
1/03/2021,Dominican Republic,Perak,0,0,0
1/03/2021,Dominican Republic,Perlis,0,0,0
1/03/2021,Dominican Republic,Pulau Pinang,0,0,0
1/03/2021,Dominican Republic,Sabah,0,0,0
1/03/2021,Dominican Republic,Sarawak,0,0,0
1/03/2021,Dominican Republic,Selangor,0,0,0
1/03/2021,Algeria,Johor,0,0,0
1/03/2021,Algeria,Kedah,0,0,0
1/03/2021,Algeria,Kelantan,0,0,0
1/03/2021,Algeria,Melaka,0,0,0
1/03/2021,Algeria,Perak,0,0,0
1/03/2021,Algeria,Perlis,0,0,0
1/03/2021,Algeria,Pulau Pinang,0,0,0
1/03/2021,Algeria,Sabah,0,0,0
1/03/2021,Algeria,Sarawak,0,0,0
1/03/2021,Algeria,Selangor,4,2,2
1/03/2021,Algeria,W.P. Labuan,0,0,0
1/03/2021,Ecuador,Johor,0,0,0
1/03/2021,Ecuador,Kedah,0,0,0
1/03/2021,Ecuador,Perak,0,0,0
1/03/2021,Ecuador,Perlis,0,0,0
1/03/2021,Ecuador,Pulau Pinang,0,0,0
1/03/2021,Ecuador,Sabah,0,0,0
1/03/2021,Ecuador,Sarawak,0,0,0
1/03/2021,Ecuador,Selangor,0,0,0
1/03/2021,Egypt,Johor,0,0,0
1/03/2021,Egypt,Kedah,0,0,0
1/03/2021,Egypt,Kelantan,0,0,0
1/03/2021,Egypt,Melaka,0,0,0
1/03/2021,Egypt,Pahang,0,0,0
1/03/2021,Egypt,Perak,0,0,0
1/03/2021,Egypt,Perlis,0,0,0
1/03/2021,Egypt,Pulau Pinang,0,0,0
1/03/2021,Egypt,Sabah,0,0,0
1/03/2021,Egypt,Sarawak,0,0,0
1/03/2021,Egypt,Selangor,114,86,28
1/03/2021,Egypt,Terengganu,0,0,0
1/03/2021,Egypt,W.P. Labuan,0,0,0
1/03/2021,Eritrea,Johor,0,0,0
1/03/2021,Eritrea,Pulau Pinang,0,0,0
1/03/2021,Eritrea,Sabah,0,0,0
1/03/2021,Eritrea,Selangor,2,1,1
1/03/2021,Spain,Johor,0,0,0
1/03/2021,Spain,Kedah,0,0,0
1/03/2021,Spain,Kelantan,0,0,0
1/03/2021,Spain,Melaka,0,0,0
1/03/2021,Spain,Negeri Sembilan,0,0,0
1/03/2021,Spain,Pahang,0,0,0
1/03/2021,Spain,Perak,0,0,0
1/03/2021,Spain,Perlis,0,0,0
1/03/2021,Spain,Pulau Pinang,0,0,0
1/03/2021,Spain,Sabah,1,1,0
1/03/2021,Spain,Sarawak,0,0,0
1/03/2021,Spain,Selangor,26,17,9
1/03/2021,Spain,W.P. Labuan,0,0,0
1/03/2021,Estonia,Johor,0,0,0
1/03/2021,Estonia,Kedah,0,0,0
1/03/2021,Estonia,Kelantan,0,0,0
1/03/2021,Estonia,Pahang,0,0,0
1/03/2021,Estonia,Perak,0,0,0
1/03/2021,Estonia,Perlis,0,0,0
1/03/2021,Estonia,Pulau Pinang,0,0,0
1/03/2021,Estonia,Sabah,0,0,0
1/03/2021,Estonia,Sarawak,0,0,0
1/03/2021,Estonia,Selangor,2,2,0
1/03/2021,Estonia,W.P. Labuan,0,0,0
1/03/2021,Ethiopia,Johor,3,3,0
1/03/2021,Ethiopia,Kedah,0,0,0
1/03/2021,Ethiopia,Pulau Pinang,0,0,0
1/03/2021,Ethiopia,Sarawak,0,0,0
1/03/2021,Ethiopia,Selangor,6,5,1
1/03/2021,Finland,Johor,0,0,0
1/03/2021,Finland,Kedah,0,0,0
1/03/2021,Finland,Kelantan,0,0,0
1/03/2021,Finland,Melaka,0,0,0
1/03/2021,Finland,Negeri Sembilan,0,0,0
1/03/2021,Finland,Pahang,0,0,0
1/03/2021,Finland,Perak,0,0,0
1/03/2021,Finland,Perlis,0,0,0
1/03/2021,Finland,Pulau Pinang,0,0,0
1/03/2021,Finland,Sabah,0,0,0
1/03/2021,Finland,Sarawak,0,0,0
1/03/2021,Finland,Selangor,15,13,2
1/03/2021,Finland,W.P. Labuan,0,0,0
1/03/2021,Fiji,Johor,0,0,0
1/03/2021,Fiji,Kedah,0,0,0
1/03/2021,Fiji,Kelantan,0,0,0
1/03/2021,Fiji,Perak,0,0,0
1/03/2021,Fiji,Perlis,0,0,0
1/03/2021,Fiji,Pulau Pinang,0,0,0
1/03/2021,Fiji,Sabah,0,0,0
1/03/2021,Fiji,Sarawak,0,0,0
1/03/2021,Fiji,Selangor,1,0,1
1/03/2021,France,Johor,3,3,0
1/03/2021,France,Kedah,0,0,0
1/03/2021,France,Kelantan,0,0,0
1/03/2021,France,Melaka,0,0,0
1/03/2021,France,Negeri Sembilan,0,0,0
1/03/2021,France,Pahang,0,0,0
1/03/2021,France,Perak,0,0,0
1/03/2021,France,Perlis,0,0,0
1/03/2021,France,Pulau Pinang,3,3,0
1/03/2021,France,Sabah,0,0,0
1/03/2021,France,Sarawak,1,1,0
1/03/2021,France,Selangor,72,57,15
1/03/2021,France,Terengganu,0,0,0
1/03/2021,France,W.P. Labuan,0,0,0
1/03/2021,"Micronesia, Federated States of",Johor,0,0,0
1/03/2021,"Micronesia, Federated States of",Pulau Pinang,0,0,0
1/03/2021,"Micronesia, Federated States of",Selangor,0,0,0
1/03/2021,Gabon,Johor,0,0,0
1/03/2021,Gabon,Pulau Pinang,0,0,0
1/03/2021,Gabon,Sarawak,0,0,0
1/03/2021,Gabon,Selangor,1,1,0
1/03/2021,United Kingdom of Great Britain and Northern Ireland,Johor,2,2,0
1/03/2021,United Kingdom of Great Britain and Northern Ireland,Kedah,0,0,0
1/03/2021,United Kingdom of Great Britain and Northern Ireland,Kelantan,0,0,0
1/03/2021,United Kingdom of Great Britain and Northern Ireland,Melaka,0,0,0
1/03/2021,United Kingdom of Great Britain and Northern Ireland,Negeri Sembilan,0,0,0
1/03/2021,United Kingdom of Great Britain and Northern Ireland,Pahang,0,0,0
1/03/2021,United Kingdom of Great Britain and Northern Ireland,Perak,0,0,0
1/03/2021,United Kingdom of Great Britain and Northern Ireland,Perlis,0,0,0
1/03/2021,United Kingdom of Great Britain and Northern Ireland,Pulau Pinang,1,1,0
1/03/2021,United Kingdom of Great Britain and Northern Ireland,Sabah,1,1,0
1/03/2021,United Kingdom of Great Britain and Northern Ireland,Sarawak,1,1,0
1/03/2021,United Kingdom of Great Britain and Northern Ireland,Selangor,233,186,47
1/03/2021,United Kingdom of Great Britain and Northern Ireland,Terengganu,0,0,0
1/03/2021,United Kingdom of Great Britain and Northern Ireland,W.P. Labuan,0,0,0
1/03/2021,Georgia,Johor,2,2,0
1/03/2021,Georgia,Kedah,0,0,0
1/03/2021,Georgia,Melaka,0,0,0
1/03/2021,Georgia,Perak,0,0,0
1/03/2021,Georgia,Perlis,0,0,0
1/03/2021,Georgia,Pulau Pinang,0,0,0
1/03/2021,Georgia,Sabah,0,0,0
1/03/2021,Georgia,Sarawak,0,0,0
1/03/2021,Georgia,Selangor,3,3,0
1/03/2021,Ghana,Johor,0,0,0
1/03/2021,Ghana,Kedah,0,0,0
1/03/2021,Ghana,Kelantan,0,0,0
1/03/2021,Ghana,Pulau Pinang,0,0,0
1/03/2021,Ghana,Sabah,1,1,0
1/03/2021,Ghana,Sarawak,0,0,0
1/03/2021,Ghana,Selangor,8,4,4
1/03/2021,Gibraltar,Johor,0,0,0
1/03/2021,Gibraltar,Sarawak,0,0,0
1/03/2021,Guinea,Johor,0,0,0
1/03/2021,Guinea,Kedah,0,0,0
1/03/2021,Guinea,Kelantan,0,0,0
1/03/2021,Guinea,Perlis,0,0,0
1/03/2021,Guinea,Pulau Pinang,0,0,0
1/03/2021,Guinea,Sabah,0,0,0
1/03/2021,Guinea,Sarawak,0,0,0
1/03/2021,Guinea,Selangor,11,4,7
1/03/2021,Guadeloupe,Selangor,0,0,0
1/03/2021,Gambia,Johor,0,0,0
1/03/2021,Gambia,Kedah,0,0,0
1/03/2021,Gambia,Kelantan,0,0,0
1/03/2021,Gambia,Pulau Pinang,0,0,0
1/03/2021,Gambia,Sabah,0,0,0
1/03/2021,Gambia,Sarawak,0,0,0
1/03/2021,Gambia,Selangor,1,1,0
1/03/2021,Guinea-Bissau,Johor,0,0,0
1/03/2021,Guinea-Bissau,Selangor,0,0,0
1/03/2021,Equatorial Guinea,Johor,0,0,0
1/03/2021,Equatorial Guinea,Selangor,0,0,0
1/03/2021,Greece,Johor,0,0,0
1/03/2021,Greece,Kedah,0,0,0
1/03/2021,Greece,Kelantan,0,0,0
1/03/2021,Greece,Melaka,0,0,0
1/03/2021,Greece,Negeri Sembilan,0,0,0
1/03/2021,Greece,Pahang,0,0,0
1/03/2021,Greece,Perak,0,0,0
1/03/2021,Greece,Perlis,0,0,0
1/03/2021,Greece,Pulau Pinang,0,0,0
1/03/2021,Greece,Sabah,0,0,0
1/03/2021,Greece,Sarawak,0,0,0
1/03/2021,Greece,Selangor,5,5,0
1/03/2021,Grenada,Johor,0,0,0
1/03/2021,Grenada,Kedah,0,0,0
1/03/2021,Grenada,Pulau Pinang,0,0,0
1/03/2021,Grenada,Sabah,0,0,0
1/03/2021,Grenada,Sarawak,0,0,0
1/03/2021,Grenada,Selangor,0,0,0
1/03/2021,Greenland,Johor,0,0,0
1/03/2021,Greenland,Selangor,0,0,0
1/03/2021,Guatemala,Johor,0,0,0
1/03/2021,Guatemala,Kedah,0,0,0
1/03/2021,Guatemala,Pahang,0,0,0
1/03/2021,Guatemala,Perak,0,0,0
1/03/2021,Guatemala,Pulau Pinang,0,0,0
1/03/2021,Guatemala,Sabah,0,0,0
1/03/2021,Guatemala,Sarawak,0,0,0
1/03/2021,Guatemala,Selangor,0,0,0
1/03/2021,Guatemala,W.P. Labuan,0,0,0
1/03/2021,Guyana,Johor,0,0,0
1/03/2021,Guyana,Kedah,0,0,0
1/03/2021,Guyana,Pulau Pinang,0,0,0
1/03/2021,Guyana,Sarawak,0,0,0
1/03/2021,Guyana,Selangor,0,0,0
1/03/2021,Hong Kong,Johor,0,0,0
1/03/2021,Hong Kong,Kedah,0,0,0
1/03/2021,Hong Kong,Kelantan,0,0,0
1/03/2021,Hong Kong,Pahang,0,0,0
1/03/2021,Hong Kong,Perak,0,0,0
1/03/2021,Hong Kong,Perlis,0,0,0
1/03/2021,Hong Kong,Pulau Pinang,5,2,3
1/03/2021,Hong Kong,Sabah,0,0,0
1/03/2021,Hong Kong,Sarawak,0,0,0
1/03/2021,Hong Kong,Selangor,0,0,0
1/03/2021,Hong Kong,Terengganu,0,0,0
1/03/2021,Heard Island and McDonald Islands,Johor,0,0,0
1/03/2021,Honduras,Johor,0,0,0
1/03/2021,Honduras,Kedah,0,0,0
1/03/2021,Honduras,Perak,0,0,0
1/03/2021,Honduras,Pulau Pinang,0,0,0
1/03/2021,Honduras,Sabah,0,0,0
1/03/2021,Honduras,Sarawak,0,0,0
1/03/2021,Honduras,Selangor,0,0,0
1/03/2021,Croatia,Johor,4,4,0
1/03/2021,Croatia,Kedah,0,0,0
1/03/2021,Croatia,Kelantan,0,0,0
1/03/2021,Croatia,Melaka,0,0,0
1/03/2021,Croatia,Pahang,0,0,0
1/03/2021,Croatia,Perak,0,0,0
1/03/2021,Croatia,Perlis,0,0,0
1/03/2021,Croatia,Pulau Pinang,0,0,0
1/03/2021,Croatia,Sabah,0,0,0
1/03/2021,Croatia,Sarawak,0,0,0
1/03/2021,Croatia,Selangor,45,41,4
1/03/2021,Haiti,Johor,0,0,0
1/03/2021,Haiti,Kedah,0,0,0
1/03/2021,Haiti,Kelantan,0,0,0
1/03/2021,Haiti,Perak,0,0,0
1/03/2021,Haiti,Pulau Pinang,0,0,0
1/03/2021,Haiti,Sabah,0,0,0
1/03/2021,Haiti,Selangor,0,0,0
1/03/2021,Hungary,Johor,0,0,0
1/03/2021,Hungary,Kedah,0,0,0
1/03/2021,Hungary,Kelantan,0,0,0
1/03/2021,Hungary,Pahang,0,0,0
1/03/2021,Hungary,Perak,0,0,0
1/03/2021,Hungary,Perlis,0,0,0
1/03/2021,Hungary,Pulau Pinang,0,0,0
1/03/2021,Hungary,Sabah,0,0,0
1/03/2021,Hungary,Sarawak,0,0,0
1/03/2021,Hungary,Selangor,5,1,4
1/03/2021,Hungary,W.P. Labuan,0,0,0
1/03/2021,Indonesia,Johor,322,254,68
1/03/2021,Indonesia,Kedah,6,6,0
1/03/2021,Indonesia,Kelantan,0,0,0
1/03/2021,Indonesia,Melaka,2,0,2
1/03/2021,Indonesia,Negeri Sembilan,0,0,0
1/03/2021,Indonesia,Pahang,1,1,0
1/03/2021,Indonesia,Perak,0,0,0
1/03/2021,Indonesia,Perlis,9,9,0
1/03/2021,Indonesia,Pulau Pinang,25,12,13
1/03/2021,Indonesia,Sabah,1,1,0
1/03/2021,Indonesia,Sarawak,488,488,0
1/03/2021,Indonesia,Selangor,1234,703,531
1/03/2021,Indonesia,Terengganu,0,0,0
1/03/2021,Indonesia,W.P. Labuan,2,0,2
1/03/2021,India,Johor,117,116,1
1/03/2021,India,Kedah,0,0,0
1/03/2021,India,Kelantan,0,0,0
1/03/2021,India,Melaka,0,0,0
1/03/2021,India,Negeri Sembilan,0,0,0
1/03/2021,India,Pahang,0,0,0
1/03/2021,India,Perak,0,0,0
1/03/2021,India,Perlis,0,0,0
1/03/2021,India,Pulau Pinang,1,1,0
1/03/2021,India,Sabah,0,0,0
1/03/2021,India,Sarawak,0,0,0
1/03/2021,India,Selangor,1441,1036,405
1/03/2021,India,Terengganu,0,0,0
1/03/2021,India,W.P. Labuan,0,0,0
1/03/2021, British Indian Ocean Territory,Pulau Pinang,0,0,0
1/03/2021, British Indian Ocean Territory,Selangor,0,0,0
1/03/2021,Ireland,Johor,0,0,0
1/03/2021,Ireland,Kedah,0,0,0
1/03/2021,Ireland,Kelantan,0,0,0
1/03/2021,Ireland,Negeri Sembilan,0,0,0
1/03/2021,Ireland,Pahang,0,0,0
1/03/2021,Ireland,Perak,0,0,0
1/03/2021,Ireland,Perlis,0,0,0
1/03/2021,Ireland,Pulau Pinang,0,0,0
1/03/2021,Ireland,Sabah,0,0,0
1/03/2021,Ireland,Sarawak,0,0,0
1/03/2021,Ireland,Selangor,17,10,7
1/03/2021,Ireland,Terengganu,0,0,0
1/03/2021,Ireland,W.P. Labuan,0,0,0
1/03/2021,"Iran, Islamic Republic of",Johor,0,0,0
1/03/2021,"Iran, Islamic Republic of",Kedah,0,0,0
1/03/2021,"Iran, Islamic Republic of",Kelantan,0,0,0
1/03/2021,"Iran, Islamic Republic of",Perak,0,0,0
1/03/2021,"Iran, Islamic Republic of",Perlis,0,0,0
1/03/2021,"Iran, Islamic Republic of",Pulau Pinang,0,0,0
1/03/2021,"Iran, Islamic Republic of",Sabah,0,0,0
1/03/2021,"Iran, Islamic Republic of",Sarawak,0,0,0
1/03/2021,"Iran, Islamic Republic of",Selangor,51,33,18
1/03/2021,"Iran, Islamic Republic of",W.P. Labuan,0,0,0
1/03/2021,Iraq,Johor,0,0,0
1/03/2021,Iraq,Kedah,0,0,0
1/03/2021,Iraq,Kelantan,0,0,0
1/03/2021,Iraq,Melaka,0,0,0
1/03/2021,Iraq,Pahang,0,0,0
1/03/2021,Iraq,Perak,0,0,0
1/03/2021,Iraq,Perlis,0,0,0
1/03/2021,Iraq,Pulau Pinang,0,0,0
1/03/2021,Iraq,Sabah,0,0,0
1/03/2021,Iraq,Sarawak,0,0,0
1/03/2021,Iraq,Selangor,52,41,11
1/03/2021,Iceland,Johor,0,0,0
1/03/2021,Iceland,Kedah,0,0,0
1/03/2021,Iceland,Kelantan,0,0,0
1/03/2021,Iceland,Perak,0,0,0
1/03/2021,Iceland,Perlis,0,0,0
1/03/2021,Iceland,Pulau Pinang,0,0,0
1/03/2021,Iceland,Sabah,0,0,0
1/03/2021,Iceland,Sarawak,0,0,0
1/03/2021,Iceland,Selangor,0,0,0
1/03/2021,Iceland,W.P. Labuan,0,0,0
1/03/2021,Israel,Pulau Pinang,0,0,0
1/03/2021,Italy,Johor,0,0,0
1/03/2021,Italy,Kedah,0,0,0
1/03/2021,Italy,Kelantan,0,0,0
1/03/2021,Italy,Melaka,0,0,0
1/03/2021,Italy,Negeri Sembilan,0,0,0
1/03/2021,Italy,Pahang,0,0,0
1/03/2021,Italy,Perak,0,0,0
1/03/2021,Italy,Perlis,0,0,0
1/03/2021,Italy,Pulau Pinang,0,0,0
1/03/2021,Italy,Sabah,0,0,0
1/03/2021,Italy,Sarawak,1,1,0
1/03/2021,Italy,Selangor,26,19,7
1/03/2021,Italy,W.P. Labuan,0,0,0
1/03/2021,Jamaica,Johor,0,0,0
1/03/2021,Jamaica,Kedah,0,0,0
1/03/2021,Jamaica,Perak,0,0,0
1/03/2021,Jamaica,Pulau Pinang,0,0,0
1/03/2021,Jamaica,Sabah,0,0,0
1/03/2021,Jamaica,Sarawak,0,0,0
1/03/2021,Jamaica,Selangor,0,0,0
1/03/2021,Jamaica,W.P. Labuan,0,0,0
1/03/2021,Jordan,Johor,0,0,0
1/03/2021,Jordan,Kedah,0,0,0
1/03/2021,Jordan,Kelantan,0,0,0
1/03/2021,Jordan,Melaka,0,0,0
1/03/2021,Jordan,Perlis,0,0,0
1/03/2021,Jordan,Pulau Pinang,0,0,0
1/03/2021,Jordan,Sabah,0,0,0
1/03/2021,Jordan,Sarawak,0,0,0
1/03/2021,Jordan,Selangor,43,33,10
1/03/2021,Jordan,W.P. Labuan,0,0,0
1/03/2021,Japan,Johor,2,2,0
1/03/2021,Japan,Kedah,0,0,0
1/03/2021,Japan,Kelantan,0,0,0
1/03/2021,Japan,Melaka,0,0,0
1/03/2021,Japan,Negeri Sembilan,0,0,0
1/03/2021,Japan,Pahang,0,0,0
1/03/2021,Japan,Perak,0,0,0
1/03/2021,Japan,Perlis,0,0,0
1/03/2021,Japan,Pulau Pinang,37,26,11
1/03/2021,Japan,Sabah,0,0,0
1/03/2021,Japan,Sarawak,1,1,0
1/03/2021,Japan,Selangor,386,262,124
1/03/2021,Japan,W.P. Labuan,0,0,0
1/03/2021,Kazakhstan,Johor,0,0,0
1/03/2021,Kazakhstan,Kedah,0,0,0
1/03/2021,Kazakhstan,Kelantan,0,0,0
1/03/2021,Kazakhstan,Melaka,0,0,0
1/03/2021,Kazakhstan,Perak,0,0,0
1/03/2021,Kazakhstan,Perlis,0,0,0
1/03/2021,Kazakhstan,Pulau Pinang,0,0,0
1/03/2021,Kazakhstan,Sabah,0,0,0
1/03/2021,Kazakhstan,Sarawak,0,0,0
1/03/2021,Kazakhstan,Selangor,20,8,12
1/03/2021,Kazakhstan,W.P. Labuan,0,0,0
1/03/2021,Kenya,Johor,0,0,0
1/03/2021,Kenya,Kedah,0,0,0
1/03/2021,Kenya,Kelantan,0,0,0
1/03/2021,Kenya,Perak,0,0,0
1/03/2021,Kenya,Perlis,0,0,0
1/03/2021,Kenya,Pulau Pinang,0,0,0
1/03/2021,Kenya,Sabah,0,0,0
1/03/2021,Kenya,Sarawak,0,0,0
1/03/2021,Kenya,Selangor,33,14,19
1/03/2021,Kyrgyzstan,Johor,0,0,0
1/03/2021,Kyrgyzstan,Kedah,0,0,0
1/03/2021,Kyrgyzstan,Kelantan,0,0,0
1/03/2021,Kyrgyzstan,Perak,0,0,0
1/03/2021,Kyrgyzstan,Perlis,0,0,0
1/03/2021,Kyrgyzstan,Pulau Pinang,0,0,0
1/03/2021,Kyrgyzstan,Sabah,0,0,0
1/03/2021,Kyrgyzstan,Sarawak,0,0,0
1/03/2021,Kyrgyzstan,Selangor,6,5,1
1/03/2021,Cambodia,Johor,0,0,0
1/03/2021,Cambodia,Kedah,0,0,0
1/03/2021,Cambodia,Kelantan,0,0,0
1/03/2021,Cambodia,Melaka,0,0,0
1/03/2021,Cambodia,Negeri Sembilan,0,0,0
1/03/2021,Cambodia,Pahang,0,0,0
1/03/2021,Cambodia,Perak,0,0,0
1/03/2021,Cambodia,Perlis,0,0,0
1/03/2021,Cambodia,Pulau Pinang,0,0,0
1/03/2021,Cambodia,Sabah,0,0,0
1/03/2021,Cambodia,Sarawak,0,0,0
1/03/2021,Cambodia,Selangor,12,3,9
1/03/2021,Cambodia,W.P. Labuan,0,0,0
1/03/2021,Kiribati,Johor,0,0,0
1/03/2021,Kiribati,Sabah,0,0,0
1/03/2021,Kiribati,Selangor,4,4,0
1/03/2021,Saint Kitts and Nevis,Johor,0,0,0
1/03/2021,Saint Kitts and Nevis,Kedah,0,0,0
1/03/2021,Saint Kitts and Nevis,Perlis,0,0,0
1/03/2021,Saint Kitts and Nevis,Pulau Pinang,0,0,0
1/03/2021,Saint Kitts and Nevis,Sabah,0,0,0
1/03/2021,Saint Kitts and Nevis,Selangor,0,0,0
1/03/2021,Saint Kitts and Nevis,W.P. Labuan,0,0,0
1/03/2021,"Korea, Republic of",Johor,1,1,0
1/03/2021,"Korea, Republic of",Kedah,0,0,0
1/03/2021,"Korea, Republic of",Kelantan,0,0,0
1/03/2021,"Korea, Republic of",Melaka,0,0,0
1/03/2021,"Korea, Republic of",Negeri Sembilan,0,0,0
1/03/2021,"Korea, Republic of",Pahang,0,0,0
1/03/2021,"Korea, Republic of",Perak,0,0,0
1/03/2021,"Korea, Republic of",Perlis,0,0,0
1/03/2021,"Korea, Republic of",Pulau Pinang,1,1,0
1/03/2021,"Korea, Republic of",Sabah,1,1,0
1/03/2021,"Korea, Republic of",Sarawak,2,2,0
1/03/2021,"Korea, Republic of",Selangor,339,230,109
1/03/2021,"Korea, Republic of",Terengganu,0,0,0
1/03/2021,"Korea, Republic of",W.P. Labuan,0,0,0
1/03/2021,Kuwait,Johor,0,0,0
1/03/2021,Kuwait,Kedah,0,0,0
1/03/2021,Kuwait,Kelantan,0,0,0
1/03/2021,Kuwait,Perak,0,0,0
1/03/2021,Kuwait,Perlis,0,0,0
1/03/2021,Kuwait,Pulau Pinang,0,0,0
1/03/2021,Kuwait,Sabah,0,0,0
1/03/2021,Kuwait,Sarawak,0,0,0
1/03/2021,Kuwait,Selangor,4,3,1
1/03/2021,Kuwait,W.P. Labuan,0,0,0
1/03/2021, Lao People's Democratic Republic,Johor,0,0,0
1/03/2021, Lao People's Democratic Republic,Kedah,0,0,0
1/03/2021, Lao People's Democratic Republic,Kelantan,0,0,0
1/03/2021, Lao People's Democratic Republic,Melaka,0,0,0
1/03/2021, Lao People's Democratic Republic,Perak,0,0,0
1/03/2021, Lao People's Democratic Republic,Perlis,0,0,0
1/03/2021, Lao People's Democratic Republic,Pulau Pinang,0,0,0
1/03/2021, Lao People's Democratic Republic,Sabah,0,0,0
1/03/2021, Lao People's Democratic Republic,Sarawak,0,0,0
1/03/2021, Lao People's Democratic Republic,Selangor,2,1,1
1/03/2021, Lao People's Democratic Republic,W.P. Labuan,0,0,0
1/03/2021,Lebanon,Johor,0,0,0
1/03/2021,Lebanon,Kedah,0,0,0
1/03/2021,Lebanon,Kelantan,0,0,0
1/03/2021,Lebanon,Pahang,0,0,0
1/03/2021,Lebanon,Perak,0,0,0
1/03/2021,Lebanon,Perlis,0,0,0
1/03/2021,Lebanon,Pulau Pinang,0,0,0
1/03/2021,Lebanon,Sabah,0,0,0
1/03/2021,Lebanon,Sarawak,0,0,0
1/03/2021,Lebanon,Selangor,4,3,1
1/03/2021,Lebanon,W.P. Labuan,0,0,0
1/03/2021,Liberia,Johor,0,0,0
1/03/2021,Liberia,Kedah,0,0,0
1/03/2021,Liberia,Sabah,0,0,0
1/03/2021,Liberia,Sarawak,0,0,0
1/03/2021,Liberia,Selangor,4,3,1
1/03/2021,Libya,Johor,0,0,0
1/03/2021,Libya,Kedah,0,0,0
1/03/2021,Libya,Perlis,0,0,0
1/03/2021,Libya,Pulau Pinang,0,0,0
1/03/2021,Libya,Sabah,0,0,0
1/03/2021,Libya,Sarawak,0,0,0
1/03/2021,Libya,Selangor,66,59,7
1/03/2021,Saint Lucia,Johor,0,0,0
1/03/2021,Saint Lucia,Kedah,0,0,0
1/03/2021,Saint Lucia,Pulau Pinang,0,0,0
1/03/2021,Saint Lucia,Sarawak,0,0,0
1/03/2021,Saint Lucia,Selangor,0,0,0
1/03/2021,Liechtenstein,Johor,0,0,0
1/03/2021,Liechtenstein,Kedah,0,0,0
1/03/2021,Liechtenstein,Perlis,0,0,0
1/03/2021,Liechtenstein,Pulau Pinang,0,0,0
1/03/2021,Liechtenstein,Sabah,0,0,0
1/03/2021,Liechtenstein,Sarawak,0,0,0
1/03/2021,Liechtenstein,Selangor,0,0,0
1/03/2021,LKA,Johor,1,1,0
1/03/2021,LKA,Kedah,0,0,0
1/03/2021,LKA,Kelantan,0,0,0
1/03/2021,LKA,Melaka,0,0,0
1/03/2021,LKA,Pahang,0,0,0
1/03/2021,LKA,Perak,0,0,0
1/03/2021,LKA,Perlis,0,0,0
1/03/2021,LKA,Pulau Pinang,0,0,0
1/03/2021,LKA,Sabah,1,1,0
1/03/2021,LKA,Sarawak,0,0,0
1/03/2021,LKA,Selangor,119,62,57
1/03/2021,LKA,W.P. Labuan,0,0,0
1/03/2021,Lesotho,Johor,0,0,0
1/03/2021,Lesotho,Kedah,0,0,0
1/03/2021,Lesotho,Pulau Pinang,0,0,0
1/03/2021,Lesotho,Sarawak,0,0,0
1/03/2021,Lesotho,Selangor,0,0,0
1/03/2021,Lithuania,Johor,0,0,0
1/03/2021,Lithuania,Kedah,0,0,0
1/03/2021,Lithuania,Kelantan,0,0,0
1/03/2021,Lithuania,Pahang,0,0,0
1/03/2021,Lithuania,Perak,0,0,0
1/03/2021,Lithuania,Perlis,0,0,0
1/03/2021,Lithuania,Pulau Pinang,0,0,0
1/03/2021,Lithuania,Sabah,0,0,0
1/03/2021,Lithuania,Sarawak,0,0,0
1/03/2021,Lithuania,Selangor,1,1,0
1/03/2021,Lithuania,W.P. Labuan,0,0,0
1/03/2021,Luxembourg,Johor,0,0,0
1/03/2021,Luxembourg,Kedah,0,0,0
1/03/2021,Luxembourg,Kelantan,0,0,0
1/03/2021,Luxembourg,Perak,0,0,0
1/03/2021,Luxembourg,Perlis,0,0,0
1/03/2021,Luxembourg,Pulau Pinang,0,0,0
1/03/2021,Luxembourg,Sabah,0,0,0
1/03/2021,Luxembourg,Sarawak,0,0,0
1/03/2021,Luxembourg,Selangor,0,0,0
1/03/2021,Latvia,Johor,0,0,0
1/03/2021,Latvia,Kedah,0,0,0
1/03/2021,Latvia,Kelantan,0,0,0
1/03/2021,Latvia,Pahang,0,0,0
1/03/2021,Latvia,Perak,0,0,0
1/03/2021,Latvia,Perlis,0,0,0
1/03/2021,Latvia,Pulau Pinang,0,0,0
1/03/2021,Latvia,Sabah,0,0,0
1/03/2021,Latvia,Sarawak,0,0,0
1/03/2021,Latvia,Selangor,12,11,1
1/03/2021,Latvia,W.P. Labuan,0,0,0
1/03/2021,Macao,Johor,0,0,0
1/03/2021,Macao,Pahang,0,0,0
1/03/2021,Macao,Perak,0,0,0
1/03/2021,Macao,Selangor,0,0,0
1/03/2021,Macao,W.P. Labuan,0,0,0
1/03/2021,Morocco,Johor,0,0,0
1/03/2021,Morocco,Kedah,0,0,0
1/03/2021,Morocco,Kelantan,0,0,0
1/03/2021,Morocco,Melaka,0,0,0
1/03/2021,Morocco,Pahang,0,0,0
1/03/2021,Morocco,Perak,0,0,0
1/03/2021,Morocco,Perlis,0,0,0
1/03/2021,Morocco,Pulau Pinang,0,0,0
1/03/2021,Morocco,Sabah,0,0,0
1/03/2021,Morocco,Sarawak,0,0,0
1/03/2021,Morocco,Selangor,11,5,6
1/03/2021,Morocco,W.P. Labuan,0,0,0
1/03/2021,Monaco,Johor,0,0,0
1/03/2021,Monaco,Kedah,0,0,0
1/03/2021,Monaco,Sabah,0,0,0
1/03/2021,Monaco,Selangor,0,0,0
1/03/2021,"Moldova, Republic of",Johor,0,0,0
1/03/2021,"Moldova, Republic of",Kedah,0,0,0
1/03/2021,"Moldova, Republic of",Kelantan,0,0,0
1/03/2021,"Moldova, Republic of",Negeri Sembilan,0,0,0
1/03/2021,"Moldova, Republic of",Perlis,0,0,0
1/03/2021,"Moldova, Republic of",Pulau Pinang,0,0,0
1/03/2021,"Moldova, Republic of",Sabah,0,0,0
1/03/2021,"Moldova, Republic of",Sarawak,0,0,0
1/03/2021,"Moldova, Republic of",Selangor,0,0,0
1/03/2021,Madagascar,Johor,0,0,0
1/03/2021,Madagascar,Kedah,0,0,0
1/03/2021,Madagascar,Perak,0,0,0
1/03/2021,Madagascar,Perlis,0,0,0
1/03/2021,Madagascar,Pulau Pinang,0,0,0
1/03/2021,Madagascar,Sabah,0,0,0
1/03/2021,Madagascar,Sarawak,0,0,0
1/03/2021,Madagascar,Selangor,0,0,0
1/03/2021,Maldives,Johor,0,0,0
1/03/2021,Maldives,Kedah,0,0,0
1/03/2021,Maldives,Kelantan,0,0,0
1/03/2021,Maldives,Perak,0,0,0
1/03/2021,Maldives,Perlis,0,0,0
1/03/2021,Maldives,Pulau Pinang,0,0,0
1/03/2021,Maldives,Sabah,0,0,0
1/03/2021,Maldives,Sarawak,0,0,0
1/03/2021,Maldives,Selangor,76,36,40
1/03/2021,Mexico,Johor,0,0,0
1/03/2021,Mexico,Kedah,0,0,0
1/03/2021,Mexico,Kelantan,0,0,0
1/03/2021,Mexico,Pahang,0,0,0
1/03/2021,Mexico,Perak,0,0,0
1/03/2021,Mexico,Perlis,0,0,0
1/03/2021,Mexico,Pulau Pinang,0,0,0
1/03/2021,Mexico,Sabah,0,0,0
1/03/2021,Mexico,Sarawak,0,0,0
1/03/2021,Mexico,Selangor,3,3,0
1/03/2021,Mexico,W.P. Labuan,0,0,0
1/03/2021,Marshall Islands,Johor,0,0,0
1/03/2021,Marshall Islands,Kedah,0,0,0
1/03/2021,Marshall Islands,Perak,0,0,0
1/03/2021,Marshall Islands,Pulau Pinang,0,0,0
1/03/2021,Marshall Islands,Sabah,0,0,0
1/03/2021,Marshall Islands,Selangor,0,0,0
1/03/2021,North Macedonia,Johor,0,0,0
1/03/2021,North Macedonia,Kedah,0,0,0
1/03/2021,North Macedonia,Perak,0,0,0
1/03/2021,North Macedonia,Pulau Pinang,0,0,0
1/03/2021,North Macedonia,Sabah,0,0,0
1/03/2021,North Macedonia,Sarawak,0,0,0
1/03/2021,North Macedonia,Selangor,1,1,0
1/03/2021,Mali,Johor,0,0,0
1/03/2021,Mali,Sabah,1,1,0
1/03/2021,Mali,Selangor,2,2,0
1/03/2021,Malta,Johor,0,0,0
1/03/2021,Malta,Kedah,0,0,0
1/03/2021,Malta,Kelantan,0,0,0
1/03/2021,Malta,Perak,0,0,0
1/03/2021,Malta,Perlis,0,0,0
1/03/2021,Malta,Pulau Pinang,0,0,0
1/03/2021,Malta,Sabah,0,0,0
1/03/2021,Malta,Sarawak,0,0,0
1/03/2021,Malta,Selangor,2,1,1
1/03/2021,Malta,W.P. Labuan,0,0,0
1/03/2021,Myanmar,Johor,9,9,0
1/03/2021,Myanmar,Kedah,0,0,0
1/03/2021,Myanmar,Kelantan,0,0,0
1/03/2021,Myanmar,Negeri Sembilan,0,0,0
1/03/2021,Myanmar,Pahang,0,0,0
1/03/2021,Myanmar,Perak,0,0,0
1/03/2021,Myanmar,Perlis,0,0,0
1/03/2021,Myanmar,Pulau Pinang,0,0,0
1/03/2021,Myanmar,Sabah,0,0,0
1/03/2021,Myanmar,Sarawak,0,0,0
1/03/2021,Myanmar,Selangor,123,101,22
1/03/2021,Myanmar,Terengganu,0,0,0
1/03/2021,Myanmar,W.P. Labuan,0,0,0
1/03/2021,Montenegro,Johor,4,4,0
1/03/2021,Montenegro,Kedah,0,0,0
1/03/2021,Montenegro,Pulau Pinang,0,0,0
1/03/2021,Montenegro,Sabah,0,0,0
1/03/2021,Montenegro,Sarawak,0,0,0
1/03/2021,Montenegro,Selangor,15,15,0
1/03/2021,Mongolia,Johor,0,0,0
1/03/2021,Mongolia,Kedah,0,0,0
1/03/2021,Mongolia,Kelantan,0,0,0
1/03/2021,Mongolia,Perak,0,0,0
1/03/2021,Mongolia,Perlis,0,0,0
1/03/2021,Mongolia,Pulau Pinang,0,0,0
1/03/2021,Mongolia,Sabah,0,0,0
1/03/2021,Mongolia,Sarawak,0,0,0
1/03/2021,Mongolia,Selangor,0,0,0
1/03/2021,Northern Mariana Islands,Selangor,0,0,0
1/03/2021,Mozambique,Johor,0,0,0
1/03/2021,Mozambique,Kedah,0,0,0
1/03/2021,Mozambique,Perak,0,0,0
1/03/2021,Mozambique,Pulau Pinang,0,0,0
1/03/2021,Mozambique,Sabah,0,0,0
1/03/2021,Mozambique,Sarawak,0,0,0
1/03/2021,Mozambique,Selangor,10,7,3
1/03/2021,Mauritania,Johor,0,0,0
1/03/2021,Mauritania,Kedah,0,0,0
1/03/2021,Mauritania,Pulau Pinang,0,0,0
1/03/2021,Mauritania,Sabah,0,0,0
1/03/2021,Mauritania,Sarawak,0,0,0
1/03/2021,Mauritania,Selangor,2,2,0
1/03/2021,Mauritius,Johor,0,0,0
1/03/2021,Mauritius,Kedah,0,0,0
1/03/2021,Mauritius,Kelantan,0,0,0
1/03/2021,Mauritius,Pahang,0,0,0
1/03/2021,Mauritius,Perak,0,0,0
1/03/2021,Mauritius,Perlis,0,0,0
1/03/2021,Mauritius,Pulau Pinang,0,0,0
1/03/2021,Mauritius,Sabah,0,0,0
1/03/2021,Mauritius,Sarawak,0,0,0
1/03/2021,Mauritius,Selangor,27,7,20
1/03/2021,Malawi,Johor,0,0,0
1/03/2021,Malawi,Pulau Pinang,0,0,0
1/03/2021,Malawi,Sabah,0,0,0
1/03/2021,Malawi,Sarawak,0,0,0
1/03/2021,Malawi,Selangor,8,4,4
1/03/2021,Mayotte,Selangor,0,0,0
1/03/2021,Namibia,Johor,0,0,0
1/03/2021,Namibia,Kedah,0,0,0
1/03/2021,Namibia,Perak,0,0,0
1/03/2021,Namibia,Perlis,0,0,0
1/03/2021,Namibia,Pulau Pinang,0,0,0
1/03/2021,Namibia,Sabah,0,0,0
1/03/2021,Namibia,Sarawak,0,0,0
1/03/2021,Namibia,Selangor,2,0,2
1/03/2021,New Caledonia,Selangor,0,0,0
1/03/2021,Niger,Johor,0,0,0
1/03/2021,Niger,Sabah,0,0,0
1/03/2021,Niger,Selangor,0,0,0
1/03/2021,Nigeria,Johor,0,0,0
1/03/2021,Nigeria,Kedah,0,0,0
1/03/2021,Nigeria,Perlis,0,0,0
1/03/2021,Nigeria,Pulau Pinang,0,0,0
1/03/2021,Nigeria,Sabah,0,0,0
1/03/2021,Nigeria,Sarawak,0,0,0
1/03/2021,Nigeria,Selangor,139,129,10
1/03/2021,Nicaragua,Johor,0,0,0
1/03/2021,Nicaragua,Kedah,0,0,0
1/03/2021,Nicaragua,Pulau Pinang,0,0,0
1/03/2021,Nicaragua,Sabah,0,0,0
1/03/2021,Nicaragua,Selangor,0,0,0
1/03/2021,Netherlands,Johor,0,0,0
1/03/2021,Netherlands,Kedah,0,0,0
1/03/2021,Netherlands,Kelantan,0,0,0
1/03/2021,Netherlands,Melaka,0,0,0
1/03/2021,Netherlands,Negeri Sembilan,0,0,0
1/03/2021,Netherlands,Pahang,0,0,0
1/03/2021,Netherlands,Perak,0,0,0
1/03/2021,Netherlands,Perlis,0,0,0
1/03/2021,Netherlands,Pulau Pinang,0,0,0
1/03/2021,Netherlands,Sabah,0,0,0
1/03/2021,Netherlands,Sarawak,0,0,0
1/03/2021,Netherlands,Selangor,46,35,11
1/03/2021,Netherlands,Terengganu,0,0,0
1/03/2021,Netherlands,W.P. Labuan,0,0,0
1/03/2021,Norway,Johor,1,1,0
1/03/2021,Norway,Kedah,0,0,0
1/03/2021,Norway,Kelantan,0,0,0
1/03/2021,Norway,Melaka,0,0,0
1/03/2021,Norway,Pahang,0,0,0
1/03/2021,Norway,Perak,0,0,0
1/03/2021,Norway,Perlis,0,0,0
1/03/2021,Norway,Pulau Pinang,0,0,0
1/03/2021,Norway,Sabah,0,0,0
1/03/2021,Norway,Sarawak,0,0,0
1/03/2021,Norway,Selangor,13,12,1
1/03/2021,Norway,W.P. Labuan,0,0,0
1/03/2021,Nepal,Johor,0,0,0
1/03/2021,Nepal,Kedah,0,0,0
1/03/2021,Nepal,Pahang,0,0,0
1/03/2021,Nepal,Perak,0,0,0
1/03/2021,Nepal,Perlis,0,0,0
1/03/2021,Nepal,Pulau Pinang,0,0,0
1/03/2021,Nepal,Sabah,0,0,0
1/03/2021,Nepal,Sarawak,0,0,0
1/03/2021,Nepal,Selangor,49,46,3
1/03/2021,Nepal,W.P. Labuan,0,0,0
1/03/2021,Nauru,Johor,0,0,0
1/03/2021,Nauru,Pulau Pinang,0,0,0
1/03/2021,Nauru,Selangor,0,0,0
1/03/2021,New Zealand,Johor,0,0,0
1/03/2021,New Zealand,Kedah,0,0,0
1/03/2021,New Zealand,Kelantan,0,0,0
1/03/2021,New Zealand,Melaka,0,0,0
1/03/2021,New Zealand,Negeri Sembilan,0,0,0
1/03/2021,New Zealand,Pahang,0,0,0
1/03/2021,New Zealand,Perak,0,0,0
1/03/2021,New Zealand,Perlis,0,0,0
1/03/2021,New Zealand,Pulau Pinang,0,0,0
1/03/2021,New Zealand,Sabah,0,0,0
1/03/2021,New Zealand,Sarawak,0,0,0
1/03/2021,New Zealand,Selangor,11,11,0
1/03/2021,New Zealand,Terengganu,0,0,0
1/03/2021,New Zealand,W.P. Labuan,0,0,0
1/03/2021,Oman,Johor,0,0,0
1/03/2021,Oman,Kedah,0,0,0
1/03/2021,Oman,Kelantan,0,0,0
1/03/2021,Oman,Melaka,0,0,0
1/03/2021,Oman,Perak,0,0,0
1/03/2021,Oman,Perlis,0,0,0
1/03/2021,Oman,Pulau Pinang,0,0,0
1/03/2021,Oman,Sabah,0,0,0
1/03/2021,Oman,Sarawak,0,0,0
1/03/2021,Oman,Selangor,34,26,8
1/03/2021,Pakistan,Johor,9,9,0
1/03/2021,Pakistan,Kedah,0,0,0
1/03/2021,Pakistan,Kelantan,0,0,0
1/03/2021,Pakistan,Melaka,0,0,0
1/03/2021,Pakistan,Negeri Sembilan,0,0,0
1/03/2021,Pakistan,Pahang,0,0,0
1/03/2021,Pakistan,Perak,0,0,0
1/03/2021,Pakistan,Perlis,0,0,0
1/03/2021,Pakistan,Pulau Pinang,0,0,0
1/03/2021,Pakistan,Sabah,0,0,0
1/03/2021,Pakistan,Sarawak,1,1,0
1/03/2021,Pakistan,Selangor,337,275,62
1/03/2021,Pakistan,W.P. Labuan,0,0,0
1/03/2021,Panama,Johor,0,0,0
1/03/2021,Panama,Kedah,0,0,0
1/03/2021,Panama,Perak,0,0,0
1/03/2021,Panama,Perlis,0,0,0
1/03/2021,Panama,Pulau Pinang,0,0,0
1/03/2021,Panama,Sabah,0,0,0
1/03/2021,Panama,Sarawak,0,0,0
1/03/2021,Panama,Selangor,0,0,0
1/03/2021,Peru,Johor,0,0,0
1/03/2021,Peru,Kedah,0,0,0
1/03/2021,Peru,Kelantan,0,0,0
1/03/2021,Peru,Pahang,0,0,0
1/03/2021,Peru,Perak,0,0,0
1/03/2021,Peru,Perlis,0,0,0
1/03/2021,Peru,Pulau Pinang,0,0,0
1/03/2021,Peru,Sabah,0,0,0
1/03/2021,Peru,Sarawak,0,0,0
1/03/2021,Peru,Selangor,0,0,0
1/03/2021,Peru,W.P. Labuan,0,0,0
1/03/2021,Philippines,Johor,97,94,3
1/03/2021,Philippines,Kedah,0,0,0
1/03/2021,Philippines,Kelantan,0,0,0
1/03/2021,Philippines,Melaka,0,0,0
1/03/2021,Philippines,Negeri Sembilan,0,0,0
1/03/2021,Philippines,Pahang,0,0,0
1/03/2021,Philippines,Perak,0,0,0
1/03/2021,Philippines,Perlis,0,0,0
1/03/2021,Philippines,Pulau Pinang,1,0,1
1/03/2021,Philippines,Sabah,0,0,0
1/03/2021,Philippines,Sarawak,66,66,0
1/03/2021,Philippines,Selangor,467,368,99
1/03/2021,Philippines,Terengganu,0,0,0
1/03/2021,Philippines,W.P. Labuan,3,3,0
1/03/2021,Palau,Johor,0,0,0
1/03/2021,Palau,Pulau Pinang,0,0,0
1/03/2021,Palau,Selangor,0,0,0
1/03/2021,Papua New Guinea,Johor,0,0,0
1/03/2021,Papua New Guinea,Kedah,0,0,0
1/03/2021,Papua New Guinea,Kelantan,0,0,0
1/03/2021,Papua New Guinea,Perak,0,0,0
1/03/2021,Papua New Guinea,Pulau Pinang,0,0,0
1/03/2021,Papua New Guinea,Sabah,0,0,0
1/03/2021,Papua New Guinea,Sarawak,0,0,0
1/03/2021,Papua New Guinea,Selangor,0,0,0
1/03/2021,Poland,Johor,1,1,0
1/03/2021,Poland,Kedah,0,0,0
1/03/2021,Poland,Kelantan,0,0,0
1/03/2021,Poland,Melaka,0,0,0
1/03/2021,Poland,Negeri Sembilan,0,0,0
1/03/2021,Poland,Pahang,0,0,0
1/03/2021,Poland,Perak,0,0,0
1/03/2021,Poland,Perlis,0,0,0
1/03/2021,Poland,Pulau Pinang,0,0,0
1/03/2021,Poland,Sabah,1,1,0
1/03/2021,Poland,Sarawak,0,0,0
1/03/2021,Poland,Selangor,27,23,4
1/03/2021,Poland,Terengganu,0,0,0
1/03/2021,Poland,W.P. Labuan,0,0,0
1/03/2021,"North Korea, Democratic People's Republic of",Selangor,1,1,0
1/03/2021,Portugal,Johor,0,0,0
1/03/2021,Portugal,Kedah,0,0,0
1/03/2021,Portugal,Kelantan,0,0,0
1/03/2021,Portugal,Melaka,0,0,0
1/03/2021,Portugal,Pahang,0,0,0
1/03/2021,Portugal,Perak,0,0,0
1/03/2021,Portugal,Perlis,0,0,0
1/03/2021,Portugal,Pulau Pinang,0,0,0
1/03/2021,Portugal,Sabah,0,0,0
1/03/2021,Portugal,Sarawak,0,0,0
1/03/2021,Portugal,Selangor,6,2,4
1/03/2021,Portugal,W.P. Labuan,0,0,0
1/03/2021,Paraguay,Johor,0,0,0
1/03/2021,Paraguay,Kedah,0,0,0
1/03/2021,Paraguay,Perak,0,0,0
1/03/2021,Paraguay,Perlis,0,0,0
1/03/2021,Paraguay,Pulau Pinang,0,0,0
1/03/2021,Paraguay,Sabah,0,0,0
1/03/2021,Paraguay,Sarawak,0,0,0
1/03/2021,Paraguay,Selangor,0,0,0
1/03/2021,"Palestine, State of",Johor,0,0,0
1/03/2021,"Palestine, State of",Kedah,0,0,0
1/03/2021,"Palestine, State of",Kelantan,0,0,0
1/03/2021,"Palestine, State of",Melaka,0,0,0
1/03/2021,"Palestine, State of",Perak,0,0,0
1/03/2021,"Palestine, State of",Perlis,0,0,0
1/03/2021,"Palestine, State of",Pulau Pinang,0,0,0
1/03/2021,"Palestine, State of",Sabah,0,0,0
1/03/2021,"Palestine, State of",Sarawak,0,0,0
1/03/2021,"Palestine, State of",Selangor,20,17,3
1/03/2021,Qatar,Johor,0,0,0
1/03/2021,Qatar,Kedah,0,0,0
1/03/2021,Qatar,Perlis,0,0,0
1/03/2021,Qatar,Pulau Pinang,0,0,0
1/03/2021,Qatar,Sabah,0,0,0
1/03/2021,Qatar,Sarawak,0,0,0
1/03/2021,Qatar,Selangor,8,6,2
1/03/2021,Réunion,Johor,0,0,0
1/03/2021,Réunion,Sarawak,0,0,0
1/03/2021,Romania,Johor,0,0,0
1/03/2021,Romania,Kedah,0,0,0
1/03/2021,Romania,Kelantan,0,0,0
1/03/2021,Romania,Negeri Sembilan,0,0,0
1/03/2021,Romania,Pahang,0,0,0
1/03/2021,Romania,Perak,0,0,0
1/03/2021,Romania,Perlis,0,0,0
1/03/2021,Romania,Pulau Pinang,0,0,0
1/03/2021,Romania,Sabah,0,0,0
1/03/2021,Romania,Sarawak,0,0,0
1/03/2021,Romania,Selangor,28,24,4
1/03/2021,Romania,W.P. Labuan,0,0,0
1/03/2021,Russian Federation (Russia),Johor,0,0,0
1/03/2021,Russian Federation (Russia),Kedah,0,0,0
1/03/2021,Russian Federation (Russia),Kelantan,0,0,0
1/03/2021,Russian Federation (Russia),Melaka,0,0,0
1/03/2021,Russian Federation (Russia),Negeri Sembilan,0,0,0
1/03/2021,Russian Federation (Russia),Pahang,0,0,0
1/03/2021,Russian Federation (Russia),Perak,0,0,0
1/03/2021,Russian Federation (Russia),Perlis,0,0,0
1/03/2021,Russian Federation (Russia),Pulau Pinang,0,0,0
1/03/2021,Russian Federation (Russia),Sabah,0,0,0
1/03/2021,Russian Federation (Russia),Sarawak,0,0,0
1/03/2021,Russian Federation (Russia),Selangor,58,45,13
1/03/2021,Russian Federation (Russia),W.P. Labuan,0,0,0
1/03/2021,Rwanda,Johor,0,0,0
1/03/2021,Rwanda,Kedah,0,0,0
1/03/2021,Rwanda,Pulau Pinang,0,0,0
1/03/2021,Rwanda,Selangor,0,0,0
1/03/2021,Saudi Arabia,Johor,0,0,0
1/03/2021,Saudi Arabia,Kedah,0,0,0
1/03/2021,Saudi Arabia,Kelantan,0,0,0
1/03/2021,Saudi Arabia,Melaka,0,0,0
1/03/2021,Saudi Arabia,Perak,0,0,0
1/03/2021,Saudi Arabia,Perlis,0,0,0
1/03/2021,Saudi Arabia,Pulau Pinang,0,0,0
1/03/2021,Saudi Arabia,Sabah,0,0,0
1/03/2021,Saudi Arabia,Sarawak,0,0,0
1/03/2021,Saudi Arabia,Selangor,81,46,35
1/03/2021,Saudi Arabia,W.P. Labuan,0,0,0
1/03/2021,Sudan,Johor,0,0,0
1/03/2021,Sudan,Kedah,0,0,0
1/03/2021,Sudan,Kelantan,0,0,0
1/03/2021,Sudan,Perlis,0,0,0
1/03/2021,Sudan,Pulau Pinang,0,0,0
1/03/2021,Sudan,Sabah,0,0,0
1/03/2021,Sudan,Sarawak,0,0,0
1/03/2021,Sudan,Selangor,59,40,19
1/03/2021,Sudan,W.P. Labuan,0,0,0
1/03/2021,Senegal,Johor,0,0,0
1/03/2021,Senegal,Kedah,0,0,0
1/03/2021,Senegal,Kelantan,0,0,0
1/03/2021,Senegal,Perak,0,0,0
1/03/2021,Senegal,Perlis,0,0,0
1/03/2021,Senegal,Pulau Pinang,0,0,0
1/03/2021,Senegal,Sabah,0,0,0
1/03/2021,Senegal,Sarawak,0,0,0
1/03/2021,Senegal,Selangor,3,2,1
1/03/2021,Singapore,Johor,297,261,36
1/03/2021,Singapore,Kedah,0,0,0
1/03/2021,Singapore,Kelantan,0,0,0
1/03/2021,Singapore,Melaka,0,0,0
1/03/2021,Singapore,Negeri Sembilan,0,0,0
1/03/2021,Singapore,Pahang,0,0,0
1/03/2021,Singapore,Perak,2,0,2
1/03/2021,Singapore,Perlis,0,0,0
1/03/2021,Singapore,Pulau Pinang,23,13,10
1/03/2021,Singapore,Sabah,0,0,0
1/03/2021,Singapore,Sarawak,8,4,4
1/03/2021,Singapore,Selangor,163,116,47
1/03/2021,Singapore,Terengganu,0,0,0
1/03/2021,Singapore,W.P. Labuan,0,0,0
1/03/2021,South Georgia and the South Sandwich Islands,Johor,0,0,0
1/03/2021,South Georgia and the South Sandwich Islands,Sabah,0,0,0
1/03/2021,South Georgia and the South Sandwich Islands,Selangor,0,0,0
1/03/2021,Saint Helena,Sarawak,0,0,0
1/03/2021,Solomon Islands,Johor,0,0,0
1/03/2021,Solomon Islands,Perlis,0,0,0
1/03/2021,Solomon Islands,Pulau Pinang,0,0,0
1/03/2021,Solomon Islands,Sabah,0,0,0
1/03/2021,Solomon Islands,Sarawak,0,0,0
1/03/2021,Solomon Islands,Selangor,0,0,0
1/03/2021,Solomon Islands,W.P. Labuan,0,0,0
1/03/2021,Sierra Leone,Johor,0,0,0
1/03/2021,Sierra Leone,Kedah,0,0,0
1/03/2021,Sierra Leone,Perak,0,0,0
1/03/2021,Sierra Leone,Pulau Pinang,0,0,0
1/03/2021,Sierra Leone,Sabah,0,0,0
1/03/2021,Sierra Leone,Selangor,5,0,5
1/03/2021,El Salvador,Johor,0,0,0
1/03/2021,El Salvador,Kedah,0,0,0
1/03/2021,El Salvador,Perak,0,0,0
1/03/2021,El Salvador,Perlis,0,0,0
1/03/2021,El Salvador,Pulau Pinang,0,0,0
1/03/2021,El Salvador,Sabah,0,0,0
1/03/2021,El Salvador,Selangor,1,1,0
1/03/2021,El Salvador,W.P. Labuan,0,0,0
1/03/2021,San Marino,Johor,0,0,0
1/03/2021,San Marino,Selangor,0,0,0
1/03/2021,Somalia,Johor,0,0,0
1/03/2021,Somalia,Kedah,0,0,0
1/03/2021,Somalia,Kelantan,0,0,0
1/03/2021,Somalia,Perlis,0,0,0
1/03/2021,Somalia,Sabah,0,0,0
1/03/2021,Somalia,Sarawak,0,0,0
1/03/2021,Somalia,Selangor,36,26,10
1/03/2021,Serbia,Johor,0,0,0
1/03/2021,Serbia,Kedah,0,0,0
1/03/2021,Serbia,Kelantan,0,0,0
1/03/2021,Serbia,Pahang,0,0,0
1/03/2021,Serbia,Perak,0,0,0
1/03/2021,Serbia,Perlis,0,0,0
1/03/2021,Serbia,Pulau Pinang,0,0,0
1/03/2021,Serbia,Sabah,0,0,0
1/03/2021,Serbia,Sarawak,0,0,0
1/03/2021,Serbia,Selangor,1,1,0
1/03/2021,South Sudan,Johor,0,0,0
1/03/2021,South Sudan,Kedah,0,0,0
1/03/2021,South Sudan,Sarawak,0,0,0
1/03/2021,South Sudan,Selangor,13,11,2
1/03/2021,South Sudan,W.P. Labuan,0,0,0
1/03/2021,Sao Tome and Principe,Selangor,0,0,0
1/03/2021,Suriname,Johor,0,0,0
1/03/2021,Suriname,Kedah,0,0,0
1/03/2021,Suriname,Kelantan,0,0,0
1/03/2021,Suriname,Perak,0,0,0
1/03/2021,Suriname,Perlis,0,0,0
1/03/2021,Suriname,Pulau Pinang,0,0,0
1/03/2021,Suriname,Sabah,0,0,0
1/03/2021,Suriname,Sarawak,0,0,0
1/03/2021,Suriname,Selangor,0,0,0
1/03/2021,Slovakia,Johor,0,0,0
1/03/2021,Slovakia,Kedah,0,0,0
1/03/2021,Slovakia,Kelantan,0,0,0
1/03/2021,Slovakia,Negeri Sembilan,0,0,0
1/03/2021,Slovakia,Pahang,0,0,0
1/03/2021,Slovakia,Perak,0,0,0
1/03/2021,Slovakia,Perlis,0,0,0
1/03/2021,Slovakia,Pulau Pinang,0,0,0
1/03/2021,Slovakia,Sabah,0,0,0
1/03/2021,Slovakia,Sarawak,0,0,0
1/03/2021,Slovakia,Selangor,12,10,2
1/03/2021,Slovakia,W.P. Labuan,0,0,0
1/03/2021,Slovenia,Johor,0,0,0
1/03/2021,Slovenia,Kedah,0,0,0
1/03/2021,Slovenia,Kelantan,0,0,0
1/03/2021,Slovenia,Perak,0,0,0
1/03/2021,Slovenia,Perlis,0,0,0
1/03/2021,Slovenia,Pulau Pinang,0,0,0
1/03/2021,Slovenia,Sabah,0,0,0
1/03/2021,Slovenia,Sarawak,0,0,0
1/03/2021,Slovenia,Selangor,2,2,0
1/03/2021,Slovenia,W.P. Labuan,0,0,0
1/03/2021,Sweden,Johor,0,0,0
1/03/2021,Sweden,Kedah,0,0,0
1/03/2021,Sweden,Kelantan,0,0,0
1/03/2021,Sweden,Melaka,0,0,0
1/03/2021,Sweden,Negeri Sembilan,0,0,0
1/03/2021,Sweden,Pahang,0,0,0
1/03/2021,Sweden,Perak,0,0,0
1/03/2021,Sweden,Perlis,0,0,0
1/03/2021,Sweden,Pulau Pinang,0,0,0
1/03/2021,Sweden,Sabah,0,0,0
1/03/2021,Sweden,Sarawak,0,0,0
1/03/2021,Sweden,Selangor,28,26,2
1/03/2021,Sweden,W.P. Labuan,0,0,0
1/03/2021,Eswatini,Johor,0,0,0
1/03/2021,Eswatini,Kedah,0,0,0
1/03/2021,Eswatini,Pulau Pinang,0,0,0
1/03/2021,Eswatini,Sabah,0,0,0
1/03/2021,Eswatini,Selangor,3,0,3
1/03/2021,Seychelles,Johor,0,0,0
1/03/2021,Seychelles,Kedah,0,0,0
1/03/2021,Seychelles,Pulau Pinang,0,0,0
1/03/2021,Seychelles,Sabah,0,0,0
1/03/2021,Seychelles,Sarawak,0,0,0
1/03/2021,Seychelles,Selangor,13,8,5
1/03/2021,Syrian Arab Republic,Johor,0,0,0
1/03/2021,Syrian Arab Republic,Kedah,0,0,0
1/03/2021,Syrian Arab Republic,Kelantan,0,0,0
1/03/2021,Syrian Arab Republic,Pahang,0,0,0
1/03/2021,Syrian Arab Republic,Perlis,0,0,0
1/03/2021,Syrian Arab Republic,Pulau Pinang,0,0,0
1/03/2021,Syrian Arab Republic,Sabah,0,0,0
1/03/2021,Syrian Arab Republic,Sarawak,0,0,0
1/03/2021,Syrian Arab Republic,Selangor,51,30,21
1/03/2021,Syrian Arab Republic,W.P. Labuan,0,0,0
1/03/2021,Turks and Caicos Islands,Perlis,0,0,0
1/03/2021,TCD,Johor,0,0,0
1/03/2021,TCD,Kedah,0,0,0
1/03/2021,TCD,Perlis,0,0,0
1/03/2021,TCD,Selangor,2,2,0
1/03/2021,Togo,Johor,0,0,0
1/03/2021,Togo,Perak,0,0,0
1/03/2021,Togo,Pulau Pinang,0,0,0
1/03/2021,Togo,Selangor,0,0,0
1/03/2021,Thailand,Johor,0,0,0
1/03/2021,Thailand,Kedah,19195,19146,49
1/03/2021,Thailand,Kelantan,4,2,2
1/03/2021,Thailand,Melaka,0,0,0
1/03/2021,Thailand,Negeri Sembilan,0,0,0
1/03/2021,Thailand,Pahang,0,0,0
1/03/2021,Thailand,Perak,2,0,2
1/03/2021,Thailand,Perlis,10965,10607,358
1/03/2021,Thailand,Pulau Pinang,19,17,2
1/03/2021,Thailand,Sabah,0,0,0
1/03/2021,Thailand,Sarawak,11,10,1
1/03/2021,Thailand,Selangor,369,223,146
1/03/2021,Thailand,Terengganu,0,0,0
1/03/2021,Thailand,W.P. Labuan,0,0,0
1/03/2021,Tajikistan,Johor,0,0,0
1/03/2021,Tajikistan,Kedah,0,0,0
1/03/2021,Tajikistan,Perlis,0,0,0
1/03/2021,Tajikistan,Pulau Pinang,0,0,0
1/03/2021,Tajikistan,Sabah,0,0,0
1/03/2021,Tajikistan,Selangor,1,1,0
1/03/2021,Tokelau,Selangor,0,0,0
1/03/2021,Turkmenistan,Johor,0,0,0
1/03/2021,Turkmenistan,Kedah,0,0,0
1/03/2021,Turkmenistan,Kelantan,0,0,0
1/03/2021,Turkmenistan,Perlis,0,0,0
1/03/2021,Turkmenistan,Pulau Pinang,0,0,0
1/03/2021,Turkmenistan,Sabah,0,0,0
1/03/2021,Turkmenistan,Sarawak,0,0,0
1/03/2021,Turkmenistan,Selangor,0,0,0
1/03/2021,Timor-Leste,Johor,0,0,0
1/03/2021,Timor-Leste,Kedah,0,0,0
1/03/2021,Timor-Leste,Perlis,0,0,0
1/03/2021,Timor-Leste,Pulau Pinang,0,0,0
1/03/2021,Timor-Leste,Sabah,0,0,0
1/03/2021,Timor-Leste,Sarawak,0,0,0
1/03/2021,Timor-Leste,Selangor,1,0,1
1/03/2021,Tonga,Johor,0,0,0
1/03/2021,Tonga,Pulau Pinang,0,0,0
1/03/2021,Tonga,Sarawak,0,0,0
1/03/2021,Tonga,Selangor,0,0,0
1/03/2021,Trinidad and Tobago,Johor,0,0,0
1/03/2021,Trinidad and Tobago,Kedah,0,0,0
1/03/2021,Trinidad and Tobago,Pahang,0,0,0
1/03/2021,Trinidad and Tobago,Pulau Pinang,0,0,0
1/03/2021,Trinidad and Tobago,Sabah,0,0,0
1/03/2021,Trinidad and Tobago,Sarawak,0,0,0
1/03/2021,Trinidad and Tobago,Selangor,0,0,0
1/03/2021,Tunisia,Johor,0,0,0
1/03/2021,Tunisia,Kedah,0,0,0
1/03/2021,Tunisia,Kelantan,0,0,0
1/03/2021,Tunisia,Melaka,0,0,0
1/03/2021,Tunisia,Perak,0,0,0
1/03/2021,Tunisia,Perlis,0,0,0
1/03/2021,Tunisia,Pulau Pinang,0,0,0
1/03/2021,Tunisia,Sabah,0,0,0
1/03/2021,Tunisia,Sarawak,0,0,0
1/03/2021,Tunisia,Selangor,9,2,7
1/03/2021,Tunisia,W.P. Labuan,0,0,0
1/03/2021,Türkiye,Johor,0,0,0
1/03/2021,Türkiye,Kedah,0,0,0
1/03/2021,Türkiye,Kelantan,0,0,0
1/03/2021,Türkiye,Melaka,0,0,0
1/03/2021,Türkiye,Negeri Sembilan,0,0,0
1/03/2021,Türkiye,Pahang,0,0,0
1/03/2021,Türkiye,Perak,0,0,0
1/03/2021,Türkiye,Perlis,0,0,0
1/03/2021,Türkiye,Pulau Pinang,0,0,0
1/03/2021,Türkiye,Sabah,0,0,0
1/03/2021,Türkiye,Sarawak,0,0,0
1/03/2021,Türkiye,Selangor,30,25,5
1/03/2021,Türkiye,W.P. Labuan,0,0,0
1/03/2021,Tuvalu,Selangor,0,0,0
1/03/2021,"Taiwan, Province of China",Johor,0,0,0
1/03/2021,"Taiwan, Province of China",Kedah,0,0,0
1/03/2021,"Taiwan, Province of China",Kelantan,0,0,0
1/03/2021,"Taiwan, Province of China",Melaka,0,0,0
1/03/2021,"Taiwan, Province of China",Negeri Sembilan,0,0,0
1/03/2021,"Taiwan, Province of China",Pahang,0,0,0
1/03/2021,"Taiwan, Province of China",Perak,0,0,0
1/03/2021,"Taiwan, Province of China",Perlis,0,0,0
1/03/2021,"Taiwan, Province of China",Pulau Pinang,11,7,4
1/03/2021,"Taiwan, Province of China",Sabah,0,0,0
1/03/2021,"Taiwan, Province of China",Sarawak,0,0,0
1/03/2021,"Taiwan, Province of China",Selangor,111,71,40
1/03/2021,"Taiwan, Province of China",W.P. Labuan,0,0,0
1/03/2021,"Tanzania, United Republic of",Johor,0,0,0
1/03/2021,"Tanzania, United Republic of",Kedah,0,0,0
1/03/2021,"Tanzania, United Republic of",Perak,0,0,0
1/03/2021,"Tanzania, United Republic of",Perlis,0,0,0
1/03/2021,"Tanzania, United Republic of",Pulau Pinang,0,0,0
1/03/2021,"Tanzania, United Republic of",Sabah,0,0,0
1/03/2021,"Tanzania, United Republic of",Sarawak,0,0,0
1/03/2021,"Tanzania, United Republic of",Selangor,38,20,18
1/03/2021,Uganda,Johor,0,0,0
1/03/2021,Uganda,Kedah,0,0,0
1/03/2021,Uganda,Perak,0,0,0
1/03/2021,Uganda,Perlis,0,0,0
1/03/2021,Uganda,Pulau Pinang,0,0,0
1/03/2021,Uganda,Sabah,0,0,0
1/03/2021,Uganda,Sarawak,0,0,0
1/03/2021,Uganda,Selangor,5,3,2
1/03/2021,Ukraine,Johor,24,24,0
1/03/2021,Ukraine,Kedah,0,0,0
1/03/2021,Ukraine,Kelantan,0,0,0
1/03/2021,Ukraine,Melaka,0,0,0
1/03/2021,Ukraine,Negeri Sembilan,0,0,0
1/03/2021,Ukraine,Pahang,0,0,0
1/03/2021,Ukraine,Perak,0,0,0
1/03/2021,Ukraine,Perlis,0,0,0
1/03/2021,Ukraine,Pulau Pinang,0,0,0
1/03/2021,Ukraine,Sabah,0,0,0
1/03/2021,Ukraine,Sarawak,0,0,0
1/03/2021,Ukraine,Selangor,47,44,3
1/03/2021,Ukraine,W.P. Labuan,0,0,0
1/03/2021,Uruguay,Johor,0,0,0
1/03/2021,Uruguay,Kedah,0,0,0
1/03/2021,Uruguay,Kelantan,0,0,0
1/03/2021,Uruguay,Perak,0,0,0
1/03/2021,Uruguay,Perlis,0,0,0
1/03/2021,Uruguay,Pulau Pinang,0,0,0
1/03/2021,Uruguay,Sabah,0,0,0
1/03/2021,Uruguay,Sarawak,0,0,0
1/03/2021,Uruguay,Selangor,0,0,0
1/03/2021,Uruguay,W.P. Labuan,0,0,0
1/03/2021,United States of America,Johor,1,1,0
1/03/2021,United States of America,Kedah,0,0,0
1/03/2021,United States of America,Kelantan,0,0,0
1/03/2021,United States of America,Melaka,0,0,0
1/03/2021,United States of America,Negeri Sembilan,0,0,0
1/03/2021,United States of America,Pahang,0,0,0
1/03/2021,United States of America,Perak,0,0,0
1/03/2021,United States of America,Perlis,0,0,0
1/03/2021,United States of America,Pulau Pinang,4,4,0
1/03/2021,United States of America,Sabah,0,0,0
1/03/2021,United States of America,Sarawak,1,1,0
1/03/2021,United States of America,Selangor,150,108,42
1/03/2021,United States of America,Terengganu,0,0,0
1/03/2021,United States of America,W.P. Labuan,0,0,0
1/03/2021,Uzbekistan,Johor,0,0,0
1/03/2021,Uzbekistan,Kedah,0,0,0
1/03/2021,Uzbekistan,Kelantan,0,0,0
1/03/2021,Uzbekistan,Perak,0,0,0
1/03/2021,Uzbekistan,Perlis,0,0,0
1/03/2021,Uzbekistan,Pulau Pinang,0,0,0
1/03/2021,Uzbekistan,Sabah,0,0,0
1/03/2021,Uzbekistan,Sarawak,0,0,0
1/03/2021,Uzbekistan,Selangor,14,11,3
1/03/2021,Holy See,Johor,0,0,0
1/03/2021,Holy See,Sarawak,0,0,0
1/03/2021,Holy See,Selangor,1,1,0
1/03/2021,Saint Vincent and the Grenadines,Johor,0,0,0
1/03/2021,Saint Vincent and the Grenadines,Kedah,0,0,0
1/03/2021,Saint Vincent and the Grenadines,Pulau Pinang,0,0,0
1/03/2021,Saint Vincent and the Grenadines,Sarawak,0,0,0
1/03/2021,Saint Vincent and the Grenadines,Selangor,0,0,0
1/03/2021,"Venezuela, Bolivarian Republic of",Johor,0,0,0
1/03/2021,"Venezuela, Bolivarian Republic of",Kedah,0,0,0
1/03/2021,"Venezuela, Bolivarian Republic of",Kelantan,0,0,0
1/03/2021,"Venezuela, Bolivarian Republic of",Melaka,0,0,0
1/03/2021,"Venezuela, Bolivarian Republic of",Perak,0,0,0
1/03/2021,"Venezuela, Bolivarian Republic of",Perlis,0,0,0
1/03/2021,"Venezuela, Bolivarian Republic of",Pulau Pinang,0,0,0
1/03/2021,"Venezuela, Bolivarian Republic of",Sabah,0,0,0
1/03/2021,"Venezuela, Bolivarian Republic of",Sarawak,0,0,0
1/03/2021,"Venezuela, Bolivarian Republic of",Selangor,2,2,0
1/03/2021,"Venezuela, Bolivarian Republic of",W.P. Labuan,0,0,0
1/03/2021,Viet Nam,Johor,1,0,1
1/03/2021,Viet Nam,Kedah,0,0,0
1/03/2021,Viet Nam,Kelantan,0,0,0
1/03/2021,Viet Nam,Melaka,0,0,0
1/03/2021,Viet Nam,Negeri Sembilan,0,0,0
1/03/2021,Viet Nam,Pahang,0,0,0
1/03/2021,Viet Nam,Perak,0,0,0
1/03/2021,Viet Nam,Perlis,0,0,0
1/03/2021,Viet Nam,Pulau Pinang,1,0,1
1/03/2021,Viet Nam,Sabah,0,0,0
1/03/2021,Viet Nam,Sarawak,0,0,0
1/03/2021,Viet Nam,Selangor,113,34,79
1/03/2021,Viet Nam,Terengganu,18,18,0
1/03/2021,Viet Nam,W.P. Labuan,0,0,0
1/03/2021,Vanuatu,Johor,0,0,0
1/03/2021,Vanuatu,Kedah,0,0,0
1/03/2021,Vanuatu,Pulau Pinang,0,0,0
1/03/2021,Vanuatu,Sabah,0,0,0
1/03/2021,Vanuatu,Sarawak,0,0,0
1/03/2021,Vanuatu,Selangor,1,1,0
1/03/2021, Samoa,Johor,0,0,0
1/03/2021, Samoa,Sarawak,0,0,0
1/03/2021, Samoa,Selangor,0,0,0
1/03/2021,Yemen,Johor,0,0,0
1/03/2021,Yemen,Kedah,0,0,0
1/03/2021,Yemen,Kelantan,0,0,0
1/03/2021,Yemen,Melaka,0,0,0
1/03/2021,Yemen,Pahang,0,0,0
1/03/2021,Yemen,Perak,0,0,0
1/03/2021,Yemen,Perlis,0,0,0
1/03/2021,Yemen,Pulau Pinang,0,0,0
1/03/2021,Yemen,Sabah,0,0,0
1/03/2021,Yemen,Sarawak,0,0,0
1/03/2021,Yemen,Selangor,83,70,13
1/03/2021,Yemen,W.P. Labuan,0,0,0
1/03/2021,South Africa,Johor,3,3,0
1/03/2021,South Africa,Kedah,0,0,0
1/03/2021,South Africa,Kelantan,0,0,0
1/03/2021,South Africa,Melaka,0,0,0
1/03/2021,South Africa,Pahang,0,0,0
1/03/2021,South Africa,Perak,0,0,0
1/03/2021,South Africa,Perlis,0,0,0
1/03/2021,South Africa,Pulau Pinang,0,0,0
1/03/2021,South Africa,Sabah,0,0,0
1/03/2021,South Africa,Sarawak,0,0,0
1/03/2021,South Africa,Selangor,68,50,18
1/03/2021,South Africa,Terengganu,0,0,0
1/03/2021,South Africa,W.P. Labuan,0,0,0
1/03/2021,ZAR,Selangor,0,0,0
1/03/2021,Zambia,Johor,0,0,0
1/03/2021,Zambia,Kedah,0,0,0
1/03/2021,Zambia,Perak,0,0,0
1/03/2021,Zambia,Perlis,0,0,0
1/03/2021,Zambia,Pulau Pinang,0,0,0
1/03/2021,Zambia,Sabah,0,0,0
1/03/2021,Zambia,Sarawak,0,0,0
1/03/2021,Zambia,Selangor,24,13,11
1/03/2021,Zimbabwe,Johor,0,0,0
1/03/2021,Zimbabwe,Kedah,0,0,0
1/03/2021,Zimbabwe,Kelantan,0,0,0
1/03/2021,Zimbabwe,Perak,0,0,0
1/03/2021,Zimbabwe,Perlis,0,0,0
1/03/2021,Zimbabwe,Pulau Pinang,0,0,0
1/03/2021,Zimbabwe,Sabah,0,0,0
1/03/2021,Zimbabwe,Sarawak,0,0,0
1/03/2021,Zimbabwe,Selangor,11,5,6
1/04/2021,Aruba,Kedah,0,0,0
1/04/2021,Aruba,Pulau Pinang,0,0,0
1/04/2021,Afghanistan,Johor,0,0,0
1/04/2021,Afghanistan,Kedah,0,0,0
1/04/2021,Afghanistan,Perlis,0,0,0
1/04/2021,Afghanistan,Pulau Pinang,0,0,0
1/04/2021,Afghanistan,Sarawak,0,0,0
1/04/2021,Afghanistan,Selangor,30,26,4
1/04/2021,Angola,Johor,0,0,0
1/04/2021,Angola,Kedah,0,0,0
1/04/2021,Angola,Sabah,0,0,0
1/04/2021,Angola,Selangor,0,0,0
1/04/2021,Anguilla,Selangor,0,0,0
1/04/2021,Albania,Johor,0,0,0
1/04/2021,Albania,Kedah,0,0,0
1/04/2021,Albania,Perak,0,0,0
1/04/2021,Albania,Perlis,0,0,0
1/04/2021,Albania,Pulau Pinang,0,0,0
1/04/2021,Albania,Sabah,0,0,0
1/04/2021,Albania,Sarawak,0,0,0
1/04/2021,Albania,Selangor,4,3,1
1/04/2021,Andorra,Johor,0,0,0
1/04/2021,Andorra,Kedah,0,0,0
1/04/2021,Andorra,Perlis,0,0,0
1/04/2021,Andorra,Pulau Pinang,0,0,0
1/04/2021,Andorra,Selangor,0,0,0
1/04/2021,Antigua and Barbuda,Selangor,0,0,0
1/04/2021,United Arab Emirates,Johor,0,0,0
1/04/2021,United Arab Emirates,Kedah,0,0,0
1/04/2021,United Arab Emirates,Kelantan,0,0,0
1/04/2021,United Arab Emirates,Perak,0,0,0
1/04/2021,United Arab Emirates,Perlis,0,0,0
1/04/2021,United Arab Emirates,Pulau Pinang,0,0,0
1/04/2021,United Arab Emirates,Sabah,0,0,0
1/04/2021,United Arab Emirates,Sarawak,0,0,0
1/04/2021,United Arab Emirates,Selangor,5,4,1
1/04/2021,Argentina,Johor,0,0,0
1/04/2021,Argentina,Kedah,0,0,0
1/04/2021,Argentina,Kelantan,0,0,0
1/04/2021,Argentina,Melaka,0,0,0
1/04/2021,Argentina,Perak,0,0,0
1/04/2021,Argentina,Perlis,0,0,0
1/04/2021,Argentina,Pulau Pinang,0,0,0
1/04/2021,Argentina,Sabah,0,0,0
1/04/2021,Argentina,Sarawak,0,0,0
1/04/2021,Argentina,Selangor,2,1,1
1/04/2021,Argentina,W.P. Labuan,0,0,0
1/04/2021,Armenia,Johor,0,0,0
1/04/2021,Armenia,Kedah,0,0,0
1/04/2021,Armenia,Kelantan,0,0,0
1/04/2021,Armenia,Perak,0,0,0
1/04/2021,Armenia,Perlis,0,0,0
1/04/2021,Armenia,Pulau Pinang,0,0,0
1/04/2021,Armenia,Sabah,0,0,0
1/04/2021,Armenia,Sarawak,0,0,0
1/04/2021,Armenia,Selangor,1,1,0
1/04/2021,Antarctica,Selangor,0,0,0
1/04/2021,Antigua and Barbuda,Johor,0,0,0
1/04/2021,Antigua and Barbuda,Kedah,0,0,0
1/04/2021,Antigua and Barbuda,Pulau Pinang,0,0,0
1/04/2021,Antigua and Barbuda,Sarawak,0,0,0
1/04/2021,Antigua and Barbuda,Selangor,0,0,0
1/04/2021,Australia,Johor,1,1,0
1/04/2021,Australia,Kedah,0,0,0
1/04/2021,Australia,Kelantan,0,0,0
1/04/2021,Australia,Melaka,0,0,0
1/04/2021,Australia,Negeri Sembilan,0,0,0
1/04/2021,Australia,Pahang,0,0,0
1/04/2021,Australia,Perak,0,0,0
1/04/2021,Australia,Perlis,0,0,0
1/04/2021,Australia,Pulau Pinang,9,5,4
1/04/2021,Australia,Sabah,0,0,0
1/04/2021,Australia,Sarawak,1,1,0
1/04/2021,Australia,Selangor,102,68,34
1/04/2021,Australia,Terengganu,0,0,0
1/04/2021,Australia,W.P. Labuan,0,0,0
1/04/2021,Austria,Johor,0,0,0
1/04/2021,Austria,Kedah,0,0,0
1/04/2021,Austria,Kelantan,0,0,0
1/04/2021,Austria,Melaka,0,0,0
1/04/2021,Austria,Negeri Sembilan,0,0,0
1/04/2021,Austria,Pahang,0,0,0
1/04/2021,Austria,Perak,0,0,0
1/04/2021,Austria,Perlis,0,0,0
1/04/2021,Austria,Pulau Pinang,0,0,0
1/04/2021,Austria,Sabah,0,0,0
1/04/2021,Austria,Sarawak,0,0,0
1/04/2021,Austria,Selangor,17,13,4
1/04/2021,Austria,Terengganu,0,0,0
1/04/2021,Austria,W.P. Labuan,0,0,0
1/04/2021,Azerbaijan,Johor,0,0,0
1/04/2021,Azerbaijan,Kedah,0,0,0
1/04/2021,Azerbaijan,Kelantan,0,0,0
1/04/2021,Azerbaijan,Melaka,0,0,0
1/04/2021,Azerbaijan,Perlis,0,0,0
1/04/2021,Azerbaijan,Pulau Pinang,0,0,0
1/04/2021,Azerbaijan,Sabah,0,0,0
1/04/2021,Azerbaijan,Sarawak,0,0,0
1/04/2021,Azerbaijan,Selangor,1,1,0
1/04/2021,Azerbaijan,W.P. Labuan,0,0,0
1/04/2021,Burundi,Pulau Pinang,0,0,0
1/04/2021,Burundi,Sarawak,0,0,0
1/04/2021,Burundi,Selangor,3,1,2
1/04/2021,Belgium,Johor,1,1,0
1/04/2021,Belgium,Kedah,0,0,0
1/04/2021,Belgium,Kelantan,0,0,0
1/04/2021,Belgium,Melaka,0,0,0
1/04/2021,Belgium,Negeri Sembilan,0,0,0
1/04/2021,Belgium,Pahang,0,0,0
1/04/2021,Belgium,Perak,0,0,0
1/04/2021,Belgium,Perlis,0,0,0
1/04/2021,Belgium,Pulau Pinang,0,0,0
1/04/2021,Belgium,Sabah,0,0,0
1/04/2021,Belgium,Sarawak,0,0,0
1/04/2021,Belgium,Selangor,9,6,3
1/04/2021,Belgium,W.P. Labuan,0,0,0
1/04/2021,Benin,Johor,0,0,0
1/04/2021,Benin,Kedah,0,0,0
1/04/2021,Benin,Perak,0,0,0
1/04/2021,Benin,Pulau Pinang,0,0,0
1/04/2021,Benin,Sabah,0,0,0
1/04/2021,Benin,Sarawak,0,0,0
1/04/2021,Benin,Selangor,1,1,0
1/04/2021,Burkina Faso,Perak,0,0,0
1/04/2021,Burkina Faso,Pulau Pinang,0,0,0
1/04/2021,Burkina Faso,Selangor,0,0,0
1/04/2021,Bangladesh,Johor,6,6,0
1/04/2021,Bangladesh,Kedah,0,0,0
1/04/2021,Bangladesh,Kelantan,0,0,0
1/04/2021,Bangladesh,Melaka,0,0,0
1/04/2021,Bangladesh,Negeri Sembilan,0,0,0
1/04/2021,Bangladesh,Pahang,0,0,0
1/04/2021,Bangladesh,Perak,0,0,0
1/04/2021,Bangladesh,Perlis,0,0,0
1/04/2021,Bangladesh,Pulau Pinang,0,0,0
1/04/2021,Bangladesh,Sabah,0,0,0
1/04/2021,Bangladesh,Sarawak,0,0,0
1/04/2021,Bangladesh,Selangor,265,235,30
1/04/2021,Bangladesh,W.P. Labuan,0,0,0
1/04/2021,Bulgaria,Johor,0,0,0
1/04/2021,Bulgaria,Kedah,0,0,0
1/04/2021,Bulgaria,Kelantan,0,0,0
1/04/2021,Bulgaria,Pahang,0,0,0
1/04/2021,Bulgaria,Perak,0,0,0
1/04/2021,Bulgaria,Perlis,0,0,0
1/04/2021,Bulgaria,Pulau Pinang,0,0,0
1/04/2021,Bulgaria,Sabah,0,0,0
1/04/2021,Bulgaria,Sarawak,0,0,0
1/04/2021,Bulgaria,Selangor,10,9,1
1/04/2021,Bulgaria,W.P. Labuan,0,0,0
1/04/2021,Bahrain,Johor,0,0,0
1/04/2021,Bahrain,Kedah,0,0,0
1/04/2021,Bahrain,Kelantan,0,0,0
1/04/2021,Bahrain,Perlis,0,0,0
1/04/2021,Bahrain,Pulau Pinang,0,0,0
1/04/2021,Bahrain,Sabah,0,0,0
1/04/2021,Bahrain,Sarawak,0,0,0
1/04/2021,Bahrain,Selangor,1,0,1
1/04/2021,Bahamas,Johor,0,0,0
1/04/2021,Bahamas,Kedah,0,0,0
1/04/2021,Bahamas,Perak,0,0,0
1/04/2021,Bahamas,Sabah,0,0,0
1/04/2021,Bahamas,Sarawak,0,0,0
1/04/2021,Bahamas,Selangor,0,0,0
1/04/2021,Bosnia and Herzegovina,Johor,0,0,0
1/04/2021,Bosnia and Herzegovina,Kedah,0,0,0
1/04/2021,Bosnia and Herzegovina,Perlis,0,0,0
1/04/2021,Bosnia and Herzegovina,Pulau Pinang,0,0,0
1/04/2021,Bosnia and Herzegovina,Sabah,0,0,0
1/04/2021,Bosnia and Herzegovina,Sarawak,0,0,0
1/04/2021,Bosnia and Herzegovina,Selangor,3,2,1
1/04/2021,Belarus,Johor,0,0,0
1/04/2021,Belarus,Kedah,0,0,0
1/04/2021,Belarus,Kelantan,0,0,0
1/04/2021,Belarus,Pahang,0,0,0
1/04/2021,Belarus,Perak,0,0,0
1/04/2021,Belarus,Perlis,0,0,0
1/04/2021,Belarus,Pulau Pinang,0,0,0
1/04/2021,Belarus,Sabah,0,0,0
1/04/2021,Belarus,Sarawak,0,0,0
1/04/2021,Belarus,Selangor,1,1,0
1/04/2021,Belarus,W.P. Labuan,0,0,0
1/04/2021,Belize,Johor,0,0,0
1/04/2021,Belize,Pulau Pinang,0,0,0
1/04/2021,Belize,Sarawak,0,0,0
1/04/2021,Belize,Selangor,0,0,0
1/04/2021,Bermuda,Selangor,0,0,0
1/04/2021,Bolivia,Johor,0,0,0
1/04/2021,Bolivia,Kedah,0,0,0
1/04/2021,Bolivia,Melaka,0,0,0
1/04/2021,Bolivia,Perak,0,0,0
1/04/2021,Bolivia,Perlis,0,0,0
1/04/2021,Bolivia,Pulau Pinang,0,0,0
1/04/2021,Bolivia,Sabah,0,0,0
1/04/2021,Bolivia,Sarawak,0,0,0
1/04/2021,Bolivia,Selangor,0,0,0
1/04/2021,Brazil,Johor,0,0,0
1/04/2021,Brazil,Kedah,0,0,0
1/04/2021,Brazil,Kelantan,0,0,0
1/04/2021,Brazil,Melaka,0,0,0
1/04/2021,Brazil,Pahang,0,0,0
1/04/2021,Brazil,Perak,0,0,0
1/04/2021,Brazil,Perlis,0,0,0
1/04/2021,Brazil,Pulau Pinang,0,0,0
1/04/2021,Brazil,Sabah,0,0,0
1/04/2021,Brazil,Sarawak,0,0,0
1/04/2021,Brazil,Selangor,27,13,14
1/04/2021,Brazil,W.P. Labuan,0,0,0
1/04/2021,Barbados,Johor,0,0,0
1/04/2021,Barbados,Kedah,0,0,0
1/04/2021,Barbados,Perlis,0,0,0
1/04/2021,Barbados,Pulau Pinang,0,0,0
1/04/2021,Barbados,Selangor,0,0,0
1/04/2021,Brunei Darussalam,Johor,0,0,0
1/04/2021,Brunei Darussalam,Kedah,0,0,0
1/04/2021,Brunei Darussalam,Kelantan,0,0,0
1/04/2021,Brunei Darussalam,Melaka,0,0,0
1/04/2021,Brunei Darussalam,Pahang,0,0,0
1/04/2021,Brunei Darussalam,Perak,0,0,0
1/04/2021,Brunei Darussalam,Perlis,0,0,0
1/04/2021,Brunei Darussalam,Pulau Pinang,0,0,0
1/04/2021,Brunei Darussalam,Sabah,0,0,0
1/04/2021,Brunei Darussalam,Sarawak,385,368,17
1/04/2021,Brunei Darussalam,Selangor,22,8,14
1/04/2021,Brunei Darussalam,W.P. Labuan,4,4,0
1/04/2021,Bhutan,Johor,0,0,0
1/04/2021,Bhutan,Kedah,0,0,0
1/04/2021,Bhutan,Perak,0,0,0
1/04/2021,Bhutan,Perlis,0,0,0
1/04/2021,Bhutan,Pulau Pinang,0,0,0
1/04/2021,Bhutan,Sabah,0,0,0
1/04/2021,Bhutan,Sarawak,0,0,0
1/04/2021,Bhutan,Selangor,0,0,0
1/04/2021,Botswana,Johor,0,0,0
1/04/2021,Botswana,Kedah,0,0,0
1/04/2021,Botswana,Perlis,0,0,0
1/04/2021,Botswana,Pulau Pinang,0,0,0
1/04/2021,Botswana,Sabah,0,0,0
1/04/2021,Botswana,Sarawak,0,0,0
1/04/2021,Botswana,Selangor,0,0,0
1/04/2021,Central African Republic,Kedah,0,0,0
1/04/2021,Central African Republic,Selangor,0,0,0
1/04/2021,Canada,Johor,0,0,0
1/04/2021,Canada,Kedah,0,0,0
1/04/2021,Canada,Kelantan,0,0,0
1/04/2021,Canada,Melaka,0,0,0
1/04/2021,Canada,Negeri Sembilan,0,0,0
1/04/2021,Canada,Pahang,0,0,0
1/04/2021,Canada,Perak,0,0,0
1/04/2021,Canada,Perlis,0,0,0
1/04/2021,Canada,Pulau Pinang,0,0,0
1/04/2021,Canada,Sabah,0,0,0
1/04/2021,Canada,Sarawak,0,0,0
1/04/2021,Canada,Selangor,36,29,7
1/04/2021,Canada,Terengganu,0,0,0
1/04/2021,Canada,W.P. Labuan,0,0,0
1/04/2021,Cocos (Keeling) Islands,Selangor,0,0,0
1/04/2021,Switzerland,Johor,0,0,0
1/04/2021,Switzerland,Kedah,0,0,0
1/04/2021,Switzerland,Kelantan,0,0,0
1/04/2021,Switzerland,Melaka,0,0,0
1/04/2021,Switzerland,Negeri Sembilan,0,0,0
1/04/2021,Switzerland,Pahang,0,0,0
1/04/2021,Switzerland,Perak,0,0,0
1/04/2021,Switzerland,Perlis,0,0,0
1/04/2021,Switzerland,Pulau Pinang,0,0,0
1/04/2021,Switzerland,Sabah,0,0,0
1/04/2021,Switzerland,Sarawak,0,0,0
1/04/2021,Switzerland,Selangor,21,17,4
1/04/2021,Switzerland,W.P. Labuan,0,0,0
1/04/2021,Chile,Johor,0,0,0
1/04/2021,Chile,Kedah,0,0,0
1/04/2021,Chile,Kelantan,0,0,0
1/04/2021,Chile,Melaka,0,0,0
1/04/2021,Chile,Pahang,0,0,0
1/04/2021,Chile,Perak,0,0,0
1/04/2021,Chile,Perlis,0,0,0
1/04/2021,Chile,Pulau Pinang,0,0,0
1/04/2021,Chile,Sabah,0,0,0
1/04/2021,Chile,Sarawak,0,0,0
1/04/2021,Chile,Selangor,1,0,1
1/04/2021,China,Johor,35,34,1
1/04/2021,China,Kedah,0,0,0
1/04/2021,China,Kelantan,0,0,0
1/04/2021,China,Melaka,0,0,0
1/04/2021,China,Pahang,1,1,0
1/04/2021,China,Perak,0,0,0
1/04/2021,China,Perlis,0,0,0
1/04/2021,China,Pulau Pinang,2,2,0
1/04/2021,China,Sabah,0,0,0
1/04/2021,China,Sarawak,67,60,7
1/04/2021,China,Selangor,1570,1181,389
1/04/2021,China,Terengganu,0,0,0
1/04/2021,China,W.P. Labuan,0,0,0
1/04/2021,Côte d'Ivoire,Johor,0,0,0
1/04/2021,Côte d'Ivoire,Kedah,0,0,0
1/04/2021,Côte d'Ivoire,Pulau Pinang,0,0,0
1/04/2021,Côte d'Ivoire,Sabah,0,0,0
1/04/2021,Côte d'Ivoire,Sarawak,0,0,0
1/04/2021,Côte d'Ivoire,Selangor,0,0,0
1/04/2021,Cameroon,Johor,0,0,0
1/04/2021,Cameroon,Kedah,0,0,0
1/04/2021,Cameroon,Pulau Pinang,0,0,0
1/04/2021,Cameroon,Sabah,0,0,0
1/04/2021,Cameroon,Sarawak,0,0,0
1/04/2021,Cameroon,Selangor,3,1,2
1/04/2021,Congo,Johor,0,0,0
1/04/2021,Congo,Pulau Pinang,0,0,0
1/04/2021,Congo,Sarawak,0,0,0
1/04/2021,Congo,Selangor,4,3,1
1/04/2021,Congo,Johor,0,0,0
1/04/2021,Congo,Kedah,0,0,0
1/04/2021,Congo,Selangor,0,0,0
1/04/2021,Cook Islands,Selangor,0,0,0
1/04/2021,Colombia,Johor,0,0,0
1/04/2021,Colombia,Kedah,0,0,0
1/04/2021,Colombia,Perak,0,0,0
1/04/2021,Colombia,Pulau Pinang,0,0,0
1/04/2021,Colombia,Sabah,0,0,0
1/04/2021,Colombia,Sarawak,0,0,0
1/04/2021,Colombia,Selangor,7,3,4
1/04/2021,Colombia,W.P. Labuan,0,0,0
1/04/2021,Comoros,Johor,0,0,0
1/04/2021,Comoros,Kedah,0,0,0
1/04/2021,Comoros,Selangor,2,1,1
1/04/2021,Cabo Verde,Johor,0,0,0
1/04/2021,Cabo Verde,Kedah,0,0,0
1/04/2021,Cabo Verde,Pulau Pinang,0,0,0
1/04/2021,Cabo Verde,Sabah,0,0,0
1/04/2021,Cabo Verde,Selangor,0,0,0
1/04/2021,Costa Rica,Johor,0,0,0
1/04/2021,Costa Rica,Kedah,0,0,0
1/04/2021,Costa Rica,Perak,0,0,0
1/04/2021,Costa Rica,Perlis,0,0,0
1/04/2021,Costa Rica,Pulau Pinang,0,0,0
1/04/2021,Costa Rica,Sabah,0,0,0
1/04/2021,Costa Rica,Sarawak,0,0,0
1/04/2021,Costa Rica,Selangor,1,0,1
1/04/2021,Cuba,Johor,0,0,0
1/04/2021,Cuba,Kedah,0,0,0
1/04/2021,Cuba,Perlis,0,0,0
1/04/2021,Cuba,Pulau Pinang,0,0,0
1/04/2021,Cuba,Sabah,0,0,0
1/04/2021,Cuba,Sarawak,0,0,0
1/04/2021,Cuba,Selangor,0,0,0
1/04/2021,Cyprus,Johor,0,0,0
1/04/2021,Cyprus,Kedah,0,0,0
1/04/2021,Cyprus,Perak,0,0,0
1/04/2021,Cyprus,Perlis,0,0,0
1/04/2021,Cyprus,Pulau Pinang,0,0,0
1/04/2021,Cyprus,Sabah,0,0,0
1/04/2021,Cyprus,Sarawak,0,0,0
1/04/2021,Cyprus,Selangor,1,1,0
1/04/2021,Czechia,Johor,0,0,0
1/04/2021,Czechia,Kedah,0,0,0
1/04/2021,Czechia,Kelantan,0,0,0
1/04/2021,Czechia,Melaka,0,0,0
1/04/2021,Czechia,Negeri Sembilan,0,0,0
1/04/2021,Czechia,Perak,0,0,0
1/04/2021,Czechia,Perlis,0,0,0
1/04/2021,Czechia,Pulau Pinang,0,0,0
1/04/2021,Czechia,Sabah,0,0,0
1/04/2021,Czechia,Sarawak,0,0,0
1/04/2021,Czechia,Selangor,9,8,1
1/04/2021,Czechia,W.P. Labuan,0,0,0
1/04/2021,Germany,Johor,2,2,0
1/04/2021,Germany,Kedah,0,0,0
1/04/2021,Germany,Kelantan,0,0,0
1/04/2021,Germany,Melaka,0,0,0
1/04/2021,Germany,Negeri Sembilan,0,0,0
1/04/2021,Germany,Pahang,0,0,0
1/04/2021,Germany,Perak,0,0,0
1/04/2021,Germany,Perlis,0,0,0
1/04/2021,Germany,Pulau Pinang,1,1,0
1/04/2021,Germany,Sabah,0,0,0
1/04/2021,Germany,Sarawak,0,0,0
1/04/2021,Germany,Selangor,101,92,9
1/04/2021,Germany,Terengganu,0,0,0
1/04/2021,Germany,W.P. Labuan,0,0,0
1/04/2021,Djibouti,Johor,0,0,0
1/04/2021,Djibouti,Selangor,24,15,9
1/04/2021,Dominica,Johor,0,0,0
1/04/2021,Dominica,Kedah,0,0,0
1/04/2021,Dominica,Pulau Pinang,0,0,0
1/04/2021,Dominica,Sabah,0,0,0
1/04/2021,Dominica,Sarawak,0,0,0
1/04/2021,Dominica,Selangor,0,0,0
1/04/2021,Dominica,W.P. Labuan,0,0,0
1/04/2021,Denmark,Johor,9,7,2
1/04/2021,Denmark,Kedah,0,0,0
1/04/2021,Denmark,Kelantan,0,0,0
1/04/2021,Denmark,Melaka,0,0,0
1/04/2021,Denmark,Negeri Sembilan,0,0,0
1/04/2021,Denmark,Pahang,0,0,0
1/04/2021,Denmark,Perak,0,0,0
1/04/2021,Denmark,Perlis,0,0,0
1/04/2021,Denmark,Pulau Pinang,2,1,1
1/04/2021,Denmark,Sabah,0,0,0
1/04/2021,Denmark,Sarawak,0,0,0
1/04/2021,Denmark,Selangor,23,19,4
1/04/2021,Denmark,W.P. Labuan,0,0,0
1/04/2021,Dominican Republic,Johor,0,0,0
1/04/2021,Dominican Republic,Kedah,0,0,0
1/04/2021,Dominican Republic,Perak,0,0,0
1/04/2021,Dominican Republic,Perlis,0,0,0
1/04/2021,Dominican Republic,Pulau Pinang,0,0,0
1/04/2021,Dominican Republic,Sabah,0,0,0
1/04/2021,Dominican Republic,Sarawak,0,0,0
1/04/2021,Dominican Republic,Selangor,0,0,0
1/04/2021,Algeria,Johor,0,0,0
1/04/2021,Algeria,Kedah,0,0,0
1/04/2021,Algeria,Kelantan,0,0,0
1/04/2021,Algeria,Melaka,0,0,0
1/04/2021,Algeria,Perak,0,0,0
1/04/2021,Algeria,Perlis,0,0,0
1/04/2021,Algeria,Pulau Pinang,0,0,0
1/04/2021,Algeria,Sabah,0,0,0
1/04/2021,Algeria,Sarawak,0,0,0
1/04/2021,Algeria,Selangor,3,2,1
1/04/2021,Algeria,W.P. Labuan,0,0,0
1/04/2021,Ecuador,Johor,0,0,0
1/04/2021,Ecuador,Kedah,0,0,0
1/04/2021,Ecuador,Perak,0,0,0
1/04/2021,Ecuador,Perlis,0,0,0
1/04/2021,Ecuador,Pulau Pinang,0,0,0
1/04/2021,Ecuador,Sabah,0,0,0
1/04/2021,Ecuador,Sarawak,0,0,0
1/04/2021,Ecuador,Selangor,1,1,0
1/04/2021,Egypt,Johor,0,0,0
1/04/2021,Egypt,Kedah,0,0,0
1/04/2021,Egypt,Kelantan,0,0,0
1/04/2021,Egypt,Melaka,0,0,0
1/04/2021,Egypt,Pahang,0,0,0
1/04/2021,Egypt,Perak,0,0,0
1/04/2021,Egypt,Perlis,0,0,0
1/04/2021,Egypt,Pulau Pinang,0,0,0
1/04/2021,Egypt,Sabah,0,0,0
1/04/2021,Egypt,Sarawak,0,0,0
1/04/2021,Egypt,Selangor,98,75,23
1/04/2021,Egypt,Terengganu,0,0,0
1/04/2021,Egypt,W.P. Labuan,0,0,0
1/04/2021,Eritrea,Johor,0,0,0
1/04/2021,Eritrea,Pulau Pinang,0,0,0
1/04/2021,Eritrea,Sabah,0,0,0
1/04/2021,Eritrea,Selangor,1,1,0
1/04/2021,Spain,Johor,0,0,0
1/04/2021,Spain,Kedah,0,0,0
1/04/2021,Spain,Kelantan,0,0,0
1/04/2021,Spain,Melaka,0,0,0
1/04/2021,Spain,Negeri Sembilan,0,0,0
1/04/2021,Spain,Pahang,0,0,0
1/04/2021,Spain,Perak,0,0,0
1/04/2021,Spain,Perlis,0,0,0
1/04/2021,Spain,Pulau Pinang,0,0,0
1/04/2021,Spain,Sabah,0,0,0
1/04/2021,Spain,Sarawak,0,0,0
1/04/2021,Spain,Selangor,21,16,5
1/04/2021,Spain,W.P. Labuan,0,0,0
1/04/2021,Estonia,Johor,0,0,0
1/04/2021,Estonia,Kedah,0,0,0
1/04/2021,Estonia,Kelantan,0,0,0
1/04/2021,Estonia,Pahang,0,0,0
1/04/2021,Estonia,Perak,0,0,0
1/04/2021,Estonia,Perlis,0,0,0
1/04/2021,Estonia,Pulau Pinang,0,0,0
1/04/2021,Estonia,Sabah,0,0,0
1/04/2021,Estonia,Sarawak,0,0,0
1/04/2021,Estonia,Selangor,3,3,0
1/04/2021,Estonia,W.P. Labuan,0,0,0
1/04/2021,Ethiopia,Johor,0,0,0
1/04/2021,Ethiopia,Kedah,0,0,0
1/04/2021,Ethiopia,Pulau Pinang,0,0,0
1/04/2021,Ethiopia,Sarawak,0,0,0
1/04/2021,Ethiopia,Selangor,4,2,2
1/04/2021,Finland,Johor,0,0,0
1/04/2021,Finland,Kedah,0,0,0
1/04/2021,Finland,Kelantan,0,0,0
1/04/2021,Finland,Melaka,0,0,0
1/04/2021,Finland,Negeri Sembilan,0,0,0
1/04/2021,Finland,Pahang,0,0,0
1/04/2021,Finland,Perak,0,0,0
1/04/2021,Finland,Perlis,0,0,0
1/04/2021,Finland,Pulau Pinang,0,0,0
1/04/2021,Finland,Sabah,0,0,0
1/04/2021,Finland,Sarawak,0,0,0
1/04/2021,Finland,Selangor,6,4,2
1/04/2021,Finland,W.P. Labuan,0,0,0
1/04/2021,Fiji,Johor,0,0,0
1/04/2021,Fiji,Kedah,0,0,0
1/04/2021,Fiji,Kelantan,0,0,0
1/04/2021,Fiji,Perak,0,0,0
1/04/2021,Fiji,Perlis,0,0,0
1/04/2021,Fiji,Pulau Pinang,0,0,0
1/04/2021,Fiji,Sabah,0,0,0
1/04/2021,Fiji,Sarawak,0,0,0
1/04/2021,Fiji,Selangor,1,1,0
1/04/2021,France,Johor,3,3,0
1/04/2021,France,Kedah,0,0,0
1/04/2021,France,Kelantan,0,0,0
1/04/2021,France,Melaka,0,0,0
1/04/2021,France,Negeri Sembilan,0,0,0
1/04/2021,France,Pahang,0,0,0
1/04/2021,France,Perak,0,0,0
1/04/2021,France,Perlis,0,0,0
1/04/2021,France,Pulau Pinang,0,0,0
1/04/2021,France,Sabah,0,0,0
1/04/2021,France,Sarawak,0,0,0
1/04/2021,France,Selangor,65,51,14
1/04/2021,France,Terengganu,0,0,0
1/04/2021,France,W.P. Labuan,0,0,0
1/04/2021,"Micronesia, Federated States of",Johor,0,0,0
1/04/2021,"Micronesia, Federated States of",Pulau Pinang,0,0,0
1/04/2021,"Micronesia, Federated States of",Selangor,0,0,0
1/04/2021,Gabon,Johor,0,0,0
1/04/2021,Gabon,Pulau Pinang,0,0,0
1/04/2021,Gabon,Sarawak,0,0,0
1/04/2021,Gabon,Selangor,1,1,0
1/04/2021,United Kingdom of Great Britain and Northern Ireland,Johor,4,4,0
1/04/2021,United Kingdom of Great Britain and Northern Ireland,Kedah,0,0,0
1/04/2021,United Kingdom of Great Britain and Northern Ireland,Kelantan,0,0,0
1/04/2021,United Kingdom of Great Britain and Northern Ireland,Melaka,0,0,0
1/04/2021,United Kingdom of Great Britain and Northern Ireland,Negeri Sembilan,0,0,0
1/04/2021,United Kingdom of Great Britain and Northern Ireland,Pahang,0,0,0
1/04/2021,United Kingdom of Great Britain and Northern Ireland,Perak,1,0,1
1/04/2021,United Kingdom of Great Britain and Northern Ireland,Perlis,0,0,0
1/04/2021,United Kingdom of Great Britain and Northern Ireland,Pulau Pinang,3,3,0
1/04/2021,United Kingdom of Great Britain and Northern Ireland,Sabah,1,0,1
1/04/2021,United Kingdom of Great Britain and Northern Ireland,Sarawak,0,0,0
1/04/2021,United Kingdom of Great Britain and Northern Ireland,Selangor,221,187,34
1/04/2021,United Kingdom of Great Britain and Northern Ireland,Terengganu,0,0,0
1/04/2021,United Kingdom of Great Britain and Northern Ireland,W.P. Labuan,0,0,0
1/04/2021,Georgia,Johor,0,0,0
1/04/2021,Georgia,Kedah,0,0,0
1/04/2021,Georgia,Melaka,0,0,0
1/04/2021,Georgia,Perak,0,0,0
1/04/2021,Georgia,Perlis,0,0,0
1/04/2021,Georgia,Pulau Pinang,0,0,0
1/04/2021,Georgia,Sabah,0,0,0
1/04/2021,Georgia,Sarawak,0,0,0
1/04/2021,Georgia,Selangor,2,2,0
1/04/2021,Ghana,Johor,0,0,0
1/04/2021,Ghana,Kedah,0,0,0
1/04/2021,Ghana,Kelantan,0,0,0
1/04/2021,Ghana,Pulau Pinang,0,0,0
1/04/2021,Ghana,Sabah,0,0,0
1/04/2021,Ghana,Sarawak,0,0,0
1/04/2021,Ghana,Selangor,10,8,2
1/04/2021,Gibraltar,Johor,0,0,0
1/04/2021,Gibraltar,Sarawak,0,0,0
1/04/2021,Guinea,Johor,0,0,0
1/04/2021,Guinea,Kedah,0,0,0
1/04/2021,Guinea,Kelantan,0,0,0
1/04/2021,Guinea,Perlis,0,0,0
1/04/2021,Guinea,Pulau Pinang,0,0,0
1/04/2021,Guinea,Sabah,0,0,0
1/04/2021,Guinea,Sarawak,0,0,0
1/04/2021,Guinea,Selangor,24,10,14
1/04/2021,Guadeloupe,Selangor,0,0,0
1/04/2021,Gambia,Johor,0,0,0
1/04/2021,Gambia,Kedah,0,0,0
1/04/2021,Gambia,Kelantan,0,0,0
1/04/2021,Gambia,Pulau Pinang,0,0,0
1/04/2021,Gambia,Sabah,0,0,0
1/04/2021,Gambia,Sarawak,0,0,0
1/04/2021,Gambia,Selangor,1,1,0
1/04/2021,Guinea-Bissau,Johor,0,0,0
1/04/2021,Guinea-Bissau,Selangor,0,0,0
1/04/2021,Equatorial Guinea,Johor,0,0,0
1/04/2021,Equatorial Guinea,Selangor,2,1,1
1/04/2021,Greece,Johor,6,5,1
1/04/2021,Greece,Kedah,0,0,0
1/04/2021,Greece,Kelantan,0,0,0
1/04/2021,Greece,Melaka,0,0,0
1/04/2021,Greece,Negeri Sembilan,0,0,0
1/04/2021,Greece,Pahang,0,0,0
1/04/2021,Greece,Perak,0,0,0
1/04/2021,Greece,Perlis,0,0,0
1/04/2021,Greece,Pulau Pinang,0,0,0
1/04/2021,Greece,Sabah,0,0,0
1/04/2021,Greece,Sarawak,0,0,0
1/04/2021,Greece,Selangor,3,3,0
1/04/2021,Grenada,Johor,0,0,0
1/04/2021,Grenada,Kedah,0,0,0
1/04/2021,Grenada,Pulau Pinang,0,0,0
1/04/2021,Grenada,Sabah,0,0,0
1/04/2021,Grenada,Sarawak,0,0,0
1/04/2021,Grenada,Selangor,0,0,0
1/04/2021,Greenland,Johor,0,0,0
1/04/2021,Greenland,Selangor,0,0,0
1/04/2021,Guatemala,Johor,0,0,0
1/04/2021,Guatemala,Kedah,0,0,0
1/04/2021,Guatemala,Pahang,0,0,0
1/04/2021,Guatemala,Perak,0,0,0
1/04/2021,Guatemala,Pulau Pinang,0,0,0
1/04/2021,Guatemala,Sabah,0,0,0
1/04/2021,Guatemala,Sarawak,0,0,0
1/04/2021,Guatemala,Selangor,0,0,0
1/04/2021,Guatemala,W.P. Labuan,0,0,0
1/04/2021,Guyana,Johor,0,0,0
1/04/2021,Guyana,Kedah,0,0,0
1/04/2021,Guyana,Pulau Pinang,0,0,0
1/04/2021,Guyana,Sarawak,0,0,0
1/04/2021,Guyana,Selangor,0,0,0
1/04/2021,Hong Kong,Johor,0,0,0
1/04/2021,Hong Kong,Kedah,0,0,0
1/04/2021,Hong Kong,Kelantan,0,0,0
1/04/2021,Hong Kong,Pahang,0,0,0
1/04/2021,Hong Kong,Perak,0,0,0
1/04/2021,Hong Kong,Perlis,0,0,0
1/04/2021,Hong Kong,Pulau Pinang,1,1,0
1/04/2021,Hong Kong,Sabah,0,0,0
1/04/2021,Hong Kong,Sarawak,0,0,0
1/04/2021,Hong Kong,Selangor,0,0,0
1/04/2021,Hong Kong,Terengganu,0,0,0
1/04/2021,Heard Island and McDonald Islands,Johor,0,0,0
1/04/2021,Honduras,Johor,0,0,0
1/04/2021,Honduras,Kedah,0,0,0
1/04/2021,Honduras,Perak,0,0,0
1/04/2021,Honduras,Pulau Pinang,0,0,0
1/04/2021,Honduras,Sabah,0,0,0
1/04/2021,Honduras,Sarawak,0,0,0
1/04/2021,Honduras,Selangor,5,5,0
1/04/2021,Croatia,Johor,0,0,0
1/04/2021,Croatia,Kedah,0,0,0
1/04/2021,Croatia,Kelantan,0,0,0
1/04/2021,Croatia,Melaka,0,0,0
1/04/2021,Croatia,Pahang,0,0,0
1/04/2021,Croatia,Perak,0,0,0
1/04/2021,Croatia,Perlis,0,0,0
1/04/2021,Croatia,Pulau Pinang,0,0,0
1/04/2021,Croatia,Sabah,0,0,0
1/04/2021,Croatia,Sarawak,0,0,0
1/04/2021,Croatia,Selangor,15,13,2
1/04/2021,Haiti,Johor,0,0,0
1/04/2021,Haiti,Kedah,0,0,0
1/04/2021,Haiti,Kelantan,0,0,0
1/04/2021,Haiti,Perak,0,0,0
1/04/2021,Haiti,Pulau Pinang,0,0,0
1/04/2021,Haiti,Sabah,0,0,0
1/04/2021,Haiti,Selangor,0,0,0
1/04/2021,Hungary,Johor,0,0,0
1/04/2021,Hungary,Kedah,0,0,0
1/04/2021,Hungary,Kelantan,0,0,0
1/04/2021,Hungary,Pahang,0,0,0
1/04/2021,Hungary,Perak,0,0,0
1/04/2021,Hungary,Perlis,0,0,0
1/04/2021,Hungary,Pulau Pinang,0,0,0
1/04/2021,Hungary,Sabah,0,0,0
1/04/2021,Hungary,Sarawak,0,0,0
1/04/2021,Hungary,Selangor,9,5,4
1/04/2021,Hungary,W.P. Labuan,0,0,0
1/04/2021,Indonesia,Johor,210,152,58
1/04/2021,Indonesia,Kedah,3,3,0
1/04/2021,Indonesia,Kelantan,0,0,0
1/04/2021,Indonesia,Melaka,0,0,0
1/04/2021,Indonesia,Negeri Sembilan,0,0,0
1/04/2021,Indonesia,Pahang,0,0,0
1/04/2021,Indonesia,Perak,0,0,0
1/04/2021,Indonesia,Perlis,5,5,0
1/04/2021,Indonesia,Pulau Pinang,17,1,16
1/04/2021,Indonesia,Sabah,1,1,0
1/04/2021,Indonesia,Sarawak,424,423,1
1/04/2021,Indonesia,Selangor,1117,740,377
1/04/2021,Indonesia,Terengganu,0,0,0
1/04/2021,Indonesia,W.P. Labuan,4,4,0
1/04/2021,India,Johor,101,101,0
1/04/2021,India,Kedah,0,0,0
1/04/2021,India,Kelantan,0,0,0
1/04/2021,India,Melaka,0,0,0
1/04/2021,India,Negeri Sembilan,0,0,0
1/04/2021,India,Pahang,2,2,0
1/04/2021,India,Perak,0,0,0
1/04/2021,India,Perlis,0,0,0
1/04/2021,India,Pulau Pinang,3,3,0
1/04/2021,India,Sabah,2,2,0
1/04/2021,India,Sarawak,0,0,0
1/04/2021,India,Selangor,1359,963,396
1/04/2021,India,Terengganu,0,0,0
1/04/2021,India,W.P. Labuan,0,0,0
1/04/2021, British Indian Ocean Territory,Pulau Pinang,0,0,0
1/04/2021, British Indian Ocean Territory,Selangor,0,0,0
1/04/2021,Ireland,Johor,0,0,0
1/04/2021,Ireland,Kedah,0,0,0
1/04/2021,Ireland,Kelantan,0,0,0
1/04/2021,Ireland,Negeri Sembilan,0,0,0
1/04/2021,Ireland,Pahang,0,0,0
1/04/2021,Ireland,Perak,0,0,0
1/04/2021,Ireland,Perlis,0,0,0
1/04/2021,Ireland,Pulau Pinang,0,0,0
1/04/2021,Ireland,Sabah,0,0,0
1/04/2021,Ireland,Sarawak,0,0,0
1/04/2021,Ireland,Selangor,10,6,4
1/04/2021,Ireland,Terengganu,0,0,0
1/04/2021,Ireland,W.P. Labuan,0,0,0
1/04/2021,"Iran, Islamic Republic of",Johor,0,0,0
1/04/2021,"Iran, Islamic Republic of",Kedah,0,0,0
1/04/2021,"Iran, Islamic Republic of",Kelantan,0,0,0
1/04/2021,"Iran, Islamic Republic of",Perak,0,0,0
1/04/2021,"Iran, Islamic Republic of",Perlis,0,0,0
1/04/2021,"Iran, Islamic Republic of",Pulau Pinang,0,0,0
1/04/2021,"Iran, Islamic Republic of",Sabah,0,0,0
1/04/2021,"Iran, Islamic Republic of",Sarawak,0,0,0
1/04/2021,"Iran, Islamic Republic of",Selangor,46,30,16
1/04/2021,"Iran, Islamic Republic of",W.P. Labuan,0,0,0
1/04/2021,Iraq,Johor,0,0,0
1/04/2021,Iraq,Kedah,0,0,0
1/04/2021,Iraq,Kelantan,0,0,0
1/04/2021,Iraq,Melaka,0,0,0
1/04/2021,Iraq,Pahang,0,0,0
1/04/2021,Iraq,Perak,0,0,0
1/04/2021,Iraq,Perlis,0,0,0
1/04/2021,Iraq,Pulau Pinang,0,0,0
1/04/2021,Iraq,Sabah,0,0,0
1/04/2021,Iraq,Sarawak,0,0,0
1/04/2021,Iraq,Selangor,39,24,15
1/04/2021,Iceland,Johor,0,0,0
1/04/2021,Iceland,Kedah,0,0,0
1/04/2021,Iceland,Kelantan,0,0,0
1/04/2021,Iceland,Perak,0,0,0
1/04/2021,Iceland,Perlis,0,0,0
1/04/2021,Iceland,Pulau Pinang,0,0,0
1/04/2021,Iceland,Sabah,0,0,0
1/04/2021,Iceland,Sarawak,0,0,0
1/04/2021,Iceland,Selangor,0,0,0
1/04/2021,Iceland,W.P. Labuan,0,0,0
1/04/2021,Israel,Pulau Pinang,0,0,0
1/04/2021,Italy,Johor,0,0,0
1/04/2021,Italy,Kedah,0,0,0
1/04/2021,Italy,Kelantan,0,0,0
1/04/2021,Italy,Melaka,0,0,0
1/04/2021,Italy,Negeri Sembilan,0,0,0
1/04/2021,Italy,Pahang,0,0,0
1/04/2021,Italy,Perak,0,0,0
1/04/2021,Italy,Perlis,0,0,0
1/04/2021,Italy,Pulau Pinang,1,1,0
1/04/2021,Italy,Sabah,0,0,0
1/04/2021,Italy,Sarawak,0,0,0
1/04/2021,Italy,Selangor,67,61,6
1/04/2021,Italy,W.P. Labuan,0,0,0
1/04/2021,Jamaica,Johor,0,0,0
1/04/2021,Jamaica,Kedah,0,0,0
1/04/2021,Jamaica,Perak,0,0,0
1/04/2021,Jamaica,Pulau Pinang,0,0,0
1/04/2021,Jamaica,Sabah,0,0,0
1/04/2021,Jamaica,Sarawak,0,0,0
1/04/2021,Jamaica,Selangor,1,0,1
1/04/2021,Jamaica,W.P. Labuan,0,0,0
1/04/2021,Jordan,Johor,0,0,0
1/04/2021,Jordan,Kedah,0,0,0
1/04/2021,Jordan,Kelantan,0,0,0
1/04/2021,Jordan,Melaka,0,0,0
1/04/2021,Jordan,Perlis,0,0,0
1/04/2021,Jordan,Pulau Pinang,0,0,0
1/04/2021,Jordan,Sabah,0,0,0
1/04/2021,Jordan,Sarawak,0,0,0
1/04/2021,Jordan,Selangor,25,18,7
1/04/2021,Jordan,W.P. Labuan,0,0,0
1/04/2021,Japan,Johor,2,1,1
1/04/2021,Japan,Kedah,0,0,0
1/04/2021,Japan,Kelantan,0,0,0
1/04/2021,Japan,Melaka,0,0,0
1/04/2021,Japan,Negeri Sembilan,0,0,0
1/04/2021,Japan,Pahang,0,0,0
1/04/2021,Japan,Perak,0,0,0
1/04/2021,Japan,Perlis,0,0,0
1/04/2021,Japan,Pulau Pinang,24,18,6
1/04/2021,Japan,Sabah,1,0,1
1/04/2021,Japan,Sarawak,4,4,0
1/04/2021,Japan,Selangor,600,409,191
1/04/2021,Japan,W.P. Labuan,0,0,0
1/04/2021,Kazakhstan,Johor,0,0,0
1/04/2021,Kazakhstan,Kedah,0,0,0
1/04/2021,Kazakhstan,Kelantan,0,0,0
1/04/2021,Kazakhstan,Melaka,0,0,0
1/04/2021,Kazakhstan,Perak,0,0,0
1/04/2021,Kazakhstan,Perlis,0,0,0
1/04/2021,Kazakhstan,Pulau Pinang,0,0,0
1/04/2021,Kazakhstan,Sabah,0,0,0
1/04/2021,Kazakhstan,Sarawak,0,0,0
1/04/2021,Kazakhstan,Selangor,21,6,15
1/04/2021,Kazakhstan,W.P. Labuan,0,0,0
1/04/2021,Kenya,Johor,0,0,0
1/04/2021,Kenya,Kedah,0,0,0
1/04/2021,Kenya,Kelantan,0,0,0
1/04/2021,Kenya,Perak,0,0,0
1/04/2021,Kenya,Perlis,0,0,0
1/04/2021,Kenya,Pulau Pinang,0,0,0
1/04/2021,Kenya,Sabah,0,0,0
1/04/2021,Kenya,Sarawak,0,0,0
1/04/2021,Kenya,Selangor,18,9,9
1/04/2021,Kyrgyzstan,Johor,0,0,0
1/04/2021,Kyrgyzstan,Kedah,0,0,0
1/04/2021,Kyrgyzstan,Kelantan,0,0,0
1/04/2021,Kyrgyzstan,Perak,0,0,0
1/04/2021,Kyrgyzstan,Perlis,0,0,0
1/04/2021,Kyrgyzstan,Pulau Pinang,0,0,0
1/04/2021,Kyrgyzstan,Sabah,0,0,0
1/04/2021,Kyrgyzstan,Sarawak,0,0,0
1/04/2021,Kyrgyzstan,Selangor,6,4,2
1/04/2021,Cambodia,Johor,0,0,0
1/04/2021,Cambodia,Kedah,0,0,0
1/04/2021,Cambodia,Kelantan,0,0,0
1/04/2021,Cambodia,Melaka,0,0,0
1/04/2021,Cambodia,Negeri Sembilan,0,0,0
1/04/2021,Cambodia,Pahang,0,0,0
1/04/2021,Cambodia,Perak,0,0,0
1/04/2021,Cambodia,Perlis,0,0,0
1/04/2021,Cambodia,Pulau Pinang,0,0,0
1/04/2021,Cambodia,Sabah,0,0,0
1/04/2021,Cambodia,Sarawak,0,0,0
1/04/2021,Cambodia,Selangor,9,1,8
1/04/2021,Cambodia,W.P. Labuan,0,0,0
1/04/2021,Kiribati,Johor,0,0,0
1/04/2021,Kiribati,Sabah,0,0,0
1/04/2021,Kiribati,Selangor,0,0,0
1/04/2021,Saint Kitts and Nevis,Johor,0,0,0
1/04/2021,Saint Kitts and Nevis,Kedah,0,0,0
1/04/2021,Saint Kitts and Nevis,Perlis,0,0,0
1/04/2021,Saint Kitts and Nevis,Pulau Pinang,0,0,0
1/04/2021,Saint Kitts and Nevis,Sabah,0,0,0
1/04/2021,Saint Kitts and Nevis,Selangor,0,0,0
1/04/2021,Saint Kitts and Nevis,W.P. Labuan,0,0,0
1/04/2021,"Korea, Republic of",Johor,0,0,0
1/04/2021,"Korea, Republic of",Kedah,0,0,0
1/04/2021,"Korea, Republic of",Kelantan,0,0,0
1/04/2021,"Korea, Republic of",Melaka,0,0,0
1/04/2021,"Korea, Republic of",Negeri Sembilan,0,0,0
1/04/2021,"Korea, Republic of",Pahang,0,0,0
1/04/2021,"Korea, Republic of",Perak,1,1,0
1/04/2021,"Korea, Republic of",Perlis,0,0,0
1/04/2021,"Korea, Republic of",Pulau Pinang,2,1,1
1/04/2021,"Korea, Republic of",Sabah,0,0,0
1/04/2021,"Korea, Republic of",Sarawak,4,3,1
1/04/2021,"Korea, Republic of",Selangor,332,235,97
1/04/2021,"Korea, Republic of",Terengganu,0,0,0
1/04/2021,"Korea, Republic of",W.P. Labuan,0,0,0
1/04/2021,Kuwait,Johor,0,0,0
1/04/2021,Kuwait,Kedah,0,0,0
1/04/2021,Kuwait,Kelantan,0,0,0
1/04/2021,Kuwait,Perak,0,0,0
1/04/2021,Kuwait,Perlis,0,0,0
1/04/2021,Kuwait,Pulau Pinang,0,0,0
1/04/2021,Kuwait,Sabah,0,0,0
1/04/2021,Kuwait,Sarawak,0,0,0
1/04/2021,Kuwait,Selangor,0,0,0
1/04/2021,Kuwait,W.P. Labuan,0,0,0
1/04/2021, Lao People's Democratic Republic,Johor,0,0,0
1/04/2021, Lao People's Democratic Republic,Kedah,0,0,0
1/04/2021, Lao People's Democratic Republic,Kelantan,0,0,0
1/04/2021, Lao People's Democratic Republic,Melaka,0,0,0
1/04/2021, Lao People's Democratic Republic,Perak,0,0,0
1/04/2021, Lao People's Democratic Republic,Perlis,0,0,0
1/04/2021, Lao People's Democratic Republic,Pulau Pinang,0,0,0
1/04/2021, Lao People's Democratic Republic,Sabah,0,0,0
1/04/2021, Lao People's Democratic Republic,Sarawak,0,0,0
1/04/2021, Lao People's Democratic Republic,Selangor,46,42,4
1/04/2021, Lao People's Democratic Republic,W.P. Labuan,0,0,0
1/04/2021,Lebanon,Johor,0,0,0
1/04/2021,Lebanon,Kedah,0,0,0
1/04/2021,Lebanon,Kelantan,0,0,0
1/04/2021,Lebanon,Pahang,0,0,0
1/04/2021,Lebanon,Perak,0,0,0
1/04/2021,Lebanon,Perlis,0,0,0
1/04/2021,Lebanon,Pulau Pinang,0,0,0
1/04/2021,Lebanon,Sabah,0,0,0
1/04/2021,Lebanon,Sarawak,0,0,0
1/04/2021,Lebanon,Selangor,5,5,0
1/04/2021,Lebanon,W.P. Labuan,0,0,0
1/04/2021,Liberia,Johor,0,0,0
1/04/2021,Liberia,Kedah,0,0,0
1/04/2021,Liberia,Sabah,0,0,0
1/04/2021,Liberia,Sarawak,0,0,0
1/04/2021,Liberia,Selangor,4,4,0
1/04/2021,Libya,Johor,0,0,0
1/04/2021,Libya,Kedah,0,0,0
1/04/2021,Libya,Perlis,0,0,0
1/04/2021,Libya,Pulau Pinang,0,0,0
1/04/2021,Libya,Sabah,0,0,0
1/04/2021,Libya,Sarawak,0,0,0
1/04/2021,Libya,Selangor,50,36,14
1/04/2021,Saint Lucia,Johor,0,0,0
1/04/2021,Saint Lucia,Kedah,0,0,0
1/04/2021,Saint Lucia,Pulau Pinang,0,0,0
1/04/2021,Saint Lucia,Sarawak,0,0,0
1/04/2021,Saint Lucia,Selangor,0,0,0
1/04/2021,Liechtenstein,Johor,0,0,0
1/04/2021,Liechtenstein,Kedah,0,0,0
1/04/2021,Liechtenstein,Perlis,0,0,0
1/04/2021,Liechtenstein,Pulau Pinang,0,0,0
1/04/2021,Liechtenstein,Sabah,0,0,0
1/04/2021,Liechtenstein,Sarawak,0,0,0
1/04/2021,Liechtenstein,Selangor,1,1,0
1/04/2021,LKA,Johor,3,3,0
1/04/2021,LKA,Kedah,0,0,0
1/04/2021,LKA,Kelantan,0,0,0
1/04/2021,LKA,Melaka,0,0,0
1/04/2021,LKA,Pahang,0,0,0
1/04/2021,LKA,Perak,0,0,0
1/04/2021,LKA,Perlis,0,0,0
1/04/2021,LKA,Pulau Pinang,0,0,0
1/04/2021,LKA,Sabah,0,0,0
1/04/2021,LKA,Sarawak,0,0,0
1/04/2021,LKA,Selangor,118,67,51
1/04/2021,LKA,W.P. Labuan,0,0,0
1/04/2021,Lesotho,Johor,0,0,0
1/04/2021,Lesotho,Kedah,0,0,0
1/04/2021,Lesotho,Pulau Pinang,0,0,0
1/04/2021,Lesotho,Sarawak,0,0,0
1/04/2021,Lesotho,Selangor,0,0,0
1/04/2021,Lithuania,Johor,1,1,0
1/04/2021,Lithuania,Kedah,0,0,0
1/04/2021,Lithuania,Kelantan,0,0,0
1/04/2021,Lithuania,Pahang,0,0,0
1/04/2021,Lithuania,Perak,0,0,0
1/04/2021,Lithuania,Perlis,0,0,0
1/04/2021,Lithuania,Pulau Pinang,0,0,0
1/04/2021,Lithuania,Sabah,0,0,0
1/04/2021,Lithuania,Sarawak,0,0,0
1/04/2021,Lithuania,Selangor,3,1,2
1/04/2021,Lithuania,W.P. Labuan,0,0,0
1/04/2021,Luxembourg,Johor,0,0,0
1/04/2021,Luxembourg,Kedah,0,0,0
1/04/2021,Luxembourg,Kelantan,0,0,0
1/04/2021,Luxembourg,Perak,0,0,0
1/04/2021,Luxembourg,Perlis,0,0,0
1/04/2021,Luxembourg,Pulau Pinang,0,0,0
1/04/2021,Luxembourg,Sabah,0,0,0
1/04/2021,Luxembourg,Sarawak,0,0,0
1/04/2021,Luxembourg,Selangor,2,1,1
1/04/2021,Latvia,Johor,0,0,0
1/04/2021,Latvia,Kedah,0,0,0
1/04/2021,Latvia,Kelantan,0,0,0
1/04/2021,Latvia,Pahang,0,0,0
1/04/2021,Latvia,Perak,0,0,0
1/04/2021,Latvia,Perlis,0,0,0
1/04/2021,Latvia,Pulau Pinang,0,0,0
1/04/2021,Latvia,Sabah,0,0,0
1/04/2021,Latvia,Sarawak,0,0,0
1/04/2021,Latvia,Selangor,2,2,0
1/04/2021,Latvia,W.P. Labuan,0,0,0
1/04/2021,Macao,Johor,0,0,0
1/04/2021,Macao,Pahang,0,0,0
1/04/2021,Macao,Perak,0,0,0
1/04/2021,Macao,Selangor,0,0,0
1/04/2021,Macao,W.P. Labuan,0,0,0
1/04/2021,Morocco,Johor,0,0,0
1/04/2021,Morocco,Kedah,0,0,0
1/04/2021,Morocco,Kelantan,0,0,0
1/04/2021,Morocco,Melaka,0,0,0
1/04/2021,Morocco,Pahang,0,0,0
1/04/2021,Morocco,Perak,0,0,0
1/04/2021,Morocco,Perlis,0,0,0
1/04/2021,Morocco,Pulau Pinang,0,0,0
1/04/2021,Morocco,Sabah,0,0,0
1/04/2021,Morocco,Sarawak,0,0,0
1/04/2021,Morocco,Selangor,12,6,6
1/04/2021,Morocco,W.P. Labuan,0,0,0
1/04/2021,Monaco,Johor,0,0,0
1/04/2021,Monaco,Kedah,0,0,0
1/04/2021,Monaco,Sabah,0,0,0
1/04/2021,Monaco,Selangor,0,0,0
1/04/2021,"Moldova, Republic of",Johor,0,0,0
1/04/2021,"Moldova, Republic of",Kedah,0,0,0
1/04/2021,"Moldova, Republic of",Kelantan,0,0,0
1/04/2021,"Moldova, Republic of",Negeri Sembilan,0,0,0
1/04/2021,"Moldova, Republic of",Perlis,0,0,0
1/04/2021,"Moldova, Republic of",Pulau Pinang,0,0,0
1/04/2021,"Moldova, Republic of",Sabah,0,0,0
1/04/2021,"Moldova, Republic of",Sarawak,0,0,0
1/04/2021,"Moldova, Republic of",Selangor,1,0,1
1/04/2021,Madagascar,Johor,0,0,0
1/04/2021,Madagascar,Kedah,0,0,0
1/04/2021,Madagascar,Perak,0,0,0
1/04/2021,Madagascar,Perlis,0,0,0
1/04/2021,Madagascar,Pulau Pinang,0,0,0
1/04/2021,Madagascar,Sabah,0,0,0
1/04/2021,Madagascar,Sarawak,0,0,0
1/04/2021,Madagascar,Selangor,1,1,0
1/04/2021,Maldives,Johor,0,0,0
1/04/2021,Maldives,Kedah,0,0,0
1/04/2021,Maldives,Kelantan,0,0,0
1/04/2021,Maldives,Perak,0,0,0
1/04/2021,Maldives,Perlis,0,0,0
1/04/2021,Maldives,Pulau Pinang,0,0,0
1/04/2021,Maldives,Sabah,0,0,0
1/04/2021,Maldives,Sarawak,0,0,0
1/04/2021,Maldives,Selangor,97,42,55
1/04/2021,Mexico,Johor,0,0,0
1/04/2021,Mexico,Kedah,0,0,0
1/04/2021,Mexico,Kelantan,0,0,0
1/04/2021,Mexico,Pahang,0,0,0
1/04/2021,Mexico,Perak,0,0,0
1/04/2021,Mexico,Perlis,0,0,0
1/04/2021,Mexico,Pulau Pinang,0,0,0
1/04/2021,Mexico,Sabah,0,0,0
1/04/2021,Mexico,Sarawak,0,0,0
1/04/2021,Mexico,Selangor,11,7,4
1/04/2021,Mexico,W.P. Labuan,0,0,0
1/04/2021,Marshall Islands,Johor,0,0,0
1/04/2021,Marshall Islands,Kedah,0,0,0
1/04/2021,Marshall Islands,Perak,0,0,0
1/04/2021,Marshall Islands,Pulau Pinang,0,0,0
1/04/2021,Marshall Islands,Sabah,0,0,0
1/04/2021,Marshall Islands,Selangor,1,1,0
1/04/2021,North Macedonia,Johor,0,0,0
1/04/2021,North Macedonia,Kedah,0,0,0
1/04/2021,North Macedonia,Perak,0,0,0
1/04/2021,North Macedonia,Pulau Pinang,0,0,0
1/04/2021,North Macedonia,Sabah,0,0,0
1/04/2021,North Macedonia,Sarawak,0,0,0
1/04/2021,North Macedonia,Selangor,2,2,0
1/04/2021,Mali,Johor,0,0,0
1/04/2021,Mali,Sabah,0,0,0
1/04/2021,Mali,Selangor,6,4,2
1/04/2021,Malta,Johor,0,0,0
1/04/2021,Malta,Kedah,0,0,0
1/04/2021,Malta,Kelantan,0,0,0
1/04/2021,Malta,Perak,0,0,0
1/04/2021,Malta,Perlis,0,0,0
1/04/2021,Malta,Pulau Pinang,0,0,0
1/04/2021,Malta,Sabah,0,0,0
1/04/2021,Malta,Sarawak,0,0,0
1/04/2021,Malta,Selangor,1,1,0
1/04/2021,Malta,W.P. Labuan,0,0,0
1/04/2021,Myanmar,Johor,6,5,1
1/04/2021,Myanmar,Kedah,0,0,0
1/04/2021,Myanmar,Kelantan,0,0,0
1/04/2021,Myanmar,Negeri Sembilan,0,0,0
1/04/2021,Myanmar,Pahang,0,0,0
1/04/2021,Myanmar,Perak,0,0,0
1/04/2021,Myanmar,Perlis,0,0,0
1/04/2021,Myanmar,Pulau Pinang,0,0,0
1/04/2021,Myanmar,Sabah,0,0,0
1/04/2021,Myanmar,Sarawak,0,0,0
1/04/2021,Myanmar,Selangor,103,90,13
1/04/2021,Myanmar,Terengganu,0,0,0
1/04/2021,Myanmar,W.P. Labuan,0,0,0
1/04/2021,Montenegro,Johor,0,0,0
1/04/2021,Montenegro,Kedah,0,0,0
1/04/2021,Montenegro,Pulau Pinang,0,0,0
1/04/2021,Montenegro,Sabah,0,0,0
1/04/2021,Montenegro,Sarawak,0,0,0
1/04/2021,Montenegro,Selangor,6,6,0
1/04/2021,Mongolia,Johor,0,0,0
1/04/2021,Mongolia,Kedah,0,0,0
1/04/2021,Mongolia,Kelantan,0,0,0
1/04/2021,Mongolia,Perak,0,0,0
1/04/2021,Mongolia,Perlis,0,0,0
1/04/2021,Mongolia,Pulau Pinang,0,0,0
1/04/2021,Mongolia,Sabah,0,0,0
1/04/2021,Mongolia,Sarawak,0,0,0
1/04/2021,Mongolia,Selangor,0,0,0
1/04/2021,Northern Mariana Islands,Selangor,0,0,0
1/04/2021,Mozambique,Johor,0,0,0
1/04/2021,Mozambique,Kedah,0,0,0
1/04/2021,Mozambique,Perak,0,0,0
1/04/2021,Mozambique,Pulau Pinang,0,0,0
1/04/2021,Mozambique,Sabah,0,0,0
1/04/2021,Mozambique,Sarawak,0,0,0
1/04/2021,Mozambique,Selangor,4,4,0
1/04/2021,Mauritania,Johor,0,0,0
1/04/2021,Mauritania,Kedah,0,0,0
1/04/2021,Mauritania,Pulau Pinang,0,0,0
1/04/2021,Mauritania,Sabah,0,0,0
1/04/2021,Mauritania,Sarawak,0,0,0
1/04/2021,Mauritania,Selangor,2,1,1
1/04/2021,Mauritius,Johor,0,0,0
1/04/2021,Mauritius,Kedah,0,0,0
1/04/2021,Mauritius,Kelantan,0,0,0
1/04/2021,Mauritius,Pahang,0,0,0
1/04/2021,Mauritius,Perak,0,0,0
1/04/2021,Mauritius,Perlis,0,0,0
1/04/2021,Mauritius,Pulau Pinang,0,0,0
1/04/2021,Mauritius,Sabah,0,0,0
1/04/2021,Mauritius,Sarawak,0,0,0
1/04/2021,Mauritius,Selangor,8,4,4
1/04/2021,Malawi,Johor,0,0,0
1/04/2021,Malawi,Pulau Pinang,0,0,0
1/04/2021,Malawi,Sabah,0,0,0
1/04/2021,Malawi,Sarawak,0,0,0
1/04/2021,Malawi,Selangor,7,5,2
1/04/2021,Mayotte,Selangor,0,0,0
1/04/2021,Namibia,Johor,0,0,0
1/04/2021,Namibia,Kedah,0,0,0
1/04/2021,Namibia,Perak,0,0,0
1/04/2021,Namibia,Perlis,0,0,0
1/04/2021,Namibia,Pulau Pinang,0,0,0
1/04/2021,Namibia,Sabah,0,0,0
1/04/2021,Namibia,Sarawak,0,0,0
1/04/2021,Namibia,Selangor,4,3,1
1/04/2021,New Caledonia,Selangor,0,0,0
1/04/2021,Niger,Johor,0,0,0
1/04/2021,Niger,Sabah,0,0,0
1/04/2021,Niger,Selangor,0,0,0
1/04/2021,Nigeria,Johor,0,0,0
1/04/2021,Nigeria,Kedah,0,0,0
1/04/2021,Nigeria,Perlis,0,0,0
1/04/2021,Nigeria,Pulau Pinang,0,0,0
1/04/2021,Nigeria,Sabah,0,0,0
1/04/2021,Nigeria,Sarawak,0,0,0
1/04/2021,Nigeria,Selangor,164,155,9
1/04/2021,Nicaragua,Johor,0,0,0
1/04/2021,Nicaragua,Kedah,0,0,0
1/04/2021,Nicaragua,Pulau Pinang,0,0,0
1/04/2021,Nicaragua,Sabah,0,0,0
1/04/2021,Nicaragua,Selangor,5,5,0
1/04/2021,Netherlands,Johor,4,4,0
1/04/2021,Netherlands,Kedah,0,0,0
1/04/2021,Netherlands,Kelantan,0,0,0
1/04/2021,Netherlands,Melaka,0,0,0
1/04/2021,Netherlands,Negeri Sembilan,0,0,0
1/04/2021,Netherlands,Pahang,0,0,0
1/04/2021,Netherlands,Perak,0,0,0
1/04/2021,Netherlands,Perlis,0,0,0
1/04/2021,Netherlands,Pulau Pinang,0,0,0
1/04/2021,Netherlands,Sabah,0,0,0
1/04/2021,Netherlands,Sarawak,0,0,0
1/04/2021,Netherlands,Selangor,61,50,11
1/04/2021,Netherlands,Terengganu,0,0,0
1/04/2021,Netherlands,W.P. Labuan,0,0,0
1/04/2021,Norway,Johor,1,1,0
1/04/2021,Norway,Kedah,0,0,0
1/04/2021,Norway,Kelantan,0,0,0
1/04/2021,Norway,Melaka,0,0,0
1/04/2021,Norway,Pahang,0,0,0
1/04/2021,Norway,Perak,0,0,0
1/04/2021,Norway,Perlis,0,0,0
1/04/2021,Norway,Pulau Pinang,0,0,0
1/04/2021,Norway,Sabah,0,0,0
1/04/2021,Norway,Sarawak,0,0,0
1/04/2021,Norway,Selangor,12,10,2
1/04/2021,Norway,W.P. Labuan,0,0,0
1/04/2021,Nepal,Johor,0,0,0
1/04/2021,Nepal,Kedah,0,0,0
1/04/2021,Nepal,Pahang,0,0,0
1/04/2021,Nepal,Perak,0,0,0
1/04/2021,Nepal,Perlis,0,0,0
1/04/2021,Nepal,Pulau Pinang,0,0,0
1/04/2021,Nepal,Sabah,0,0,0
1/04/2021,Nepal,Sarawak,0,0,0
1/04/2021,Nepal,Selangor,182,178,4
1/04/2021,Nepal,W.P. Labuan,0,0,0
1/04/2021,Nauru,Johor,0,0,0
1/04/2021,Nauru,Pulau Pinang,0,0,0
1/04/2021,Nauru,Selangor,0,0,0
1/04/2021,New Zealand,Johor,0,0,0
1/04/2021,New Zealand,Kedah,0,0,0
1/04/2021,New Zealand,Kelantan,0,0,0
1/04/2021,New Zealand,Melaka,0,0,0
1/04/2021,New Zealand,Negeri Sembilan,0,0,0
1/04/2021,New Zealand,Pahang,0,0,0
1/04/2021,New Zealand,Perak,0,0,0
1/04/2021,New Zealand,Perlis,0,0,0
1/04/2021,New Zealand,Pulau Pinang,0,0,0
1/04/2021,New Zealand,Sabah,0,0,0
1/04/2021,New Zealand,Sarawak,0,0,0
1/04/2021,New Zealand,Selangor,26,17,9
1/04/2021,New Zealand,Terengganu,0,0,0
1/04/2021,New Zealand,W.P. Labuan,0,0,0
1/04/2021,Oman,Johor,0,0,0
1/04/2021,Oman,Kedah,0,0,0
1/04/2021,Oman,Kelantan,0,0,0
1/04/2021,Oman,Melaka,0,0,0
1/04/2021,Oman,Perak,0,0,0
1/04/2021,Oman,Perlis,0,0,0
1/04/2021,Oman,Pulau Pinang,0,0,0
1/04/2021,Oman,Sabah,0,0,0
1/04/2021,Oman,Sarawak,0,0,0
1/04/2021,Oman,Selangor,10,6,4
1/04/2021,Pakistan,Johor,13,13,0
1/04/2021,Pakistan,Kedah,0,0,0
1/04/2021,Pakistan,Kelantan,0,0,0
1/04/2021,Pakistan,Melaka,0,0,0
1/04/2021,Pakistan,Negeri Sembilan,0,0,0
1/04/2021,Pakistan,Pahang,0,0,0
1/04/2021,Pakistan,Perak,0,0,0
1/04/2021,Pakistan,Perlis,0,0,0
1/04/2021,Pakistan,Pulau Pinang,0,0,0
1/04/2021,Pakistan,Sabah,1,1,0
1/04/2021,Pakistan,Sarawak,0,0,0
1/04/2021,Pakistan,Selangor,298,232,66
1/04/2021,Pakistan,W.P. Labuan,0,0,0
1/04/2021,Panama,Johor,0,0,0
1/04/2021,Panama,Kedah,0,0,0
1/04/2021,Panama,Perak,0,0,0
1/04/2021,Panama,Perlis,0,0,0
1/04/2021,Panama,Pulau Pinang,0,0,0
1/04/2021,Panama,Sabah,0,0,0
1/04/2021,Panama,Sarawak,0,0,0
1/04/2021,Panama,Selangor,1,1,0
1/04/2021,Peru,Johor,0,0,0
1/04/2021,Peru,Kedah,0,0,0
1/04/2021,Peru,Kelantan,0,0,0
1/04/2021,Peru,Pahang,0,0,0
1/04/2021,Peru,Perak,0,0,0
1/04/2021,Peru,Perlis,0,0,0
1/04/2021,Peru,Pulau Pinang,0,0,0
1/04/2021,Peru,Sabah,0,0,0
1/04/2021,Peru,Sarawak,0,0,0
1/04/2021,Peru,Selangor,2,1,1
1/04/2021,Peru,W.P. Labuan,0,0,0
1/04/2021,Philippines,Johor,158,156,2
1/04/2021,Philippines,Kedah,0,0,0
1/04/2021,Philippines,Kelantan,0,0,0
1/04/2021,Philippines,Melaka,0,0,0
1/04/2021,Philippines,Negeri Sembilan,0,0,0
1/04/2021,Philippines,Pahang,0,0,0
1/04/2021,Philippines,Perak,0,0,0
1/04/2021,Philippines,Perlis,0,0,0
1/04/2021,Philippines,Pulau Pinang,1,1,0
1/04/2021,Philippines,Sabah,0,0,0
1/04/2021,Philippines,Sarawak,72,72,0
1/04/2021,Philippines,Selangor,622,512,110
1/04/2021,Philippines,Terengganu,0,0,0
1/04/2021,Philippines,W.P. Labuan,2,2,0
1/04/2021,Palau,Johor,0,0,0
1/04/2021,Palau,Pulau Pinang,0,0,0
1/04/2021,Palau,Selangor,0,0,0
1/04/2021,Papua New Guinea,Johor,0,0,0
1/04/2021,Papua New Guinea,Kedah,0,0,0
1/04/2021,Papua New Guinea,Kelantan,0,0,0
1/04/2021,Papua New Guinea,Perak,0,0,0
1/04/2021,Papua New Guinea,Pulau Pinang,0,0,0
1/04/2021,Papua New Guinea,Sabah,0,0,0
1/04/2021,Papua New Guinea,Sarawak,0,0,0
1/04/2021,Papua New Guinea,Selangor,1,0,1
1/04/2021,Poland,Johor,4,4,0
1/04/2021,Poland,Kedah,0,0,0
1/04/2021,Poland,Kelantan,0,0,0
1/04/2021,Poland,Melaka,0,0,0
1/04/2021,Poland,Negeri Sembilan,0,0,0
1/04/2021,Poland,Pahang,0,0,0
1/04/2021,Poland,Perak,0,0,0
1/04/2021,Poland,Perlis,0,0,0
1/04/2021,Poland,Pulau Pinang,0,0,0
1/04/2021,Poland,Sabah,0,0,0
1/04/2021,Poland,Sarawak,0,0,0
1/04/2021,Poland,Selangor,26,26,0
1/04/2021,Poland,Terengganu,0,0,0
1/04/2021,Poland,W.P. Labuan,0,0,0
1/04/2021,"North Korea, Democratic People's Republic of",Selangor,0,0,0
1/04/2021,Portugal,Johor,0,0,0
1/04/2021,Portugal,Kedah,0,0,0
1/04/2021,Portugal,Kelantan,0,0,0
1/04/2021,Portugal,Melaka,0,0,0
1/04/2021,Portugal,Pahang,0,0,0
1/04/2021,Portugal,Perak,0,0,0
1/04/2021,Portugal,Perlis,0,0,0
1/04/2021,Portugal,Pulau Pinang,0,0,0
1/04/2021,Portugal,Sabah,0,0,0
1/04/2021,Portugal,Sarawak,0,0,0
1/04/2021,Portugal,Selangor,7,4,3
1/04/2021,Portugal,W.P. Labuan,0,0,0
1/04/2021,Paraguay,Johor,0,0,0
1/04/2021,Paraguay,Kedah,0,0,0
1/04/2021,Paraguay,Perak,0,0,0
1/04/2021,Paraguay,Perlis,0,0,0
1/04/2021,Paraguay,Pulau Pinang,0,0,0
1/04/2021,Paraguay,Sabah,0,0,0
1/04/2021,Paraguay,Sarawak,0,0,0
1/04/2021,Paraguay,Selangor,0,0,0
1/04/2021,"Palestine, State of",Johor,0,0,0
1/04/2021,"Palestine, State of",Kedah,0,0,0
1/04/2021,"Palestine, State of",Kelantan,0,0,0
1/04/2021,"Palestine, State of",Melaka,0,0,0
1/04/2021,"Palestine, State of",Perak,0,0,0
1/04/2021,"Palestine, State of",Perlis,0,0,0
1/04/2021,"Palestine, State of",Pulau Pinang,0,0,0
1/04/2021,"Palestine, State of",Sabah,0,0,0
1/04/2021,"Palestine, State of",Sarawak,0,0,0
1/04/2021,"Palestine, State of",Selangor,15,14,1
1/04/2021,Qatar,Johor,0,0,0
1/04/2021,Qatar,Kedah,0,0,0
1/04/2021,Qatar,Perlis,0,0,0
1/04/2021,Qatar,Pulau Pinang,0,0,0
1/04/2021,Qatar,Sabah,0,0,0
1/04/2021,Qatar,Sarawak,0,0,0
1/04/2021,Qatar,Selangor,8,4,4
1/04/2021,Réunion,Johor,0,0,0
1/04/2021,Réunion,Sarawak,0,0,0
1/04/2021,Romania,Johor,0,0,0
1/04/2021,Romania,Kedah,0,0,0
1/04/2021,Romania,Kelantan,0,0,0
1/04/2021,Romania,Negeri Sembilan,0,0,0
1/04/2021,Romania,Pahang,0,0,0
1/04/2021,Romania,Perak,0,0,0
1/04/2021,Romania,Perlis,0,0,0
1/04/2021,Romania,Pulau Pinang,0,0,0
1/04/2021,Romania,Sabah,0,0,0
1/04/2021,Romania,Sarawak,0,0,0
1/04/2021,Romania,Selangor,22,19,3
1/04/2021,Romania,W.P. Labuan,0,0,0
1/04/2021,Russian Federation (Russia),Johor,5,5,0
1/04/2021,Russian Federation (Russia),Kedah,3,3,0
1/04/2021,Russian Federation (Russia),Kelantan,0,0,0
1/04/2021,Russian Federation (Russia),Melaka,0,0,0
1/04/2021,Russian Federation (Russia),Negeri Sembilan,0,0,0
1/04/2021,Russian Federation (Russia),Pahang,0,0,0
1/04/2021,Russian Federation (Russia),Perak,0,0,0
1/04/2021,Russian Federation (Russia),Perlis,0,0,0
1/04/2021,Russian Federation (Russia),Pulau Pinang,0,0,0
1/04/2021,Russian Federation (Russia),Sabah,0,0,0
1/04/2021,Russian Federation (Russia),Sarawak,0,0,0
1/04/2021,Russian Federation (Russia),Selangor,101,84,17
1/04/2021,Russian Federation (Russia),W.P. Labuan,0,0,0
1/04/2021,Rwanda,Johor,0,0,0
1/04/2021,Rwanda,Kedah,0,0,0
1/04/2021,Rwanda,Pulau Pinang,0,0,0
1/04/2021,Rwanda,Selangor,4,3,1
1/04/2021,Saudi Arabia,Johor,0,0,0
1/04/2021,Saudi Arabia,Kedah,0,0,0
1/04/2021,Saudi Arabia,Kelantan,0,0,0
1/04/2021,Saudi Arabia,Melaka,0,0,0
1/04/2021,Saudi Arabia,Perak,0,0,0
1/04/2021,Saudi Arabia,Perlis,0,0,0
1/04/2021,Saudi Arabia,Pulau Pinang,0,0,0
1/04/2021,Saudi Arabia,Sabah,0,0,0
1/04/2021,Saudi Arabia,Sarawak,0,0,0
1/04/2021,Saudi Arabia,Selangor,64,36,28
1/04/2021,Saudi Arabia,W.P. Labuan,0,0,0
1/04/2021,Sudan,Johor,0,0,0
1/04/2021,Sudan,Kedah,0,0,0
1/04/2021,Sudan,Kelantan,0,0,0
1/04/2021,Sudan,Perlis,0,0,0
1/04/2021,Sudan,Pulau Pinang,0,0,0
1/04/2021,Sudan,Sabah,0,0,0
1/04/2021,Sudan,Sarawak,0,0,0
1/04/2021,Sudan,Selangor,67,40,27
1/04/2021,Sudan,W.P. Labuan,0,0,0
1/04/2021,Senegal,Johor,0,0,0
1/04/2021,Senegal,Kedah,0,0,0
1/04/2021,Senegal,Kelantan,0,0,0
1/04/2021,Senegal,Perak,0,0,0
1/04/2021,Senegal,Perlis,0,0,0
1/04/2021,Senegal,Pulau Pinang,0,0,0
1/04/2021,Senegal,Sabah,0,0,0
1/04/2021,Senegal,Sarawak,0,0,0
1/04/2021,Senegal,Selangor,2,2,0
1/04/2021,Singapore,Johor,244,217,27
1/04/2021,Singapore,Kedah,0,0,0
1/04/2021,Singapore,Kelantan,0,0,0
1/04/2021,Singapore,Melaka,0,0,0
1/04/2021,Singapore,Negeri Sembilan,0,0,0
1/04/2021,Singapore,Pahang,0,0,0
1/04/2021,Singapore,Perak,8,3,5
1/04/2021,Singapore,Perlis,1,0,1
1/04/2021,Singapore,Pulau Pinang,20,14,6
1/04/2021,Singapore,Sabah,1,1,0
1/04/2021,Singapore,Sarawak,6,4,2
1/04/2021,Singapore,Selangor,162,104,58
1/04/2021,Singapore,Terengganu,0,0,0
1/04/2021,Singapore,W.P. Labuan,0,0,0
1/04/2021,South Georgia and the South Sandwich Islands,Johor,0,0,0
1/04/2021,South Georgia and the South Sandwich Islands,Sabah,0,0,0
1/04/2021,South Georgia and the South Sandwich Islands,Selangor,0,0,0
1/04/2021,Saint Helena,Sarawak,0,0,0
1/04/2021,Solomon Islands,Johor,0,0,0
1/04/2021,Solomon Islands,Perlis,0,0,0
1/04/2021,Solomon Islands,Pulau Pinang,0,0,0
1/04/2021,Solomon Islands,Sabah,0,0,0
1/04/2021,Solomon Islands,Sarawak,0,0,0
1/04/2021,Solomon Islands,Selangor,0,0,0
1/04/2021,Solomon Islands,W.P. Labuan,0,0,0
1/04/2021,Sierra Leone,Johor,0,0,0
1/04/2021,Sierra Leone,Kedah,0,0,0
1/04/2021,Sierra Leone,Perak,0,0,0
1/04/2021,Sierra Leone,Pulau Pinang,0,0,0
1/04/2021,Sierra Leone,Sabah,0,0,0
1/04/2021,Sierra Leone,Selangor,2,2,0
1/04/2021,El Salvador,Johor,0,0,0
1/04/2021,El Salvador,Kedah,0,0,0
1/04/2021,El Salvador,Perak,0,0,0
1/04/2021,El Salvador,Perlis,0,0,0
1/04/2021,El Salvador,Pulau Pinang,0,0,0
1/04/2021,El Salvador,Sabah,0,0,0
1/04/2021,El Salvador,Selangor,0,0,0
1/04/2021,El Salvador,W.P. Labuan,0,0,0
1/04/2021,San Marino,Johor,0,0,0
1/04/2021,San Marino,Selangor,0,0,0
1/04/2021,Somalia,Johor,0,0,0
1/04/2021,Somalia,Kedah,0,0,0
1/04/2021,Somalia,Kelantan,0,0,0
1/04/2021,Somalia,Perlis,0,0,0
1/04/2021,Somalia,Sabah,0,0,0
1/04/2021,Somalia,Sarawak,0,0,0
1/04/2021,Somalia,Selangor,48,38,10
1/04/2021,Serbia,Johor,0,0,0
1/04/2021,Serbia,Kedah,0,0,0
1/04/2021,Serbia,Kelantan,0,0,0
1/04/2021,Serbia,Pahang,0,0,0
1/04/2021,Serbia,Perak,0,0,0
1/04/2021,Serbia,Perlis,0,0,0
1/04/2021,Serbia,Pulau Pinang,0,0,0
1/04/2021,Serbia,Sabah,0,0,0
1/04/2021,Serbia,Sarawak,0,0,0
1/04/2021,Serbia,Selangor,2,1,1
1/04/2021,South Sudan,Johor,0,0,0
1/04/2021,South Sudan,Kedah,0,0,0
1/04/2021,South Sudan,Sarawak,0,0,0
1/04/2021,South Sudan,Selangor,4,3,1
1/04/2021,South Sudan,W.P. Labuan,0,0,0
1/04/2021,Sao Tome and Principe,Selangor,0,0,0
1/04/2021,Suriname,Johor,0,0,0
1/04/2021,Suriname,Kedah,0,0,0
1/04/2021,Suriname,Kelantan,0,0,0
1/04/2021,Suriname,Perak,0,0,0
1/04/2021,Suriname,Perlis,0,0,0
1/04/2021,Suriname,Pulau Pinang,0,0,0
1/04/2021,Suriname,Sabah,0,0,0
1/04/2021,Suriname,Sarawak,0,0,0
1/04/2021,Suriname,Selangor,0,0,0
1/04/2021,Slovakia,Johor,0,0,0
1/04/2021,Slovakia,Kedah,0,0,0
1/04/2021,Slovakia,Kelantan,0,0,0
1/04/2021,Slovakia,Negeri Sembilan,0,0,0
1/04/2021,Slovakia,Pahang,0,0,0
1/04/2021,Slovakia,Perak,0,0,0
1/04/2021,Slovakia,Perlis,0,0,0
1/04/2021,Slovakia,Pulau Pinang,0,0,0
1/04/2021,Slovakia,Sabah,0,0,0
1/04/2021,Slovakia,Sarawak,0,0,0
1/04/2021,Slovakia,Selangor,11,8,3
1/04/2021,Slovakia,W.P. Labuan,0,0,0
1/04/2021,Slovenia,Johor,0,0,0
1/04/2021,Slovenia,Kedah,0,0,0
1/04/2021,Slovenia,Kelantan,0,0,0
1/04/2021,Slovenia,Perak,0,0,0
1/04/2021,Slovenia,Perlis,0,0,0
1/04/2021,Slovenia,Pulau Pinang,0,0,0
1/04/2021,Slovenia,Sabah,0,0,0
1/04/2021,Slovenia,Sarawak,0,0,0
1/04/2021,Slovenia,Selangor,1,1,0
1/04/2021,Slovenia,W.P. Labuan,0,0,0
1/04/2021,Sweden,Johor,2,2,0
1/04/2021,Sweden,Kedah,0,0,0
1/04/2021,Sweden,Kelantan,0,0,0
1/04/2021,Sweden,Melaka,0,0,0
1/04/2021,Sweden,Negeri Sembilan,0,0,0
1/04/2021,Sweden,Pahang,0,0,0
1/04/2021,Sweden,Perak,0,0,0
1/04/2021,Sweden,Perlis,0,0,0
1/04/2021,Sweden,Pulau Pinang,0,0,0
1/04/2021,Sweden,Sabah,0,0,0
1/04/2021,Sweden,Sarawak,0,0,0
1/04/2021,Sweden,Selangor,32,27,5
1/04/2021,Sweden,W.P. Labuan,0,0,0
1/04/2021,Eswatini,Johor,0,0,0
1/04/2021,Eswatini,Kedah,0,0,0
1/04/2021,Eswatini,Pulau Pinang,0,0,0
1/04/2021,Eswatini,Sabah,0,0,0
1/04/2021,Eswatini,Selangor,1,1,0
1/04/2021,Seychelles,Johor,0,0,0
1/04/2021,Seychelles,Kedah,0,0,0
1/04/2021,Seychelles,Pulau Pinang,0,0,0
1/04/2021,Seychelles,Sabah,0,0,0
1/04/2021,Seychelles,Sarawak,0,0,0
1/04/2021,Seychelles,Selangor,6,1,5
1/04/2021,Syrian Arab Republic,Johor,0,0,0
1/04/2021,Syrian Arab Republic,Kedah,0,0,0
1/04/2021,Syrian Arab Republic,Kelantan,0,0,0
1/04/2021,Syrian Arab Republic,Pahang,0,0,0
1/04/2021,Syrian Arab Republic,Perlis,0,0,0
1/04/2021,Syrian Arab Republic,Pulau Pinang,0,0,0
1/04/2021,Syrian Arab Republic,Sabah,0,0,0
1/04/2021,Syrian Arab Republic,Sarawak,0,0,0
1/04/2021,Syrian Arab Republic,Selangor,33,22,11
1/04/2021,Syrian Arab Republic,W.P. Labuan,0,0,0
1/04/2021,Turks and Caicos Islands,Perlis,0,0,0
1/04/2021,TCD,Johor,0,0,0
1/04/2021,TCD,Kedah,0,0,0
1/04/2021,TCD,Perlis,0,0,0
1/04/2021,TCD,Selangor,3,3,0
1/04/2021,Togo,Johor,0,0,0
1/04/2021,Togo,Perak,0,0,0
1/04/2021,Togo,Pulau Pinang,0,0,0
1/04/2021,Togo,Selangor,1,1,0
1/04/2021,Thailand,Johor,7,7,0
1/04/2021,Thailand,Kedah,17845,17805,40
1/04/2021,Thailand,Kelantan,5,2,3
1/04/2021,Thailand,Melaka,0,0,0
1/04/2021,Thailand,Negeri Sembilan,0,0,0
1/04/2021,Thailand,Pahang,0,0,0
1/04/2021,Thailand,Perak,0,0,0
1/04/2021,Thailand,Perlis,8154,7874,280
1/04/2021,Thailand,Pulau Pinang,2,1,1
1/04/2021,Thailand,Sabah,0,0,0
1/04/2021,Thailand,Sarawak,14,14,0
1/04/2021,Thailand,Selangor,243,144,99
1/04/2021,Thailand,Terengganu,0,0,0
1/04/2021,Thailand,W.P. Labuan,0,0,0
1/04/2021,Tajikistan,Johor,0,0,0
1/04/2021,Tajikistan,Kedah,0,0,0
1/04/2021,Tajikistan,Perlis,0,0,0
1/04/2021,Tajikistan,Pulau Pinang,0,0,0
1/04/2021,Tajikistan,Sabah,0,0,0
1/04/2021,Tajikistan,Selangor,3,3,0
1/04/2021,Tokelau,Selangor,0,0,0
1/04/2021,Turkmenistan,Johor,0,0,0
1/04/2021,Turkmenistan,Kedah,0,0,0
1/04/2021,Turkmenistan,Kelantan,0,0,0
1/04/2021,Turkmenistan,Perlis,0,0,0
1/04/2021,Turkmenistan,Pulau Pinang,0,0,0
1/04/2021,Turkmenistan,Sabah,0,0,0
1/04/2021,Turkmenistan,Sarawak,0,0,0
1/04/2021,Turkmenistan,Selangor,1,0,1
1/04/2021,Timor-Leste,Johor,0,0,0
1/04/2021,Timor-Leste,Kedah,0,0,0
1/04/2021,Timor-Leste,Perlis,0,0,0
1/04/2021,Timor-Leste,Pulau Pinang,0,0,0
1/04/2021,Timor-Leste,Sabah,0,0,0
1/04/2021,Timor-Leste,Sarawak,0,0,0
1/04/2021,Timor-Leste,Selangor,2,1,1
1/04/2021,Tonga,Johor,0,0,0
1/04/2021,Tonga,Pulau Pinang,0,0,0
1/04/2021,Tonga,Sarawak,0,0,0
1/04/2021,Tonga,Selangor,0,0,0
1/04/2021,Trinidad and Tobago,Johor,0,0,0
1/04/2021,Trinidad and Tobago,Kedah,0,0,0
1/04/2021,Trinidad and Tobago,Pahang,0,0,0
1/04/2021,Trinidad and Tobago,Pulau Pinang,0,0,0
1/04/2021,Trinidad and Tobago,Sabah,0,0,0
1/04/2021,Trinidad and Tobago,Sarawak,0,0,0
1/04/2021,Trinidad and Tobago,Selangor,1,0,1
1/04/2021,Tunisia,Johor,0,0,0
1/04/2021,Tunisia,Kedah,0,0,0
1/04/2021,Tunisia,Kelantan,0,0,0
1/04/2021,Tunisia,Melaka,0,0,0
1/04/2021,Tunisia,Perak,0,0,0
1/04/2021,Tunisia,Perlis,0,0,0
1/04/2021,Tunisia,Pulau Pinang,0,0,0
1/04/2021,Tunisia,Sabah,0,0,0
1/04/2021,Tunisia,Sarawak,0,0,0
1/04/2021,Tunisia,Selangor,6,3,3
1/04/2021,Tunisia,W.P. Labuan,0,0,0
1/04/2021,Türkiye,Johor,1,1,0
1/04/2021,Türkiye,Kedah,0,0,0
1/04/2021,Türkiye,Kelantan,0,0,0
1/04/2021,Türkiye,Melaka,0,0,0
1/04/2021,Türkiye,Negeri Sembilan,0,0,0
1/04/2021,Türkiye,Pahang,0,0,0
1/04/2021,Türkiye,Perak,0,0,0
1/04/2021,Türkiye,Perlis,0,0,0
1/04/2021,Türkiye,Pulau Pinang,0,0,0
1/04/2021,Türkiye,Sabah,0,0,0
1/04/2021,Türkiye,Sarawak,0,0,0
1/04/2021,Türkiye,Selangor,27,22,5
1/04/2021,Türkiye,W.P. Labuan,0,0,0
1/04/2021,Tuvalu,Selangor,0,0,0
1/04/2021,"Taiwan, Province of China",Johor,2,2,0
1/04/2021,"Taiwan, Province of China",Kedah,0,0,0
1/04/2021,"Taiwan, Province of China",Kelantan,0,0,0
1/04/2021,"Taiwan, Province of China",Melaka,0,0,0
1/04/2021,"Taiwan, Province of China",Negeri Sembilan,0,0,0
1/04/2021,"Taiwan, Province of China",Pahang,0,0,0
1/04/2021,"Taiwan, Province of China",Perak,0,0,0
1/04/2021,"Taiwan, Province of China",Perlis,0,0,0
1/04/2021,"Taiwan, Province of China",Pulau Pinang,15,10,5
1/04/2021,"Taiwan, Province of China",Sabah,0,0,0
1/04/2021,"Taiwan, Province of China",Sarawak,2,2,0
1/04/2021,"Taiwan, Province of China",Selangor,89,65,24
1/04/2021,"Taiwan, Province of China",W.P. Labuan,0,0,0
1/04/2021,"Tanzania, United Republic of",Johor,0,0,0
1/04/2021,"Tanzania, United Republic of",Kedah,0,0,0
1/04/2021,"Tanzania, United Republic of",Perak,0,0,0
1/04/2021,"Tanzania, United Republic of",Perlis,0,0,0
1/04/2021,"Tanzania, United Republic of",Pulau Pinang,0,0,0
1/04/2021,"Tanzania, United Republic of",Sabah,0,0,0
1/04/2021,"Tanzania, United Republic of",Sarawak,0,0,0
1/04/2021,"Tanzania, United Republic of",Selangor,32,14,18
1/04/2021,Uganda,Johor,0,0,0
1/04/2021,Uganda,Kedah,0,0,0
1/04/2021,Uganda,Perak,0,0,0
1/04/2021,Uganda,Perlis,0,0,0
1/04/2021,Uganda,Pulau Pinang,0,0,0
1/04/2021,Uganda,Sabah,0,0,0
1/04/2021,Uganda,Sarawak,0,0,0
1/04/2021,Uganda,Selangor,9,3,6
1/04/2021,Ukraine,Johor,8,8,0
1/04/2021,Ukraine,Kedah,0,0,0
1/04/2021,Ukraine,Kelantan,0,0,0
1/04/2021,Ukraine,Melaka,0,0,0
1/04/2021,Ukraine,Negeri Sembilan,0,0,0
1/04/2021,Ukraine,Pahang,0,0,0
1/04/2021,Ukraine,Perak,0,0,0
1/04/2021,Ukraine,Perlis,0,0,0
1/04/2021,Ukraine,Pulau Pinang,0,0,0
1/04/2021,Ukraine,Sabah,0,0,0
1/04/2021,Ukraine,Sarawak,0,0,0
1/04/2021,Ukraine,Selangor,63,62,1
1/04/2021,Ukraine,W.P. Labuan,0,0,0
1/04/2021,Uruguay,Johor,0,0,0
1/04/2021,Uruguay,Kedah,0,0,0
1/04/2021,Uruguay,Kelantan,0,0,0
1/04/2021,Uruguay,Perak,0,0,0
1/04/2021,Uruguay,Perlis,0,0,0
1/04/2021,Uruguay,Pulau Pinang,0,0,0
1/04/2021,Uruguay,Sabah,0,0,0
1/04/2021,Uruguay,Sarawak,0,0,0
1/04/2021,Uruguay,Selangor,0,0,0
1/04/2021,Uruguay,W.P. Labuan,0,0,0
1/04/2021,United States of America,Johor,0,0,0
1/04/2021,United States of America,Kedah,0,0,0
1/04/2021,United States of America,Kelantan,0,0,0
1/04/2021,United States of America,Melaka,0,0,0
1/04/2021,United States of America,Negeri Sembilan,0,0,0
1/04/2021,United States of America,Pahang,0,0,0
1/04/2021,United States of America,Perak,0,0,0
1/04/2021,United States of America,Perlis,0,0,0
1/04/2021,United States of America,Pulau Pinang,4,0,4
1/04/2021,United States of America,Sabah,0,0,0
1/04/2021,United States of America,Sarawak,2,1,1
1/04/2021,United States of America,Selangor,164,119,45
1/04/2021,United States of America,Terengganu,0,0,0
1/04/2021,United States of America,W.P. Labuan,0,0,0
1/04/2021,Uzbekistan,Johor,0,0,0
1/04/2021,Uzbekistan,Kedah,0,0,0
1/04/2021,Uzbekistan,Kelantan,0,0,0
1/04/2021,Uzbekistan,Perak,0,0,0
1/04/2021,Uzbekistan,Perlis,0,0,0
1/04/2021,Uzbekistan,Pulau Pinang,0,0,0
1/04/2021,Uzbekistan,Sabah,0,0,0
1/04/2021,Uzbekistan,Sarawak,0,0,0
1/04/2021,Uzbekistan,Selangor,13,12,1
1/04/2021,Holy See,Johor,0,0,0
1/04/2021,Holy See,Sarawak,0,0,0
1/04/2021,Holy See,Selangor,0,0,0
1/04/2021,Saint Vincent and the Grenadines,Johor,0,0,0
1/04/2021,Saint Vincent and the Grenadines,Kedah,0,0,0
1/04/2021,Saint Vincent and the Grenadines,Pulau Pinang,0,0,0
1/04/2021,Saint Vincent and the Grenadines,Sarawak,0,0,0
1/04/2021,Saint Vincent and the Grenadines,Selangor,0,0,0
1/04/2021,"Venezuela, Bolivarian Republic of",Johor,0,0,0
1/04/2021,"Venezuela, Bolivarian Republic of",Kedah,0,0,0
1/04/2021,"Venezuela, Bolivarian Republic of",Kelantan,0,0,0
1/04/2021,"Venezuela, Bolivarian Republic of",Melaka,0,0,0
1/04/2021,"Venezuela, Bolivarian Republic of",Perak,0,0,0
1/04/2021,"Venezuela, Bolivarian Republic of",Perlis,0,0,0
1/04/2021,"Venezuela, Bolivarian Republic of",Pulau Pinang,0,0,0
1/04/2021,"Venezuela, Bolivarian Republic of",Sabah,0,0,0
1/04/2021,"Venezuela, Bolivarian Republic of",Sarawak,0,0,0
1/04/2021,"Venezuela, Bolivarian Republic of",Selangor,2,2,0
1/04/2021,"Venezuela, Bolivarian Republic of",W.P. Labuan,0,0,0
1/04/2021,Viet Nam,Johor,1,0,1
1/04/2021,Viet Nam,Kedah,0,0,0
1/04/2021,Viet Nam,Kelantan,0,0,0
1/04/2021,Viet Nam,Melaka,0,0,0
1/04/2021,Viet Nam,Negeri Sembilan,0,0,0
1/04/2021,Viet Nam,Pahang,0,0,0
1/04/2021,Viet Nam,Perak,0,0,0
1/04/2021,Viet Nam,Perlis,0,0,0
1/04/2021,Viet Nam,Pulau Pinang,1,0,1
1/04/2021,Viet Nam,Sabah,0,0,0
1/04/2021,Viet Nam,Sarawak,0,0,0
1/04/2021,Viet Nam,Selangor,118,31,87
1/04/2021,Viet Nam,Terengganu,0,0,0
1/04/2021,Viet Nam,W.P. Labuan,0,0,0
1/04/2021,Vanuatu,Johor,0,0,0
1/04/2021,Vanuatu,Kedah,0,0,0
1/04/2021,Vanuatu,Pulau Pinang,0,0,0
1/04/2021,Vanuatu,Sabah,0,0,0
1/04/2021,Vanuatu,Sarawak,0,0,0
1/04/2021,Vanuatu,Selangor,0,0,0
1/04/2021, Samoa,Johor,0,0,0
1/04/2021, Samoa,Sarawak,0,0,0
1/04/2021, Samoa,Selangor,0,0,0
1/04/2021,Yemen,Johor,0,0,0
1/04/2021,Yemen,Kedah,0,0,0
1/04/2021,Yemen,Kelantan,0,0,0
1/04/2021,Yemen,Melaka,0,0,0
1/04/2021,Yemen,Pahang,0,0,0
1/04/2021,Yemen,Perak,0,0,0
1/04/2021,Yemen,Perlis,0,0,0
1/04/2021,Yemen,Pulau Pinang,0,0,0
1/04/2021,Yemen,Sabah,0,0,0
1/04/2021,Yemen,Sarawak,0,0,0
1/04/2021,Yemen,Selangor,96,77,19
1/04/2021,Yemen,W.P. Labuan,0,0,0
1/04/2021,South Africa,Johor,2,2,0
1/04/2021,South Africa,Kedah,0,0,0
1/04/2021,South Africa,Kelantan,0,0,0
1/04/2021,South Africa,Melaka,0,0,0
1/04/2021,South Africa,Pahang,0,0,0
1/04/2021,South Africa,Perak,0,0,0
1/04/2021,South Africa,Perlis,0,0,0
1/04/2021,South Africa,Pulau Pinang,0,0,0
1/04/2021,South Africa,Sabah,0,0,0
1/04/2021,South Africa,Sarawak,0,0,0
1/04/2021,South Africa,Selangor,41,32,9
1/04/2021,South Africa,Terengganu,0,0,0
1/04/2021,South Africa,W.P. Labuan,0,0,0
1/04/2021,ZAR,Selangor,0,0,0
1/04/2021,Zambia,Johor,0,0,0
1/04/2021,Zambia,Kedah,0,0,0
1/04/2021,Zambia,Perak,0,0,0
1/04/2021,Zambia,Perlis,0,0,0
1/04/2021,Zambia,Pulau Pinang,0,0,0
1/04/2021,Zambia,Sabah,0,0,0
1/04/2021,Zambia,Sarawak,0,0,0
1/04/2021,Zambia,Selangor,15,4,11
1/04/2021,Zimbabwe,Johor,0,0,0
1/04/2021,Zimbabwe,Kedah,0,0,0
1/04/2021,Zimbabwe,Kelantan,0,0,0
1/04/2021,Zimbabwe,Perak,0,0,0
1/04/2021,Zimbabwe,Perlis,0,0,0
1/04/2021,Zimbabwe,Pulau Pinang,0,0,0
1/04/2021,Zimbabwe,Sabah,0,0,0
1/04/2021,Zimbabwe,Sarawak,0,0,0
1/04/2021,Zimbabwe,Selangor,12,6,6
1/05/2021,Aruba,Kedah,0,0,0
1/05/2021,Aruba,Pulau Pinang,0,0,0
1/05/2021,Afghanistan,Johor,0,0,0
1/05/2021,Afghanistan,Kedah,0,0,0
1/05/2021,Afghanistan,Perlis,0,0,0
1/05/2021,Afghanistan,Pulau Pinang,0,0,0
1/05/2021,Afghanistan,Sarawak,0,0,0
1/05/2021,Afghanistan,Selangor,26,18,8
1/05/2021,Angola,Johor,0,0,0
1/05/2021,Angola,Kedah,0,0,0
1/05/2021,Angola,Sabah,0,0,0
1/05/2021,Angola,Selangor,0,0,0
1/05/2021,Anguilla,Selangor,0,0,0
1/05/2021,Albania,Johor,0,0,0
1/05/2021,Albania,Kedah,0,0,0
1/05/2021,Albania,Perak,0,0,0
1/05/2021,Albania,Perlis,0,0,0
1/05/2021,Albania,Pulau Pinang,0,0,0
1/05/2021,Albania,Sabah,0,0,0
1/05/2021,Albania,Sarawak,0,0,0
1/05/2021,Albania,Selangor,1,0,1
1/05/2021,Andorra,Johor,0,0,0
1/05/2021,Andorra,Kedah,0,0,0
1/05/2021,Andorra,Perlis,0,0,0
1/05/2021,Andorra,Pulau Pinang,0,0,0
1/05/2021,Andorra,Selangor,0,0,0
1/05/2021,Antigua and Barbuda,Selangor,0,0,0
1/05/2021,United Arab Emirates,Johor,0,0,0
1/05/2021,United Arab Emirates,Kedah,0,0,0
1/05/2021,United Arab Emirates,Kelantan,0,0,0
1/05/2021,United Arab Emirates,Perak,0,0,0
1/05/2021,United Arab Emirates,Perlis,0,0,0
1/05/2021,United Arab Emirates,Pulau Pinang,0,0,0
1/05/2021,United Arab Emirates,Sabah,0,0,0
1/05/2021,United Arab Emirates,Sarawak,0,0,0
1/05/2021,United Arab Emirates,Selangor,11,6,5
1/05/2021,Argentina,Johor,0,0,0
1/05/2021,Argentina,Kedah,0,0,0
1/05/2021,Argentina,Kelantan,0,0,0
1/05/2021,Argentina,Melaka,0,0,0
1/05/2021,Argentina,Perak,0,0,0
1/05/2021,Argentina,Perlis,0,0,0
1/05/2021,Argentina,Pulau Pinang,0,0,0
1/05/2021,Argentina,Sabah,0,0,0
1/05/2021,Argentina,Sarawak,0,0,0
1/05/2021,Argentina,Selangor,6,6,0
1/05/2021,Argentina,W.P. Labuan,0,0,0
1/05/2021,Armenia,Johor,0,0,0
1/05/2021,Armenia,Kedah,0,0,0
1/05/2021,Armenia,Kelantan,0,0,0
1/05/2021,Armenia,Perak,0,0,0
1/05/2021,Armenia,Perlis,0,0,0
1/05/2021,Armenia,Pulau Pinang,0,0,0
1/05/2021,Armenia,Sabah,0,0,0
1/05/2021,Armenia,Sarawak,0,0,0
1/05/2021,Armenia,Selangor,1,0,1
1/05/2021,Antarctica,Selangor,0,0,0
1/05/2021,Antigua and Barbuda,Johor,0,0,0
1/05/2021,Antigua and Barbuda,Kedah,0,0,0
1/05/2021,Antigua and Barbuda,Pulau Pinang,0,0,0
1/05/2021,Antigua and Barbuda,Sarawak,0,0,0
1/05/2021,Antigua and Barbuda,Selangor,0,0,0
1/05/2021,Australia,Johor,0,0,0
1/05/2021,Australia,Kedah,0,0,0
1/05/2021,Australia,Kelantan,0,0,0
1/05/2021,Australia,Melaka,0,0,0
1/05/2021,Australia,Negeri Sembilan,0,0,0
1/05/2021,Australia,Pahang,0,0,0
1/05/2021,Australia,Perak,0,0,0
1/05/2021,Australia,Perlis,0,0,0
1/05/2021,Australia,Pulau Pinang,1,1,0
1/05/2021,Australia,Sabah,0,0,0
1/05/2021,Australia,Sarawak,0,0,0
1/05/2021,Australia,Selangor,77,55,22
1/05/2021,Australia,Terengganu,0,0,0
1/05/2021,Australia,W.P. Labuan,0,0,0
1/05/2021,Austria,Johor,0,0,0
1/05/2021,Austria,Kedah,0,0,0
1/05/2021,Austria,Kelantan,0,0,0
1/05/2021,Austria,Melaka,0,0,0
1/05/2021,Austria,Negeri Sembilan,0,0,0
1/05/2021,Austria,Pahang,0,0,0
1/05/2021,Austria,Perak,0,0,0
1/05/2021,Austria,Perlis,0,0,0
1/05/2021,Austria,Pulau Pinang,0,0,0
1/05/2021,Austria,Sabah,0,0,0
1/05/2021,Austria,Sarawak,1,1,0
1/05/2021,Austria,Selangor,10,9,1
1/05/2021,Austria,Terengganu,0,0,0
1/05/2021,Austria,W.P. Labuan,0,0,0
1/05/2021,Azerbaijan,Johor,0,0,0
1/05/2021,Azerbaijan,Kedah,0,0,0
1/05/2021,Azerbaijan,Kelantan,0,0,0
1/05/2021,Azerbaijan,Melaka,0,0,0
1/05/2021,Azerbaijan,Perlis,0,0,0
1/05/2021,Azerbaijan,Pulau Pinang,0,0,0
1/05/2021,Azerbaijan,Sabah,0,0,0
1/05/2021,Azerbaijan,Sarawak,0,0,0
1/05/2021,Azerbaijan,Selangor,4,3,1
1/05/2021,Azerbaijan,W.P. Labuan,0,0,0
1/05/2021,Burundi,Pulau Pinang,0,0,0
1/05/2021,Burundi,Sarawak,0,0,0
1/05/2021,Burundi,Selangor,5,2,3
1/05/2021,Belgium,Johor,0,0,0
1/05/2021,Belgium,Kedah,0,0,0
1/05/2021,Belgium,Kelantan,0,0,0
1/05/2021,Belgium,Melaka,0,0,0
1/05/2021,Belgium,Negeri Sembilan,0,0,0
1/05/2021,Belgium,Pahang,0,0,0
1/05/2021,Belgium,Perak,0,0,0
1/05/2021,Belgium,Perlis,0,0,0
1/05/2021,Belgium,Pulau Pinang,0,0,0
1/05/2021,Belgium,Sabah,0,0,0
1/05/2021,Belgium,Sarawak,0,0,0
1/05/2021,Belgium,Selangor,7,4,3
1/05/2021,Belgium,W.P. Labuan,0,0,0
1/05/2021,Benin,Johor,0,0,0
1/05/2021,Benin,Kedah,0,0,0
1/05/2021,Benin,Perak,0,0,0
1/05/2021,Benin,Pulau Pinang,0,0,0
1/05/2021,Benin,Sabah,0,0,0
1/05/2021,Benin,Sarawak,0,0,0
1/05/2021,Benin,Selangor,0,0,0
1/05/2021,Burkina Faso,Perak,0,0,0
1/05/2021,Burkina Faso,Pulau Pinang,0,0,0
1/05/2021,Burkina Faso,Selangor,0,0,0
1/05/2021,Bangladesh,Johor,2,2,0
1/05/2021,Bangladesh,Kedah,0,0,0
1/05/2021,Bangladesh,Kelantan,0,0,0
1/05/2021,Bangladesh,Melaka,0,0,0
1/05/2021,Bangladesh,Negeri Sembilan,0,0,0
1/05/2021,Bangladesh,Pahang,0,0,0
1/05/2021,Bangladesh,Perak,0,0,0
1/05/2021,Bangladesh,Perlis,0,0,0
1/05/2021,Bangladesh,Pulau Pinang,0,0,0
1/05/2021,Bangladesh,Sabah,0,0,0
1/05/2021,Bangladesh,Sarawak,0,0,0
1/05/2021,Bangladesh,Selangor,98,78,20
1/05/2021,Bangladesh,W.P. Labuan,0,0,0
1/05/2021,Bulgaria,Johor,0,0,0
1/05/2021,Bulgaria,Kedah,0,0,0
1/05/2021,Bulgaria,Kelantan,0,0,0
1/05/2021,Bulgaria,Pahang,0,0,0
1/05/2021,Bulgaria,Perak,0,0,0
1/05/2021,Bulgaria,Perlis,0,0,0
1/05/2021,Bulgaria,Pulau Pinang,0,0,0
1/05/2021,Bulgaria,Sabah,0,0,0
1/05/2021,Bulgaria,Sarawak,0,0,0
1/05/2021,Bulgaria,Selangor,17,17,0
1/05/2021,Bulgaria,W.P. Labuan,0,0,0
1/05/2021,Bahrain,Johor,0,0,0
1/05/2021,Bahrain,Kedah,0,0,0
1/05/2021,Bahrain,Kelantan,0,0,0
1/05/2021,Bahrain,Perlis,0,0,0
1/05/2021,Bahrain,Pulau Pinang,0,0,0
1/05/2021,Bahrain,Sabah,0,0,0
1/05/2021,Bahrain,Sarawak,0,0,0
1/05/2021,Bahrain,Selangor,2,1,1
1/05/2021,Bahamas,Johor,0,0,0
1/05/2021,Bahamas,Kedah,0,0,0
1/05/2021,Bahamas,Perak,0,0,0
1/05/2021,Bahamas,Sabah,0,0,0
1/05/2021,Bahamas,Sarawak,0,0,0
1/05/2021,Bahamas,Selangor,0,0,0
1/05/2021,Bosnia and Herzegovina,Johor,0,0,0
1/05/2021,Bosnia and Herzegovina,Kedah,0,0,0
1/05/2021,Bosnia and Herzegovina,Perlis,0,0,0
1/05/2021,Bosnia and Herzegovina,Pulau Pinang,0,0,0
1/05/2021,Bosnia and Herzegovina,Sabah,0,0,0
1/05/2021,Bosnia and Herzegovina,Sarawak,0,0,0
1/05/2021,Bosnia and Herzegovina,Selangor,2,1,1
1/05/2021,Belarus,Johor,0,0,0
1/05/2021,Belarus,Kedah,0,0,0
1/05/2021,Belarus,Kelantan,0,0,0
1/05/2021,Belarus,Pahang,0,0,0
1/05/2021,Belarus,Perak,0,0,0
1/05/2021,Belarus,Perlis,0,0,0
1/05/2021,Belarus,Pulau Pinang,0,0,0
1/05/2021,Belarus,Sabah,0,0,0
1/05/2021,Belarus,Sarawak,0,0,0
1/05/2021,Belarus,Selangor,1,1,0
1/05/2021,Belarus,W.P. Labuan,0,0,0
1/05/2021,Belize,Johor,0,0,0
1/05/2021,Belize,Pulau Pinang,0,0,0
1/05/2021,Belize,Sarawak,0,0,0
1/05/2021,Belize,Selangor,0,0,0
1/05/2021,Bermuda,Selangor,0,0,0
1/05/2021,Bolivia,Johor,0,0,0
1/05/2021,Bolivia,Kedah,0,0,0
1/05/2021,Bolivia,Melaka,0,0,0
1/05/2021,Bolivia,Perak,0,0,0
1/05/2021,Bolivia,Perlis,0,0,0
1/05/2021,Bolivia,Pulau Pinang,0,0,0
1/05/2021,Bolivia,Sabah,0,0,0
1/05/2021,Bolivia,Sarawak,0,0,0
1/05/2021,Bolivia,Selangor,0,0,0
1/05/2021,Brazil,Johor,0,0,0
1/05/2021,Brazil,Kedah,0,0,0
1/05/2021,Brazil,Kelantan,0,0,0
1/05/2021,Brazil,Melaka,0,0,0
1/05/2021,Brazil,Pahang,0,0,0
1/05/2021,Brazil,Perak,0,0,0
1/05/2021,Brazil,Perlis,0,0,0
1/05/2021,Brazil,Pulau Pinang,0,0,0
1/05/2021,Brazil,Sabah,0,0,0
1/05/2021,Brazil,Sarawak,0,0,0
1/05/2021,Brazil,Selangor,20,19,1
1/05/2021,Brazil,W.P. Labuan,0,0,0
1/05/2021,Barbados,Johor,0,0,0
1/05/2021,Barbados,Kedah,0,0,0
1/05/2021,Barbados,Perlis,0,0,0
1/05/2021,Barbados,Pulau Pinang,0,0,0
1/05/2021,Barbados,Selangor,0,0,0
1/05/2021,Brunei Darussalam,Johor,0,0,0
1/05/2021,Brunei Darussalam,Kedah,0,0,0
1/05/2021,Brunei Darussalam,Kelantan,0,0,0
1/05/2021,Brunei Darussalam,Melaka,0,0,0
1/05/2021,Brunei Darussalam,Pahang,0,0,0
1/05/2021,Brunei Darussalam,Perak,0,0,0
1/05/2021,Brunei Darussalam,Perlis,0,0,0
1/05/2021,Brunei Darussalam,Pulau Pinang,0,0,0
1/05/2021,Brunei Darussalam,Sabah,0,0,0
1/05/2021,Brunei Darussalam,Sarawak,265,261,4
1/05/2021,Brunei Darussalam,Selangor,24,10,14
1/05/2021,Brunei Darussalam,W.P. Labuan,1,1,0
1/05/2021,Bhutan,Johor,0,0,0
1/05/2021,Bhutan,Kedah,0,0,0
1/05/2021,Bhutan,Perak,0,0,0
1/05/2021,Bhutan,Perlis,0,0,0
1/05/2021,Bhutan,Pulau Pinang,0,0,0
1/05/2021,Bhutan,Sabah,0,0,0
1/05/2021,Bhutan,Sarawak,0,0,0
1/05/2021,Bhutan,Selangor,0,0,0
1/05/2021,Botswana,Johor,0,0,0
1/05/2021,Botswana,Kedah,0,0,0
1/05/2021,Botswana,Perlis,0,0,0
1/05/2021,Botswana,Pulau Pinang,0,0,0
1/05/2021,Botswana,Sabah,0,0,0
1/05/2021,Botswana,Sarawak,0,0,0
1/05/2021,Botswana,Selangor,2,1,1
1/05/2021,Central African Republic,Kedah,0,0,0
1/05/2021,Central African Republic,Selangor,1,1,0
1/05/2021,Canada,Johor,0,0,0
1/05/2021,Canada,Kedah,0,0,0
1/05/2021,Canada,Kelantan,0,0,0
1/05/2021,Canada,Melaka,0,0,0
1/05/2021,Canada,Negeri Sembilan,0,0,0
1/05/2021,Canada,Pahang,0,0,0
1/05/2021,Canada,Perak,0,0,0
1/05/2021,Canada,Perlis,0,0,0
1/05/2021,Canada,Pulau Pinang,0,0,0
1/05/2021,Canada,Sabah,0,0,0
1/05/2021,Canada,Sarawak,0,0,0
1/05/2021,Canada,Selangor,28,20,8
1/05/2021,Canada,Terengganu,0,0,0
1/05/2021,Canada,W.P. Labuan,0,0,0
1/05/2021,Cocos (Keeling) Islands,Selangor,0,0,0
1/05/2021,Switzerland,Johor,0,0,0
1/05/2021,Switzerland,Kedah,0,0,0
1/05/2021,Switzerland,Kelantan,0,0,0
1/05/2021,Switzerland,Melaka,0,0,0
1/05/2021,Switzerland,Negeri Sembilan,0,0,0
1/05/2021,Switzerland,Pahang,0,0,0
1/05/2021,Switzerland,Perak,0,0,0
1/05/2021,Switzerland,Perlis,0,0,0
1/05/2021,Switzerland,Pulau Pinang,0,0,0
1/05/2021,Switzerland,Sabah,0,0,0
1/05/2021,Switzerland,Sarawak,0,0,0
1/05/2021,Switzerland,Selangor,11,10,1
1/05/2021,Switzerland,W.P. Labuan,0,0,0
1/05/2021,Chile,Johor,0,0,0
1/05/2021,Chile,Kedah,0,0,0
1/05/2021,Chile,Kelantan,0,0,0
1/05/2021,Chile,Melaka,0,0,0
1/05/2021,Chile,Pahang,0,0,0
1/05/2021,Chile,Perak,0,0,0
1/05/2021,Chile,Perlis,0,0,0
1/05/2021,Chile,Pulau Pinang,0,0,0
1/05/2021,Chile,Sabah,0,0,0
1/05/2021,Chile,Sarawak,0,0,0
1/05/2021,Chile,Selangor,1,0,1
1/05/2021,China,Johor,29,28,1
1/05/2021,China,Kedah,0,0,0
1/05/2021,China,Kelantan,0,0,0
1/05/2021,China,Melaka,0,0,0
1/05/2021,China,Pahang,0,0,0
1/05/2021,China,Perak,0,0,0
1/05/2021,China,Perlis,0,0,0
1/05/2021,China,Pulau Pinang,2,1,1
1/05/2021,China,Sabah,3,0,3
1/05/2021,China,Sarawak,206,199,7
1/05/2021,China,Selangor,1261,1018,243
1/05/2021,China,Terengganu,0,0,0
1/05/2021,China,W.P. Labuan,0,0,0
1/05/2021,Côte d'Ivoire,Johor,0,0,0
1/05/2021,Côte d'Ivoire,Kedah,0,0,0
1/05/2021,Côte d'Ivoire,Pulau Pinang,0,0,0
1/05/2021,Côte d'Ivoire,Sabah,0,0,0
1/05/2021,Côte d'Ivoire,Sarawak,0,0,0
1/05/2021,Côte d'Ivoire,Selangor,2,2,0
1/05/2021,Cameroon,Johor,0,0,0
1/05/2021,Cameroon,Kedah,0,0,0
1/05/2021,Cameroon,Pulau Pinang,0,0,0
1/05/2021,Cameroon,Sabah,0,0,0
1/05/2021,Cameroon,Sarawak,0,0,0
1/05/2021,Cameroon,Selangor,1,1,0
1/05/2021,Congo,Johor,0,0,0
1/05/2021,Congo,Pulau Pinang,0,0,0
1/05/2021,Congo,Sarawak,0,0,0
1/05/2021,Congo,Selangor,1,1,0
1/05/2021,Congo,Johor,0,0,0
1/05/2021,Congo,Kedah,0,0,0
1/05/2021,Congo,Selangor,0,0,0
1/05/2021,Cook Islands,Selangor,0,0,0
1/05/2021,Colombia,Johor,0,0,0
1/05/2021,Colombia,Kedah,0,0,0
1/05/2021,Colombia,Perak,0,0,0
1/05/2021,Colombia,Pulau Pinang,0,0,0
1/05/2021,Colombia,Sabah,0,0,0
1/05/2021,Colombia,Sarawak,0,0,0
1/05/2021,Colombia,Selangor,4,3,1
1/05/2021,Colombia,W.P. Labuan,0,0,0
1/05/2021,Comoros,Johor,0,0,0
1/05/2021,Comoros,Kedah,0,0,0
1/05/2021,Comoros,Selangor,4,2,2
1/05/2021,Cabo Verde,Johor,0,0,0
1/05/2021,Cabo Verde,Kedah,0,0,0
1/05/2021,Cabo Verde,Pulau Pinang,0,0,0
1/05/2021,Cabo Verde,Sabah,0,0,0
1/05/2021,Cabo Verde,Selangor,0,0,0
1/05/2021,Costa Rica,Johor,0,0,0
1/05/2021,Costa Rica,Kedah,0,0,0
1/05/2021,Costa Rica,Perak,0,0,0
1/05/2021,Costa Rica,Perlis,0,0,0
1/05/2021,Costa Rica,Pulau Pinang,0,0,0
1/05/2021,Costa Rica,Sabah,0,0,0
1/05/2021,Costa Rica,Sarawak,0,0,0
1/05/2021,Costa Rica,Selangor,37,30,7
1/05/2021,Cuba,Johor,0,0,0
1/05/2021,Cuba,Kedah,0,0,0
1/05/2021,Cuba,Perlis,0,0,0
1/05/2021,Cuba,Pulau Pinang,0,0,0
1/05/2021,Cuba,Sabah,0,0,0
1/05/2021,Cuba,Sarawak,0,0,0
1/05/2021,Cuba,Selangor,0,0,0
1/05/2021,Cyprus,Johor,0,0,0
1/05/2021,Cyprus,Kedah,0,0,0
1/05/2021,Cyprus,Perak,0,0,0
1/05/2021,Cyprus,Perlis,0,0,0
1/05/2021,Cyprus,Pulau Pinang,0,0,0
1/05/2021,Cyprus,Sabah,0,0,0
1/05/2021,Cyprus,Sarawak,0,0,0
1/05/2021,Cyprus,Selangor,3,2,1
1/05/2021,Czechia,Johor,0,0,0
1/05/2021,Czechia,Kedah,0,0,0
1/05/2021,Czechia,Kelantan,0,0,0
1/05/2021,Czechia,Melaka,0,0,0
1/05/2021,Czechia,Negeri Sembilan,0,0,0
1/05/2021,Czechia,Perak,0,0,0
1/05/2021,Czechia,Perlis,0,0,0
1/05/2021,Czechia,Pulau Pinang,0,0,0
1/05/2021,Czechia,Sabah,0,0,0
1/05/2021,Czechia,Sarawak,0,0,0
1/05/2021,Czechia,Selangor,6,6,0
1/05/2021,Czechia,W.P. Labuan,0,0,0
1/05/2021,Germany,Johor,0,0,0
1/05/2021,Germany,Kedah,0,0,0
1/05/2021,Germany,Kelantan,0,0,0
1/05/2021,Germany,Melaka,0,0,0
1/05/2021,Germany,Negeri Sembilan,0,0,0
1/05/2021,Germany,Pahang,0,0,0
1/05/2021,Germany,Perak,0,0,0
1/05/2021,Germany,Perlis,0,0,0
1/05/2021,Germany,Pulau Pinang,1,1,0
1/05/2021,Germany,Sabah,0,0,0
1/05/2021,Germany,Sarawak,0,0,0
1/05/2021,Germany,Selangor,67,54,13
1/05/2021,Germany,Terengganu,0,0,0
1/05/2021,Germany,W.P. Labuan,0,0,0
1/05/2021,Djibouti,Johor,0,0,0
1/05/2021,Djibouti,Selangor,1,0,1
1/05/2021,Dominica,Johor,0,0,0
1/05/2021,Dominica,Kedah,0,0,0
1/05/2021,Dominica,Pulau Pinang,0,0,0
1/05/2021,Dominica,Sabah,0,0,0
1/05/2021,Dominica,Sarawak,0,0,0
1/05/2021,Dominica,Selangor,0,0,0
1/05/2021,Dominica,W.P. Labuan,0,0,0
1/05/2021,Denmark,Johor,0,0,0
1/05/2021,Denmark,Kedah,0,0,0
1/05/2021,Denmark,Kelantan,0,0,0
1/05/2021,Denmark,Melaka,0,0,0
1/05/2021,Denmark,Negeri Sembilan,0,0,0
1/05/2021,Denmark,Pahang,0,0,0
1/05/2021,Denmark,Perak,0,0,0
1/05/2021,Denmark,Perlis,0,0,0
1/05/2021,Denmark,Pulau Pinang,0,0,0
1/05/2021,Denmark,Sabah,0,0,0
1/05/2021,Denmark,Sarawak,1,1,0
1/05/2021,Denmark,Selangor,10,9,1
1/05/2021,Denmark,W.P. Labuan,0,0,0
1/05/2021,Dominican Republic,Johor,0,0,0
1/05/2021,Dominican Republic,Kedah,0,0,0
1/05/2021,Dominican Republic,Perak,0,0,0
1/05/2021,Dominican Republic,Perlis,0,0,0
1/05/2021,Dominican Republic,Pulau Pinang,0,0,0
1/05/2021,Dominican Republic,Sabah,0,0,0
1/05/2021,Dominican Republic,Sarawak,0,0,0
1/05/2021,Dominican Republic,Selangor,0,0,0
1/05/2021,Algeria,Johor,0,0,0
1/05/2021,Algeria,Kedah,0,0,0
1/05/2021,Algeria,Kelantan,0,0,0
1/05/2021,Algeria,Melaka,0,0,0
1/05/2021,Algeria,Perak,0,0,0
1/05/2021,Algeria,Perlis,0,0,0
1/05/2021,Algeria,Pulau Pinang,0,0,0
1/05/2021,Algeria,Sabah,0,0,0
1/05/2021,Algeria,Sarawak,0,0,0
1/05/2021,Algeria,Selangor,4,4,0
1/05/2021,Algeria,W.P. Labuan,0,0,0
1/05/2021,Ecuador,Johor,0,0,0
1/05/2021,Ecuador,Kedah,0,0,0
1/05/2021,Ecuador,Perak,0,0,0
1/05/2021,Ecuador,Perlis,0,0,0
1/05/2021,Ecuador,Pulau Pinang,0,0,0
1/05/2021,Ecuador,Sabah,0,0,0
1/05/2021,Ecuador,Sarawak,0,0,0
1/05/2021,Ecuador,Selangor,2,2,0
1/05/2021,Egypt,Johor,0,0,0
1/05/2021,Egypt,Kedah,0,0,0
1/05/2021,Egypt,Kelantan,0,0,0
1/05/2021,Egypt,Melaka,0,0,0
1/05/2021,Egypt,Pahang,0,0,0
1/05/2021,Egypt,Perak,0,0,0
1/05/2021,Egypt,Perlis,0,0,0
1/05/2021,Egypt,Pulau Pinang,0,0,0
1/05/2021,Egypt,Sabah,1,1,0
1/05/2021,Egypt,Sarawak,0,0,0
1/05/2021,Egypt,Selangor,75,58,17
1/05/2021,Egypt,Terengganu,0,0,0
1/05/2021,Egypt,W.P. Labuan,0,0,0
1/05/2021,Eritrea,Johor,0,0,0
1/05/2021,Eritrea,Pulau Pinang,0,0,0
1/05/2021,Eritrea,Sabah,0,0,0
1/05/2021,Eritrea,Selangor,2,1,1
1/05/2021,Spain,Johor,0,0,0
1/05/2021,Spain,Kedah,0,0,0
1/05/2021,Spain,Kelantan,0,0,0
1/05/2021,Spain,Melaka,0,0,0
1/05/2021,Spain,Negeri Sembilan,0,0,0
1/05/2021,Spain,Pahang,0,0,0
1/05/2021,Spain,Perak,0,0,0
1/05/2021,Spain,Perlis,0,0,0
1/05/2021,Spain,Pulau Pinang,0,0,0
1/05/2021,Spain,Sabah,0,0,0
1/05/2021,Spain,Sarawak,0,0,0
1/05/2021,Spain,Selangor,27,23,4
1/05/2021,Spain,W.P. Labuan,0,0,0
1/05/2021,Estonia,Johor,0,0,0
1/05/2021,Estonia,Kedah,0,0,0
1/05/2021,Estonia,Kelantan,0,0,0
1/05/2021,Estonia,Pahang,0,0,0
1/05/2021,Estonia,Perak,0,0,0
1/05/2021,Estonia,Perlis,0,0,0
1/05/2021,Estonia,Pulau Pinang,0,0,0
1/05/2021,Estonia,Sabah,0,0,0
1/05/2021,Estonia,Sarawak,0,0,0
1/05/2021,Estonia,Selangor,4,3,1
1/05/2021,Estonia,W.P. Labuan,0,0,0
1/05/2021,Ethiopia,Johor,0,0,0
1/05/2021,Ethiopia,Kedah,0,0,0
1/05/2021,Ethiopia,Pulau Pinang,0,0,0
1/05/2021,Ethiopia,Sarawak,0,0,0
1/05/2021,Ethiopia,Selangor,8,4,4
1/05/2021,Finland,Johor,2,2,0
1/05/2021,Finland,Kedah,0,0,0
1/05/2021,Finland,Kelantan,0,0,0
1/05/2021,Finland,Melaka,0,0,0
1/05/2021,Finland,Negeri Sembilan,0,0,0
1/05/2021,Finland,Pahang,0,0,0
1/05/2021,Finland,Perak,0,0,0
1/05/2021,Finland,Perlis,0,0,0
1/05/2021,Finland,Pulau Pinang,0,0,0
1/05/2021,Finland,Sabah,0,0,0
1/05/2021,Finland,Sarawak,0,0,0
1/05/2021,Finland,Selangor,9,9,0
1/05/2021,Finland,W.P. Labuan,0,0,0
1/05/2021,Fiji,Johor,0,0,0
1/05/2021,Fiji,Kedah,0,0,0
1/05/2021,Fiji,Kelantan,0,0,0
1/05/2021,Fiji,Perak,0,0,0
1/05/2021,Fiji,Perlis,0,0,0
1/05/2021,Fiji,Pulau Pinang,0,0,0
1/05/2021,Fiji,Sabah,0,0,0
1/05/2021,Fiji,Sarawak,0,0,0
1/05/2021,Fiji,Selangor,0,0,0
1/05/2021,France,Johor,0,0,0
1/05/2021,France,Kedah,0,0,0
1/05/2021,France,Kelantan,0,0,0
1/05/2021,France,Melaka,0,0,0
1/05/2021,France,Negeri Sembilan,0,0,0
1/05/2021,France,Pahang,0,0,0
1/05/2021,France,Perak,0,0,0
1/05/2021,France,Perlis,0,0,0
1/05/2021,France,Pulau Pinang,0,0,0
1/05/2021,France,Sabah,0,0,0
1/05/2021,France,Sarawak,0,0,0
1/05/2021,France,Selangor,80,60,20
1/05/2021,France,Terengganu,0,0,0
1/05/2021,France,W.P. Labuan,0,0,0
1/05/2021,"Micronesia, Federated States of",Johor,0,0,0
1/05/2021,"Micronesia, Federated States of",Pulau Pinang,0,0,0
1/05/2021,"Micronesia, Federated States of",Selangor,0,0,0
1/05/2021,Gabon,Johor,0,0,0
1/05/2021,Gabon,Pulau Pinang,0,0,0
1/05/2021,Gabon,Sarawak,0,0,0
1/05/2021,Gabon,Selangor,0,0,0
1/05/2021,United Kingdom of Great Britain and Northern Ireland,Johor,25,23,2
1/05/2021,United Kingdom of Great Britain and Northern Ireland,Kedah,0,0,0
1/05/2021,United Kingdom of Great Britain and Northern Ireland,Kelantan,0,0,0
1/05/2021,United Kingdom of Great Britain and Northern Ireland,Melaka,0,0,0
1/05/2021,United Kingdom of Great Britain and Northern Ireland,Negeri Sembilan,0,0,0
1/05/2021,United Kingdom of Great Britain and Northern Ireland,Pahang,0,0,0
1/05/2021,United Kingdom of Great Britain and Northern Ireland,Perak,0,0,0
1/05/2021,United Kingdom of Great Britain and Northern Ireland,Perlis,0,0,0
1/05/2021,United Kingdom of Great Britain and Northern Ireland,Pulau Pinang,3,2,1
1/05/2021,United Kingdom of Great Britain and Northern Ireland,Sabah,0,0,0
1/05/2021,United Kingdom of Great Britain and Northern Ireland,Sarawak,0,0,0
1/05/2021,United Kingdom of Great Britain and Northern Ireland,Selangor,218,189,29
1/05/2021,United Kingdom of Great Britain and Northern Ireland,Terengganu,0,0,0
1/05/2021,United Kingdom of Great Britain and Northern Ireland,W.P. Labuan,0,0,0
1/05/2021,Georgia,Johor,0,0,0
1/05/2021,Georgia,Kedah,0,0,0
1/05/2021,Georgia,Melaka,0,0,0
1/05/2021,Georgia,Perak,0,0,0
1/05/2021,Georgia,Perlis,0,0,0
1/05/2021,Georgia,Pulau Pinang,0,0,0
1/05/2021,Georgia,Sabah,0,0,0
1/05/2021,Georgia,Sarawak,0,0,0
1/05/2021,Georgia,Selangor,0,0,0
1/05/2021,Ghana,Johor,0,0,0
1/05/2021,Ghana,Kedah,0,0,0
1/05/2021,Ghana,Kelantan,0,0,0
1/05/2021,Ghana,Pulau Pinang,0,0,0
1/05/2021,Ghana,Sabah,0,0,0
1/05/2021,Ghana,Sarawak,0,0,0
1/05/2021,Ghana,Selangor,8,6,2
1/05/2021,Gibraltar,Johor,0,0,0
1/05/2021,Gibraltar,Sarawak,0,0,0
1/05/2021,Guinea,Johor,0,0,0
1/05/2021,Guinea,Kedah,0,0,0
1/05/2021,Guinea,Kelantan,0,0,0
1/05/2021,Guinea,Perlis,0,0,0
1/05/2021,Guinea,Pulau Pinang,0,0,0
1/05/2021,Guinea,Sabah,0,0,0
1/05/2021,Guinea,Sarawak,0,0,0
1/05/2021,Guinea,Selangor,6,4,2
1/05/2021,Guadeloupe,Selangor,0,0,0
1/05/2021,Gambia,Johor,0,0,0
1/05/2021,Gambia,Kedah,0,0,0
1/05/2021,Gambia,Kelantan,0,0,0
1/05/2021,Gambia,Pulau Pinang,0,0,0
1/05/2021,Gambia,Sabah,0,0,0
1/05/2021,Gambia,Sarawak,0,0,0
1/05/2021,Gambia,Selangor,2,1,1
1/05/2021,Guinea-Bissau,Johor,0,0,0
1/05/2021,Guinea-Bissau,Selangor,0,0,0
1/05/2021,Equatorial Guinea,Johor,0,0,0
1/05/2021,Equatorial Guinea,Selangor,1,0,1
1/05/2021,Greece,Johor,2,2,0
1/05/2021,Greece,Kedah,0,0,0
1/05/2021,Greece,Kelantan,0,0,0
1/05/2021,Greece,Melaka,0,0,0
1/05/2021,Greece,Negeri Sembilan,0,0,0
1/05/2021,Greece,Pahang,0,0,0
1/05/2021,Greece,Perak,0,0,0
1/05/2021,Greece,Perlis,0,0,0
1/05/2021,Greece,Pulau Pinang,0,0,0
1/05/2021,Greece,Sabah,0,0,0
1/05/2021,Greece,Sarawak,0,0,0
1/05/2021,Greece,Selangor,13,13,0
1/05/2021,Grenada,Johor,0,0,0
1/05/2021,Grenada,Kedah,0,0,0
1/05/2021,Grenada,Pulau Pinang,0,0,0
1/05/2021,Grenada,Sabah,0,0,0
1/05/2021,Grenada,Sarawak,0,0,0
1/05/2021,Grenada,Selangor,0,0,0
1/05/2021,Greenland,Johor,0,0,0
1/05/2021,Greenland,Selangor,0,0,0
1/05/2021,Guatemala,Johor,0,0,0
1/05/2021,Guatemala,Kedah,0,0,0
1/05/2021,Guatemala,Pahang,0,0,0
1/05/2021,Guatemala,Perak,0,0,0
1/05/2021,Guatemala,Pulau Pinang,0,0,0
1/05/2021,Guatemala,Sabah,0,0,0
1/05/2021,Guatemala,Sarawak,0,0,0
1/05/2021,Guatemala,Selangor,0,0,0
1/05/2021,Guatemala,W.P. Labuan,0,0,0
1/05/2021,Guyana,Johor,0,0,0
1/05/2021,Guyana,Kedah,0,0,0
1/05/2021,Guyana,Pulau Pinang,0,0,0
1/05/2021,Guyana,Sarawak,0,0,0
1/05/2021,Guyana,Selangor,0,0,0
1/05/2021,Hong Kong,Johor,0,0,0
1/05/2021,Hong Kong,Kedah,0,0,0
1/05/2021,Hong Kong,Kelantan,0,0,0
1/05/2021,Hong Kong,Pahang,0,0,0
1/05/2021,Hong Kong,Perak,0,0,0
1/05/2021,Hong Kong,Perlis,0,0,0
1/05/2021,Hong Kong,Pulau Pinang,1,1,0
1/05/2021,Hong Kong,Sabah,0,0,0
1/05/2021,Hong Kong,Sarawak,0,0,0
1/05/2021,Hong Kong,Selangor,0,0,0
1/05/2021,Hong Kong,Terengganu,0,0,0
1/05/2021,Heard Island and McDonald Islands,Johor,0,0,0
1/05/2021,Honduras,Johor,0,0,0
1/05/2021,Honduras,Kedah,0,0,0
1/05/2021,Honduras,Perak,0,0,0
1/05/2021,Honduras,Pulau Pinang,0,0,0
1/05/2021,Honduras,Sabah,0,0,0
1/05/2021,Honduras,Sarawak,0,0,0
1/05/2021,Honduras,Selangor,0,0,0
1/05/2021,Croatia,Johor,0,0,0
1/05/2021,Croatia,Kedah,0,0,0
1/05/2021,Croatia,Kelantan,0,0,0
1/05/2021,Croatia,Melaka,0,0,0
1/05/2021,Croatia,Pahang,0,0,0
1/05/2021,Croatia,Perak,0,0,0
1/05/2021,Croatia,Perlis,0,0,0
1/05/2021,Croatia,Pulau Pinang,0,0,0
1/05/2021,Croatia,Sabah,0,0,0
1/05/2021,Croatia,Sarawak,0,0,0
1/05/2021,Croatia,Selangor,43,41,2
1/05/2021,Haiti,Johor,0,0,0
1/05/2021,Haiti,Kedah,0,0,0
1/05/2021,Haiti,Kelantan,0,0,0
1/05/2021,Haiti,Perak,0,0,0
1/05/2021,Haiti,Pulau Pinang,0,0,0
1/05/2021,Haiti,Sabah,0,0,0
1/05/2021,Haiti,Selangor,0,0,0
1/05/2021,Hungary,Johor,0,0,0
1/05/2021,Hungary,Kedah,0,0,0
1/05/2021,Hungary,Kelantan,0,0,0
1/05/2021,Hungary,Pahang,0,0,0
1/05/2021,Hungary,Perak,0,0,0
1/05/2021,Hungary,Perlis,0,0,0
1/05/2021,Hungary,Pulau Pinang,0,0,0
1/05/2021,Hungary,Sabah,0,0,0
1/05/2021,Hungary,Sarawak,0,0,0
1/05/2021,Hungary,Selangor,4,4,0
1/05/2021,Hungary,W.P. Labuan,0,0,0
1/05/2021,Indonesia,Johor,131,109,22
1/05/2021,Indonesia,Kedah,6,6,0
1/05/2021,Indonesia,Kelantan,0,0,0
1/05/2021,Indonesia,Melaka,0,0,0
1/05/2021,Indonesia,Negeri Sembilan,0,0,0
1/05/2021,Indonesia,Pahang,0,0,0
1/05/2021,Indonesia,Perak,0,0,0
1/05/2021,Indonesia,Perlis,5,5,0
1/05/2021,Indonesia,Pulau Pinang,35,11,24
1/05/2021,Indonesia,Sabah,2,1,1
1/05/2021,Indonesia,Sarawak,336,332,4
1/05/2021,Indonesia,Selangor,806,532,274
1/05/2021,Indonesia,Terengganu,4,4,0
1/05/2021,Indonesia,W.P. Labuan,6,6,0
1/05/2021,India,Johor,3,3,0
1/05/2021,India,Kedah,0,0,0
1/05/2021,India,Kelantan,0,0,0
1/05/2021,India,Melaka,0,0,0
1/05/2021,India,Negeri Sembilan,0,0,0
1/05/2021,India,Pahang,0,0,0
1/05/2021,India,Perak,0,0,0
1/05/2021,India,Perlis,0,0,0
1/05/2021,India,Pulau Pinang,0,0,0
1/05/2021,India,Sabah,0,0,0
1/05/2021,India,Sarawak,0,0,0
1/05/2021,India,Selangor,36,21,15
1/05/2021,India,Terengganu,0,0,0
1/05/2021,India,W.P. Labuan,0,0,0
1/05/2021, British Indian Ocean Territory,Pulau Pinang,0,0,0
1/05/2021, British Indian Ocean Territory,Selangor,0,0,0
1/05/2021,Ireland,Johor,0,0,0
1/05/2021,Ireland,Kedah,0,0,0
1/05/2021,Ireland,Kelantan,0,0,0
1/05/2021,Ireland,Negeri Sembilan,0,0,0
1/05/2021,Ireland,Pahang,0,0,0
1/05/2021,Ireland,Perak,0,0,0
1/05/2021,Ireland,Perlis,0,0,0
1/05/2021,Ireland,Pulau Pinang,0,0,0
1/05/2021,Ireland,Sabah,0,0,0
1/05/2021,Ireland,Sarawak,0,0,0
1/05/2021,Ireland,Selangor,12,12,0
1/05/2021,Ireland,Terengganu,0,0,0
1/05/2021,Ireland,W.P. Labuan,0,0,0
1/05/2021,"Iran, Islamic Republic of",Johor,2,2,0
1/05/2021,"Iran, Islamic Republic of",Kedah,0,0,0
1/05/2021,"Iran, Islamic Republic of",Kelantan,0,0,0
1/05/2021,"Iran, Islamic Republic of",Perak,0,0,0
1/05/2021,"Iran, Islamic Republic of",Perlis,0,0,0
1/05/2021,"Iran, Islamic Republic of",Pulau Pinang,0,0,0
1/05/2021,"Iran, Islamic Republic of",Sabah,0,0,0
1/05/2021,"Iran, Islamic Republic of",Sarawak,0,0,0
1/05/2021,"Iran, Islamic Republic of",Selangor,40,21,19
1/05/2021,"Iran, Islamic Republic of",W.P. Labuan,0,0,0
1/05/2021,Iraq,Johor,0,0,0
1/05/2021,Iraq,Kedah,0,0,0
1/05/2021,Iraq,Kelantan,0,0,0
1/05/2021,Iraq,Melaka,0,0,0
1/05/2021,Iraq,Pahang,0,0,0
1/05/2021,Iraq,Perak,0,0,0
1/05/2021,Iraq,Perlis,0,0,0
1/05/2021,Iraq,Pulau Pinang,0,0,0
1/05/2021,Iraq,Sabah,0,0,0
1/05/2021,Iraq,Sarawak,0,0,0
1/05/2021,Iraq,Selangor,25,20,5
1/05/2021,Iceland,Johor,0,0,0
1/05/2021,Iceland,Kedah,0,0,0
1/05/2021,Iceland,Kelantan,0,0,0
1/05/2021,Iceland,Perak,0,0,0
1/05/2021,Iceland,Perlis,0,0,0
1/05/2021,Iceland,Pulau Pinang,0,0,0
1/05/2021,Iceland,Sabah,0,0,0
1/05/2021,Iceland,Sarawak,0,0,0
1/05/2021,Iceland,Selangor,0,0,0
1/05/2021,Iceland,W.P. Labuan,0,0,0
1/05/2021,Israel,Pulau Pinang,0,0,0
1/05/2021,Italy,Johor,0,0,0
1/05/2021,Italy,Kedah,2,2,0
1/05/2021,Italy,Kelantan,0,0,0
1/05/2021,Italy,Melaka,0,0,0
1/05/2021,Italy,Negeri Sembilan,0,0,0
1/05/2021,Italy,Pahang,0,0,0
1/05/2021,Italy,Perak,0,0,0
1/05/2021,Italy,Perlis,0,0,0
1/05/2021,Italy,Pulau Pinang,0,0,0
1/05/2021,Italy,Sabah,0,0,0
1/05/2021,Italy,Sarawak,0,0,0
1/05/2021,Italy,Selangor,49,41,8
1/05/2021,Italy,W.P. Labuan,0,0,0
1/05/2021,Jamaica,Johor,0,0,0
1/05/2021,Jamaica,Kedah,0,0,0
1/05/2021,Jamaica,Perak,0,0,0
1/05/2021,Jamaica,Pulau Pinang,0,0,0
1/05/2021,Jamaica,Sabah,0,0,0
1/05/2021,Jamaica,Sarawak,0,0,0
1/05/2021,Jamaica,Selangor,0,0,0
1/05/2021,Jamaica,W.P. Labuan,0,0,0
1/05/2021,Jordan,Johor,0,0,0
1/05/2021,Jordan,Kedah,0,0,0
1/05/2021,Jordan,Kelantan,0,0,0
1/05/2021,Jordan,Melaka,0,0,0
1/05/2021,Jordan,Perlis,0,0,0
1/05/2021,Jordan,Pulau Pinang,0,0,0
1/05/2021,Jordan,Sabah,0,0,0
1/05/2021,Jordan,Sarawak,0,0,0
1/05/2021,Jordan,Selangor,45,35,10
1/05/2021,Jordan,W.P. Labuan,0,0,0
1/05/2021,Japan,Johor,0,0,0
1/05/2021,Japan,Kedah,0,0,0
1/05/2021,Japan,Kelantan,0,0,0
1/05/2021,Japan,Melaka,0,0,0
1/05/2021,Japan,Negeri Sembilan,0,0,0
1/05/2021,Japan,Pahang,0,0,0
1/05/2021,Japan,Perak,0,0,0
1/05/2021,Japan,Perlis,0,0,0
1/05/2021,Japan,Pulau Pinang,15,14,1
1/05/2021,Japan,Sabah,0,0,0
1/05/2021,Japan,Sarawak,7,7,0
1/05/2021,Japan,Selangor,459,318,141
1/05/2021,Japan,W.P. Labuan,0,0,0
1/05/2021,Kazakhstan,Johor,0,0,0
1/05/2021,Kazakhstan,Kedah,0,0,0
1/05/2021,Kazakhstan,Kelantan,0,0,0
1/05/2021,Kazakhstan,Melaka,0,0,0
1/05/2021,Kazakhstan,Perak,0,0,0
1/05/2021,Kazakhstan,Perlis,0,0,0
1/05/2021,Kazakhstan,Pulau Pinang,0,0,0
1/05/2021,Kazakhstan,Sabah,0,0,0
1/05/2021,Kazakhstan,Sarawak,0,0,0
1/05/2021,Kazakhstan,Selangor,15,7,8
1/05/2021,Kazakhstan,W.P. Labuan,0,0,0
1/05/2021,Kenya,Johor,0,0,0
1/05/2021,Kenya,Kedah,0,0,0
1/05/2021,Kenya,Kelantan,0,0,0
1/05/2021,Kenya,Perak,0,0,0
1/05/2021,Kenya,Perlis,0,0,0
1/05/2021,Kenya,Pulau Pinang,0,0,0
1/05/2021,Kenya,Sabah,0,0,0
1/05/2021,Kenya,Sarawak,0,0,0
1/05/2021,Kenya,Selangor,37,26,11
1/05/2021,Kyrgyzstan,Johor,0,0,0
1/05/2021,Kyrgyzstan,Kedah,0,0,0
1/05/2021,Kyrgyzstan,Kelantan,0,0,0
1/05/2021,Kyrgyzstan,Perak,0,0,0
1/05/2021,Kyrgyzstan,Perlis,0,0,0
1/05/2021,Kyrgyzstan,Pulau Pinang,0,0,0
1/05/2021,Kyrgyzstan,Sabah,0,0,0
1/05/2021,Kyrgyzstan,Sarawak,0,0,0
1/05/2021,Kyrgyzstan,Selangor,1,0,1
1/05/2021,Cambodia,Johor,0,0,0
1/05/2021,Cambodia,Kedah,0,0,0
1/05/2021,Cambodia,Kelantan,0,0,0
1/05/2021,Cambodia,Melaka,0,0,0
1/05/2021,Cambodia,Negeri Sembilan,0,0,0
1/05/2021,Cambodia,Pahang,0,0,0
1/05/2021,Cambodia,Perak,1,0,1
1/05/2021,Cambodia,Perlis,0,0,0
1/05/2021,Cambodia,Pulau Pinang,2,1,1
1/05/2021,Cambodia,Sabah,0,0,0
1/05/2021,Cambodia,Sarawak,0,0,0
1/05/2021,Cambodia,Selangor,9,5,4
1/05/2021,Cambodia,W.P. Labuan,0,0,0
1/05/2021,Kiribati,Johor,11,11,0
1/05/2021,Kiribati,Sabah,0,0,0
1/05/2021,Kiribati,Selangor,0,0,0
1/05/2021,Saint Kitts and Nevis,Johor,0,0,0
1/05/2021,Saint Kitts and Nevis,Kedah,0,0,0
1/05/2021,Saint Kitts and Nevis,Perlis,0,0,0
1/05/2021,Saint Kitts and Nevis,Pulau Pinang,0,0,0
1/05/2021,Saint Kitts and Nevis,Sabah,0,0,0
1/05/2021,Saint Kitts and Nevis,Selangor,0,0,0
1/05/2021,Saint Kitts and Nevis,W.P. Labuan,0,0,0
1/05/2021,"Korea, Republic of",Johor,2,2,0
1/05/2021,"Korea, Republic of",Kedah,0,0,0
1/05/2021,"Korea, Republic of",Kelantan,0,0,0
1/05/2021,"Korea, Republic of",Melaka,0,0,0
1/05/2021,"Korea, Republic of",Negeri Sembilan,0,0,0
1/05/2021,"Korea, Republic of",Pahang,0,0,0
1/05/2021,"Korea, Republic of",Perak,0,0,0
1/05/2021,"Korea, Republic of",Perlis,0,0,0
1/05/2021,"Korea, Republic of",Pulau Pinang,1,0,1
1/05/2021,"Korea, Republic of",Sabah,0,0,0
1/05/2021,"Korea, Republic of",Sarawak,12,11,1
1/05/2021,"Korea, Republic of",Selangor,291,221,70
1/05/2021,"Korea, Republic of",Terengganu,0,0,0
1/05/2021,"Korea, Republic of",W.P. Labuan,0,0,0
1/05/2021,Kuwait,Johor,0,0,0
1/05/2021,Kuwait,Kedah,0,0,0
1/05/2021,Kuwait,Kelantan,0,0,0
1/05/2021,Kuwait,Perak,0,0,0
1/05/2021,Kuwait,Perlis,0,0,0
1/05/2021,Kuwait,Pulau Pinang,0,0,0
1/05/2021,Kuwait,Sabah,0,0,0
1/05/2021,Kuwait,Sarawak,0,0,0
1/05/2021,Kuwait,Selangor,1,1,0
1/05/2021,Kuwait,W.P. Labuan,0,0,0
1/05/2021, Lao People's Democratic Republic,Johor,0,0,0
1/05/2021, Lao People's Democratic Republic,Kedah,0,0,0
1/05/2021, Lao People's Democratic Republic,Kelantan,0,0,0
1/05/2021, Lao People's Democratic Republic,Melaka,0,0,0
1/05/2021, Lao People's Democratic Republic,Perak,0,0,0
1/05/2021, Lao People's Democratic Republic,Perlis,0,0,0
1/05/2021, Lao People's Democratic Republic,Pulau Pinang,0,0,0
1/05/2021, Lao People's Democratic Republic,Sabah,0,0,0
1/05/2021, Lao People's Democratic Republic,Sarawak,0,0,0
1/05/2021, Lao People's Democratic Republic,Selangor,74,73,1
1/05/2021, Lao People's Democratic Republic,W.P. Labuan,0,0,0
1/05/2021,Lebanon,Johor,0,0,0
1/05/2021,Lebanon,Kedah,0,0,0
1/05/2021,Lebanon,Kelantan,0,0,0
1/05/2021,Lebanon,Pahang,0,0,0
1/05/2021,Lebanon,Perak,0,0,0
1/05/2021,Lebanon,Perlis,0,0,0
1/05/2021,Lebanon,Pulau Pinang,0,0,0
1/05/2021,Lebanon,Sabah,0,0,0
1/05/2021,Lebanon,Sarawak,0,0,0
1/05/2021,Lebanon,Selangor,4,1,3
1/05/2021,Lebanon,W.P. Labuan,0,0,0
1/05/2021,Liberia,Johor,0,0,0
1/05/2021,Liberia,Kedah,0,0,0
1/05/2021,Liberia,Sabah,0,0,0
1/05/2021,Liberia,Sarawak,0,0,0
1/05/2021,Liberia,Selangor,4,2,2
1/05/2021,Libya,Johor,0,0,0
1/05/2021,Libya,Kedah,0,0,0
1/05/2021,Libya,Perlis,0,0,0
1/05/2021,Libya,Pulau Pinang,0,0,0
1/05/2021,Libya,Sabah,0,0,0
1/05/2021,Libya,Sarawak,0,0,0
1/05/2021,Libya,Selangor,35,32,3
1/05/2021,Saint Lucia,Johor,0,0,0
1/05/2021,Saint Lucia,Kedah,0,0,0
1/05/2021,Saint Lucia,Pulau Pinang,0,0,0
1/05/2021,Saint Lucia,Sarawak,0,0,0
1/05/2021,Saint Lucia,Selangor,0,0,0
1/05/2021,Liechtenstein,Johor,0,0,0
1/05/2021,Liechtenstein,Kedah,0,0,0
1/05/2021,Liechtenstein,Perlis,0,0,0
1/05/2021,Liechtenstein,Pulau Pinang,0,0,0
1/05/2021,Liechtenstein,Sabah,0,0,0
1/05/2021,Liechtenstein,Sarawak,0,0,0
1/05/2021,Liechtenstein,Selangor,0,0,0
1/05/2021,LKA,Johor,0,0,0
1/05/2021,LKA,Kedah,0,0,0
1/05/2021,LKA,Kelantan,0,0,0
1/05/2021,LKA,Melaka,0,0,0
1/05/2021,LKA,Pahang,0,0,0
1/05/2021,LKA,Perak,0,0,0
1/05/2021,LKA,Perlis,0,0,0
1/05/2021,LKA,Pulau Pinang,0,0,0
1/05/2021,LKA,Sabah,0,0,0
1/05/2021,LKA,Sarawak,1,1,0
1/05/2021,LKA,Selangor,43,33,10
1/05/2021,LKA,W.P. Labuan,0,0,0
1/05/2021,Lesotho,Johor,0,0,0
1/05/2021,Lesotho,Kedah,0,0,0
1/05/2021,Lesotho,Pulau Pinang,0,0,0
1/05/2021,Lesotho,Sarawak,0,0,0
1/05/2021,Lesotho,Selangor,2,1,1
1/05/2021,Lithuania,Johor,0,0,0
1/05/2021,Lithuania,Kedah,0,0,0
1/05/2021,Lithuania,Kelantan,0,0,0
1/05/2021,Lithuania,Pahang,0,0,0
1/05/2021,Lithuania,Perak,0,0,0
1/05/2021,Lithuania,Perlis,0,0,0
1/05/2021,Lithuania,Pulau Pinang,0,0,0
1/05/2021,Lithuania,Sabah,0,0,0
1/05/2021,Lithuania,Sarawak,0,0,0
1/05/2021,Lithuania,Selangor,9,9,0
1/05/2021,Lithuania,W.P. Labuan,0,0,0
1/05/2021,Luxembourg,Johor,0,0,0
1/05/2021,Luxembourg,Kedah,0,0,0
1/05/2021,Luxembourg,Kelantan,0,0,0
1/05/2021,Luxembourg,Perak,0,0,0
1/05/2021,Luxembourg,Perlis,0,0,0
1/05/2021,Luxembourg,Pulau Pinang,0,0,0
1/05/2021,Luxembourg,Sabah,0,0,0
1/05/2021,Luxembourg,Sarawak,0,0,0
1/05/2021,Luxembourg,Selangor,0,0,0
1/05/2021,Latvia,Johor,0,0,0
1/05/2021,Latvia,Kedah,0,0,0
1/05/2021,Latvia,Kelantan,0,0,0
1/05/2021,Latvia,Pahang,0,0,0
1/05/2021,Latvia,Perak,0,0,0
1/05/2021,Latvia,Perlis,0,0,0
1/05/2021,Latvia,Pulau Pinang,0,0,0
1/05/2021,Latvia,Sabah,0,0,0
1/05/2021,Latvia,Sarawak,0,0,0
1/05/2021,Latvia,Selangor,3,3,0
1/05/2021,Latvia,W.P. Labuan,0,0,0
1/05/2021,Macao,Johor,0,0,0
1/05/2021,Macao,Pahang,0,0,0
1/05/2021,Macao,Perak,0,0,0
1/05/2021,Macao,Selangor,0,0,0
1/05/2021,Macao,W.P. Labuan,0,0,0
1/05/2021,Morocco,Johor,0,0,0
1/05/2021,Morocco,Kedah,0,0,0
1/05/2021,Morocco,Kelantan,0,0,0
1/05/2021,Morocco,Melaka,0,0,0
1/05/2021,Morocco,Pahang,0,0,0
1/05/2021,Morocco,Perak,0,0,0
1/05/2021,Morocco,Perlis,0,0,0
1/05/2021,Morocco,Pulau Pinang,0,0,0
1/05/2021,Morocco,Sabah,0,0,0
1/05/2021,Morocco,Sarawak,0,0,0
1/05/2021,Morocco,Selangor,7,5,2
1/05/2021,Morocco,W.P. Labuan,0,0,0
1/05/2021,Monaco,Johor,0,0,0
1/05/2021,Monaco,Kedah,0,0,0
1/05/2021,Monaco,Sabah,0,0,0
1/05/2021,Monaco,Selangor,0,0,0
1/05/2021,"Moldova, Republic of",Johor,0,0,0
1/05/2021,"Moldova, Republic of",Kedah,0,0,0
1/05/2021,"Moldova, Republic of",Kelantan,0,0,0
1/05/2021,"Moldova, Republic of",Negeri Sembilan,0,0,0
1/05/2021,"Moldova, Republic of",Perlis,0,0,0
1/05/2021,"Moldova, Republic of",Pulau Pinang,0,0,0
1/05/2021,"Moldova, Republic of",Sabah,0,0,0
1/05/2021,"Moldova, Republic of",Sarawak,0,0,0
1/05/2021,"Moldova, Republic of",Selangor,0,0,0
1/05/2021,Madagascar,Johor,0,0,0
1/05/2021,Madagascar,Kedah,0,0,0
1/05/2021,Madagascar,Perak,0,0,0
1/05/2021,Madagascar,Perlis,0,0,0
1/05/2021,Madagascar,Pulau Pinang,0,0,0
1/05/2021,Madagascar,Sabah,0,0,0
1/05/2021,Madagascar,Sarawak,0,0,0
1/05/2021,Madagascar,Selangor,0,0,0
1/05/2021,Maldives,Johor,0,0,0
1/05/2021,Maldives,Kedah,0,0,0
1/05/2021,Maldives,Kelantan,0,0,0
1/05/2021,Maldives,Perak,0,0,0
1/05/2021,Maldives,Perlis,0,0,0
1/05/2021,Maldives,Pulau Pinang,0,0,0
1/05/2021,Maldives,Sabah,0,0,0
1/05/2021,Maldives,Sarawak,0,0,0
1/05/2021,Maldives,Selangor,103,32,71
1/05/2021,Mexico,Johor,0,0,0
1/05/2021,Mexico,Kedah,0,0,0
1/05/2021,Mexico,Kelantan,0,0,0
1/05/2021,Mexico,Pahang,0,0,0
1/05/2021,Mexico,Perak,0,0,0
1/05/2021,Mexico,Perlis,0,0,0
1/05/2021,Mexico,Pulau Pinang,0,0,0
1/05/2021,Mexico,Sabah,0,0,0
1/05/2021,Mexico,Sarawak,0,0,0
1/05/2021,Mexico,Selangor,11,8,3
1/05/2021,Mexico,W.P. Labuan,0,0,0
1/05/2021,Marshall Islands,Johor,0,0,0
1/05/2021,Marshall Islands,Kedah,0,0,0
1/05/2021,Marshall Islands,Perak,0,0,0
1/05/2021,Marshall Islands,Pulau Pinang,0,0,0
1/05/2021,Marshall Islands,Sabah,0,0,0
1/05/2021,Marshall Islands,Selangor,0,0,0
1/05/2021,North Macedonia,Johor,0,0,0
1/05/2021,North Macedonia,Kedah,0,0,0
1/05/2021,North Macedonia,Perak,0,0,0
1/05/2021,North Macedonia,Pulau Pinang,0,0,0
1/05/2021,North Macedonia,Sabah,0,0,0
1/05/2021,North Macedonia,Sarawak,0,0,0
1/05/2021,North Macedonia,Selangor,2,2,0
1/05/2021,Mali,Johor,0,0,0
1/05/2021,Mali,Sabah,0,0,0
1/05/2021,Mali,Selangor,1,1,0
1/05/2021,Malta,Johor,0,0,0
1/05/2021,Malta,Kedah,0,0,0
1/05/2021,Malta,Kelantan,0,0,0
1/05/2021,Malta,Perak,0,0,0
1/05/2021,Malta,Perlis,0,0,0
1/05/2021,Malta,Pulau Pinang,0,0,0
1/05/2021,Malta,Sabah,0,0,0
1/05/2021,Malta,Sarawak,0,0,0
1/05/2021,Malta,Selangor,2,2,0
1/05/2021,Malta,W.P. Labuan,0,0,0
1/05/2021,Myanmar,Johor,9,9,0
1/05/2021,Myanmar,Kedah,0,0,0
1/05/2021,Myanmar,Kelantan,0,0,0
1/05/2021,Myanmar,Negeri Sembilan,0,0,0
1/05/2021,Myanmar,Pahang,0,0,0
1/05/2021,Myanmar,Perak,0,0,0
1/05/2021,Myanmar,Perlis,0,0,0
1/05/2021,Myanmar,Pulau Pinang,0,0,0
1/05/2021,Myanmar,Sabah,0,0,0
1/05/2021,Myanmar,Sarawak,0,0,0
1/05/2021,Myanmar,Selangor,60,50,10
1/05/2021,Myanmar,Terengganu,0,0,0
1/05/2021,Myanmar,W.P. Labuan,0,0,0
1/05/2021,Montenegro,Johor,0,0,0
1/05/2021,Montenegro,Kedah,0,0,0
1/05/2021,Montenegro,Pulau Pinang,0,0,0
1/05/2021,Montenegro,Sabah,0,0,0
1/05/2021,Montenegro,Sarawak,0,0,0
1/05/2021,Montenegro,Selangor,3,3,0
1/05/2021,Mongolia,Johor,0,0,0
1/05/2021,Mongolia,Kedah,0,0,0
1/05/2021,Mongolia,Kelantan,0,0,0
1/05/2021,Mongolia,Perak,0,0,0
1/05/2021,Mongolia,Perlis,0,0,0
1/05/2021,Mongolia,Pulau Pinang,0,0,0
1/05/2021,Mongolia,Sabah,0,0,0
1/05/2021,Mongolia,Sarawak,0,0,0
1/05/2021,Mongolia,Selangor,3,0,3
1/05/2021,Northern Mariana Islands,Selangor,0,0,0
1/05/2021,Mozambique,Johor,0,0,0
1/05/2021,Mozambique,Kedah,0,0,0
1/05/2021,Mozambique,Perak,0,0,0
1/05/2021,Mozambique,Pulau Pinang,0,0,0
1/05/2021,Mozambique,Sabah,0,0,0
1/05/2021,Mozambique,Sarawak,0,0,0
1/05/2021,Mozambique,Selangor,8,3,5
1/05/2021,Mauritania,Johor,0,0,0
1/05/2021,Mauritania,Kedah,0,0,0
1/05/2021,Mauritania,Pulau Pinang,0,0,0
1/05/2021,Mauritania,Sabah,0,0,0
1/05/2021,Mauritania,Sarawak,0,0,0
1/05/2021,Mauritania,Selangor,3,3,0
1/05/2021,Mauritius,Johor,0,0,0
1/05/2021,Mauritius,Kedah,0,0,0
1/05/2021,Mauritius,Kelantan,0,0,0
1/05/2021,Mauritius,Pahang,0,0,0
1/05/2021,Mauritius,Perak,0,0,0
1/05/2021,Mauritius,Perlis,0,0,0
1/05/2021,Mauritius,Pulau Pinang,0,0,0
1/05/2021,Mauritius,Sabah,0,0,0
1/05/2021,Mauritius,Sarawak,0,0,0
1/05/2021,Mauritius,Selangor,13,4,9
1/05/2021,Malawi,Johor,0,0,0
1/05/2021,Malawi,Pulau Pinang,0,0,0
1/05/2021,Malawi,Sabah,0,0,0
1/05/2021,Malawi,Sarawak,0,0,0
1/05/2021,Malawi,Selangor,5,1,4
1/05/2021,Mayotte,Selangor,0,0,0
1/05/2021,Namibia,Johor,0,0,0
1/05/2021,Namibia,Kedah,0,0,0
1/05/2021,Namibia,Perak,0,0,0
1/05/2021,Namibia,Perlis,0,0,0
1/05/2021,Namibia,Pulau Pinang,0,0,0
1/05/2021,Namibia,Sabah,0,0,0
1/05/2021,Namibia,Sarawak,0,0,0
1/05/2021,Namibia,Selangor,2,2,0
1/05/2021,New Caledonia,Selangor,0,0,0
1/05/2021,Niger,Johor,0,0,0
1/05/2021,Niger,Sabah,0,0,0
1/05/2021,Niger,Selangor,0,0,0
1/05/2021,Nigeria,Johor,0,0,0
1/05/2021,Nigeria,Kedah,0,0,0
1/05/2021,Nigeria,Perlis,0,0,0
1/05/2021,Nigeria,Pulau Pinang,0,0,0
1/05/2021,Nigeria,Sabah,0,0,0
1/05/2021,Nigeria,Sarawak,0,0,0
1/05/2021,Nigeria,Selangor,132,111,21
1/05/2021,Nicaragua,Johor,0,0,0
1/05/2021,Nicaragua,Kedah,0,0,0
1/05/2021,Nicaragua,Pulau Pinang,0,0,0
1/05/2021,Nicaragua,Sabah,0,0,0
1/05/2021,Nicaragua,Selangor,0,0,0
1/05/2021,Netherlands,Johor,0,0,0
1/05/2021,Netherlands,Kedah,0,0,0
1/05/2021,Netherlands,Kelantan,0,0,0
1/05/2021,Netherlands,Melaka,0,0,0
1/05/2021,Netherlands,Negeri Sembilan,0,0,0
1/05/2021,Netherlands,Pahang,0,0,0
1/05/2021,Netherlands,Perak,0,0,0
1/05/2021,Netherlands,Perlis,0,0,0
1/05/2021,Netherlands,Pulau Pinang,1,0,1
1/05/2021,Netherlands,Sabah,1,1,0
1/05/2021,Netherlands,Sarawak,0,0,0
1/05/2021,Netherlands,Selangor,38,32,6
1/05/2021,Netherlands,Terengganu,0,0,0
1/05/2021,Netherlands,W.P. Labuan,0,0,0
1/05/2021,Norway,Johor,0,0,0
1/05/2021,Norway,Kedah,0,0,0
1/05/2021,Norway,Kelantan,0,0,0
1/05/2021,Norway,Melaka,0,0,0
1/05/2021,Norway,Pahang,0,0,0
1/05/2021,Norway,Perak,0,0,0
1/05/2021,Norway,Perlis,0,0,0
1/05/2021,Norway,Pulau Pinang,0,0,0
1/05/2021,Norway,Sabah,0,0,0
1/05/2021,Norway,Sarawak,1,0,1
1/05/2021,Norway,Selangor,14,14,0
1/05/2021,Norway,W.P. Labuan,0,0,0
1/05/2021,Nepal,Johor,0,0,0
1/05/2021,Nepal,Kedah,0,0,0
1/05/2021,Nepal,Pahang,0,0,0
1/05/2021,Nepal,Perak,0,0,0
1/05/2021,Nepal,Perlis,0,0,0
1/05/2021,Nepal,Pulau Pinang,0,0,0
1/05/2021,Nepal,Sabah,0,0,0
1/05/2021,Nepal,Sarawak,0,0,0
1/05/2021,Nepal,Selangor,74,73,1
1/05/2021,Nepal,W.P. Labuan,0,0,0
1/05/2021,Nauru,Johor,0,0,0
1/05/2021,Nauru,Pulau Pinang,0,0,0
1/05/2021,Nauru,Selangor,0,0,0
1/05/2021,New Zealand,Johor,0,0,0
1/05/2021,New Zealand,Kedah,0,0,0
1/05/2021,New Zealand,Kelantan,0,0,0
1/05/2021,New Zealand,Melaka,0,0,0
1/05/2021,New Zealand,Negeri Sembilan,0,0,0
1/05/2021,New Zealand,Pahang,0,0,0
1/05/2021,New Zealand,Perak,0,0,0
1/05/2021,New Zealand,Perlis,0,0,0
1/05/2021,New Zealand,Pulau Pinang,1,1,0
1/05/2021,New Zealand,Sabah,0,0,0
1/05/2021,New Zealand,Sarawak,1,1,0
1/05/2021,New Zealand,Selangor,6,5,1
1/05/2021,New Zealand,Terengganu,0,0,0
1/05/2021,New Zealand,W.P. Labuan,0,0,0
1/05/2021,Oman,Johor,0,0,0
1/05/2021,Oman,Kedah,0,0,0
1/05/2021,Oman,Kelantan,0,0,0
1/05/2021,Oman,Melaka,0,0,0
1/05/2021,Oman,Perak,0,0,0
1/05/2021,Oman,Perlis,0,0,0
1/05/2021,Oman,Pulau Pinang,0,0,0
1/05/2021,Oman,Sabah,0,0,0
1/05/2021,Oman,Sarawak,0,0,0
1/05/2021,Oman,Selangor,9,8,1
1/05/2021,Pakistan,Johor,0,0,0
1/05/2021,Pakistan,Kedah,0,0,0
1/05/2021,Pakistan,Kelantan,0,0,0
1/05/2021,Pakistan,Melaka,0,0,0
1/05/2021,Pakistan,Negeri Sembilan,0,0,0
1/05/2021,Pakistan,Pahang,0,0,0
1/05/2021,Pakistan,Perak,0,0,0
1/05/2021,Pakistan,Perlis,0,0,0
1/05/2021,Pakistan,Pulau Pinang,1,1,0
1/05/2021,Pakistan,Sabah,1,1,0
1/05/2021,Pakistan,Sarawak,0,0,0
1/05/2021,Pakistan,Selangor,57,40,17
1/05/2021,Pakistan,W.P. Labuan,0,0,0
1/05/2021,Panama,Johor,0,0,0
1/05/2021,Panama,Kedah,0,0,0
1/05/2021,Panama,Perak,0,0,0
1/05/2021,Panama,Perlis,0,0,0
1/05/2021,Panama,Pulau Pinang,0,0,0
1/05/2021,Panama,Sabah,0,0,0
1/05/2021,Panama,Sarawak,0,0,0
1/05/2021,Panama,Selangor,1,1,0
1/05/2021,Peru,Johor,0,0,0
1/05/2021,Peru,Kedah,0,0,0
1/05/2021,Peru,Kelantan,0,0,0
1/05/2021,Peru,Pahang,0,0,0
1/05/2021,Peru,Perak,0,0,0
1/05/2021,Peru,Perlis,0,0,0
1/05/2021,Peru,Pulau Pinang,0,0,0
1/05/2021,Peru,Sabah,0,0,0
1/05/2021,Peru,Sarawak,0,0,0
1/05/2021,Peru,Selangor,1,1,0
1/05/2021,Peru,W.P. Labuan,0,0,0
1/05/2021,Philippines,Johor,78,77,1
1/05/2021,Philippines,Kedah,0,0,0
1/05/2021,Philippines,Kelantan,0,0,0
1/05/2021,Philippines,Melaka,0,0,0
1/05/2021,Philippines,Negeri Sembilan,0,0,0
1/05/2021,Philippines,Pahang,1,1,0
1/05/2021,Philippines,Perak,0,0,0
1/05/2021,Philippines,Perlis,0,0,0
1/05/2021,Philippines,Pulau Pinang,2,1,1
1/05/2021,Philippines,Sabah,2,1,1
1/05/2021,Philippines,Sarawak,47,46,1
1/05/2021,Philippines,Selangor,775,647,128
1/05/2021,Philippines,Terengganu,0,0,0
1/05/2021,Philippines,W.P. Labuan,7,7,0
1/05/2021,Palau,Johor,0,0,0
1/05/2021,Palau,Pulau Pinang,0,0,0
1/05/2021,Palau,Selangor,0,0,0
1/05/2021,Papua New Guinea,Johor,0,0,0
1/05/2021,Papua New Guinea,Kedah,0,0,0
1/05/2021,Papua New Guinea,Kelantan,0,0,0
1/05/2021,Papua New Guinea,Perak,0,0,0
1/05/2021,Papua New Guinea,Pulau Pinang,0,0,0
1/05/2021,Papua New Guinea,Sabah,0,0,0
1/05/2021,Papua New Guinea,Sarawak,0,0,0
1/05/2021,Papua New Guinea,Selangor,1,1,0
1/05/2021,Poland,Johor,0,0,0
1/05/2021,Poland,Kedah,0,0,0
1/05/2021,Poland,Kelantan,0,0,0
1/05/2021,Poland,Melaka,0,0,0
1/05/2021,Poland,Negeri Sembilan,0,0,0
1/05/2021,Poland,Pahang,0,0,0
1/05/2021,Poland,Perak,0,0,0
1/05/2021,Poland,Perlis,0,0,0
1/05/2021,Poland,Pulau Pinang,0,0,0
1/05/2021,Poland,Sabah,0,0,0
1/05/2021,Poland,Sarawak,0,0,0
1/05/2021,Poland,Selangor,38,32,6
1/05/2021,Poland,Terengganu,0,0,0
1/05/2021,Poland,W.P. Labuan,0,0,0
1/05/2021,"North Korea, Democratic People's Republic of",Selangor,0,0,0
1/05/2021,Portugal,Johor,0,0,0
1/05/2021,Portugal,Kedah,0,0,0
1/05/2021,Portugal,Kelantan,0,0,0
1/05/2021,Portugal,Melaka,0,0,0
1/05/2021,Portugal,Pahang,0,0,0
1/05/2021,Portugal,Perak,0,0,0
1/05/2021,Portugal,Perlis,0,0,0
1/05/2021,Portugal,Pulau Pinang,0,0,0
1/05/2021,Portugal,Sabah,0,0,0
1/05/2021,Portugal,Sarawak,0,0,0
1/05/2021,Portugal,Selangor,8,5,3
1/05/2021,Portugal,W.P. Labuan,0,0,0
1/05/2021,Paraguay,Johor,0,0,0
1/05/2021,Paraguay,Kedah,0,0,0
1/05/2021,Paraguay,Perak,0,0,0
1/05/2021,Paraguay,Perlis,0,0,0
1/05/2021,Paraguay,Pulau Pinang,0,0,0
1/05/2021,Paraguay,Sabah,0,0,0
1/05/2021,Paraguay,Sarawak,0,0,0
1/05/2021,Paraguay,Selangor,0,0,0
1/05/2021,"Palestine, State of",Johor,0,0,0
1/05/2021,"Palestine, State of",Kedah,0,0,0
1/05/2021,"Palestine, State of",Kelantan,0,0,0
1/05/2021,"Palestine, State of",Melaka,0,0,0
1/05/2021,"Palestine, State of",Perak,0,0,0
1/05/2021,"Palestine, State of",Perlis,0,0,0
1/05/2021,"Palestine, State of",Pulau Pinang,0,0,0
1/05/2021,"Palestine, State of",Sabah,0,0,0
1/05/2021,"Palestine, State of",Sarawak,0,0,0
1/05/2021,"Palestine, State of",Selangor,18,15,3
1/05/2021,Qatar,Johor,0,0,0
1/05/2021,Qatar,Kedah,0,0,0
1/05/2021,Qatar,Perlis,0,0,0
1/05/2021,Qatar,Pulau Pinang,0,0,0
1/05/2021,Qatar,Sabah,0,0,0
1/05/2021,Qatar,Sarawak,0,0,0
1/05/2021,Qatar,Selangor,3,3,0
1/05/2021,Réunion,Johor,0,0,0
1/05/2021,Réunion,Sarawak,0,0,0
1/05/2021,Romania,Johor,0,0,0
1/05/2021,Romania,Kedah,0,0,0
1/05/2021,Romania,Kelantan,0,0,0
1/05/2021,Romania,Negeri Sembilan,0,0,0
1/05/2021,Romania,Pahang,0,0,0
1/05/2021,Romania,Perak,0,0,0
1/05/2021,Romania,Perlis,0,0,0
1/05/2021,Romania,Pulau Pinang,0,0,0
1/05/2021,Romania,Sabah,0,0,0
1/05/2021,Romania,Sarawak,0,0,0
1/05/2021,Romania,Selangor,36,30,6
1/05/2021,Romania,W.P. Labuan,0,0,0
1/05/2021,Russian Federation (Russia),Johor,3,3,0
1/05/2021,Russian Federation (Russia),Kedah,0,0,0
1/05/2021,Russian Federation (Russia),Kelantan,0,0,0
1/05/2021,Russian Federation (Russia),Melaka,0,0,0
1/05/2021,Russian Federation (Russia),Negeri Sembilan,0,0,0
1/05/2021,Russian Federation (Russia),Pahang,0,0,0
1/05/2021,Russian Federation (Russia),Perak,0,0,0
1/05/2021,Russian Federation (Russia),Perlis,0,0,0
1/05/2021,Russian Federation (Russia),Pulau Pinang,0,0,0
1/05/2021,Russian Federation (Russia),Sabah,0,0,0
1/05/2021,Russian Federation (Russia),Sarawak,0,0,0
1/05/2021,Russian Federation (Russia),Selangor,64,55,9
1/05/2021,Russian Federation (Russia),W.P. Labuan,0,0,0
1/05/2021,Rwanda,Johor,0,0,0
1/05/2021,Rwanda,Kedah,0,0,0
1/05/2021,Rwanda,Pulau Pinang,0,0,0
1/05/2021,Rwanda,Selangor,2,1,1
1/05/2021,Saudi Arabia,Johor,0,0,0
1/05/2021,Saudi Arabia,Kedah,0,0,0
1/05/2021,Saudi Arabia,Kelantan,0,0,0
1/05/2021,Saudi Arabia,Melaka,0,0,0
1/05/2021,Saudi Arabia,Perak,0,0,0
1/05/2021,Saudi Arabia,Perlis,0,0,0
1/05/2021,Saudi Arabia,Pulau Pinang,0,0,0
1/05/2021,Saudi Arabia,Sabah,0,0,0
1/05/2021,Saudi Arabia,Sarawak,0,0,0
1/05/2021,Saudi Arabia,Selangor,61,46,15
1/05/2021,Saudi Arabia,W.P. Labuan,0,0,0
1/05/2021,Sudan,Johor,0,0,0
1/05/2021,Sudan,Kedah,0,0,0
1/05/2021,Sudan,Kelantan,0,0,0
1/05/2021,Sudan,Perlis,0,0,0
1/05/2021,Sudan,Pulau Pinang,0,0,0
1/05/2021,Sudan,Sabah,0,0,0
1/05/2021,Sudan,Sarawak,0,0,0
1/05/2021,Sudan,Selangor,47,36,11
1/05/2021,Sudan,W.P. Labuan,0,0,0
1/05/2021,Senegal,Johor,0,0,0
1/05/2021,Senegal,Kedah,0,0,0
1/05/2021,Senegal,Kelantan,0,0,0
1/05/2021,Senegal,Perak,0,0,0
1/05/2021,Senegal,Perlis,0,0,0
1/05/2021,Senegal,Pulau Pinang,0,0,0
1/05/2021,Senegal,Sabah,0,0,0
1/05/2021,Senegal,Sarawak,0,0,0
1/05/2021,Senegal,Selangor,2,1,1
1/05/2021,Singapore,Johor,139,129,10
1/05/2021,Singapore,Kedah,1,1,0
1/05/2021,Singapore,Kelantan,0,0,0
1/05/2021,Singapore,Melaka,0,0,0
1/05/2021,Singapore,Negeri Sembilan,0,0,0
1/05/2021,Singapore,Pahang,2,2,0
1/05/2021,Singapore,Perak,7,2,5
1/05/2021,Singapore,Perlis,0,0,0
1/05/2021,Singapore,Pulau Pinang,13,10,3
1/05/2021,Singapore,Sabah,1,1,0
1/05/2021,Singapore,Sarawak,7,5,2
1/05/2021,Singapore,Selangor,103,71,32
1/05/2021,Singapore,Terengganu,0,0,0
1/05/2021,Singapore,W.P. Labuan,0,0,0
1/05/2021,South Georgia and the South Sandwich Islands,Johor,0,0,0
1/05/2021,South Georgia and the South Sandwich Islands,Sabah,0,0,0
1/05/2021,South Georgia and the South Sandwich Islands,Selangor,0,0,0
1/05/2021,Saint Helena,Sarawak,0,0,0
1/05/2021,Solomon Islands,Johor,0,0,0
1/05/2021,Solomon Islands,Perlis,0,0,0
1/05/2021,Solomon Islands,Pulau Pinang,0,0,0
1/05/2021,Solomon Islands,Sabah,0,0,0
1/05/2021,Solomon Islands,Sarawak,0,0,0
1/05/2021,Solomon Islands,Selangor,0,0,0
1/05/2021,Solomon Islands,W.P. Labuan,0,0,0
1/05/2021,Sierra Leone,Johor,0,0,0
1/05/2021,Sierra Leone,Kedah,0,0,0
1/05/2021,Sierra Leone,Perak,0,0,0
1/05/2021,Sierra Leone,Pulau Pinang,0,0,0
1/05/2021,Sierra Leone,Sabah,0,0,0
1/05/2021,Sierra Leone,Selangor,3,3,0
1/05/2021,El Salvador,Johor,0,0,0
1/05/2021,El Salvador,Kedah,0,0,0
1/05/2021,El Salvador,Perak,0,0,0
1/05/2021,El Salvador,Perlis,0,0,0
1/05/2021,El Salvador,Pulau Pinang,0,0,0
1/05/2021,El Salvador,Sabah,0,0,0
1/05/2021,El Salvador,Selangor,0,0,0
1/05/2021,El Salvador,W.P. Labuan,0,0,0
1/05/2021,San Marino,Johor,0,0,0
1/05/2021,San Marino,Selangor,0,0,0
1/05/2021,Somalia,Johor,0,0,0
1/05/2021,Somalia,Kedah,0,0,0
1/05/2021,Somalia,Kelantan,0,0,0
1/05/2021,Somalia,Perlis,0,0,0
1/05/2021,Somalia,Sabah,0,0,0
1/05/2021,Somalia,Sarawak,0,0,0
1/05/2021,Somalia,Selangor,16,11,5
1/05/2021,Serbia,Johor,0,0,0
1/05/2021,Serbia,Kedah,0,0,0
1/05/2021,Serbia,Kelantan,0,0,0
1/05/2021,Serbia,Pahang,0,0,0
1/05/2021,Serbia,Perak,0,0,0
1/05/2021,Serbia,Perlis,0,0,0
1/05/2021,Serbia,Pulau Pinang,0,0,0
1/05/2021,Serbia,Sabah,0,0,0
1/05/2021,Serbia,Sarawak,0,0,0
1/05/2021,Serbia,Selangor,4,4,0
1/05/2021,South Sudan,Johor,0,0,0
1/05/2021,South Sudan,Kedah,0,0,0
1/05/2021,South Sudan,Sarawak,0,0,0
1/05/2021,South Sudan,Selangor,5,4,1
1/05/2021,South Sudan,W.P. Labuan,0,0,0
1/05/2021,Sao Tome and Principe,Selangor,0,0,0
1/05/2021,Suriname,Johor,0,0,0
1/05/2021,Suriname,Kedah,0,0,0
1/05/2021,Suriname,Kelantan,0,0,0
1/05/2021,Suriname,Perak,0,0,0
1/05/2021,Suriname,Perlis,0,0,0
1/05/2021,Suriname,Pulau Pinang,0,0,0
1/05/2021,Suriname,Sabah,0,0,0
1/05/2021,Suriname,Sarawak,0,0,0
1/05/2021,Suriname,Selangor,0,0,0
1/05/2021,Slovakia,Johor,0,0,0
1/05/2021,Slovakia,Kedah,0,0,0
1/05/2021,Slovakia,Kelantan,0,0,0
1/05/2021,Slovakia,Negeri Sembilan,0,0,0
1/05/2021,Slovakia,Pahang,0,0,0
1/05/2021,Slovakia,Perak,0,0,0
1/05/2021,Slovakia,Perlis,0,0,0
1/05/2021,Slovakia,Pulau Pinang,0,0,0
1/05/2021,Slovakia,Sabah,0,0,0
1/05/2021,Slovakia,Sarawak,0,0,0
1/05/2021,Slovakia,Selangor,7,5,2
1/05/2021,Slovakia,W.P. Labuan,0,0,0
1/05/2021,Slovenia,Johor,0,0,0
1/05/2021,Slovenia,Kedah,0,0,0
1/05/2021,Slovenia,Kelantan,0,0,0
1/05/2021,Slovenia,Perak,0,0,0
1/05/2021,Slovenia,Perlis,0,0,0
1/05/2021,Slovenia,Pulau Pinang,0,0,0
1/05/2021,Slovenia,Sabah,0,0,0
1/05/2021,Slovenia,Sarawak,1,1,0
1/05/2021,Slovenia,Selangor,1,1,0
1/05/2021,Slovenia,W.P. Labuan,0,0,0
1/05/2021,Sweden,Johor,0,0,0
1/05/2021,Sweden,Kedah,0,0,0
1/05/2021,Sweden,Kelantan,0,0,0
1/05/2021,Sweden,Melaka,0,0,0
1/05/2021,Sweden,Negeri Sembilan,0,0,0
1/05/2021,Sweden,Pahang,0,0,0
1/05/2021,Sweden,Perak,0,0,0
1/05/2021,Sweden,Perlis,0,0,0
1/05/2021,Sweden,Pulau Pinang,0,0,0
1/05/2021,Sweden,Sabah,1,0,1
1/05/2021,Sweden,Sarawak,0,0,0
1/05/2021,Sweden,Selangor,38,33,5
1/05/2021,Sweden,W.P. Labuan,0,0,0
1/05/2021,Eswatini,Johor,0,0,0
1/05/2021,Eswatini,Kedah,0,0,0
1/05/2021,Eswatini,Pulau Pinang,0,0,0
1/05/2021,Eswatini,Sabah,0,0,0
1/05/2021,Eswatini,Selangor,0,0,0
1/05/2021,Seychelles,Johor,0,0,0
1/05/2021,Seychelles,Kedah,0,0,0
1/05/2021,Seychelles,Pulau Pinang,0,0,0
1/05/2021,Seychelles,Sabah,0,0,0
1/05/2021,Seychelles,Sarawak,0,0,0
1/05/2021,Seychelles,Selangor,12,6,6
1/05/2021,Syrian Arab Republic,Johor,0,0,0
1/05/2021,Syrian Arab Republic,Kedah,0,0,0
1/05/2021,Syrian Arab Republic,Kelantan,0,0,0
1/05/2021,Syrian Arab Republic,Pahang,0,0,0
1/05/2021,Syrian Arab Republic,Perlis,0,0,0
1/05/2021,Syrian Arab Republic,Pulau Pinang,0,0,0
1/05/2021,Syrian Arab Republic,Sabah,0,0,0
1/05/2021,Syrian Arab Republic,Sarawak,0,0,0
1/05/2021,Syrian Arab Republic,Selangor,29,19,10
1/05/2021,Syrian Arab Republic,W.P. Labuan,0,0,0
1/05/2021,Turks and Caicos Islands,Perlis,0,0,0
1/05/2021,TCD,Johor,0,0,0
1/05/2021,TCD,Kedah,0,0,0
1/05/2021,TCD,Perlis,0,0,0
1/05/2021,TCD,Selangor,3,3,0
1/05/2021,Togo,Johor,0,0,0
1/05/2021,Togo,Perak,0,0,0
1/05/2021,Togo,Pulau Pinang,0,0,0
1/05/2021,Togo,Selangor,1,1,0
1/05/2021,Thailand,Johor,6,6,0
1/05/2021,Thailand,Kedah,18417,18374,43
1/05/2021,Thailand,Kelantan,1,1,0
1/05/2021,Thailand,Melaka,0,0,0
1/05/2021,Thailand,Negeri Sembilan,0,0,0
1/05/2021,Thailand,Pahang,0,0,0
1/05/2021,Thailand,Perak,1,0,1
1/05/2021,Thailand,Perlis,8612,8377,235
1/05/2021,Thailand,Pulau Pinang,37,32,5
1/05/2021,Thailand,Sabah,0,0,0
1/05/2021,Thailand,Sarawak,12,11,1
1/05/2021,Thailand,Selangor,211,93,118
1/05/2021,Thailand,Terengganu,0,0,0
1/05/2021,Thailand,W.P. Labuan,1,0,1
1/05/2021,Tajikistan,Johor,0,0,0
1/05/2021,Tajikistan,Kedah,0,0,0
1/05/2021,Tajikistan,Perlis,0,0,0
1/05/2021,Tajikistan,Pulau Pinang,0,0,0
1/05/2021,Tajikistan,Sabah,0,0,0
1/05/2021,Tajikistan,Selangor,0,0,0
1/05/2021,Tokelau,Selangor,0,0,0
1/05/2021,Turkmenistan,Johor,0,0,0
1/05/2021,Turkmenistan,Kedah,0,0,0
1/05/2021,Turkmenistan,Kelantan,0,0,0
1/05/2021,Turkmenistan,Perlis,0,0,0
1/05/2021,Turkmenistan,Pulau Pinang,0,0,0
1/05/2021,Turkmenistan,Sabah,0,0,0
1/05/2021,Turkmenistan,Sarawak,0,0,0
1/05/2021,Turkmenistan,Selangor,0,0,0
1/05/2021,Timor-Leste,Johor,0,0,0
1/05/2021,Timor-Leste,Kedah,0,0,0
1/05/2021,Timor-Leste,Perlis,0,0,0
1/05/2021,Timor-Leste,Pulau Pinang,0,0,0
1/05/2021,Timor-Leste,Sabah,0,0,0
1/05/2021,Timor-Leste,Sarawak,0,0,0
1/05/2021,Timor-Leste,Selangor,1,1,0
1/05/2021,Tonga,Johor,0,0,0
1/05/2021,Tonga,Pulau Pinang,0,0,0
1/05/2021,Tonga,Sarawak,0,0,0
1/05/2021,Tonga,Selangor,0,0,0
1/05/2021,Trinidad and Tobago,Johor,0,0,0
1/05/2021,Trinidad and Tobago,Kedah,0,0,0
1/05/2021,Trinidad and Tobago,Pahang,0,0,0
1/05/2021,Trinidad and Tobago,Pulau Pinang,0,0,0
1/05/2021,Trinidad and Tobago,Sabah,0,0,0
1/05/2021,Trinidad and Tobago,Sarawak,0,0,0
1/05/2021,Trinidad and Tobago,Selangor,1,1,0
1/05/2021,Tunisia,Johor,0,0,0
1/05/2021,Tunisia,Kedah,0,0,0
1/05/2021,Tunisia,Kelantan,0,0,0
1/05/2021,Tunisia,Melaka,0,0,0
1/05/2021,Tunisia,Perak,0,0,0
1/05/2021,Tunisia,Perlis,0,0,0
1/05/2021,Tunisia,Pulau Pinang,0,0,0
1/05/2021,Tunisia,Sabah,0,0,0
1/05/2021,Tunisia,Sarawak,0,0,0
1/05/2021,Tunisia,Selangor,9,7,2
1/05/2021,Tunisia,W.P. Labuan,0,0,0
1/05/2021,Türkiye,Johor,0,0,0
1/05/2021,Türkiye,Kedah,0,0,0
1/05/2021,Türkiye,Kelantan,0,0,0
1/05/2021,Türkiye,Melaka,0,0,0
1/05/2021,Türkiye,Negeri Sembilan,0,0,0
1/05/2021,Türkiye,Pahang,0,0,0
1/05/2021,Türkiye,Perak,0,0,0
1/05/2021,Türkiye,Perlis,0,0,0
1/05/2021,Türkiye,Pulau Pinang,0,0,0
1/05/2021,Türkiye,Sabah,0,0,0
1/05/2021,Türkiye,Sarawak,0,0,0
1/05/2021,Türkiye,Selangor,15,13,2
1/05/2021,Türkiye,W.P. Labuan,0,0,0
1/05/2021,Tuvalu,Selangor,0,0,0
1/05/2021,"Taiwan, Province of China",Johor,1,0,1
1/05/2021,"Taiwan, Province of China",Kedah,0,0,0
1/05/2021,"Taiwan, Province of China",Kelantan,0,0,0
1/05/2021,"Taiwan, Province of China",Melaka,0,0,0
1/05/2021,"Taiwan, Province of China",Negeri Sembilan,0,0,0
1/05/2021,"Taiwan, Province of China",Pahang,0,0,0
1/05/2021,"Taiwan, Province of China",Perak,0,0,0
1/05/2021,"Taiwan, Province of China",Perlis,0,0,0
1/05/2021,"Taiwan, Province of China",Pulau Pinang,10,8,2
1/05/2021,"Taiwan, Province of China",Sabah,0,0,0
1/05/2021,"Taiwan, Province of China",Sarawak,0,0,0
1/05/2021,"Taiwan, Province of China",Selangor,66,48,18
1/05/2021,"Taiwan, Province of China",W.P. Labuan,0,0,0
1/05/2021,"Tanzania, United Republic of",Johor,0,0,0
1/05/2021,"Tanzania, United Republic of",Kedah,0,0,0
1/05/2021,"Tanzania, United Republic of",Perak,0,0,0
1/05/2021,"Tanzania, United Republic of",Perlis,0,0,0
1/05/2021,"Tanzania, United Republic of",Pulau Pinang,0,0,0
1/05/2021,"Tanzania, United Republic of",Sabah,0,0,0
1/05/2021,"Tanzania, United Republic of",Sarawak,0,0,0
1/05/2021,"Tanzania, United Republic of",Selangor,16,8,8
1/05/2021,Uganda,Johor,0,0,0
1/05/2021,Uganda,Kedah,0,0,0
1/05/2021,Uganda,Perak,0,0,0
1/05/2021,Uganda,Perlis,0,0,0
1/05/2021,Uganda,Pulau Pinang,0,0,0
1/05/2021,Uganda,Sabah,0,0,0
1/05/2021,Uganda,Sarawak,0,0,0
1/05/2021,Uganda,Selangor,4,1,3
1/05/2021,Ukraine,Johor,2,2,0
1/05/2021,Ukraine,Kedah,0,0,0
1/05/2021,Ukraine,Kelantan,0,0,0
1/05/2021,Ukraine,Melaka,0,0,0
1/05/2021,Ukraine,Negeri Sembilan,0,0,0
1/05/2021,Ukraine,Pahang,0,0,0
1/05/2021,Ukraine,Perak,0,0,0
1/05/2021,Ukraine,Perlis,0,0,0
1/05/2021,Ukraine,Pulau Pinang,0,0,0
1/05/2021,Ukraine,Sabah,0,0,0
1/05/2021,Ukraine,Sarawak,0,0,0
1/05/2021,Ukraine,Selangor,61,57,4
1/05/2021,Ukraine,W.P. Labuan,0,0,0
1/05/2021,Uruguay,Johor,0,0,0
1/05/2021,Uruguay,Kedah,0,0,0
1/05/2021,Uruguay,Kelantan,0,0,0
1/05/2021,Uruguay,Perak,0,0,0
1/05/2021,Uruguay,Perlis,0,0,0
1/05/2021,Uruguay,Pulau Pinang,0,0,0
1/05/2021,Uruguay,Sabah,0,0,0
1/05/2021,Uruguay,Sarawak,0,0,0
1/05/2021,Uruguay,Selangor,0,0,0
1/05/2021,Uruguay,W.P. Labuan,0,0,0
1/05/2021,United States of America,Johor,0,0,0
1/05/2021,United States of America,Kedah,0,0,0
1/05/2021,United States of America,Kelantan,0,0,0
1/05/2021,United States of America,Melaka,0,0,0
1/05/2021,United States of America,Negeri Sembilan,0,0,0
1/05/2021,United States of America,Pahang,0,0,0
1/05/2021,United States of America,Perak,0,0,0
1/05/2021,United States of America,Perlis,0,0,0
1/05/2021,United States of America,Pulau Pinang,6,4,2
1/05/2021,United States of America,Sabah,0,0,0
1/05/2021,United States of America,Sarawak,1,1,0
1/05/2021,United States of America,Selangor,152,103,49
1/05/2021,United States of America,Terengganu,0,0,0
1/05/2021,United States of America,W.P. Labuan,0,0,0
1/05/2021,Uzbekistan,Johor,0,0,0
1/05/2021,Uzbekistan,Kedah,0,0,0
1/05/2021,Uzbekistan,Kelantan,0,0,0
1/05/2021,Uzbekistan,Perak,0,0,0
1/05/2021,Uzbekistan,Perlis,0,0,0
1/05/2021,Uzbekistan,Pulau Pinang,0,0,0
1/05/2021,Uzbekistan,Sabah,0,0,0
1/05/2021,Uzbekistan,Sarawak,0,0,0
1/05/2021,Uzbekistan,Selangor,15,14,1
1/05/2021,Holy See,Johor,0,0,0
1/05/2021,Holy See,Sarawak,0,0,0
1/05/2021,Holy See,Selangor,0,0,0
1/05/2021,Saint Vincent and the Grenadines,Johor,0,0,0
1/05/2021,Saint Vincent and the Grenadines,Kedah,0,0,0
1/05/2021,Saint Vincent and the Grenadines,Pulau Pinang,0,0,0
1/05/2021,Saint Vincent and the Grenadines,Sarawak,0,0,0
1/05/2021,Saint Vincent and the Grenadines,Selangor,0,0,0
1/05/2021,"Venezuela, Bolivarian Republic of",Johor,0,0,0
1/05/2021,"Venezuela, Bolivarian Republic of",Kedah,0,0,0
1/05/2021,"Venezuela, Bolivarian Republic of",Kelantan,0,0,0
1/05/2021,"Venezuela, Bolivarian Republic of",Melaka,0,0,0
1/05/2021,"Venezuela, Bolivarian Republic of",Perak,0,0,0
1/05/2021,"Venezuela, Bolivarian Republic of",Perlis,0,0,0
1/05/2021,"Venezuela, Bolivarian Republic of",Pulau Pinang,0,0,0
1/05/2021,"Venezuela, Bolivarian Republic of",Sabah,0,0,0
1/05/2021,"Venezuela, Bolivarian Republic of",Sarawak,0,0,0
1/05/2021,"Venezuela, Bolivarian Republic of",Selangor,4,4,0
1/05/2021,"Venezuela, Bolivarian Republic of",W.P. Labuan,0,0,0
1/05/2021,Viet Nam,Johor,0,0,0
1/05/2021,Viet Nam,Kedah,0,0,0
1/05/2021,Viet Nam,Kelantan,0,0,0
1/05/2021,Viet Nam,Melaka,0,0,0
1/05/2021,Viet Nam,Negeri Sembilan,0,0,0
1/05/2021,Viet Nam,Pahang,0,0,0
1/05/2021,Viet Nam,Perak,0,0,0
1/05/2021,Viet Nam,Perlis,0,0,0
1/05/2021,Viet Nam,Pulau Pinang,2,1,1
1/05/2021,Viet Nam,Sabah,0,0,0
1/05/2021,Viet Nam,Sarawak,0,0,0
1/05/2021,Viet Nam,Selangor,107,43,64
1/05/2021,Viet Nam,Terengganu,0,0,0
1/05/2021,Viet Nam,W.P. Labuan,0,0,0
1/05/2021,Vanuatu,Johor,0,0,0
1/05/2021,Vanuatu,Kedah,0,0,0
1/05/2021,Vanuatu,Pulau Pinang,0,0,0
1/05/2021,Vanuatu,Sabah,0,0,0
1/05/2021,Vanuatu,Sarawak,0,0,0
1/05/2021,Vanuatu,Selangor,0,0,0
1/05/2021, Samoa,Johor,0,0,0
1/05/2021, Samoa,Sarawak,0,0,0
1/05/2021, Samoa,Selangor,0,0,0
1/05/2021,Yemen,Johor,0,0,0
1/05/2021,Yemen,Kedah,0,0,0
1/05/2021,Yemen,Kelantan,0,0,0
1/05/2021,Yemen,Melaka,0,0,0
1/05/2021,Yemen,Pahang,0,0,0
1/05/2021,Yemen,Perak,0,0,0
1/05/2021,Yemen,Perlis,0,0,0
1/05/2021,Yemen,Pulau Pinang,0,0,0
1/05/2021,Yemen,Sabah,0,0,0
1/05/2021,Yemen,Sarawak,0,0,0
1/05/2021,Yemen,Selangor,52,38,14
1/05/2021,Yemen,W.P. Labuan,0,0,0
1/05/2021,South Africa,Johor,0,0,0
1/05/2021,South Africa,Kedah,0,0,0
1/05/2021,South Africa,Kelantan,0,0,0
1/05/2021,South Africa,Melaka,0,0,0
1/05/2021,South Africa,Pahang,0,0,0
1/05/2021,South Africa,Perak,0,0,0
1/05/2021,South Africa,Perlis,0,0,0
1/05/2021,South Africa,Pulau Pinang,0,0,0
1/05/2021,South Africa,Sabah,0,0,0
1/05/2021,South Africa,Sarawak,0,0,0
1/05/2021,South Africa,Selangor,33,25,8
1/05/2021,South Africa,Terengganu,0,0,0
1/05/2021,South Africa,W.P. Labuan,0,0,0
1/05/2021,ZAR,Selangor,0,0,0
1/05/2021,Zambia,Johor,0,0,0
1/05/2021,Zambia,Kedah,0,0,0
1/05/2021,Zambia,Perak,0,0,0
1/05/2021,Zambia,Perlis,0,0,0
1/05/2021,Zambia,Pulau Pinang,0,0,0
1/05/2021,Zambia,Sabah,0,0,0
1/05/2021,Zambia,Sarawak,0,0,0
1/05/2021,Zambia,Selangor,11,4,7
1/05/2021,Zimbabwe,Johor,0,0,0
1/05/2021,Zimbabwe,Kedah,0,0,0
1/05/2021,Zimbabwe,Kelantan,0,0,0
1/05/2021,Zimbabwe,Perak,0,0,0
1/05/2021,Zimbabwe,Perlis,0,0,0
1/05/2021,Zimbabwe,Pulau Pinang,0,0,0
1/05/2021,Zimbabwe,Sabah,0,0,0
1/05/2021,Zimbabwe,Sarawak,0,0,0
1/05/2021,Zimbabwe,Selangor,11,8,3
1/06/2021,Aruba,Kedah,0,0,0
1/06/2021,Aruba,Pulau Pinang,0,0,0
1/06/2021,Afghanistan,Johor,0,0,0
1/06/2021,Afghanistan,Kedah,0,0,0
1/06/2021,Afghanistan,Perlis,0,0,0
1/06/2021,Afghanistan,Pulau Pinang,0,0,0
1/06/2021,Afghanistan,Sarawak,0,0,0
1/06/2021,Afghanistan,Selangor,6,3,3
1/06/2021,Angola,Johor,0,0,0
1/06/2021,Angola,Kedah,0,0,0
1/06/2021,Angola,Sabah,0,0,0
1/06/2021,Angola,Selangor,0,0,0
1/06/2021,Anguilla,Selangor,0,0,0
1/06/2021,Albania,Johor,0,0,0
1/06/2021,Albania,Kedah,0,0,0
1/06/2021,Albania,Perak,0,0,0
1/06/2021,Albania,Perlis,0,0,0
1/06/2021,Albania,Pulau Pinang,0,0,0
1/06/2021,Albania,Sabah,0,0,0
1/06/2021,Albania,Sarawak,0,0,0
1/06/2021,Albania,Selangor,1,0,1
1/06/2021,Andorra,Johor,0,0,0
1/06/2021,Andorra,Kedah,0,0,0
1/06/2021,Andorra,Perlis,0,0,0
1/06/2021,Andorra,Pulau Pinang,0,0,0
1/06/2021,Andorra,Selangor,0,0,0
1/06/2021,Antigua and Barbuda,Selangor,0,0,0
1/06/2021,United Arab Emirates,Johor,0,0,0
1/06/2021,United Arab Emirates,Kedah,0,0,0
1/06/2021,United Arab Emirates,Kelantan,0,0,0
1/06/2021,United Arab Emirates,Perak,0,0,0
1/06/2021,United Arab Emirates,Perlis,0,0,0
1/06/2021,United Arab Emirates,Pulau Pinang,0,0,0
1/06/2021,United Arab Emirates,Sabah,0,0,0
1/06/2021,United Arab Emirates,Sarawak,0,0,0
1/06/2021,United Arab Emirates,Selangor,1,0,1
1/06/2021,Argentina,Johor,0,0,0
1/06/2021,Argentina,Kedah,0,0,0
1/06/2021,Argentina,Kelantan,0,0,0
1/06/2021,Argentina,Melaka,0,0,0
1/06/2021,Argentina,Perak,0,0,0
1/06/2021,Argentina,Perlis,0,0,0
1/06/2021,Argentina,Pulau Pinang,0,0,0
1/06/2021,Argentina,Sabah,0,0,0
1/06/2021,Argentina,Sarawak,0,0,0
1/06/2021,Argentina,Selangor,7,4,3
1/06/2021,Argentina,W.P. Labuan,0,0,0
1/06/2021,Armenia,Johor,0,0,0
1/06/2021,Armenia,Kedah,0,0,0
1/06/2021,Armenia,Kelantan,0,0,0
1/06/2021,Armenia,Perak,0,0,0
1/06/2021,Armenia,Perlis,0,0,0
1/06/2021,Armenia,Pulau Pinang,0,0,0
1/06/2021,Armenia,Sabah,0,0,0
1/06/2021,Armenia,Sarawak,0,0,0
1/06/2021,Armenia,Selangor,0,0,0
1/06/2021,Antarctica,Selangor,0,0,0
1/06/2021,Antigua and Barbuda,Johor,0,0,0
1/06/2021,Antigua and Barbuda,Kedah,0,0,0
1/06/2021,Antigua and Barbuda,Pulau Pinang,0,0,0
1/06/2021,Antigua and Barbuda,Sarawak,0,0,0
1/06/2021,Antigua and Barbuda,Selangor,0,0,0
1/06/2021,Australia,Johor,2,1,1
1/06/2021,Australia,Kedah,0,0,0
1/06/2021,Australia,Kelantan,0,0,0
1/06/2021,Australia,Melaka,0,0,0
1/06/2021,Australia,Negeri Sembilan,0,0,0
1/06/2021,Australia,Pahang,0,0,0
1/06/2021,Australia,Perak,0,0,0
1/06/2021,Australia,Perlis,0,0,0
1/06/2021,Australia,Pulau Pinang,6,3,3
1/06/2021,Australia,Sabah,0,0,0
1/06/2021,Australia,Sarawak,1,1,0
1/06/2021,Australia,Selangor,46,37,9
1/06/2021,Australia,Terengganu,0,0,0
1/06/2021,Australia,W.P. Labuan,0,0,0
1/06/2021,Austria,Johor,0,0,0
1/06/2021,Austria,Kedah,0,0,0
1/06/2021,Austria,Kelantan,0,0,0
1/06/2021,Austria,Melaka,0,0,0
1/06/2021,Austria,Negeri Sembilan,0,0,0
1/06/2021,Austria,Pahang,0,0,0
1/06/2021,Austria,Perak,0,0,0
1/06/2021,Austria,Perlis,0,0,0
1/06/2021,Austria,Pulau Pinang,0,0,0
1/06/2021,Austria,Sabah,0,0,0
1/06/2021,Austria,Sarawak,0,0,0
1/06/2021,Austria,Selangor,8,8,0
1/06/2021,Austria,Terengganu,0,0,0
1/06/2021,Austria,W.P. Labuan,0,0,0
1/06/2021,Azerbaijan,Johor,0,0,0
1/06/2021,Azerbaijan,Kedah,0,0,0
1/06/2021,Azerbaijan,Kelantan,0,0,0
1/06/2021,Azerbaijan,Melaka,0,0,0
1/06/2021,Azerbaijan,Perlis,0,0,0
1/06/2021,Azerbaijan,Pulau Pinang,0,0,0
1/06/2021,Azerbaijan,Sabah,0,0,0
1/06/2021,Azerbaijan,Sarawak,0,0,0
1/06/2021,Azerbaijan,Selangor,1,1,0
1/06/2021,Azerbaijan,W.P. Labuan,0,0,0
1/06/2021,Burundi,Pulau Pinang,0,0,0
1/06/2021,Burundi,Sarawak,0,0,0
1/06/2021,Burundi,Selangor,0,0,0
1/06/2021,Belgium,Johor,0,0,0
1/06/2021,Belgium,Kedah,0,0,0
1/06/2021,Belgium,Kelantan,0,0,0
1/06/2021,Belgium,Melaka,0,0,0
1/06/2021,Belgium,Negeri Sembilan,0,0,0
1/06/2021,Belgium,Pahang,0,0,0
1/06/2021,Belgium,Perak,0,0,0
1/06/2021,Belgium,Perlis,0,0,0
1/06/2021,Belgium,Pulau Pinang,0,0,0
1/06/2021,Belgium,Sabah,0,0,0
1/06/2021,Belgium,Sarawak,0,0,0
1/06/2021,Belgium,Selangor,5,3,2
1/06/2021,Belgium,W.P. Labuan,0,0,0
1/06/2021,Benin,Johor,0,0,0
1/06/2021,Benin,Kedah,0,0,0
1/06/2021,Benin,Perak,0,0,0
1/06/2021,Benin,Pulau Pinang,0,0,0
1/06/2021,Benin,Sabah,0,0,0
1/06/2021,Benin,Sarawak,0,0,0
1/06/2021,Benin,Selangor,0,0,0
1/06/2021,Burkina Faso,Perak,0,0,0
1/06/2021,Burkina Faso,Pulau Pinang,0,0,0
1/06/2021,Burkina Faso,Selangor,0,0,0
1/06/2021,Bangladesh,Johor,0,0,0
1/06/2021,Bangladesh,Kedah,0,0,0
1/06/2021,Bangladesh,Kelantan,0,0,0
1/06/2021,Bangladesh,Melaka,0,0,0
1/06/2021,Bangladesh,Negeri Sembilan,0,0,0
1/06/2021,Bangladesh,Pahang,0,0,0
1/06/2021,Bangladesh,Perak,0,0,0
1/06/2021,Bangladesh,Perlis,0,0,0
1/06/2021,Bangladesh,Pulau Pinang,0,0,0
1/06/2021,Bangladesh,Sabah,0,0,0
1/06/2021,Bangladesh,Sarawak,0,0,0
1/06/2021,Bangladesh,Selangor,3,1,2
1/06/2021,Bangladesh,W.P. Labuan,0,0,0
1/06/2021,Bulgaria,Johor,0,0,0
1/06/2021,Bulgaria,Kedah,0,0,0
1/06/2021,Bulgaria,Kelantan,0,0,0
1/06/2021,Bulgaria,Pahang,0,0,0
1/06/2021,Bulgaria,Perak,0,0,0
1/06/2021,Bulgaria,Perlis,0,0,0
1/06/2021,Bulgaria,Pulau Pinang,0,0,0
1/06/2021,Bulgaria,Sabah,0,0,0
1/06/2021,Bulgaria,Sarawak,0,0,0
1/06/2021,Bulgaria,Selangor,8,8,0
1/06/2021,Bulgaria,W.P. Labuan,0,0,0
1/06/2021,Bahrain,Johor,0,0,0
1/06/2021,Bahrain,Kedah,0,0,0
1/06/2021,Bahrain,Kelantan,0,0,0
1/06/2021,Bahrain,Perlis,0,0,0
1/06/2021,Bahrain,Pulau Pinang,0,0,0
1/06/2021,Bahrain,Sabah,0,0,0
1/06/2021,Bahrain,Sarawak,0,0,0
1/06/2021,Bahrain,Selangor,1,1,0
1/06/2021,Bahamas,Johor,0,0,0
1/06/2021,Bahamas,Kedah,0,0,0
1/06/2021,Bahamas,Perak,0,0,0
1/06/2021,Bahamas,Sabah,0,0,0
1/06/2021,Bahamas,Sarawak,0,0,0
1/06/2021,Bahamas,Selangor,0,0,0
1/06/2021,Bosnia and Herzegovina,Johor,0,0,0
1/06/2021,Bosnia and Herzegovina,Kedah,0,0,0
1/06/2021,Bosnia and Herzegovina,Perlis,0,0,0
1/06/2021,Bosnia and Herzegovina,Pulau Pinang,0,0,0
1/06/2021,Bosnia and Herzegovina,Sabah,0,0,0
1/06/2021,Bosnia and Herzegovina,Sarawak,0,0,0
1/06/2021,Bosnia and Herzegovina,Selangor,2,1,1
1/06/2021,Belarus,Johor,0,0,0
1/06/2021,Belarus,Kedah,0,0,0
1/06/2021,Belarus,Kelantan,0,0,0
1/06/2021,Belarus,Pahang,0,0,0
1/06/2021,Belarus,Perak,0,0,0
1/06/2021,Belarus,Perlis,0,0,0
1/06/2021,Belarus,Pulau Pinang,0,0,0
1/06/2021,Belarus,Sabah,0,0,0
1/06/2021,Belarus,Sarawak,0,0,0
1/06/2021,Belarus,Selangor,0,0,0
1/06/2021,Belarus,W.P. Labuan,0,0,0
1/06/2021,Belize,Johor,0,0,0
1/06/2021,Belize,Pulau Pinang,0,0,0
1/06/2021,Belize,Sarawak,0,0,0
1/06/2021,Belize,Selangor,0,0,0
1/06/2021,Bermuda,Selangor,0,0,0
1/06/2021,Bolivia,Johor,0,0,0
1/06/2021,Bolivia,Kedah,0,0,0
1/06/2021,Bolivia,Melaka,0,0,0
1/06/2021,Bolivia,Perak,0,0,0
1/06/2021,Bolivia,Perlis,0,0,0
1/06/2021,Bolivia,Pulau Pinang,0,0,0
1/06/2021,Bolivia,Sabah,0,0,0
1/06/2021,Bolivia,Sarawak,0,0,0
1/06/2021,Bolivia,Selangor,0,0,0
1/06/2021,Brazil,Johor,0,0,0
1/06/2021,Brazil,Kedah,0,0,0
1/06/2021,Brazil,Kelantan,0,0,0
1/06/2021,Brazil,Melaka,0,0,0
1/06/2021,Brazil,Pahang,0,0,0
1/06/2021,Brazil,Perak,0,0,0
1/06/2021,Brazil,Perlis,0,0,0
1/06/2021,Brazil,Pulau Pinang,0,0,0
1/06/2021,Brazil,Sabah,0,0,0
1/06/2021,Brazil,Sarawak,0,0,0
1/06/2021,Brazil,Selangor,15,12,3
1/06/2021,Brazil,W.P. Labuan,0,0,0
1/06/2021,Barbados,Johor,0,0,0
1/06/2021,Barbados,Kedah,0,0,0
1/06/2021,Barbados,Perlis,0,0,0
1/06/2021,Barbados,Pulau Pinang,0,0,0
1/06/2021,Barbados,Selangor,0,0,0
1/06/2021,Brunei Darussalam,Johor,0,0,0
1/06/2021,Brunei Darussalam,Kedah,0,0,0
1/06/2021,Brunei Darussalam,Kelantan,0,0,0
1/06/2021,Brunei Darussalam,Melaka,0,0,0
1/06/2021,Brunei Darussalam,Pahang,0,0,0
1/06/2021,Brunei Darussalam,Perak,0,0,0
1/06/2021,Brunei Darussalam,Perlis,0,0,0
1/06/2021,Brunei Darussalam,Pulau Pinang,0,0,0
1/06/2021,Brunei Darussalam,Sabah,0,0,0
1/06/2021,Brunei Darussalam,Sarawak,308,306,2
1/06/2021,Brunei Darussalam,Selangor,8,2,6
1/06/2021,Brunei Darussalam,W.P. Labuan,0,0,0
1/06/2021,Bhutan,Johor,0,0,0
1/06/2021,Bhutan,Kedah,0,0,0
1/06/2021,Bhutan,Perak,0,0,0
1/06/2021,Bhutan,Perlis,0,0,0
1/06/2021,Bhutan,Pulau Pinang,0,0,0
1/06/2021,Bhutan,Sabah,0,0,0
1/06/2021,Bhutan,Sarawak,0,0,0
1/06/2021,Bhutan,Selangor,0,0,0
1/06/2021,Botswana,Johor,0,0,0
1/06/2021,Botswana,Kedah,0,0,0
1/06/2021,Botswana,Perlis,0,0,0
1/06/2021,Botswana,Pulau Pinang,0,0,0
1/06/2021,Botswana,Sabah,0,0,0
1/06/2021,Botswana,Sarawak,0,0,0
1/06/2021,Botswana,Selangor,0,0,0
1/06/2021,Central African Republic,Kedah,0,0,0
1/06/2021,Central African Republic,Selangor,0,0,0
1/06/2021,Canada,Johor,0,0,0
1/06/2021,Canada,Kedah,0,0,0
1/06/2021,Canada,Kelantan,0,0,0
1/06/2021,Canada,Melaka,0,0,0
1/06/2021,Canada,Negeri Sembilan,0,0,0
1/06/2021,Canada,Pahang,0,0,0
1/06/2021,Canada,Perak,0,0,0
1/06/2021,Canada,Perlis,0,0,0
1/06/2021,Canada,Pulau Pinang,0,0,0
1/06/2021,Canada,Sabah,0,0,0
1/06/2021,Canada,Sarawak,0,0,0
1/06/2021,Canada,Selangor,29,19,10
1/06/2021,Canada,Terengganu,0,0,0
1/06/2021,Canada,W.P. Labuan,0,0,0
1/06/2021,Cocos (Keeling) Islands,Selangor,0,0,0
1/06/2021,Switzerland,Johor,0,0,0
1/06/2021,Switzerland,Kedah,0,0,0
1/06/2021,Switzerland,Kelantan,0,0,0
1/06/2021,Switzerland,Melaka,0,0,0
1/06/2021,Switzerland,Negeri Sembilan,0,0,0
1/06/2021,Switzerland,Pahang,0,0,0
1/06/2021,Switzerland,Perak,0,0,0
1/06/2021,Switzerland,Perlis,0,0,0
1/06/2021,Switzerland,Pulau Pinang,0,0,0
1/06/2021,Switzerland,Sabah,0,0,0
1/06/2021,Switzerland,Sarawak,0,0,0
1/06/2021,Switzerland,Selangor,12,9,3
1/06/2021,Switzerland,W.P. Labuan,0,0,0
1/06/2021,Chile,Johor,0,0,0
1/06/2021,Chile,Kedah,0,0,0
1/06/2021,Chile,Kelantan,0,0,0
1/06/2021,Chile,Melaka,0,0,0
1/06/2021,Chile,Pahang,0,0,0
1/06/2021,Chile,Perak,0,0,0
1/06/2021,Chile,Perlis,0,0,0
1/06/2021,Chile,Pulau Pinang,0,0,0
1/06/2021,Chile,Sabah,0,0,0
1/06/2021,Chile,Sarawak,0,0,0
1/06/2021,Chile,Selangor,0,0,0
1/06/2021,China,Johor,6,5,1
1/06/2021,China,Kedah,0,0,0
1/06/2021,China,Kelantan,0,0,0
1/06/2021,China,Melaka,0,0,0
1/06/2021,China,Pahang,0,0,0
1/06/2021,China,Perak,0,0,0
1/06/2021,China,Perlis,0,0,0
1/06/2021,China,Pulau Pinang,2,1,1
1/06/2021,China,Sabah,0,0,0
1/06/2021,China,Sarawak,77,67,10
1/06/2021,China,Selangor,727,622,105
1/06/2021,China,Terengganu,0,0,0
1/06/2021,China,W.P. Labuan,0,0,0
1/06/2021,Côte d'Ivoire,Johor,0,0,0
1/06/2021,Côte d'Ivoire,Kedah,0,0,0
1/06/2021,Côte d'Ivoire,Pulau Pinang,0,0,0
1/06/2021,Côte d'Ivoire,Sabah,0,0,0
1/06/2021,Côte d'Ivoire,Sarawak,0,0,0
1/06/2021,Côte d'Ivoire,Selangor,1,0,1
1/06/2021,Cameroon,Johor,0,0,0
1/06/2021,Cameroon,Kedah,0,0,0
1/06/2021,Cameroon,Pulau Pinang,0,0,0
1/06/2021,Cameroon,Sabah,0,0,0
1/06/2021,Cameroon,Sarawak,0,0,0
1/06/2021,Cameroon,Selangor,0,0,0
1/06/2021,Congo,Johor,0,0,0
1/06/2021,Congo,Pulau Pinang,0,0,0
1/06/2021,Congo,Sarawak,0,0,0
1/06/2021,Congo,Selangor,0,0,0
1/06/2021,Congo,Johor,0,0,0
1/06/2021,Congo,Kedah,0,0,0
1/06/2021,Congo,Selangor,0,0,0
1/06/2021,Cook Islands,Selangor,0,0,0
1/06/2021,Colombia,Johor,0,0,0
1/06/2021,Colombia,Kedah,0,0,0
1/06/2021,Colombia,Perak,0,0,0
1/06/2021,Colombia,Pulau Pinang,0,0,0
1/06/2021,Colombia,Sabah,0,0,0
1/06/2021,Colombia,Sarawak,0,0,0
1/06/2021,Colombia,Selangor,1,1,0
1/06/2021,Colombia,W.P. Labuan,0,0,0
1/06/2021,Comoros,Johor,0,0,0
1/06/2021,Comoros,Kedah,0,0,0
1/06/2021,Comoros,Selangor,0,0,0
1/06/2021,Cabo Verde,Johor,0,0,0
1/06/2021,Cabo Verde,Kedah,0,0,0
1/06/2021,Cabo Verde,Pulau Pinang,0,0,0
1/06/2021,Cabo Verde,Sabah,0,0,0
1/06/2021,Cabo Verde,Selangor,0,0,0
1/06/2021,Costa Rica,Johor,0,0,0
1/06/2021,Costa Rica,Kedah,0,0,0
1/06/2021,Costa Rica,Perak,0,0,0
1/06/2021,Costa Rica,Perlis,0,0,0
1/06/2021,Costa Rica,Pulau Pinang,0,0,0
1/06/2021,Costa Rica,Sabah,0,0,0
1/06/2021,Costa Rica,Sarawak,0,0,0
1/06/2021,Costa Rica,Selangor,1,1,0
1/06/2021,Cuba,Johor,0,0,0
1/06/2021,Cuba,Kedah,0,0,0
1/06/2021,Cuba,Perlis,0,0,0
1/06/2021,Cuba,Pulau Pinang,0,0,0
1/06/2021,Cuba,Sabah,0,0,0
1/06/2021,Cuba,Sarawak,0,0,0
1/06/2021,Cuba,Selangor,0,0,0
1/06/2021,Cyprus,Johor,0,0,0
1/06/2021,Cyprus,Kedah,0,0,0
1/06/2021,Cyprus,Perak,0,0,0
1/06/2021,Cyprus,Perlis,0,0,0
1/06/2021,Cyprus,Pulau Pinang,0,0,0
1/06/2021,Cyprus,Sabah,0,0,0
1/06/2021,Cyprus,Sarawak,0,0,0
1/06/2021,Cyprus,Selangor,0,0,0
1/06/2021,Czechia,Johor,0,0,0
1/06/2021,Czechia,Kedah,0,0,0
1/06/2021,Czechia,Kelantan,0,0,0
1/06/2021,Czechia,Melaka,0,0,0
1/06/2021,Czechia,Negeri Sembilan,0,0,0
1/06/2021,Czechia,Perak,0,0,0
1/06/2021,Czechia,Perlis,0,0,0
1/06/2021,Czechia,Pulau Pinang,0,0,0
1/06/2021,Czechia,Sabah,0,0,0
1/06/2021,Czechia,Sarawak,0,0,0
1/06/2021,Czechia,Selangor,2,2,0
1/06/2021,Czechia,W.P. Labuan,0,0,0
1/06/2021,Germany,Johor,0,0,0
1/06/2021,Germany,Kedah,0,0,0
1/06/2021,Germany,Kelantan,0,0,0
1/06/2021,Germany,Melaka,0,0,0
1/06/2021,Germany,Negeri Sembilan,0,0,0
1/06/2021,Germany,Pahang,0,0,0
1/06/2021,Germany,Perak,0,0,0
1/06/2021,Germany,Perlis,0,0,0
1/06/2021,Germany,Pulau Pinang,1,1,0
1/06/2021,Germany,Sabah,0,0,0
1/06/2021,Germany,Sarawak,0,0,0
1/06/2021,Germany,Selangor,50,45,5
1/06/2021,Germany,Terengganu,0,0,0
1/06/2021,Germany,W.P. Labuan,0,0,0
1/06/2021,Djibouti,Johor,0,0,0
1/06/2021,Djibouti,Selangor,1,0,1
1/06/2021,Dominica,Johor,0,0,0
1/06/2021,Dominica,Kedah,0,0,0
1/06/2021,Dominica,Pulau Pinang,0,0,0
1/06/2021,Dominica,Sabah,0,0,0
1/06/2021,Dominica,Sarawak,0,0,0
1/06/2021,Dominica,Selangor,0,0,0
1/06/2021,Dominica,W.P. Labuan,0,0,0
1/06/2021,Denmark,Johor,0,0,0
1/06/2021,Denmark,Kedah,0,0,0
1/06/2021,Denmark,Kelantan,0,0,0
1/06/2021,Denmark,Melaka,0,0,0
1/06/2021,Denmark,Negeri Sembilan,0,0,0
1/06/2021,Denmark,Pahang,0,0,0
1/06/2021,Denmark,Perak,0,0,0
1/06/2021,Denmark,Perlis,0,0,0
1/06/2021,Denmark,Pulau Pinang,0,0,0
1/06/2021,Denmark,Sabah,0,0,0
1/06/2021,Denmark,Sarawak,0,0,0
1/06/2021,Denmark,Selangor,10,9,1
1/06/2021,Denmark,W.P. Labuan,0,0,0
1/06/2021,Dominican Republic,Johor,0,0,0
1/06/2021,Dominican Republic,Kedah,0,0,0
1/06/2021,Dominican Republic,Perak,0,0,0
1/06/2021,Dominican Republic,Perlis,0,0,0
1/06/2021,Dominican Republic,Pulau Pinang,0,0,0
1/06/2021,Dominican Republic,Sabah,0,0,0
1/06/2021,Dominican Republic,Sarawak,0,0,0
1/06/2021,Dominican Republic,Selangor,0,0,0
1/06/2021,Algeria,Johor,0,0,0
1/06/2021,Algeria,Kedah,0,0,0
1/06/2021,Algeria,Kelantan,0,0,0
1/06/2021,Algeria,Melaka,0,0,0
1/06/2021,Algeria,Perak,0,0,0
1/06/2021,Algeria,Perlis,0,0,0
1/06/2021,Algeria,Pulau Pinang,0,0,0
1/06/2021,Algeria,Sabah,0,0,0
1/06/2021,Algeria,Sarawak,0,0,0
1/06/2021,Algeria,Selangor,11,7,4
1/06/2021,Algeria,W.P. Labuan,0,0,0
1/06/2021,Ecuador,Johor,0,0,0
1/06/2021,Ecuador,Kedah,0,0,0
1/06/2021,Ecuador,Perak,0,0,0
1/06/2021,Ecuador,Perlis,0,0,0
1/06/2021,Ecuador,Pulau Pinang,0,0,0
1/06/2021,Ecuador,Sabah,0,0,0
1/06/2021,Ecuador,Sarawak,0,0,0
1/06/2021,Ecuador,Selangor,0,0,0
1/06/2021,Egypt,Johor,0,0,0
1/06/2021,Egypt,Kedah,0,0,0
1/06/2021,Egypt,Kelantan,0,0,0
1/06/2021,Egypt,Melaka,0,0,0
1/06/2021,Egypt,Pahang,0,0,0
1/06/2021,Egypt,Perak,0,0,0
1/06/2021,Egypt,Perlis,0,0,0
1/06/2021,Egypt,Pulau Pinang,0,0,0
1/06/2021,Egypt,Sabah,0,0,0
1/06/2021,Egypt,Sarawak,0,0,0
1/06/2021,Egypt,Selangor,50,36,14
1/06/2021,Egypt,Terengganu,0,0,0
1/06/2021,Egypt,W.P. Labuan,0,0,0
1/06/2021,Eritrea,Johor,0,0,0
1/06/2021,Eritrea,Pulau Pinang,0,0,0
1/06/2021,Eritrea,Sabah,0,0,0
1/06/2021,Eritrea,Selangor,0,0,0
1/06/2021,Spain,Johor,0,0,0
1/06/2021,Spain,Kedah,0,0,0
1/06/2021,Spain,Kelantan,0,0,0
1/06/2021,Spain,Melaka,0,0,0
1/06/2021,Spain,Negeri Sembilan,0,0,0
1/06/2021,Spain,Pahang,0,0,0
1/06/2021,Spain,Perak,0,0,0
1/06/2021,Spain,Perlis,0,0,0
1/06/2021,Spain,Pulau Pinang,0,0,0
1/06/2021,Spain,Sabah,0,0,0
1/06/2021,Spain,Sarawak,0,0,0
1/06/2021,Spain,Selangor,14,12,2
1/06/2021,Spain,W.P. Labuan,0,0,0
1/06/2021,Estonia,Johor,0,0,0
1/06/2021,Estonia,Kedah,0,0,0
1/06/2021,Estonia,Kelantan,0,0,0
1/06/2021,Estonia,Pahang,0,0,0
1/06/2021,Estonia,Perak,0,0,0
1/06/2021,Estonia,Perlis,0,0,0
1/06/2021,Estonia,Pulau Pinang,0,0,0
1/06/2021,Estonia,Sabah,0,0,0
1/06/2021,Estonia,Sarawak,0,0,0
1/06/2021,Estonia,Selangor,1,1,0
1/06/2021,Estonia,W.P. Labuan,0,0,0
1/06/2021,Ethiopia,Johor,0,0,0
1/06/2021,Ethiopia,Kedah,0,0,0
1/06/2021,Ethiopia,Pulau Pinang,0,0,0
1/06/2021,Ethiopia,Sarawak,0,0,0
1/06/2021,Ethiopia,Selangor,4,2,2
1/06/2021,Finland,Johor,0,0,0
1/06/2021,Finland,Kedah,0,0,0
1/06/2021,Finland,Kelantan,0,0,0
1/06/2021,Finland,Melaka,0,0,0
1/06/2021,Finland,Negeri Sembilan,0,0,0
1/06/2021,Finland,Pahang,0,0,0
1/06/2021,Finland,Perak,0,0,0
1/06/2021,Finland,Perlis,0,0,0
1/06/2021,Finland,Pulau Pinang,0,0,0
1/06/2021,Finland,Sabah,0,0,0
1/06/2021,Finland,Sarawak,0,0,0
1/06/2021,Finland,Selangor,7,5,2
1/06/2021,Finland,W.P. Labuan,0,0,0
1/06/2021,Fiji,Johor,0,0,0
1/06/2021,Fiji,Kedah,0,0,0
1/06/2021,Fiji,Kelantan,0,0,0
1/06/2021,Fiji,Perak,0,0,0
1/06/2021,Fiji,Perlis,0,0,0
1/06/2021,Fiji,Pulau Pinang,0,0,0
1/06/2021,Fiji,Sabah,0,0,0
1/06/2021,Fiji,Sarawak,0,0,0
1/06/2021,Fiji,Selangor,0,0,0
1/06/2021,France,Johor,0,0,0
1/06/2021,France,Kedah,0,0,0
1/06/2021,France,Kelantan,0,0,0
1/06/2021,France,Melaka,0,0,0
1/06/2021,France,Negeri Sembilan,0,0,0
1/06/2021,France,Pahang,0,0,0
1/06/2021,France,Perak,0,0,0
1/06/2021,France,Perlis,0,0,0
1/06/2021,France,Pulau Pinang,0,0,0
1/06/2021,France,Sabah,0,0,0
1/06/2021,France,Sarawak,0,0,0
1/06/2021,France,Selangor,50,41,9
1/06/2021,France,Terengganu,0,0,0
1/06/2021,France,W.P. Labuan,0,0,0
1/06/2021,"Micronesia, Federated States of",Johor,0,0,0
1/06/2021,"Micronesia, Federated States of",Pulau Pinang,0,0,0
1/06/2021,"Micronesia, Federated States of",Selangor,0,0,0
1/06/2021,Gabon,Johor,0,0,0
1/06/2021,Gabon,Pulau Pinang,0,0,0
1/06/2021,Gabon,Sarawak,0,0,0
1/06/2021,Gabon,Selangor,0,0,0
1/06/2021,United Kingdom of Great Britain and Northern Ireland,Johor,3,3,0
1/06/2021,United Kingdom of Great Britain and Northern Ireland,Kedah,2,1,1
1/06/2021,United Kingdom of Great Britain and Northern Ireland,Kelantan,0,0,0
1/06/2021,United Kingdom of Great Britain and Northern Ireland,Melaka,0,0,0
1/06/2021,United Kingdom of Great Britain and Northern Ireland,Negeri Sembilan,0,0,0
1/06/2021,United Kingdom of Great Britain and Northern Ireland,Pahang,0,0,0
1/06/2021,United Kingdom of Great Britain and Northern Ireland,Perak,0,0,0
1/06/2021,United Kingdom of Great Britain and Northern Ireland,Perlis,0,0,0
1/06/2021,United Kingdom of Great Britain and Northern Ireland,Pulau Pinang,0,0,0
1/06/2021,United Kingdom of Great Britain and Northern Ireland,Sabah,0,0,0
1/06/2021,United Kingdom of Great Britain and Northern Ireland,Sarawak,2,2,0
1/06/2021,United Kingdom of Great Britain and Northern Ireland,Selangor,142,112,30
1/06/2021,United Kingdom of Great Britain and Northern Ireland,Terengganu,0,0,0
1/06/2021,United Kingdom of Great Britain and Northern Ireland,W.P. Labuan,0,0,0
1/06/2021,Georgia,Johor,0,0,0
1/06/2021,Georgia,Kedah,0,0,0
1/06/2021,Georgia,Melaka,0,0,0
1/06/2021,Georgia,Perak,0,0,0
1/06/2021,Georgia,Perlis,0,0,0
1/06/2021,Georgia,Pulau Pinang,0,0,0
1/06/2021,Georgia,Sabah,0,0,0
1/06/2021,Georgia,Sarawak,0,0,0
1/06/2021,Georgia,Selangor,5,5,0
1/06/2021,Ghana,Johor,0,0,0
1/06/2021,Ghana,Kedah,0,0,0
1/06/2021,Ghana,Kelantan,0,0,0
1/06/2021,Ghana,Pulau Pinang,0,0,0
1/06/2021,Ghana,Sabah,0,0,0
1/06/2021,Ghana,Sarawak,0,0,0
1/06/2021,Ghana,Selangor,7,6,1
1/06/2021,Gibraltar,Johor,0,0,0
1/06/2021,Gibraltar,Sarawak,0,0,0
1/06/2021,Guinea,Johor,0,0,0
1/06/2021,Guinea,Kedah,0,0,0
1/06/2021,Guinea,Kelantan,0,0,0
1/06/2021,Guinea,Perlis,0,0,0
1/06/2021,Guinea,Pulau Pinang,0,0,0
1/06/2021,Guinea,Sabah,0,0,0
1/06/2021,Guinea,Sarawak,0,0,0
1/06/2021,Guinea,Selangor,5,4,1
1/06/2021,Guadeloupe,Selangor,0,0,0
1/06/2021,Gambia,Johor,0,0,0
1/06/2021,Gambia,Kedah,0,0,0
1/06/2021,Gambia,Kelantan,0,0,0
1/06/2021,Gambia,Pulau Pinang,0,0,0
1/06/2021,Gambia,Sabah,0,0,0
1/06/2021,Gambia,Sarawak,0,0,0
1/06/2021,Gambia,Selangor,1,1,0
1/06/2021,Guinea-Bissau,Johor,0,0,0
1/06/2021,Guinea-Bissau,Selangor,0,0,0
1/06/2021,Equatorial Guinea,Johor,0,0,0
1/06/2021,Equatorial Guinea,Selangor,1,0,1
1/06/2021,Greece,Johor,0,0,0
1/06/2021,Greece,Kedah,0,0,0
1/06/2021,Greece,Kelantan,0,0,0
1/06/2021,Greece,Melaka,0,0,0
1/06/2021,Greece,Negeri Sembilan,0,0,0
1/06/2021,Greece,Pahang,0,0,0
1/06/2021,Greece,Perak,0,0,0
1/06/2021,Greece,Perlis,0,0,0
1/06/2021,Greece,Pulau Pinang,0,0,0
1/06/2021,Greece,Sabah,0,0,0
1/06/2021,Greece,Sarawak,0,0,0
1/06/2021,Greece,Selangor,5,4,1
1/06/2021,Grenada,Johor,0,0,0
1/06/2021,Grenada,Kedah,0,0,0
1/06/2021,Grenada,Pulau Pinang,0,0,0
1/06/2021,Grenada,Sabah,0,0,0
1/06/2021,Grenada,Sarawak,0,0,0
1/06/2021,Grenada,Selangor,1,1,0
1/06/2021,Greenland,Johor,0,0,0
1/06/2021,Greenland,Selangor,0,0,0
1/06/2021,Guatemala,Johor,0,0,0
1/06/2021,Guatemala,Kedah,0,0,0
1/06/2021,Guatemala,Pahang,0,0,0
1/06/2021,Guatemala,Perak,0,0,0
1/06/2021,Guatemala,Pulau Pinang,0,0,0
1/06/2021,Guatemala,Sabah,0,0,0
1/06/2021,Guatemala,Sarawak,0,0,0
1/06/2021,Guatemala,Selangor,1,1,0
1/06/2021,Guatemala,W.P. Labuan,0,0,0
1/06/2021,Guyana,Johor,0,0,0
1/06/2021,Guyana,Kedah,0,0,0
1/06/2021,Guyana,Pulau Pinang,0,0,0
1/06/2021,Guyana,Sarawak,0,0,0
1/06/2021,Guyana,Selangor,0,0,0
1/06/2021,Hong Kong,Johor,0,0,0
1/06/2021,Hong Kong,Kedah,0,0,0
1/06/2021,Hong Kong,Kelantan,0,0,0
1/06/2021,Hong Kong,Pahang,0,0,0
1/06/2021,Hong Kong,Perak,0,0,0
1/06/2021,Hong Kong,Perlis,0,0,0
1/06/2021,Hong Kong,Pulau Pinang,0,0,0
1/06/2021,Hong Kong,Sabah,0,0,0
1/06/2021,Hong Kong,Sarawak,0,0,0
1/06/2021,Hong Kong,Selangor,0,0,0
1/06/2021,Hong Kong,Terengganu,0,0,0
1/06/2021,Heard Island and McDonald Islands,Johor,0,0,0
1/06/2021,Honduras,Johor,0,0,0
1/06/2021,Honduras,Kedah,0,0,0
1/06/2021,Honduras,Perak,0,0,0
1/06/2021,Honduras,Pulau Pinang,0,0,0
1/06/2021,Honduras,Sabah,0,0,0
1/06/2021,Honduras,Sarawak,0,0,0
1/06/2021,Honduras,Selangor,2,2,0
1/06/2021,Croatia,Johor,0,0,0
1/06/2021,Croatia,Kedah,0,0,0
1/06/2021,Croatia,Kelantan,0,0,0
1/06/2021,Croatia,Melaka,0,0,0
1/06/2021,Croatia,Pahang,0,0,0
1/06/2021,Croatia,Perak,0,0,0
1/06/2021,Croatia,Perlis,0,0,0
1/06/2021,Croatia,Pulau Pinang,0,0,0
1/06/2021,Croatia,Sabah,0,0,0
1/06/2021,Croatia,Sarawak,0,0,0
1/06/2021,Croatia,Selangor,21,21,0
1/06/2021,Haiti,Johor,0,0,0
1/06/2021,Haiti,Kedah,0,0,0
1/06/2021,Haiti,Kelantan,0,0,0
1/06/2021,Haiti,Perak,0,0,0
1/06/2021,Haiti,Pulau Pinang,0,0,0
1/06/2021,Haiti,Sabah,0,0,0
1/06/2021,Haiti,Selangor,0,0,0
1/06/2021,Hungary,Johor,0,0,0
1/06/2021,Hungary,Kedah,0,0,0
1/06/2021,Hungary,Kelantan,0,0,0
1/06/2021,Hungary,Pahang,0,0,0
1/06/2021,Hungary,Perak,0,0,0
1/06/2021,Hungary,Perlis,0,0,0
1/06/2021,Hungary,Pulau Pinang,0,0,0
1/06/2021,Hungary,Sabah,0,0,0
1/06/2021,Hungary,Sarawak,0,0,0
1/06/2021,Hungary,Selangor,4,3,1
1/06/2021,Hungary,W.P. Labuan,0,0,0
1/06/2021,Indonesia,Johor,39,33,6
1/06/2021,Indonesia,Kedah,4,4,0
1/06/2021,Indonesia,Kelantan,0,0,0
1/06/2021,Indonesia,Melaka,0,0,0
1/06/2021,Indonesia,Negeri Sembilan,0,0,0
1/06/2021,Indonesia,Pahang,0,0,0
1/06/2021,Indonesia,Perak,0,0,0
1/06/2021,Indonesia,Perlis,2,2,0
1/06/2021,Indonesia,Pulau Pinang,7,5,2
1/06/2021,Indonesia,Sabah,1,1,0
1/06/2021,Indonesia,Sarawak,334,330,4
1/06/2021,Indonesia,Selangor,518,377,141
1/06/2021,Indonesia,Terengganu,0,0,0
1/06/2021,Indonesia,W.P. Labuan,0,0,0
1/06/2021,India,Johor,0,0,0
1/06/2021,India,Kedah,0,0,0
1/06/2021,India,Kelantan,0,0,0
1/06/2021,India,Melaka,0,0,0
1/06/2021,India,Negeri Sembilan,0,0,0
1/06/2021,India,Pahang,0,0,0
1/06/2021,India,Perak,0,0,0
1/06/2021,India,Perlis,0,0,0
1/06/2021,India,Pulau Pinang,0,0,0
1/06/2021,India,Sabah,0,0,0
1/06/2021,India,Sarawak,0,0,0
1/06/2021,India,Selangor,29,19,10
1/06/2021,India,Terengganu,0,0,0
1/06/2021,India,W.P. Labuan,0,0,0
1/06/2021, British Indian Ocean Territory,Pulau Pinang,0,0,0
1/06/2021, British Indian Ocean Territory,Selangor,0,0,0
1/06/2021,Ireland,Johor,0,0,0
1/06/2021,Ireland,Kedah,0,0,0
1/06/2021,Ireland,Kelantan,0,0,0
1/06/2021,Ireland,Negeri Sembilan,0,0,0
1/06/2021,Ireland,Pahang,0,0,0
1/06/2021,Ireland,Perak,0,0,0
1/06/2021,Ireland,Perlis,0,0,0
1/06/2021,Ireland,Pulau Pinang,0,0,0
1/06/2021,Ireland,Sabah,0,0,0
1/06/2021,Ireland,Sarawak,0,0,0
1/06/2021,Ireland,Selangor,6,4,2
1/06/2021,Ireland,Terengganu,0,0,0
1/06/2021,Ireland,W.P. Labuan,0,0,0
1/06/2021,"Iran, Islamic Republic of",Johor,0,0,0
1/06/2021,"Iran, Islamic Republic of",Kedah,0,0,0
1/06/2021,"Iran, Islamic Republic of",Kelantan,0,0,0
1/06/2021,"Iran, Islamic Republic of",Perak,0,0,0
1/06/2021,"Iran, Islamic Republic of",Perlis,0,0,0
1/06/2021,"Iran, Islamic Republic of",Pulau Pinang,0,0,0
1/06/2021,"Iran, Islamic Republic of",Sabah,0,0,0
1/06/2021,"Iran, Islamic Republic of",Sarawak,0,0,0
1/06/2021,"Iran, Islamic Republic of",Selangor,15,10,5
1/06/2021,"Iran, Islamic Republic of",W.P. Labuan,0,0,0
1/06/2021,Iraq,Johor,0,0,0
1/06/2021,Iraq,Kedah,0,0,0
1/06/2021,Iraq,Kelantan,0,0,0
1/06/2021,Iraq,Melaka,0,0,0
1/06/2021,Iraq,Pahang,0,0,0
1/06/2021,Iraq,Perak,0,0,0
1/06/2021,Iraq,Perlis,0,0,0
1/06/2021,Iraq,Pulau Pinang,0,0,0
1/06/2021,Iraq,Sabah,0,0,0
1/06/2021,Iraq,Sarawak,0,0,0
1/06/2021,Iraq,Selangor,25,15,10
1/06/2021,Iceland,Johor,0,0,0
1/06/2021,Iceland,Kedah,0,0,0
1/06/2021,Iceland,Kelantan,0,0,0
1/06/2021,Iceland,Perak,0,0,0
1/06/2021,Iceland,Perlis,0,0,0
1/06/2021,Iceland,Pulau Pinang,0,0,0
1/06/2021,Iceland,Sabah,0,0,0
1/06/2021,Iceland,Sarawak,0,0,0
1/06/2021,Iceland,Selangor,0,0,0
1/06/2021,Iceland,W.P. Labuan,0,0,0
1/06/2021,Israel,Pulau Pinang,0,0,0
1/06/2021,Italy,Johor,0,0,0
1/06/2021,Italy,Kedah,0,0,0
1/06/2021,Italy,Kelantan,0,0,0
1/06/2021,Italy,Melaka,0,0,0
1/06/2021,Italy,Negeri Sembilan,0,0,0
1/06/2021,Italy,Pahang,0,0,0
1/06/2021,Italy,Perak,0,0,0
1/06/2021,Italy,Perlis,0,0,0
1/06/2021,Italy,Pulau Pinang,0,0,0
1/06/2021,Italy,Sabah,0,0,0
1/06/2021,Italy,Sarawak,0,0,0
1/06/2021,Italy,Selangor,31,29,2
1/06/2021,Italy,W.P. Labuan,0,0,0
1/06/2021,Jamaica,Johor,0,0,0
1/06/2021,Jamaica,Kedah,0,0,0
1/06/2021,Jamaica,Perak,0,0,0
1/06/2021,Jamaica,Pulau Pinang,0,0,0
1/06/2021,Jamaica,Sabah,0,0,0
1/06/2021,Jamaica,Sarawak,0,0,0
1/06/2021,Jamaica,Selangor,0,0,0
1/06/2021,Jamaica,W.P. Labuan,0,0,0
1/06/2021,Jordan,Johor,0,0,0
1/06/2021,Jordan,Kedah,0,0,0
1/06/2021,Jordan,Kelantan,0,0,0
1/06/2021,Jordan,Melaka,0,0,0
1/06/2021,Jordan,Perlis,0,0,0
1/06/2021,Jordan,Pulau Pinang,0,0,0
1/06/2021,Jordan,Sabah,0,0,0
1/06/2021,Jordan,Sarawak,0,0,0
1/06/2021,Jordan,Selangor,13,11,2
1/06/2021,Jordan,W.P. Labuan,0,0,0
1/06/2021,Japan,Johor,0,0,0
1/06/2021,Japan,Kedah,0,0,0
1/06/2021,Japan,Kelantan,0,0,0
1/06/2021,Japan,Melaka,0,0,0
1/06/2021,Japan,Negeri Sembilan,0,0,0
1/06/2021,Japan,Pahang,0,0,0
1/06/2021,Japan,Perak,0,0,0
1/06/2021,Japan,Perlis,0,0,0
1/06/2021,Japan,Pulau Pinang,13,12,1
1/06/2021,Japan,Sabah,0,0,0
1/06/2021,Japan,Sarawak,2,1,1
1/06/2021,Japan,Selangor,297,195,102
1/06/2021,Japan,W.P. Labuan,0,0,0
1/06/2021,Kazakhstan,Johor,0,0,0
1/06/2021,Kazakhstan,Kedah,0,0,0
1/06/2021,Kazakhstan,Kelantan,0,0,0
1/06/2021,Kazakhstan,Melaka,0,0,0
1/06/2021,Kazakhstan,Perak,0,0,0
1/06/2021,Kazakhstan,Perlis,0,0,0
1/06/2021,Kazakhstan,Pulau Pinang,0,0,0
1/06/2021,Kazakhstan,Sabah,0,0,0
1/06/2021,Kazakhstan,Sarawak,0,0,0
1/06/2021,Kazakhstan,Selangor,28,21,7
1/06/2021,Kazakhstan,W.P. Labuan,0,0,0
1/06/2021,Kenya,Johor,0,0,0
1/06/2021,Kenya,Kedah,0,0,0
1/06/2021,Kenya,Kelantan,0,0,0
1/06/2021,Kenya,Perak,0,0,0
1/06/2021,Kenya,Perlis,0,0,0
1/06/2021,Kenya,Pulau Pinang,0,0,0
1/06/2021,Kenya,Sabah,0,0,0
1/06/2021,Kenya,Sarawak,0,0,0
1/06/2021,Kenya,Selangor,6,4,2
1/06/2021,Kyrgyzstan,Johor,0,0,0
1/06/2021,Kyrgyzstan,Kedah,0,0,0
1/06/2021,Kyrgyzstan,Kelantan,0,0,0
1/06/2021,Kyrgyzstan,Perak,0,0,0
1/06/2021,Kyrgyzstan,Perlis,0,0,0
1/06/2021,Kyrgyzstan,Pulau Pinang,0,0,0
1/06/2021,Kyrgyzstan,Sabah,0,0,0
1/06/2021,Kyrgyzstan,Sarawak,0,0,0
1/06/2021,Kyrgyzstan,Selangor,3,2,1
1/06/2021,Cambodia,Johor,0,0,0
1/06/2021,Cambodia,Kedah,0,0,0
1/06/2021,Cambodia,Kelantan,0,0,0
1/06/2021,Cambodia,Melaka,0,0,0
1/06/2021,Cambodia,Negeri Sembilan,0,0,0
1/06/2021,Cambodia,Pahang,0,0,0
1/06/2021,Cambodia,Perak,0,0,0
1/06/2021,Cambodia,Perlis,0,0,0
1/06/2021,Cambodia,Pulau Pinang,0,0,0
1/06/2021,Cambodia,Sabah,0,0,0
1/06/2021,Cambodia,Sarawak,0,0,0
1/06/2021,Cambodia,Selangor,9,9,0
1/06/2021,Cambodia,W.P. Labuan,0,0,0
1/06/2021,Kiribati,Johor,0,0,0
1/06/2021,Kiribati,Sabah,0,0,0
1/06/2021,Kiribati,Selangor,5,5,0
1/06/2021,Saint Kitts and Nevis,Johor,0,0,0
1/06/2021,Saint Kitts and Nevis,Kedah,0,0,0
1/06/2021,Saint Kitts and Nevis,Perlis,0,0,0
1/06/2021,Saint Kitts and Nevis,Pulau Pinang,0,0,0
1/06/2021,Saint Kitts and Nevis,Sabah,0,0,0
1/06/2021,Saint Kitts and Nevis,Selangor,0,0,0
1/06/2021,Saint Kitts and Nevis,W.P. Labuan,0,0,0
1/06/2021,"Korea, Republic of",Johor,0,0,0
1/06/2021,"Korea, Republic of",Kedah,0,0,0
1/06/2021,"Korea, Republic of",Kelantan,0,0,0
1/06/2021,"Korea, Republic of",Melaka,0,0,0
1/06/2021,"Korea, Republic of",Negeri Sembilan,0,0,0
1/06/2021,"Korea, Republic of",Pahang,0,0,0
1/06/2021,"Korea, Republic of",Perak,0,0,0
1/06/2021,"Korea, Republic of",Perlis,0,0,0
1/06/2021,"Korea, Republic of",Pulau Pinang,0,0,0
1/06/2021,"Korea, Republic of",Sabah,0,0,0
1/06/2021,"Korea, Republic of",Sarawak,15,12,3
1/06/2021,"Korea, Republic of",Selangor,199,151,48
1/06/2021,"Korea, Republic of",Terengganu,0,0,0
1/06/2021,"Korea, Republic of",W.P. Labuan,0,0,0
1/06/2021,Kuwait,Johor,0,0,0
1/06/2021,Kuwait,Kedah,0,0,0
1/06/2021,Kuwait,Kelantan,0,0,0
1/06/2021,Kuwait,Perak,0,0,0
1/06/2021,Kuwait,Perlis,0,0,0
1/06/2021,Kuwait,Pulau Pinang,0,0,0
1/06/2021,Kuwait,Sabah,0,0,0
1/06/2021,Kuwait,Sarawak,0,0,0
1/06/2021,Kuwait,Selangor,2,2,0
1/06/2021,Kuwait,W.P. Labuan,0,0,0
1/06/2021, Lao People's Democratic Republic,Johor,0,0,0
1/06/2021, Lao People's Democratic Republic,Kedah,0,0,0
1/06/2021, Lao People's Democratic Republic,Kelantan,0,0,0
1/06/2021, Lao People's Democratic Republic,Melaka,0,0,0
1/06/2021, Lao People's Democratic Republic,Perak,0,0,0
1/06/2021, Lao People's Democratic Republic,Perlis,0,0,0
1/06/2021, Lao People's Democratic Republic,Pulau Pinang,0,0,0
1/06/2021, Lao People's Democratic Republic,Sabah,0,0,0
1/06/2021, Lao People's Democratic Republic,Sarawak,0,0,0
1/06/2021, Lao People's Democratic Republic,Selangor,86,85,1
1/06/2021, Lao People's Democratic Republic,W.P. Labuan,0,0,0
1/06/2021,Lebanon,Johor,0,0,0
1/06/2021,Lebanon,Kedah,0,0,0
1/06/2021,Lebanon,Kelantan,0,0,0
1/06/2021,Lebanon,Pahang,0,0,0
1/06/2021,Lebanon,Perak,0,0,0
1/06/2021,Lebanon,Perlis,0,0,0
1/06/2021,Lebanon,Pulau Pinang,0,0,0
1/06/2021,Lebanon,Sabah,0,0,0
1/06/2021,Lebanon,Sarawak,0,0,0
1/06/2021,Lebanon,Selangor,4,2,2
1/06/2021,Lebanon,W.P. Labuan,0,0,0
1/06/2021,Liberia,Johor,0,0,0
1/06/2021,Liberia,Kedah,0,0,0
1/06/2021,Liberia,Sabah,0,0,0
1/06/2021,Liberia,Sarawak,0,0,0
1/06/2021,Liberia,Selangor,0,0,0
1/06/2021,Libya,Johor,0,0,0
1/06/2021,Libya,Kedah,0,0,0
1/06/2021,Libya,Perlis,0,0,0
1/06/2021,Libya,Pulau Pinang,0,0,0
1/06/2021,Libya,Sabah,0,0,0
1/06/2021,Libya,Sarawak,0,0,0
1/06/2021,Libya,Selangor,26,18,8
1/06/2021,Saint Lucia,Johor,0,0,0
1/06/2021,Saint Lucia,Kedah,0,0,0
1/06/2021,Saint Lucia,Pulau Pinang,0,0,0
1/06/2021,Saint Lucia,Sarawak,0,0,0
1/06/2021,Saint Lucia,Selangor,0,0,0
1/06/2021,Liechtenstein,Johor,0,0,0
1/06/2021,Liechtenstein,Kedah,0,0,0
1/06/2021,Liechtenstein,Perlis,0,0,0
1/06/2021,Liechtenstein,Pulau Pinang,0,0,0
1/06/2021,Liechtenstein,Sabah,0,0,0
1/06/2021,Liechtenstein,Sarawak,0,0,0
1/06/2021,Liechtenstein,Selangor,0,0,0
1/06/2021,LKA,Johor,0,0,0
1/06/2021,LKA,Kedah,0,0,0
1/06/2021,LKA,Kelantan,0,0,0
1/06/2021,LKA,Melaka,0,0,0
1/06/2021,LKA,Pahang,0,0,0
1/06/2021,LKA,Perak,0,0,0
1/06/2021,LKA,Perlis,0,0,0
1/06/2021,LKA,Pulau Pinang,0,0,0
1/06/2021,LKA,Sabah,0,0,0
1/06/2021,LKA,Sarawak,0,0,0
1/06/2021,LKA,Selangor,3,2,1
1/06/2021,LKA,W.P. Labuan,0,0,0
1/06/2021,Lesotho,Johor,0,0,0
1/06/2021,Lesotho,Kedah,0,0,0
1/06/2021,Lesotho,Pulau Pinang,0,0,0
1/06/2021,Lesotho,Sarawak,0,0,0
1/06/2021,Lesotho,Selangor,0,0,0
1/06/2021,Lithuania,Johor,0,0,0
1/06/2021,Lithuania,Kedah,0,0,0
1/06/2021,Lithuania,Kelantan,0,0,0
1/06/2021,Lithuania,Pahang,0,0,0
1/06/2021,Lithuania,Perak,0,0,0
1/06/2021,Lithuania,Perlis,0,0,0
1/06/2021,Lithuania,Pulau Pinang,0,0,0
1/06/2021,Lithuania,Sabah,0,0,0
1/06/2021,Lithuania,Sarawak,0,0,0
1/06/2021,Lithuania,Selangor,1,0,1
1/06/2021,Lithuania,W.P. Labuan,0,0,0
1/06/2021,Luxembourg,Johor,0,0,0
1/06/2021,Luxembourg,Kedah,0,0,0
1/06/2021,Luxembourg,Kelantan,0,0,0
1/06/2021,Luxembourg,Perak,0,0,0
1/06/2021,Luxembourg,Perlis,0,0,0
1/06/2021,Luxembourg,Pulau Pinang,0,0,0
1/06/2021,Luxembourg,Sabah,0,0,0
1/06/2021,Luxembourg,Sarawak,0,0,0
1/06/2021,Luxembourg,Selangor,0,0,0
1/06/2021,Latvia,Johor,0,0,0
1/06/2021,Latvia,Kedah,0,0,0
1/06/2021,Latvia,Kelantan,0,0,0
1/06/2021,Latvia,Pahang,0,0,0
1/06/2021,Latvia,Perak,0,0,0
1/06/2021,Latvia,Perlis,0,0,0
1/06/2021,Latvia,Pulau Pinang,0,0,0
1/06/2021,Latvia,Sabah,0,0,0
1/06/2021,Latvia,Sarawak,0,0,0
1/06/2021,Latvia,Selangor,2,2,0
1/06/2021,Latvia,W.P. Labuan,0,0,0
1/06/2021,Macao,Johor,0,0,0
1/06/2021,Macao,Pahang,0,0,0
1/06/2021,Macao,Perak,0,0,0
1/06/2021,Macao,Selangor,0,0,0
1/06/2021,Macao,W.P. Labuan,0,0,0
1/06/2021,Morocco,Johor,0,0,0
1/06/2021,Morocco,Kedah,0,0,0
1/06/2021,Morocco,Kelantan,0,0,0
1/06/2021,Morocco,Melaka,0,0,0
1/06/2021,Morocco,Pahang,0,0,0
1/06/2021,Morocco,Perak,0,0,0
1/06/2021,Morocco,Perlis,0,0,0
1/06/2021,Morocco,Pulau Pinang,0,0,0
1/06/2021,Morocco,Sabah,0,0,0
1/06/2021,Morocco,Sarawak,0,0,0
1/06/2021,Morocco,Selangor,6,3,3
1/06/2021,Morocco,W.P. Labuan,0,0,0
1/06/2021,Monaco,Johor,0,0,0
1/06/2021,Monaco,Kedah,0,0,0
1/06/2021,Monaco,Sabah,0,0,0
1/06/2021,Monaco,Selangor,0,0,0
1/06/2021,"Moldova, Republic of",Johor,0,0,0
1/06/2021,"Moldova, Republic of",Kedah,0,0,0
1/06/2021,"Moldova, Republic of",Kelantan,0,0,0
1/06/2021,"Moldova, Republic of",Negeri Sembilan,0,0,0
1/06/2021,"Moldova, Republic of",Perlis,0,0,0
1/06/2021,"Moldova, Republic of",Pulau Pinang,0,0,0
1/06/2021,"Moldova, Republic of",Sabah,0,0,0
1/06/2021,"Moldova, Republic of",Sarawak,0,0,0
1/06/2021,"Moldova, Republic of",Selangor,0,0,0
1/06/2021,Madagascar,Johor,0,0,0
1/06/2021,Madagascar,Kedah,0,0,0
1/06/2021,Madagascar,Perak,0,0,0
1/06/2021,Madagascar,Perlis,0,0,0
1/06/2021,Madagascar,Pulau Pinang,0,0,0
1/06/2021,Madagascar,Sabah,0,0,0
1/06/2021,Madagascar,Sarawak,0,0,0
1/06/2021,Madagascar,Selangor,0,0,0
1/06/2021,Maldives,Johor,0,0,0
1/06/2021,Maldives,Kedah,0,0,0
1/06/2021,Maldives,Kelantan,0,0,0
1/06/2021,Maldives,Perak,0,0,0
1/06/2021,Maldives,Perlis,0,0,0
1/06/2021,Maldives,Pulau Pinang,0,0,0
1/06/2021,Maldives,Sabah,0,0,0
1/06/2021,Maldives,Sarawak,0,0,0
1/06/2021,Maldives,Selangor,24,12,12
1/06/2021,Mexico,Johor,0,0,0
1/06/2021,Mexico,Kedah,0,0,0
1/06/2021,Mexico,Kelantan,0,0,0
1/06/2021,Mexico,Pahang,0,0,0
1/06/2021,Mexico,Perak,0,0,0
1/06/2021,Mexico,Perlis,0,0,0
1/06/2021,Mexico,Pulau Pinang,0,0,0
1/06/2021,Mexico,Sabah,0,0,0
1/06/2021,Mexico,Sarawak,0,0,0
1/06/2021,Mexico,Selangor,10,8,2
1/06/2021,Mexico,W.P. Labuan,0,0,0
1/06/2021,Marshall Islands,Johor,0,0,0
1/06/2021,Marshall Islands,Kedah,0,0,0
1/06/2021,Marshall Islands,Perak,0,0,0
1/06/2021,Marshall Islands,Pulau Pinang,0,0,0
1/06/2021,Marshall Islands,Sabah,0,0,0
1/06/2021,Marshall Islands,Selangor,0,0,0
1/06/2021,North Macedonia,Johor,0,0,0
1/06/2021,North Macedonia,Kedah,0,0,0
1/06/2021,North Macedonia,Perak,0,0,0
1/06/2021,North Macedonia,Pulau Pinang,0,0,0
1/06/2021,North Macedonia,Sabah,0,0,0
1/06/2021,North Macedonia,Sarawak,0,0,0
1/06/2021,North Macedonia,Selangor,0,0,0
1/06/2021,Mali,Johor,0,0,0
1/06/2021,Mali,Sabah,0,0,0
1/06/2021,Mali,Selangor,0,0,0
1/06/2021,Malta,Johor,0,0,0
1/06/2021,Malta,Kedah,0,0,0
1/06/2021,Malta,Kelantan,0,0,0
1/06/2021,Malta,Perak,0,0,0
1/06/2021,Malta,Perlis,0,0,0
1/06/2021,Malta,Pulau Pinang,0,0,0
1/06/2021,Malta,Sabah,0,0,0
1/06/2021,Malta,Sarawak,0,0,0
1/06/2021,Malta,Selangor,1,1,0
1/06/2021,Malta,W.P. Labuan,0,0,0
1/06/2021,Myanmar,Johor,2,2,0
1/06/2021,Myanmar,Kedah,0,0,0
1/06/2021,Myanmar,Kelantan,0,0,0
1/06/2021,Myanmar,Negeri Sembilan,0,0,0
1/06/2021,Myanmar,Pahang,0,0,0
1/06/2021,Myanmar,Perak,0,0,0
1/06/2021,Myanmar,Perlis,0,0,0
1/06/2021,Myanmar,Pulau Pinang,1,0,1
1/06/2021,Myanmar,Sabah,0,0,0
1/06/2021,Myanmar,Sarawak,0,0,0
1/06/2021,Myanmar,Selangor,77,65,12
1/06/2021,Myanmar,Terengganu,0,0,0
1/06/2021,Myanmar,W.P. Labuan,0,0,0
1/06/2021,Montenegro,Johor,0,0,0
1/06/2021,Montenegro,Kedah,0,0,0
1/06/2021,Montenegro,Pulau Pinang,0,0,0
1/06/2021,Montenegro,Sabah,0,0,0
1/06/2021,Montenegro,Sarawak,0,0,0
1/06/2021,Montenegro,Selangor,3,3,0
1/06/2021,Mongolia,Johor,0,0,0
1/06/2021,Mongolia,Kedah,0,0,0
1/06/2021,Mongolia,Kelantan,0,0,0
1/06/2021,Mongolia,Perak,0,0,0
1/06/2021,Mongolia,Perlis,0,0,0
1/06/2021,Mongolia,Pulau Pinang,0,0,0
1/06/2021,Mongolia,Sabah,0,0,0
1/06/2021,Mongolia,Sarawak,0,0,0
1/06/2021,Mongolia,Selangor,1,0,1
1/06/2021,Northern Mariana Islands,Selangor,0,0,0
1/06/2021,Mozambique,Johor,0,0,0
1/06/2021,Mozambique,Kedah,0,0,0
1/06/2021,Mozambique,Perak,0,0,0
1/06/2021,Mozambique,Pulau Pinang,0,0,0
1/06/2021,Mozambique,Sabah,0,0,0
1/06/2021,Mozambique,Sarawak,0,0,0
1/06/2021,Mozambique,Selangor,6,3,3
1/06/2021,Mauritania,Johor,0,0,0
1/06/2021,Mauritania,Kedah,0,0,0
1/06/2021,Mauritania,Pulau Pinang,0,0,0
1/06/2021,Mauritania,Sabah,0,0,0
1/06/2021,Mauritania,Sarawak,0,0,0
1/06/2021,Mauritania,Selangor,0,0,0
1/06/2021,Mauritius,Johor,0,0,0
1/06/2021,Mauritius,Kedah,0,0,0
1/06/2021,Mauritius,Kelantan,0,0,0
1/06/2021,Mauritius,Pahang,0,0,0
1/06/2021,Mauritius,Perak,0,0,0
1/06/2021,Mauritius,Perlis,0,0,0
1/06/2021,Mauritius,Pulau Pinang,0,0,0
1/06/2021,Mauritius,Sabah,0,0,0
1/06/2021,Mauritius,Sarawak,0,0,0
1/06/2021,Mauritius,Selangor,7,3,4
1/06/2021,Malawi,Johor,0,0,0
1/06/2021,Malawi,Pulau Pinang,0,0,0
1/06/2021,Malawi,Sabah,0,0,0
1/06/2021,Malawi,Sarawak,0,0,0
1/06/2021,Malawi,Selangor,1,0,1
1/06/2021,Mayotte,Selangor,0,0,0
1/06/2021,Namibia,Johor,0,0,0
1/06/2021,Namibia,Kedah,0,0,0
1/06/2021,Namibia,Perak,0,0,0
1/06/2021,Namibia,Perlis,0,0,0
1/06/2021,Namibia,Pulau Pinang,0,0,0
1/06/2021,Namibia,Sabah,0,0,0
1/06/2021,Namibia,Sarawak,0,0,0
1/06/2021,Namibia,Selangor,2,1,1
1/06/2021,New Caledonia,Selangor,0,0,0
1/06/2021,Niger,Johor,0,0,0
1/06/2021,Niger,Sabah,0,0,0
1/06/2021,Niger,Selangor,0,0,0
1/06/2021,Nigeria,Johor,0,0,0
1/06/2021,Nigeria,Kedah,0,0,0
1/06/2021,Nigeria,Perlis,0,0,0
1/06/2021,Nigeria,Pulau Pinang,0,0,0
1/06/2021,Nigeria,Sabah,0,0,0
1/06/2021,Nigeria,Sarawak,0,0,0
1/06/2021,Nigeria,Selangor,93,81,12
1/06/2021,Nicaragua,Johor,0,0,0
1/06/2021,Nicaragua,Kedah,0,0,0
1/06/2021,Nicaragua,Pulau Pinang,0,0,0
1/06/2021,Nicaragua,Sabah,0,0,0
1/06/2021,Nicaragua,Selangor,0,0,0
1/06/2021,Netherlands,Johor,0,0,0
1/06/2021,Netherlands,Kedah,0,0,0
1/06/2021,Netherlands,Kelantan,0,0,0
1/06/2021,Netherlands,Melaka,0,0,0
1/06/2021,Netherlands,Negeri Sembilan,0,0,0
1/06/2021,Netherlands,Pahang,0,0,0
1/06/2021,Netherlands,Perak,0,0,0
1/06/2021,Netherlands,Perlis,0,0,0
1/06/2021,Netherlands,Pulau Pinang,2,2,0
1/06/2021,Netherlands,Sabah,0,0,0
1/06/2021,Netherlands,Sarawak,0,0,0
1/06/2021,Netherlands,Selangor,24,20,4
1/06/2021,Netherlands,Terengganu,0,0,0
1/06/2021,Netherlands,W.P. Labuan,0,0,0
1/06/2021,Norway,Johor,0,0,0
1/06/2021,Norway,Kedah,0,0,0
1/06/2021,Norway,Kelantan,0,0,0
1/06/2021,Norway,Melaka,0,0,0
1/06/2021,Norway,Pahang,0,0,0
1/06/2021,Norway,Perak,0,0,0
1/06/2021,Norway,Perlis,0,0,0
1/06/2021,Norway,Pulau Pinang,0,0,0
1/06/2021,Norway,Sabah,0,0,0
1/06/2021,Norway,Sarawak,0,0,0
1/06/2021,Norway,Selangor,8,8,0
1/06/2021,Norway,W.P. Labuan,0,0,0
1/06/2021,Nepal,Johor,0,0,0
1/06/2021,Nepal,Kedah,0,0,0
1/06/2021,Nepal,Pahang,0,0,0
1/06/2021,Nepal,Perak,0,0,0
1/06/2021,Nepal,Perlis,0,0,0
1/06/2021,Nepal,Pulau Pinang,0,0,0
1/06/2021,Nepal,Sabah,0,0,0
1/06/2021,Nepal,Sarawak,0,0,0
1/06/2021,Nepal,Selangor,1,1,0
1/06/2021,Nepal,W.P. Labuan,0,0,0
1/06/2021,Nauru,Johor,0,0,0
1/06/2021,Nauru,Pulau Pinang,0,0,0
1/06/2021,Nauru,Selangor,0,0,0
1/06/2021,New Zealand,Johor,0,0,0
1/06/2021,New Zealand,Kedah,0,0,0
1/06/2021,New Zealand,Kelantan,0,0,0
1/06/2021,New Zealand,Melaka,0,0,0
1/06/2021,New Zealand,Negeri Sembilan,0,0,0
1/06/2021,New Zealand,Pahang,0,0,0
1/06/2021,New Zealand,Perak,0,0,0
1/06/2021,New Zealand,Perlis,0,0,0
1/06/2021,New Zealand,Pulau Pinang,0,0,0
1/06/2021,New Zealand,Sabah,0,0,0
1/06/2021,New Zealand,Sarawak,0,0,0
1/06/2021,New Zealand,Selangor,20,11,9
1/06/2021,New Zealand,Terengganu,0,0,0
1/06/2021,New Zealand,W.P. Labuan,0,0,0
1/06/2021,Oman,Johor,0,0,0
1/06/2021,Oman,Kedah,0,0,0
1/06/2021,Oman,Kelantan,0,0,0
1/06/2021,Oman,Melaka,0,0,0
1/06/2021,Oman,Perak,0,0,0
1/06/2021,Oman,Perlis,0,0,0
1/06/2021,Oman,Pulau Pinang,0,0,0
1/06/2021,Oman,Sabah,0,0,0
1/06/2021,Oman,Sarawak,0,0,0
1/06/2021,Oman,Selangor,0,0,0
1/06/2021,Pakistan,Johor,2,2,0
1/06/2021,Pakistan,Kedah,0,0,0
1/06/2021,Pakistan,Kelantan,0,0,0
1/06/2021,Pakistan,Melaka,0,0,0
1/06/2021,Pakistan,Negeri Sembilan,0,0,0
1/06/2021,Pakistan,Pahang,0,0,0
1/06/2021,Pakistan,Perak,0,0,0
1/06/2021,Pakistan,Perlis,0,0,0
1/06/2021,Pakistan,Pulau Pinang,0,0,0
1/06/2021,Pakistan,Sabah,1,1,0
1/06/2021,Pakistan,Sarawak,0,0,0
1/06/2021,Pakistan,Selangor,14,8,6
1/06/2021,Pakistan,W.P. Labuan,0,0,0
1/06/2021,Panama,Johor,0,0,0
1/06/2021,Panama,Kedah,0,0,0
1/06/2021,Panama,Perak,0,0,0
1/06/2021,Panama,Perlis,0,0,0
1/06/2021,Panama,Pulau Pinang,0,0,0
1/06/2021,Panama,Sabah,0,0,0
1/06/2021,Panama,Sarawak,0,0,0
1/06/2021,Panama,Selangor,0,0,0
1/06/2021,Peru,Johor,0,0,0
1/06/2021,Peru,Kedah,0,0,0
1/06/2021,Peru,Kelantan,0,0,0
1/06/2021,Peru,Pahang,0,0,0
1/06/2021,Peru,Perak,0,0,0
1/06/2021,Peru,Perlis,0,0,0
1/06/2021,Peru,Pulau Pinang,0,0,0
1/06/2021,Peru,Sabah,0,0,0
1/06/2021,Peru,Sarawak,0,0,0
1/06/2021,Peru,Selangor,0,0,0
1/06/2021,Peru,W.P. Labuan,0,0,0
1/06/2021,Philippines,Johor,7,6,1
1/06/2021,Philippines,Kedah,0,0,0
1/06/2021,Philippines,Kelantan,0,0,0
1/06/2021,Philippines,Melaka,0,0,0
1/06/2021,Philippines,Negeri Sembilan,0,0,0
1/06/2021,Philippines,Pahang,0,0,0
1/06/2021,Philippines,Perak,0,0,0
1/06/2021,Philippines,Perlis,0,0,0
1/06/2021,Philippines,Pulau Pinang,3,2,1
1/06/2021,Philippines,Sabah,2,0,2
1/06/2021,Philippines,Sarawak,52,51,1
1/06/2021,Philippines,Selangor,337,274,63
1/06/2021,Philippines,Terengganu,0,0,0
1/06/2021,Philippines,W.P. Labuan,0,0,0
1/06/2021,Palau,Johor,0,0,0
1/06/2021,Palau,Pulau Pinang,0,0,0
1/06/2021,Palau,Selangor,0,0,0
1/06/2021,Papua New Guinea,Johor,0,0,0
1/06/2021,Papua New Guinea,Kedah,0,0,0
1/06/2021,Papua New Guinea,Kelantan,0,0,0
1/06/2021,Papua New Guinea,Perak,0,0,0
1/06/2021,Papua New Guinea,Pulau Pinang,0,0,0
1/06/2021,Papua New Guinea,Sabah,0,0,0
1/06/2021,Papua New Guinea,Sarawak,0,0,0
1/06/2021,Papua New Guinea,Selangor,3,2,1
1/06/2021,Poland,Johor,0,0,0
1/06/2021,Poland,Kedah,0,0,0
1/06/2021,Poland,Kelantan,0,0,0
1/06/2021,Poland,Melaka,0,0,0
1/06/2021,Poland,Negeri Sembilan,0,0,0
1/06/2021,Poland,Pahang,0,0,0
1/06/2021,Poland,Perak,0,0,0
1/06/2021,Poland,Perlis,0,0,0
1/06/2021,Poland,Pulau Pinang,0,0,0
1/06/2021,Poland,Sabah,0,0,0
1/06/2021,Poland,Sarawak,0,0,0
1/06/2021,Poland,Selangor,14,11,3
1/06/2021,Poland,Terengganu,0,0,0
1/06/2021,Poland,W.P. Labuan,0,0,0
1/06/2021,"North Korea, Democratic People's Republic of",Selangor,0,0,0
1/06/2021,Portugal,Johor,0,0,0
1/06/2021,Portugal,Kedah,0,0,0
1/06/2021,Portugal,Kelantan,0,0,0
1/06/2021,Portugal,Melaka,0,0,0
1/06/2021,Portugal,Pahang,0,0,0
1/06/2021,Portugal,Perak,0,0,0
1/06/2021,Portugal,Perlis,0,0,0
1/06/2021,Portugal,Pulau Pinang,0,0,0
1/06/2021,Portugal,Sabah,0,0,0
1/06/2021,Portugal,Sarawak,0,0,0
1/06/2021,Portugal,Selangor,7,4,3
1/06/2021,Portugal,W.P. Labuan,0,0,0
1/06/2021,Paraguay,Johor,0,0,0
1/06/2021,Paraguay,Kedah,0,0,0
1/06/2021,Paraguay,Perak,0,0,0
1/06/2021,Paraguay,Perlis,0,0,0
1/06/2021,Paraguay,Pulau Pinang,0,0,0
1/06/2021,Paraguay,Sabah,0,0,0
1/06/2021,Paraguay,Sarawak,0,0,0
1/06/2021,Paraguay,Selangor,0,0,0
1/06/2021,"Palestine, State of",Johor,0,0,0
1/06/2021,"Palestine, State of",Kedah,0,0,0
1/06/2021,"Palestine, State of",Kelantan,0,0,0
1/06/2021,"Palestine, State of",Melaka,0,0,0
1/06/2021,"Palestine, State of",Perak,0,0,0
1/06/2021,"Palestine, State of",Perlis,0,0,0
1/06/2021,"Palestine, State of",Pulau Pinang,0,0,0
1/06/2021,"Palestine, State of",Sabah,0,0,0
1/06/2021,"Palestine, State of",Sarawak,0,0,0
1/06/2021,"Palestine, State of",Selangor,9,9,0
1/06/2021,Qatar,Johor,0,0,0
1/06/2021,Qatar,Kedah,0,0,0
1/06/2021,Qatar,Perlis,0,0,0
1/06/2021,Qatar,Pulau Pinang,0,0,0
1/06/2021,Qatar,Sabah,0,0,0
1/06/2021,Qatar,Sarawak,0,0,0
1/06/2021,Qatar,Selangor,0,0,0
1/06/2021,Réunion,Johor,0,0,0
1/06/2021,Réunion,Sarawak,0,0,0
1/06/2021,Romania,Johor,0,0,0
1/06/2021,Romania,Kedah,0,0,0
1/06/2021,Romania,Kelantan,0,0,0
1/06/2021,Romania,Negeri Sembilan,0,0,0
1/06/2021,Romania,Pahang,0,0,0
1/06/2021,Romania,Perak,0,0,0
1/06/2021,Romania,Perlis,0,0,0
1/06/2021,Romania,Pulau Pinang,0,0,0
1/06/2021,Romania,Sabah,0,0,0
1/06/2021,Romania,Sarawak,0,0,0
1/06/2021,Romania,Selangor,17,16,1
1/06/2021,Romania,W.P. Labuan,0,0,0
1/06/2021,Russian Federation (Russia),Johor,0,0,0
1/06/2021,Russian Federation (Russia),Kedah,0,0,0
1/06/2021,Russian Federation (Russia),Kelantan,0,0,0
1/06/2021,Russian Federation (Russia),Melaka,0,0,0
1/06/2021,Russian Federation (Russia),Negeri Sembilan,0,0,0
1/06/2021,Russian Federation (Russia),Pahang,0,0,0
1/06/2021,Russian Federation (Russia),Perak,0,0,0
1/06/2021,Russian Federation (Russia),Perlis,0,0,0
1/06/2021,Russian Federation (Russia),Pulau Pinang,0,0,0
1/06/2021,Russian Federation (Russia),Sabah,0,0,0
1/06/2021,Russian Federation (Russia),Sarawak,0,0,0
1/06/2021,Russian Federation (Russia),Selangor,77,67,10
1/06/2021,Russian Federation (Russia),W.P. Labuan,0,0,0
1/06/2021,Rwanda,Johor,0,0,0
1/06/2021,Rwanda,Kedah,0,0,0
1/06/2021,Rwanda,Pulau Pinang,0,0,0
1/06/2021,Rwanda,Selangor,0,0,0
1/06/2021,Saudi Arabia,Johor,0,0,0
1/06/2021,Saudi Arabia,Kedah,0,0,0
1/06/2021,Saudi Arabia,Kelantan,0,0,0
1/06/2021,Saudi Arabia,Melaka,0,0,0
1/06/2021,Saudi Arabia,Perak,0,0,0
1/06/2021,Saudi Arabia,Perlis,0,0,0
1/06/2021,Saudi Arabia,Pulau Pinang,0,0,0
1/06/2021,Saudi Arabia,Sabah,0,0,0
1/06/2021,Saudi Arabia,Sarawak,0,0,0
1/06/2021,Saudi Arabia,Selangor,47,33,14
1/06/2021,Saudi Arabia,W.P. Labuan,0,0,0
1/06/2021,Sudan,Johor,0,0,0
1/06/2021,Sudan,Kedah,0,0,0
1/06/2021,Sudan,Kelantan,0,0,0
1/06/2021,Sudan,Perlis,0,0,0
1/06/2021,Sudan,Pulau Pinang,0,0,0
1/06/2021,Sudan,Sabah,0,0,0
1/06/2021,Sudan,Sarawak,0,0,0
1/06/2021,Sudan,Selangor,30,23,7
1/06/2021,Sudan,W.P. Labuan,0,0,0
1/06/2021,Senegal,Johor,0,0,0
1/06/2021,Senegal,Kedah,0,0,0
1/06/2021,Senegal,Kelantan,0,0,0
1/06/2021,Senegal,Perak,0,0,0
1/06/2021,Senegal,Perlis,0,0,0
1/06/2021,Senegal,Pulau Pinang,0,0,0
1/06/2021,Senegal,Sabah,0,0,0
1/06/2021,Senegal,Sarawak,0,0,0
1/06/2021,Senegal,Selangor,3,1,2
1/06/2021,Singapore,Johor,72,61,11
1/06/2021,Singapore,Kedah,1,1,0
1/06/2021,Singapore,Kelantan,0,0,0
1/06/2021,Singapore,Melaka,0,0,0
1/06/2021,Singapore,Negeri Sembilan,0,0,0
1/06/2021,Singapore,Pahang,0,0,0
1/06/2021,Singapore,Perak,1,1,0
1/06/2021,Singapore,Perlis,1,1,0
1/06/2021,Singapore,Pulau Pinang,5,1,4
1/06/2021,Singapore,Sabah,0,0,0
1/06/2021,Singapore,Sarawak,5,4,1
1/06/2021,Singapore,Selangor,82,54,28
1/06/2021,Singapore,Terengganu,0,0,0
1/06/2021,Singapore,W.P. Labuan,0,0,0
1/06/2021,South Georgia and the South Sandwich Islands,Johor,0,0,0
1/06/2021,South Georgia and the South Sandwich Islands,Sabah,0,0,0
1/06/2021,South Georgia and the South Sandwich Islands,Selangor,0,0,0
1/06/2021,Saint Helena,Sarawak,0,0,0
1/06/2021,Solomon Islands,Johor,0,0,0
1/06/2021,Solomon Islands,Perlis,0,0,0
1/06/2021,Solomon Islands,Pulau Pinang,0,0,0
1/06/2021,Solomon Islands,Sabah,0,0,0
1/06/2021,Solomon Islands,Sarawak,0,0,0
1/06/2021,Solomon Islands,Selangor,0,0,0
1/06/2021,Solomon Islands,W.P. Labuan,0,0,0
1/06/2021,Sierra Leone,Johor,0,0,0
1/06/2021,Sierra Leone,Kedah,0,0,0
1/06/2021,Sierra Leone,Perak,0,0,0
1/06/2021,Sierra Leone,Pulau Pinang,0,0,0
1/06/2021,Sierra Leone,Sabah,0,0,0
1/06/2021,Sierra Leone,Selangor,0,0,0
1/06/2021,El Salvador,Johor,0,0,0
1/06/2021,El Salvador,Kedah,0,0,0
1/06/2021,El Salvador,Perak,0,0,0
1/06/2021,El Salvador,Perlis,0,0,0
1/06/2021,El Salvador,Pulau Pinang,0,0,0
1/06/2021,El Salvador,Sabah,0,0,0
1/06/2021,El Salvador,Selangor,1,0,1
1/06/2021,El Salvador,W.P. Labuan,0,0,0
1/06/2021,San Marino,Johor,0,0,0
1/06/2021,San Marino,Selangor,0,0,0
1/06/2021,Somalia,Johor,0,0,0
1/06/2021,Somalia,Kedah,0,0,0
1/06/2021,Somalia,Kelantan,0,0,0
1/06/2021,Somalia,Perlis,0,0,0
1/06/2021,Somalia,Sabah,0,0,0
1/06/2021,Somalia,Sarawak,0,0,0
1/06/2021,Somalia,Selangor,9,5,4
1/06/2021,Serbia,Johor,0,0,0
1/06/2021,Serbia,Kedah,0,0,0
1/06/2021,Serbia,Kelantan,0,0,0
1/06/2021,Serbia,Pahang,0,0,0
1/06/2021,Serbia,Perak,0,0,0
1/06/2021,Serbia,Perlis,0,0,0
1/06/2021,Serbia,Pulau Pinang,0,0,0
1/06/2021,Serbia,Sabah,0,0,0
1/06/2021,Serbia,Sarawak,0,0,0
1/06/2021,Serbia,Selangor,0,0,0
1/06/2021,South Sudan,Johor,0,0,0
1/06/2021,South Sudan,Kedah,0,0,0
1/06/2021,South Sudan,Sarawak,0,0,0
1/06/2021,South Sudan,Selangor,2,1,1
1/06/2021,South Sudan,W.P. Labuan,0,0,0
1/06/2021,Sao Tome and Principe,Selangor,0,0,0
1/06/2021,Suriname,Johor,0,0,0
1/06/2021,Suriname,Kedah,0,0,0
1/06/2021,Suriname,Kelantan,0,0,0
1/06/2021,Suriname,Perak,0,0,0
1/06/2021,Suriname,Perlis,0,0,0
1/06/2021,Suriname,Pulau Pinang,0,0,0
1/06/2021,Suriname,Sabah,0,0,0
1/06/2021,Suriname,Sarawak,0,0,0
1/06/2021,Suriname,Selangor,0,0,0
1/06/2021,Slovakia,Johor,0,0,0
1/06/2021,Slovakia,Kedah,0,0,0
1/06/2021,Slovakia,Kelantan,0,0,0
1/06/2021,Slovakia,Negeri Sembilan,0,0,0
1/06/2021,Slovakia,Pahang,0,0,0
1/06/2021,Slovakia,Perak,0,0,0
1/06/2021,Slovakia,Perlis,0,0,0
1/06/2021,Slovakia,Pulau Pinang,0,0,0
1/06/2021,Slovakia,Sabah,0,0,0
1/06/2021,Slovakia,Sarawak,0,0,0
1/06/2021,Slovakia,Selangor,0,0,0
1/06/2021,Slovakia,W.P. Labuan,0,0,0
1/06/2021,Slovenia,Johor,0,0,0
1/06/2021,Slovenia,Kedah,0,0,0
1/06/2021,Slovenia,Kelantan,0,0,0
1/06/2021,Slovenia,Perak,0,0,0
1/06/2021,Slovenia,Perlis,0,0,0
1/06/2021,Slovenia,Pulau Pinang,0,0,0
1/06/2021,Slovenia,Sabah,0,0,0
1/06/2021,Slovenia,Sarawak,0,0,0
1/06/2021,Slovenia,Selangor,2,2,0
1/06/2021,Slovenia,W.P. Labuan,0,0,0
1/06/2021,Sweden,Johor,0,0,0
1/06/2021,Sweden,Kedah,0,0,0
1/06/2021,Sweden,Kelantan,0,0,0
1/06/2021,Sweden,Melaka,0,0,0
1/06/2021,Sweden,Negeri Sembilan,0,0,0
1/06/2021,Sweden,Pahang,0,0,0
1/06/2021,Sweden,Perak,0,0,0
1/06/2021,Sweden,Perlis,0,0,0
1/06/2021,Sweden,Pulau Pinang,0,0,0
1/06/2021,Sweden,Sabah,0,0,0
1/06/2021,Sweden,Sarawak,0,0,0
1/06/2021,Sweden,Selangor,11,10,1
1/06/2021,Sweden,W.P. Labuan,0,0,0
1/06/2021,Eswatini,Johor,0,0,0
1/06/2021,Eswatini,Kedah,0,0,0
1/06/2021,Eswatini,Pulau Pinang,0,0,0
1/06/2021,Eswatini,Sabah,0,0,0
1/06/2021,Eswatini,Selangor,0,0,0
1/06/2021,Seychelles,Johor,0,0,0
1/06/2021,Seychelles,Kedah,0,0,0
1/06/2021,Seychelles,Pulau Pinang,0,0,0
1/06/2021,Seychelles,Sabah,0,0,0
1/06/2021,Seychelles,Sarawak,0,0,0
1/06/2021,Seychelles,Selangor,1,1,0
1/06/2021,Syrian Arab Republic,Johor,0,0,0
1/06/2021,Syrian Arab Republic,Kedah,0,0,0
1/06/2021,Syrian Arab Republic,Kelantan,0,0,0
1/06/2021,Syrian Arab Republic,Pahang,0,0,0
1/06/2021,Syrian Arab Republic,Perlis,0,0,0
1/06/2021,Syrian Arab Republic,Pulau Pinang,0,0,0
1/06/2021,Syrian Arab Republic,Sabah,0,0,0
1/06/2021,Syrian Arab Republic,Sarawak,1,1,0
1/06/2021,Syrian Arab Republic,Selangor,14,10,4
1/06/2021,Syrian Arab Republic,W.P. Labuan,0,0,0
1/06/2021,Turks and Caicos Islands,Perlis,0,0,0
1/06/2021,TCD,Johor,0,0,0
1/06/2021,TCD,Kedah,0,0,0
1/06/2021,TCD,Perlis,0,0,0
1/06/2021,TCD,Selangor,0,0,0
1/06/2021,Togo,Johor,0,0,0
1/06/2021,Togo,Perak,0,0,0
1/06/2021,Togo,Pulau Pinang,0,0,0
1/06/2021,Togo,Selangor,0,0,0
1/06/2021,Thailand,Johor,0,0,0
1/06/2021,Thailand,Kedah,16884,16840,44
1/06/2021,Thailand,Kelantan,1,0,1
1/06/2021,Thailand,Melaka,0,0,0
1/06/2021,Thailand,Negeri Sembilan,0,0,0
1/06/2021,Thailand,Pahang,0,0,0
1/06/2021,Thailand,Perak,0,0,0
1/06/2021,Thailand,Perlis,7245,7161,84
1/06/2021,Thailand,Pulau Pinang,282,280,2
1/06/2021,Thailand,Sabah,0,0,0
1/06/2021,Thailand,Sarawak,13,12,1
1/06/2021,Thailand,Selangor,197,127,70
1/06/2021,Thailand,Terengganu,0,0,0
1/06/2021,Thailand,W.P. Labuan,0,0,0
1/06/2021,Tajikistan,Johor,0,0,0
1/06/2021,Tajikistan,Kedah,0,0,0
1/06/2021,Tajikistan,Perlis,0,0,0
1/06/2021,Tajikistan,Pulau Pinang,0,0,0
1/06/2021,Tajikistan,Sabah,0,0,0
1/06/2021,Tajikistan,Selangor,2,2,0
1/06/2021,Tokelau,Selangor,0,0,0
1/06/2021,Turkmenistan,Johor,0,0,0
1/06/2021,Turkmenistan,Kedah,0,0,0
1/06/2021,Turkmenistan,Kelantan,0,0,0
1/06/2021,Turkmenistan,Perlis,0,0,0
1/06/2021,Turkmenistan,Pulau Pinang,0,0,0
1/06/2021,Turkmenistan,Sabah,0,0,0
1/06/2021,Turkmenistan,Sarawak,0,0,0
1/06/2021,Turkmenistan,Selangor,3,3,0
1/06/2021,Timor-Leste,Johor,0,0,0
1/06/2021,Timor-Leste,Kedah,0,0,0
1/06/2021,Timor-Leste,Perlis,0,0,0
1/06/2021,Timor-Leste,Pulau Pinang,0,0,0
1/06/2021,Timor-Leste,Sabah,0,0,0
1/06/2021,Timor-Leste,Sarawak,0,0,0
1/06/2021,Timor-Leste,Selangor,2,0,2
1/06/2021,Tonga,Johor,0,0,0
1/06/2021,Tonga,Pulau Pinang,0,0,0
1/06/2021,Tonga,Sarawak,0,0,0
1/06/2021,Tonga,Selangor,0,0,0
1/06/2021,Trinidad and Tobago,Johor,0,0,0
1/06/2021,Trinidad and Tobago,Kedah,0,0,0
1/06/2021,Trinidad and Tobago,Pahang,0,0,0
1/06/2021,Trinidad and Tobago,Pulau Pinang,0,0,0
1/06/2021,Trinidad and Tobago,Sabah,0,0,0
1/06/2021,Trinidad and Tobago,Sarawak,0,0,0
1/06/2021,Trinidad and Tobago,Selangor,1,0,1
1/06/2021,Tunisia,Johor,0,0,0
1/06/2021,Tunisia,Kedah,0,0,0
1/06/2021,Tunisia,Kelantan,0,0,0
1/06/2021,Tunisia,Melaka,0,0,0
1/06/2021,Tunisia,Perak,0,0,0
1/06/2021,Tunisia,Perlis,0,0,0
1/06/2021,Tunisia,Pulau Pinang,0,0,0
1/06/2021,Tunisia,Sabah,0,0,0
1/06/2021,Tunisia,Sarawak,0,0,0
1/06/2021,Tunisia,Selangor,1,1,0
1/06/2021,Tunisia,W.P. Labuan,0,0,0
1/06/2021,Türkiye,Johor,0,0,0
1/06/2021,Türkiye,Kedah,0,0,0
1/06/2021,Türkiye,Kelantan,0,0,0
1/06/2021,Türkiye,Melaka,0,0,0
1/06/2021,Türkiye,Negeri Sembilan,0,0,0
1/06/2021,Türkiye,Pahang,0,0,0
1/06/2021,Türkiye,Perak,0,0,0
1/06/2021,Türkiye,Perlis,0,0,0
1/06/2021,Türkiye,Pulau Pinang,0,0,0
1/06/2021,Türkiye,Sabah,0,0,0
1/06/2021,Türkiye,Sarawak,0,0,0
1/06/2021,Türkiye,Selangor,26,22,4
1/06/2021,Türkiye,W.P. Labuan,0,0,0
1/06/2021,Tuvalu,Selangor,0,0,0
1/06/2021,"Taiwan, Province of China",Johor,0,0,0
1/06/2021,"Taiwan, Province of China",Kedah,0,0,0
1/06/2021,"Taiwan, Province of China",Kelantan,0,0,0
1/06/2021,"Taiwan, Province of China",Melaka,0,0,0
1/06/2021,"Taiwan, Province of China",Negeri Sembilan,0,0,0
1/06/2021,"Taiwan, Province of China",Pahang,0,0,0
1/06/2021,"Taiwan, Province of China",Perak,0,0,0
1/06/2021,"Taiwan, Province of China",Perlis,0,0,0
1/06/2021,"Taiwan, Province of China",Pulau Pinang,15,10,5
1/06/2021,"Taiwan, Province of China",Sabah,0,0,0
1/06/2021,"Taiwan, Province of China",Sarawak,1,1,0
1/06/2021,"Taiwan, Province of China",Selangor,30,18,12
1/06/2021,"Taiwan, Province of China",W.P. Labuan,0,0,0
1/06/2021,"Tanzania, United Republic of",Johor,0,0,0
1/06/2021,"Tanzania, United Republic of",Kedah,0,0,0
1/06/2021,"Tanzania, United Republic of",Perak,0,0,0
1/06/2021,"Tanzania, United Republic of",Perlis,0,0,0
1/06/2021,"Tanzania, United Republic of",Pulau Pinang,0,0,0
1/06/2021,"Tanzania, United Republic of",Sabah,0,0,0
1/06/2021,"Tanzania, United Republic of",Sarawak,0,0,0
1/06/2021,"Tanzania, United Republic of",Selangor,6,5,1
1/06/2021,Uganda,Johor,0,0,0
1/06/2021,Uganda,Kedah,0,0,0
1/06/2021,Uganda,Perak,0,0,0
1/06/2021,Uganda,Perlis,0,0,0
1/06/2021,Uganda,Pulau Pinang,0,0,0
1/06/2021,Uganda,Sabah,0,0,0
1/06/2021,Uganda,Sarawak,0,0,0
1/06/2021,Uganda,Selangor,5,0,5
1/06/2021,Ukraine,Johor,0,0,0
1/06/2021,Ukraine,Kedah,0,0,0
1/06/2021,Ukraine,Kelantan,0,0,0
1/06/2021,Ukraine,Melaka,0,0,0
1/06/2021,Ukraine,Negeri Sembilan,0,0,0
1/06/2021,Ukraine,Pahang,0,0,0
1/06/2021,Ukraine,Perak,0,0,0
1/06/2021,Ukraine,Perlis,0,0,0
1/06/2021,Ukraine,Pulau Pinang,0,0,0
1/06/2021,Ukraine,Sabah,0,0,0
1/06/2021,Ukraine,Sarawak,0,0,0
1/06/2021,Ukraine,Selangor,50,49,1
1/06/2021,Ukraine,W.P. Labuan,0,0,0
1/06/2021,Uruguay,Johor,0,0,0
1/06/2021,Uruguay,Kedah,0,0,0
1/06/2021,Uruguay,Kelantan,0,0,0
1/06/2021,Uruguay,Perak,0,0,0
1/06/2021,Uruguay,Perlis,0,0,0
1/06/2021,Uruguay,Pulau Pinang,0,0,0
1/06/2021,Uruguay,Sabah,0,0,0
1/06/2021,Uruguay,Sarawak,0,0,0
1/06/2021,Uruguay,Selangor,0,0,0
1/06/2021,Uruguay,W.P. Labuan,0,0,0
1/06/2021,United States of America,Johor,0,0,0
1/06/2021,United States of America,Kedah,0,0,0
1/06/2021,United States of America,Kelantan,0,0,0
1/06/2021,United States of America,Melaka,0,0,0
1/06/2021,United States of America,Negeri Sembilan,0,0,0
1/06/2021,United States of America,Pahang,0,0,0
1/06/2021,United States of America,Perak,0,0,0
1/06/2021,United States of America,Perlis,0,0,0
1/06/2021,United States of America,Pulau Pinang,7,5,2
1/06/2021,United States of America,Sabah,0,0,0
1/06/2021,United States of America,Sarawak,0,0,0
1/06/2021,United States of America,Selangor,152,96,56
1/06/2021,United States of America,Terengganu,0,0,0
1/06/2021,United States of America,W.P. Labuan,0,0,0
1/06/2021,Uzbekistan,Johor,0,0,0
1/06/2021,Uzbekistan,Kedah,0,0,0
1/06/2021,Uzbekistan,Kelantan,0,0,0
1/06/2021,Uzbekistan,Perak,0,0,0
1/06/2021,Uzbekistan,Perlis,0,0,0
1/06/2021,Uzbekistan,Pulau Pinang,0,0,0
1/06/2021,Uzbekistan,Sabah,0,0,0
1/06/2021,Uzbekistan,Sarawak,0,0,0
1/06/2021,Uzbekistan,Selangor,8,3,5
1/06/2021,Holy See,Johor,0,0,0
1/06/2021,Holy See,Sarawak,0,0,0
1/06/2021,Holy See,Selangor,1,1,0
1/06/2021,Saint Vincent and the Grenadines,Johor,0,0,0
1/06/2021,Saint Vincent and the Grenadines,Kedah,0,0,0
1/06/2021,Saint Vincent and the Grenadines,Pulau Pinang,0,0,0
1/06/2021,Saint Vincent and the Grenadines,Sarawak,0,0,0
1/06/2021,Saint Vincent and the Grenadines,Selangor,0,0,0
1/06/2021,"Venezuela, Bolivarian Republic of",Johor,0,0,0
1/06/2021,"Venezuela, Bolivarian Republic of",Kedah,0,0,0
1/06/2021,"Venezuela, Bolivarian Republic of",Kelantan,0,0,0
1/06/2021,"Venezuela, Bolivarian Republic of",Melaka,0,0,0
1/06/2021,"Venezuela, Bolivarian Republic of",Perak,0,0,0
1/06/2021,"Venezuela, Bolivarian Republic of",Perlis,0,0,0
1/06/2021,"Venezuela, Bolivarian Republic of",Pulau Pinang,0,0,0
1/06/2021,"Venezuela, Bolivarian Republic of",Sabah,0,0,0
1/06/2021,"Venezuela, Bolivarian Republic of",Sarawak,0,0,0
1/06/2021,"Venezuela, Bolivarian Republic of",Selangor,0,0,0
1/06/2021,"Venezuela, Bolivarian Republic of",W.P. Labuan,0,0,0
1/06/2021,Viet Nam,Johor,0,0,0
1/06/2021,Viet Nam,Kedah,0,0,0
1/06/2021,Viet Nam,Kelantan,0,0,0
1/06/2021,Viet Nam,Melaka,0,0,0
1/06/2021,Viet Nam,Negeri Sembilan,0,0,0
1/06/2021,Viet Nam,Pahang,0,0,0
1/06/2021,Viet Nam,Perak,0,0,0
1/06/2021,Viet Nam,Perlis,0,0,0
1/06/2021,Viet Nam,Pulau Pinang,2,0,2
1/06/2021,Viet Nam,Sabah,0,0,0
1/06/2021,Viet Nam,Sarawak,0,0,0
1/06/2021,Viet Nam,Selangor,63,23,40
1/06/2021,Viet Nam,Terengganu,0,0,0
1/06/2021,Viet Nam,W.P. Labuan,0,0,0
1/06/2021,Vanuatu,Johor,0,0,0
1/06/2021,Vanuatu,Kedah,0,0,0
1/06/2021,Vanuatu,Pulau Pinang,0,0,0
1/06/2021,Vanuatu,Sabah,0,0,0
1/06/2021,Vanuatu,Sarawak,0,0,0
1/06/2021,Vanuatu,Selangor,0,0,0
1/06/2021, Samoa,Johor,0,0,0
1/06/2021, Samoa,Sarawak,0,0,0
1/06/2021, Samoa,Selangor,0,0,0
1/06/2021,Yemen,Johor,0,0,0
1/06/2021,Yemen,Kedah,0,0,0
1/06/2021,Yemen,Kelantan,0,0,0
1/06/2021,Yemen,Melaka,0,0,0
1/06/2021,Yemen,Pahang,0,0,0
1/06/2021,Yemen,Perak,0,0,0
1/06/2021,Yemen,Perlis,0,0,0
1/06/2021,Yemen,Pulau Pinang,0,0,0
1/06/2021,Yemen,Sabah,0,0,0
1/06/2021,Yemen,Sarawak,0,0,0
1/06/2021,Yemen,Selangor,38,35,3
1/06/2021,Yemen,W.P. Labuan,0,0,0
1/06/2021,South Africa,Johor,1,1,0
1/06/2021,South Africa,Kedah,0,0,0
1/06/2021,South Africa,Kelantan,0,0,0
1/06/2021,South Africa,Melaka,0,0,0
1/06/2021,South Africa,Pahang,0,0,0
1/06/2021,South Africa,Perak,0,0,0
1/06/2021,South Africa,Perlis,0,0,0
1/06/2021,South Africa,Pulau Pinang,0,0,0
1/06/2021,South Africa,Sabah,0,0,0
1/06/2021,South Africa,Sarawak,0,0,0
1/06/2021,South Africa,Selangor,23,14,9
1/06/2021,South Africa,Terengganu,0,0,0
1/06/2021,South Africa,W.P. Labuan,0,0,0
1/06/2021,ZAR,Selangor,0,0,0
1/06/2021,Zambia,Johor,0,0,0
1/06/2021,Zambia,Kedah,0,0,0
1/06/2021,Zambia,Perak,0,0,0
1/06/2021,Zambia,Perlis,0,0,0
1/06/2021,Zambia,Pulau Pinang,0,0,0
1/06/2021,Zambia,Sabah,0,0,0
1/06/2021,Zambia,Sarawak,0,0,0
1/06/2021,Zambia,Selangor,4,2,2
1/06/2021,Zimbabwe,Johor,0,0,0
1/06/2021,Zimbabwe,Kedah,0,0,0
1/06/2021,Zimbabwe,Kelantan,0,0,0
1/06/2021,Zimbabwe,Perak,0,0,0
1/06/2021,Zimbabwe,Perlis,0,0,0
1/06/2021,Zimbabwe,Pulau Pinang,1,1,0
1/06/2021,Zimbabwe,Sabah,0,0,0
1/06/2021,Zimbabwe,Sarawak,0,0,0
1/06/2021,Zimbabwe,Selangor,2,1,1
1/07/2021,Aruba,Kedah,0,0,0
1/07/2021,Aruba,Pulau Pinang,0,0,0
1/07/2021,Afghanistan,Johor,0,0,0
1/07/2021,Afghanistan,Kedah,0,0,0
1/07/2021,Afghanistan,Perlis,0,0,0
1/07/2021,Afghanistan,Pulau Pinang,0,0,0
1/07/2021,Afghanistan,Sarawak,0,0,0
1/07/2021,Afghanistan,Selangor,10,7,3
1/07/2021,Angola,Johor,0,0,0
1/07/2021,Angola,Kedah,0,0,0
1/07/2021,Angola,Sabah,0,0,0
1/07/2021,Angola,Selangor,0,0,0
1/07/2021,Anguilla,Selangor,0,0,0
1/07/2021,Albania,Johor,0,0,0
1/07/2021,Albania,Kedah,0,0,0
1/07/2021,Albania,Perak,0,0,0
1/07/2021,Albania,Perlis,0,0,0
1/07/2021,Albania,Pulau Pinang,0,0,0
1/07/2021,Albania,Sabah,0,0,0
1/07/2021,Albania,Sarawak,0,0,0
1/07/2021,Albania,Selangor,0,0,0
1/07/2021,Andorra,Johor,0,0,0
1/07/2021,Andorra,Kedah,0,0,0
1/07/2021,Andorra,Perlis,0,0,0
1/07/2021,Andorra,Pulau Pinang,0,0,0
1/07/2021,Andorra,Selangor,0,0,0
1/07/2021,Antigua and Barbuda,Selangor,1,0,1
1/07/2021,United Arab Emirates,Johor,0,0,0
1/07/2021,United Arab Emirates,Kedah,0,0,0
1/07/2021,United Arab Emirates,Kelantan,0,0,0
1/07/2021,United Arab Emirates,Perak,0,0,0
1/07/2021,United Arab Emirates,Perlis,0,0,0
1/07/2021,United Arab Emirates,Pulau Pinang,0,0,0
1/07/2021,United Arab Emirates,Sabah,0,0,0
1/07/2021,United Arab Emirates,Sarawak,0,0,0
1/07/2021,United Arab Emirates,Selangor,1,1,0
1/07/2021,Argentina,Johor,2,2,0
1/07/2021,Argentina,Kedah,0,0,0
1/07/2021,Argentina,Kelantan,0,0,0
1/07/2021,Argentina,Melaka,0,0,0
1/07/2021,Argentina,Perak,0,0,0
1/07/2021,Argentina,Perlis,0,0,0
1/07/2021,Argentina,Pulau Pinang,0,0,0
1/07/2021,Argentina,Sabah,0,0,0
1/07/2021,Argentina,Sarawak,0,0,0
1/07/2021,Argentina,Selangor,8,6,2
1/07/2021,Argentina,W.P. Labuan,0,0,0
1/07/2021,Armenia,Johor,0,0,0
1/07/2021,Armenia,Kedah,0,0,0
1/07/2021,Armenia,Kelantan,0,0,0
1/07/2021,Armenia,Perak,0,0,0
1/07/2021,Armenia,Perlis,0,0,0
1/07/2021,Armenia,Pulau Pinang,0,0,0
1/07/2021,Armenia,Sabah,0,0,0
1/07/2021,Armenia,Sarawak,0,0,0
1/07/2021,Armenia,Selangor,3,2,1
1/07/2021,Antarctica,Selangor,0,0,0
1/07/2021,Antigua and Barbuda,Johor,0,0,0
1/07/2021,Antigua and Barbuda,Kedah,0,0,0
1/07/2021,Antigua and Barbuda,Pulau Pinang,0,0,0
1/07/2021,Antigua and Barbuda,Sarawak,0,0,0
1/07/2021,Antigua and Barbuda,Selangor,0,0,0
1/07/2021,Australia,Johor,2,2,0
1/07/2021,Australia,Kedah,3,1,2
1/07/2021,Australia,Kelantan,0,0,0
1/07/2021,Australia,Melaka,0,0,0
1/07/2021,Australia,Negeri Sembilan,0,0,0
1/07/2021,Australia,Pahang,0,0,0
1/07/2021,Australia,Perak,0,0,0
1/07/2021,Australia,Perlis,0,0,0
1/07/2021,Australia,Pulau Pinang,1,0,1
1/07/2021,Australia,Sabah,1,1,0
1/07/2021,Australia,Sarawak,1,0,1
1/07/2021,Australia,Selangor,91,51,40
1/07/2021,Australia,Terengganu,0,0,0
1/07/2021,Australia,W.P. Labuan,0,0,0
1/07/2021,Austria,Johor,0,0,0
1/07/2021,Austria,Kedah,0,0,0
1/07/2021,Austria,Kelantan,0,0,0
1/07/2021,Austria,Melaka,0,0,0
1/07/2021,Austria,Negeri Sembilan,0,0,0
1/07/2021,Austria,Pahang,0,0,0
1/07/2021,Austria,Perak,0,0,0
1/07/2021,Austria,Perlis,0,0,0
1/07/2021,Austria,Pulau Pinang,0,0,0
1/07/2021,Austria,Sabah,0,0,0
1/07/2021,Austria,Sarawak,0,0,0
1/07/2021,Austria,Selangor,12,8,4
1/07/2021,Austria,Terengganu,0,0,0
1/07/2021,Austria,W.P. Labuan,0,0,0
1/07/2021,Azerbaijan,Johor,0,0,0
1/07/2021,Azerbaijan,Kedah,0,0,0
1/07/2021,Azerbaijan,Kelantan,0,0,0
1/07/2021,Azerbaijan,Melaka,0,0,0
1/07/2021,Azerbaijan,Perlis,0,0,0
1/07/2021,Azerbaijan,Pulau Pinang,0,0,0
1/07/2021,Azerbaijan,Sabah,0,0,0
1/07/2021,Azerbaijan,Sarawak,0,0,0
1/07/2021,Azerbaijan,Selangor,5,3,2
1/07/2021,Azerbaijan,W.P. Labuan,0,0,0
1/07/2021,Burundi,Pulau Pinang,0,0,0
1/07/2021,Burundi,Sarawak,0,0,0
1/07/2021,Burundi,Selangor,1,0,1
1/07/2021,Belgium,Johor,0,0,0
1/07/2021,Belgium,Kedah,0,0,0
1/07/2021,Belgium,Kelantan,0,0,0
1/07/2021,Belgium,Melaka,0,0,0
1/07/2021,Belgium,Negeri Sembilan,0,0,0
1/07/2021,Belgium,Pahang,0,0,0
1/07/2021,Belgium,Perak,0,0,0
1/07/2021,Belgium,Perlis,0,0,0
1/07/2021,Belgium,Pulau Pinang,1,1,0
1/07/2021,Belgium,Sabah,0,0,0
1/07/2021,Belgium,Sarawak,0,0,0
1/07/2021,Belgium,Selangor,16,12,4
1/07/2021,Belgium,W.P. Labuan,0,0,0
1/07/2021,Benin,Johor,0,0,0
1/07/2021,Benin,Kedah,0,0,0
1/07/2021,Benin,Perak,0,0,0
1/07/2021,Benin,Pulau Pinang,0,0,0
1/07/2021,Benin,Sabah,0,0,0
1/07/2021,Benin,Sarawak,0,0,0
1/07/2021,Benin,Selangor,0,0,0
1/07/2021,Burkina Faso,Perak,0,0,0
1/07/2021,Burkina Faso,Pulau Pinang,0,0,0
1/07/2021,Burkina Faso,Selangor,0,0,0
1/07/2021,Bangladesh,Johor,0,0,0
1/07/2021,Bangladesh,Kedah,0,0,0
1/07/2021,Bangladesh,Kelantan,0,0,0
1/07/2021,Bangladesh,Melaka,0,0,0
1/07/2021,Bangladesh,Negeri Sembilan,0,0,0
1/07/2021,Bangladesh,Pahang,0,0,0
1/07/2021,Bangladesh,Perak,0,0,0
1/07/2021,Bangladesh,Perlis,0,0,0
1/07/2021,Bangladesh,Pulau Pinang,0,0,0
1/07/2021,Bangladesh,Sabah,0,0,0
1/07/2021,Bangladesh,Sarawak,0,0,0
1/07/2021,Bangladesh,Selangor,10,8,2
1/07/2021,Bangladesh,W.P. Labuan,0,0,0
1/07/2021,Bulgaria,Johor,0,0,0
1/07/2021,Bulgaria,Kedah,0,0,0
1/07/2021,Bulgaria,Kelantan,0,0,0
1/07/2021,Bulgaria,Pahang,0,0,0
1/07/2021,Bulgaria,Perak,0,0,0
1/07/2021,Bulgaria,Perlis,0,0,0
1/07/2021,Bulgaria,Pulau Pinang,0,0,0
1/07/2021,Bulgaria,Sabah,0,0,0
1/07/2021,Bulgaria,Sarawak,0,0,0
1/07/2021,Bulgaria,Selangor,2,2,0
1/07/2021,Bulgaria,W.P. Labuan,0,0,0
1/07/2021,Bahrain,Johor,0,0,0
1/07/2021,Bahrain,Kedah,0,0,0
1/07/2021,Bahrain,Kelantan,0,0,0
1/07/2021,Bahrain,Perlis,0,0,0
1/07/2021,Bahrain,Pulau Pinang,0,0,0
1/07/2021,Bahrain,Sabah,0,0,0
1/07/2021,Bahrain,Sarawak,0,0,0
1/07/2021,Bahrain,Selangor,1,1,0
1/07/2021,Bahamas,Johor,0,0,0
1/07/2021,Bahamas,Kedah,0,0,0
1/07/2021,Bahamas,Perak,0,0,0
1/07/2021,Bahamas,Sabah,0,0,0
1/07/2021,Bahamas,Sarawak,0,0,0
1/07/2021,Bahamas,Selangor,0,0,0
1/07/2021,Bosnia and Herzegovina,Johor,0,0,0
1/07/2021,Bosnia and Herzegovina,Kedah,0,0,0
1/07/2021,Bosnia and Herzegovina,Perlis,0,0,0
1/07/2021,Bosnia and Herzegovina,Pulau Pinang,0,0,0
1/07/2021,Bosnia and Herzegovina,Sabah,0,0,0
1/07/2021,Bosnia and Herzegovina,Sarawak,0,0,0
1/07/2021,Bosnia and Herzegovina,Selangor,1,1,0
1/07/2021,Belarus,Johor,0,0,0
1/07/2021,Belarus,Kedah,0,0,0
1/07/2021,Belarus,Kelantan,0,0,0
1/07/2021,Belarus,Pahang,0,0,0
1/07/2021,Belarus,Perak,0,0,0
1/07/2021,Belarus,Perlis,0,0,0
1/07/2021,Belarus,Pulau Pinang,0,0,0
1/07/2021,Belarus,Sabah,0,0,0
1/07/2021,Belarus,Sarawak,0,0,0
1/07/2021,Belarus,Selangor,1,1,0
1/07/2021,Belarus,W.P. Labuan,0,0,0
1/07/2021,Belize,Johor,0,0,0
1/07/2021,Belize,Pulau Pinang,0,0,0
1/07/2021,Belize,Sarawak,0,0,0
1/07/2021,Belize,Selangor,0,0,0
1/07/2021,Bermuda,Selangor,0,0,0
1/07/2021,Bolivia,Johor,0,0,0
1/07/2021,Bolivia,Kedah,0,0,0
1/07/2021,Bolivia,Melaka,0,0,0
1/07/2021,Bolivia,Perak,0,0,0
1/07/2021,Bolivia,Perlis,0,0,0
1/07/2021,Bolivia,Pulau Pinang,0,0,0
1/07/2021,Bolivia,Sabah,0,0,0
1/07/2021,Bolivia,Sarawak,0,0,0
1/07/2021,Bolivia,Selangor,1,0,1
1/07/2021,Brazil,Johor,2,2,0
1/07/2021,Brazil,Kedah,0,0,0
1/07/2021,Brazil,Kelantan,0,0,0
1/07/2021,Brazil,Melaka,0,0,0
1/07/2021,Brazil,Pahang,0,0,0
1/07/2021,Brazil,Perak,0,0,0
1/07/2021,Brazil,Perlis,0,0,0
1/07/2021,Brazil,Pulau Pinang,0,0,0
1/07/2021,Brazil,Sabah,0,0,0
1/07/2021,Brazil,Sarawak,0,0,0
1/07/2021,Brazil,Selangor,19,11,8
1/07/2021,Brazil,W.P. Labuan,0,0,0
1/07/2021,Barbados,Johor,0,0,0
1/07/2021,Barbados,Kedah,0,0,0
1/07/2021,Barbados,Perlis,0,0,0
1/07/2021,Barbados,Pulau Pinang,0,0,0
1/07/2021,Barbados,Selangor,0,0,0
1/07/2021,Brunei Darussalam,Johor,0,0,0
1/07/2021,Brunei Darussalam,Kedah,0,0,0
1/07/2021,Brunei Darussalam,Kelantan,0,0,0
1/07/2021,Brunei Darussalam,Melaka,0,0,0
1/07/2021,Brunei Darussalam,Pahang,0,0,0
1/07/2021,Brunei Darussalam,Perak,0,0,0
1/07/2021,Brunei Darussalam,Perlis,0,0,0
1/07/2021,Brunei Darussalam,Pulau Pinang,0,0,0
1/07/2021,Brunei Darussalam,Sabah,0,0,0
1/07/2021,Brunei Darussalam,Sarawak,405,398,7
1/07/2021,Brunei Darussalam,Selangor,16,9,7
1/07/2021,Brunei Darussalam,W.P. Labuan,0,0,0
1/07/2021,Bhutan,Johor,0,0,0
1/07/2021,Bhutan,Kedah,0,0,0
1/07/2021,Bhutan,Perak,0,0,0
1/07/2021,Bhutan,Perlis,0,0,0
1/07/2021,Bhutan,Pulau Pinang,0,0,0
1/07/2021,Bhutan,Sabah,0,0,0
1/07/2021,Bhutan,Sarawak,0,0,0
1/07/2021,Bhutan,Selangor,0,0,0
1/07/2021,Botswana,Johor,0,0,0
1/07/2021,Botswana,Kedah,0,0,0
1/07/2021,Botswana,Perlis,0,0,0
1/07/2021,Botswana,Pulau Pinang,0,0,0
1/07/2021,Botswana,Sabah,0,0,0
1/07/2021,Botswana,Sarawak,0,0,0
1/07/2021,Botswana,Selangor,0,0,0
1/07/2021,Central African Republic,Kedah,0,0,0
1/07/2021,Central African Republic,Selangor,0,0,0
1/07/2021,Canada,Johor,0,0,0
1/07/2021,Canada,Kedah,0,0,0
1/07/2021,Canada,Kelantan,0,0,0
1/07/2021,Canada,Melaka,0,0,0
1/07/2021,Canada,Negeri Sembilan,0,0,0
1/07/2021,Canada,Pahang,0,0,0
1/07/2021,Canada,Perak,0,0,0
1/07/2021,Canada,Perlis,0,0,0
1/07/2021,Canada,Pulau Pinang,0,0,0
1/07/2021,Canada,Sabah,0,0,0
1/07/2021,Canada,Sarawak,0,0,0
1/07/2021,Canada,Selangor,81,47,34
1/07/2021,Canada,Terengganu,0,0,0
1/07/2021,Canada,W.P. Labuan,0,0,0
1/07/2021,Cocos (Keeling) Islands,Selangor,0,0,0
1/07/2021,Switzerland,Johor,0,0,0
1/07/2021,Switzerland,Kedah,0,0,0
1/07/2021,Switzerland,Kelantan,0,0,0
1/07/2021,Switzerland,Melaka,0,0,0
1/07/2021,Switzerland,Negeri Sembilan,0,0,0
1/07/2021,Switzerland,Pahang,0,0,0
1/07/2021,Switzerland,Perak,0,0,0
1/07/2021,Switzerland,Perlis,0,0,0
1/07/2021,Switzerland,Pulau Pinang,0,0,0
1/07/2021,Switzerland,Sabah,0,0,0
1/07/2021,Switzerland,Sarawak,0,0,0
1/07/2021,Switzerland,Selangor,10,6,4
1/07/2021,Switzerland,W.P. Labuan,0,0,0
1/07/2021,Chile,Johor,0,0,0
1/07/2021,Chile,Kedah,0,0,0
1/07/2021,Chile,Kelantan,0,0,0
1/07/2021,Chile,Melaka,0,0,0
1/07/2021,Chile,Pahang,0,0,0
1/07/2021,Chile,Perak,0,0,0
1/07/2021,Chile,Perlis,0,0,0
1/07/2021,Chile,Pulau Pinang,0,0,0
1/07/2021,Chile,Sabah,0,0,0
1/07/2021,Chile,Sarawak,0,0,0
1/07/2021,Chile,Selangor,1,1,0
1/07/2021,China,Johor,2,2,0
1/07/2021,China,Kedah,1,1,0
1/07/2021,China,Kelantan,0,0,0
1/07/2021,China,Melaka,0,0,0
1/07/2021,China,Pahang,0,0,0
1/07/2021,China,Perak,0,0,0
1/07/2021,China,Perlis,0,0,0
1/07/2021,China,Pulau Pinang,1,1,0
1/07/2021,China,Sabah,2,2,0
1/07/2021,China,Sarawak,145,145,0
1/07/2021,China,Selangor,722,580,142
1/07/2021,China,Terengganu,0,0,0
1/07/2021,China,W.P. Labuan,0,0,0
1/07/2021,Côte d'Ivoire,Johor,0,0,0
1/07/2021,Côte d'Ivoire,Kedah,0,0,0
1/07/2021,Côte d'Ivoire,Pulau Pinang,0,0,0
1/07/2021,Côte d'Ivoire,Sabah,0,0,0
1/07/2021,Côte d'Ivoire,Sarawak,0,0,0
1/07/2021,Côte d'Ivoire,Selangor,3,3,0
1/07/2021,Cameroon,Johor,0,0,0
1/07/2021,Cameroon,Kedah,0,0,0
1/07/2021,Cameroon,Pulau Pinang,0,0,0
1/07/2021,Cameroon,Sabah,0,0,0
1/07/2021,Cameroon,Sarawak,0,0,0
1/07/2021,Cameroon,Selangor,2,1,1
1/07/2021,Congo,Johor,0,0,0
1/07/2021,Congo,Pulau Pinang,0,0,0
1/07/2021,Congo,Sarawak,0,0,0
1/07/2021,Congo,Selangor,1,1,0
1/07/2021,Congo,Johor,0,0,0
1/07/2021,Congo,Kedah,0,0,0
1/07/2021,Congo,Selangor,0,0,0
1/07/2021,Cook Islands,Selangor,0,0,0
1/07/2021,Colombia,Johor,0,0,0
1/07/2021,Colombia,Kedah,0,0,0
1/07/2021,Colombia,Perak,0,0,0
1/07/2021,Colombia,Pulau Pinang,0,0,0
1/07/2021,Colombia,Sabah,0,0,0
1/07/2021,Colombia,Sarawak,0,0,0
1/07/2021,Colombia,Selangor,5,2,3
1/07/2021,Colombia,W.P. Labuan,0,0,0
1/07/2021,Comoros,Johor,0,0,0
1/07/2021,Comoros,Kedah,0,0,0
1/07/2021,Comoros,Selangor,0,0,0
1/07/2021,Cabo Verde,Johor,0,0,0
1/07/2021,Cabo Verde,Kedah,0,0,0
1/07/2021,Cabo Verde,Pulau Pinang,0,0,0
1/07/2021,Cabo Verde,Sabah,0,0,0
1/07/2021,Cabo Verde,Selangor,0,0,0
1/07/2021,Costa Rica,Johor,0,0,0
1/07/2021,Costa Rica,Kedah,0,0,0
1/07/2021,Costa Rica,Perak,0,0,0
1/07/2021,Costa Rica,Perlis,0,0,0
1/07/2021,Costa Rica,Pulau Pinang,0,0,0
1/07/2021,Costa Rica,Sabah,0,0,0
1/07/2021,Costa Rica,Sarawak,0,0,0
1/07/2021,Costa Rica,Selangor,3,1,2
1/07/2021,Cuba,Johor,0,0,0
1/07/2021,Cuba,Kedah,0,0,0
1/07/2021,Cuba,Perlis,0,0,0
1/07/2021,Cuba,Pulau Pinang,0,0,0
1/07/2021,Cuba,Sabah,0,0,0
1/07/2021,Cuba,Sarawak,0,0,0
1/07/2021,Cuba,Selangor,0,0,0
1/07/2021,Cyprus,Johor,0,0,0
1/07/2021,Cyprus,Kedah,0,0,0
1/07/2021,Cyprus,Perak,0,0,0
1/07/2021,Cyprus,Perlis,0,0,0
1/07/2021,Cyprus,Pulau Pinang,0,0,0
1/07/2021,Cyprus,Sabah,0,0,0
1/07/2021,Cyprus,Sarawak,0,0,0
1/07/2021,Cyprus,Selangor,0,0,0
1/07/2021,Czechia,Johor,0,0,0
1/07/2021,Czechia,Kedah,0,0,0
1/07/2021,Czechia,Kelantan,0,0,0
1/07/2021,Czechia,Melaka,0,0,0
1/07/2021,Czechia,Negeri Sembilan,0,0,0
1/07/2021,Czechia,Perak,0,0,0
1/07/2021,Czechia,Perlis,0,0,0
1/07/2021,Czechia,Pulau Pinang,0,0,0
1/07/2021,Czechia,Sabah,0,0,0
1/07/2021,Czechia,Sarawak,0,0,0
1/07/2021,Czechia,Selangor,4,2,2
1/07/2021,Czechia,W.P. Labuan,0,0,0
1/07/2021,Germany,Johor,0,0,0
1/07/2021,Germany,Kedah,0,0,0
1/07/2021,Germany,Kelantan,0,0,0
1/07/2021,Germany,Melaka,0,0,0
1/07/2021,Germany,Negeri Sembilan,0,0,0
1/07/2021,Germany,Pahang,0,0,0
1/07/2021,Germany,Perak,0,0,0
1/07/2021,Germany,Perlis,0,0,0
1/07/2021,Germany,Pulau Pinang,2,2,0
1/07/2021,Germany,Sabah,1,1,0
1/07/2021,Germany,Sarawak,1,1,0
1/07/2021,Germany,Selangor,78,47,31
1/07/2021,Germany,Terengganu,0,0,0
1/07/2021,Germany,W.P. Labuan,0,0,0
1/07/2021,Djibouti,Johor,0,0,0
1/07/2021,Djibouti,Selangor,1,1,0
1/07/2021,Dominica,Johor,0,0,0
1/07/2021,Dominica,Kedah,0,0,0
1/07/2021,Dominica,Pulau Pinang,0,0,0
1/07/2021,Dominica,Sabah,0,0,0
1/07/2021,Dominica,Sarawak,0,0,0
1/07/2021,Dominica,Selangor,0,0,0
1/07/2021,Dominica,W.P. Labuan,0,0,0
1/07/2021,Denmark,Johor,0,0,0
1/07/2021,Denmark,Kedah,0,0,0
1/07/2021,Denmark,Kelantan,0,0,0
1/07/2021,Denmark,Melaka,0,0,0
1/07/2021,Denmark,Negeri Sembilan,0,0,0
1/07/2021,Denmark,Pahang,0,0,0
1/07/2021,Denmark,Perak,0,0,0
1/07/2021,Denmark,Perlis,0,0,0
1/07/2021,Denmark,Pulau Pinang,0,0,0
1/07/2021,Denmark,Sabah,0,0,0
1/07/2021,Denmark,Sarawak,0,0,0
1/07/2021,Denmark,Selangor,14,10,4
1/07/2021,Denmark,W.P. Labuan,0,0,0
1/07/2021,Dominican Republic,Johor,0,0,0
1/07/2021,Dominican Republic,Kedah,0,0,0
1/07/2021,Dominican Republic,Perak,0,0,0
1/07/2021,Dominican Republic,Perlis,0,0,0
1/07/2021,Dominican Republic,Pulau Pinang,0,0,0
1/07/2021,Dominican Republic,Sabah,0,0,0
1/07/2021,Dominican Republic,Sarawak,0,0,0
1/07/2021,Dominican Republic,Selangor,0,0,0
1/07/2021,Algeria,Johor,0,0,0
1/07/2021,Algeria,Kedah,0,0,0
1/07/2021,Algeria,Kelantan,0,0,0
1/07/2021,Algeria,Melaka,0,0,0
1/07/2021,Algeria,Perak,0,0,0
1/07/2021,Algeria,Perlis,0,0,0
1/07/2021,Algeria,Pulau Pinang,0,0,0
1/07/2021,Algeria,Sabah,0,0,0
1/07/2021,Algeria,Sarawak,0,0,0
1/07/2021,Algeria,Selangor,3,1,2
1/07/2021,Algeria,W.P. Labuan,0,0,0
1/07/2021,Ecuador,Johor,0,0,0
1/07/2021,Ecuador,Kedah,0,0,0
1/07/2021,Ecuador,Perak,0,0,0
1/07/2021,Ecuador,Perlis,0,0,0
1/07/2021,Ecuador,Pulau Pinang,0,0,0
1/07/2021,Ecuador,Sabah,0,0,0
1/07/2021,Ecuador,Sarawak,0,0,0
1/07/2021,Ecuador,Selangor,0,0,0
1/07/2021,Egypt,Johor,0,0,0
1/07/2021,Egypt,Kedah,0,0,0
1/07/2021,Egypt,Kelantan,0,0,0
1/07/2021,Egypt,Melaka,0,0,0
1/07/2021,Egypt,Pahang,0,0,0
1/07/2021,Egypt,Perak,0,0,0
1/07/2021,Egypt,Perlis,0,0,0
1/07/2021,Egypt,Pulau Pinang,0,0,0
1/07/2021,Egypt,Sabah,0,0,0
1/07/2021,Egypt,Sarawak,0,0,0
1/07/2021,Egypt,Selangor,52,39,13
1/07/2021,Egypt,Terengganu,0,0,0
1/07/2021,Egypt,W.P. Labuan,0,0,0
1/07/2021,Eritrea,Johor,0,0,0
1/07/2021,Eritrea,Pulau Pinang,0,0,0
1/07/2021,Eritrea,Sabah,0,0,0
1/07/2021,Eritrea,Selangor,0,0,0
1/07/2021,Spain,Johor,2,2,0
1/07/2021,Spain,Kedah,0,0,0
1/07/2021,Spain,Kelantan,0,0,0
1/07/2021,Spain,Melaka,0,0,0
1/07/2021,Spain,Negeri Sembilan,0,0,0
1/07/2021,Spain,Pahang,0,0,0
1/07/2021,Spain,Perak,0,0,0
1/07/2021,Spain,Perlis,0,0,0
1/07/2021,Spain,Pulau Pinang,0,0,0
1/07/2021,Spain,Sabah,0,0,0
1/07/2021,Spain,Sarawak,0,0,0
1/07/2021,Spain,Selangor,30,20,10
1/07/2021,Spain,W.P. Labuan,0,0,0
1/07/2021,Estonia,Johor,0,0,0
1/07/2021,Estonia,Kedah,0,0,0
1/07/2021,Estonia,Kelantan,0,0,0
1/07/2021,Estonia,Pahang,0,0,0
1/07/2021,Estonia,Perak,0,0,0
1/07/2021,Estonia,Perlis,0,0,0
1/07/2021,Estonia,Pulau Pinang,0,0,0
1/07/2021,Estonia,Sabah,0,0,0
1/07/2021,Estonia,Sarawak,0,0,0
1/07/2021,Estonia,Selangor,0,0,0
1/07/2021,Estonia,W.P. Labuan,0,0,0
1/07/2021,Ethiopia,Johor,0,0,0
1/07/2021,Ethiopia,Kedah,0,0,0
1/07/2021,Ethiopia,Pulau Pinang,0,0,0
1/07/2021,Ethiopia,Sarawak,1,0,1
1/07/2021,Ethiopia,Selangor,2,1,1
1/07/2021,Finland,Johor,0,0,0
1/07/2021,Finland,Kedah,0,0,0
1/07/2021,Finland,Kelantan,0,0,0
1/07/2021,Finland,Melaka,0,0,0
1/07/2021,Finland,Negeri Sembilan,0,0,0
1/07/2021,Finland,Pahang,0,0,0
1/07/2021,Finland,Perak,0,0,0
1/07/2021,Finland,Perlis,0,0,0
1/07/2021,Finland,Pulau Pinang,0,0,0
1/07/2021,Finland,Sabah,0,0,0
1/07/2021,Finland,Sarawak,0,0,0
1/07/2021,Finland,Selangor,16,13,3
1/07/2021,Finland,W.P. Labuan,0,0,0
1/07/2021,Fiji,Johor,0,0,0
1/07/2021,Fiji,Kedah,0,0,0
1/07/2021,Fiji,Kelantan,0,0,0
1/07/2021,Fiji,Perak,0,0,0
1/07/2021,Fiji,Perlis,0,0,0
1/07/2021,Fiji,Pulau Pinang,0,0,0
1/07/2021,Fiji,Sabah,0,0,0
1/07/2021,Fiji,Sarawak,0,0,0
1/07/2021,Fiji,Selangor,0,0,0
1/07/2021,France,Johor,0,0,0
1/07/2021,France,Kedah,0,0,0
1/07/2021,France,Kelantan,0,0,0
1/07/2021,France,Melaka,0,0,0
1/07/2021,France,Negeri Sembilan,0,0,0
1/07/2021,France,Pahang,0,0,0
1/07/2021,France,Perak,0,0,0
1/07/2021,France,Perlis,0,0,0
1/07/2021,France,Pulau Pinang,1,1,0
1/07/2021,France,Sabah,0,0,0
1/07/2021,France,Sarawak,2,2,0
1/07/2021,France,Selangor,99,72,27
1/07/2021,France,Terengganu,0,0,0
1/07/2021,France,W.P. Labuan,0,0,0
1/07/2021,"Micronesia, Federated States of",Johor,0,0,0
1/07/2021,"Micronesia, Federated States of",Pulau Pinang,0,0,0
1/07/2021,"Micronesia, Federated States of",Selangor,0,0,0
1/07/2021,Gabon,Johor,0,0,0
1/07/2021,Gabon,Pulau Pinang,0,0,0
1/07/2021,Gabon,Sarawak,0,0,0
1/07/2021,Gabon,Selangor,0,0,0
1/07/2021,United Kingdom of Great Britain and Northern Ireland,Johor,1,1,0
1/07/2021,United Kingdom of Great Britain and Northern Ireland,Kedah,0,0,0
1/07/2021,United Kingdom of Great Britain and Northern Ireland,Kelantan,0,0,0
1/07/2021,United Kingdom of Great Britain and Northern Ireland,Melaka,0,0,0
1/07/2021,United Kingdom of Great Britain and Northern Ireland,Negeri Sembilan,0,0,0
1/07/2021,United Kingdom of Great Britain and Northern Ireland,Pahang,0,0,0
1/07/2021,United Kingdom of Great Britain and Northern Ireland,Perak,0,0,0
1/07/2021,United Kingdom of Great Britain and Northern Ireland,Perlis,0,0,0
1/07/2021,United Kingdom of Great Britain and Northern Ireland,Pulau Pinang,7,4,3
1/07/2021,United Kingdom of Great Britain and Northern Ireland,Sabah,0,0,0
1/07/2021,United Kingdom of Great Britain and Northern Ireland,Sarawak,2,1,1
1/07/2021,United Kingdom of Great Britain and Northern Ireland,Selangor,386,249,137
1/07/2021,United Kingdom of Great Britain and Northern Ireland,Terengganu,0,0,0
1/07/2021,United Kingdom of Great Britain and Northern Ireland,W.P. Labuan,0,0,0
1/07/2021,Georgia,Johor,0,0,0
1/07/2021,Georgia,Kedah,0,0,0
1/07/2021,Georgia,Melaka,0,0,0
1/07/2021,Georgia,Perak,0,0,0
1/07/2021,Georgia,Perlis,0,0,0
1/07/2021,Georgia,Pulau Pinang,0,0,0
1/07/2021,Georgia,Sabah,0,0,0
1/07/2021,Georgia,Sarawak,0,0,0
1/07/2021,Georgia,Selangor,2,2,0
1/07/2021,Ghana,Johor,0,0,0
1/07/2021,Ghana,Kedah,0,0,0
1/07/2021,Ghana,Kelantan,0,0,0
1/07/2021,Ghana,Pulau Pinang,0,0,0
1/07/2021,Ghana,Sabah,0,0,0
1/07/2021,Ghana,Sarawak,0,0,0
1/07/2021,Ghana,Selangor,2,2,0
1/07/2021,Gibraltar,Johor,0,0,0
1/07/2021,Gibraltar,Sarawak,0,0,0
1/07/2021,Guinea,Johor,0,0,0
1/07/2021,Guinea,Kedah,0,0,0
1/07/2021,Guinea,Kelantan,0,0,0
1/07/2021,Guinea,Perlis,0,0,0
1/07/2021,Guinea,Pulau Pinang,0,0,0
1/07/2021,Guinea,Sabah,0,0,0
1/07/2021,Guinea,Sarawak,0,0,0
1/07/2021,Guinea,Selangor,1,1,0
1/07/2021,Guadeloupe,Selangor,0,0,0
1/07/2021,Gambia,Johor,0,0,0
1/07/2021,Gambia,Kedah,0,0,0
1/07/2021,Gambia,Kelantan,0,0,0
1/07/2021,Gambia,Pulau Pinang,0,0,0
1/07/2021,Gambia,Sabah,0,0,0
1/07/2021,Gambia,Sarawak,0,0,0
1/07/2021,Gambia,Selangor,0,0,0
1/07/2021,Guinea-Bissau,Johor,0,0,0
1/07/2021,Guinea-Bissau,Selangor,0,0,0
1/07/2021,Equatorial Guinea,Johor,0,0,0
1/07/2021,Equatorial Guinea,Selangor,0,0,0
1/07/2021,Greece,Johor,1,1,0
1/07/2021,Greece,Kedah,0,0,0
1/07/2021,Greece,Kelantan,0,0,0
1/07/2021,Greece,Melaka,0,0,0
1/07/2021,Greece,Negeri Sembilan,0,0,0
1/07/2021,Greece,Pahang,0,0,0
1/07/2021,Greece,Perak,0,0,0
1/07/2021,Greece,Perlis,0,0,0
1/07/2021,Greece,Pulau Pinang,0,0,0
1/07/2021,Greece,Sabah,0,0,0
1/07/2021,Greece,Sarawak,0,0,0
1/07/2021,Greece,Selangor,11,10,1
1/07/2021,Grenada,Johor,0,0,0
1/07/2021,Grenada,Kedah,0,0,0
1/07/2021,Grenada,Pulau Pinang,0,0,0
1/07/2021,Grenada,Sabah,0,0,0
1/07/2021,Grenada,Sarawak,0,0,0
1/07/2021,Grenada,Selangor,0,0,0
1/07/2021,Greenland,Johor,0,0,0
1/07/2021,Greenland,Selangor,0,0,0
1/07/2021,Guatemala,Johor,0,0,0
1/07/2021,Guatemala,Kedah,0,0,0
1/07/2021,Guatemala,Pahang,0,0,0
1/07/2021,Guatemala,Perak,0,0,0
1/07/2021,Guatemala,Pulau Pinang,0,0,0
1/07/2021,Guatemala,Sabah,0,0,0
1/07/2021,Guatemala,Sarawak,0,0,0
1/07/2021,Guatemala,Selangor,0,0,0
1/07/2021,Guatemala,W.P. Labuan,0,0,0
1/07/2021,Guyana,Johor,0,0,0
1/07/2021,Guyana,Kedah,0,0,0
1/07/2021,Guyana,Pulau Pinang,0,0,0
1/07/2021,Guyana,Sarawak,0,0,0
1/07/2021,Guyana,Selangor,0,0,0
1/07/2021,Hong Kong,Johor,0,0,0
1/07/2021,Hong Kong,Kedah,0,0,0
1/07/2021,Hong Kong,Kelantan,0,0,0
1/07/2021,Hong Kong,Pahang,0,0,0
1/07/2021,Hong Kong,Perak,0,0,0
1/07/2021,Hong Kong,Perlis,0,0,0
1/07/2021,Hong Kong,Pulau Pinang,2,1,1
1/07/2021,Hong Kong,Sabah,0,0,0
1/07/2021,Hong Kong,Sarawak,0,0,0
1/07/2021,Hong Kong,Selangor,0,0,0
1/07/2021,Hong Kong,Terengganu,0,0,0
1/07/2021,Heard Island and McDonald Islands,Johor,0,0,0
1/07/2021,Honduras,Johor,0,0,0
1/07/2021,Honduras,Kedah,0,0,0
1/07/2021,Honduras,Perak,0,0,0
1/07/2021,Honduras,Pulau Pinang,0,0,0
1/07/2021,Honduras,Sabah,0,0,0
1/07/2021,Honduras,Sarawak,0,0,0
1/07/2021,Honduras,Selangor,0,0,0
1/07/2021,Croatia,Johor,0,0,0
1/07/2021,Croatia,Kedah,0,0,0
1/07/2021,Croatia,Kelantan,0,0,0
1/07/2021,Croatia,Melaka,0,0,0
1/07/2021,Croatia,Pahang,0,0,0
1/07/2021,Croatia,Perak,0,0,0
1/07/2021,Croatia,Perlis,0,0,0
1/07/2021,Croatia,Pulau Pinang,0,0,0
1/07/2021,Croatia,Sabah,0,0,0
1/07/2021,Croatia,Sarawak,0,0,0
1/07/2021,Croatia,Selangor,13,13,0
1/07/2021,Haiti,Johor,0,0,0
1/07/2021,Haiti,Kedah,0,0,0
1/07/2021,Haiti,Kelantan,0,0,0
1/07/2021,Haiti,Perak,0,0,0
1/07/2021,Haiti,Pulau Pinang,0,0,0
1/07/2021,Haiti,Sabah,0,0,0
1/07/2021,Haiti,Selangor,0,0,0
1/07/2021,Hungary,Johor,0,0,0
1/07/2021,Hungary,Kedah,0,0,0
1/07/2021,Hungary,Kelantan,0,0,0
1/07/2021,Hungary,Pahang,0,0,0
1/07/2021,Hungary,Perak,0,0,0
1/07/2021,Hungary,Perlis,0,0,0
1/07/2021,Hungary,Pulau Pinang,0,0,0
1/07/2021,Hungary,Sabah,0,0,0
1/07/2021,Hungary,Sarawak,0,0,0
1/07/2021,Hungary,Selangor,4,3,1
1/07/2021,Hungary,W.P. Labuan,0,0,0
1/07/2021,Indonesia,Johor,59,49,10
1/07/2021,Indonesia,Kedah,8,8,0
1/07/2021,Indonesia,Kelantan,0,0,0
1/07/2021,Indonesia,Melaka,2,1,1
1/07/2021,Indonesia,Negeri Sembilan,0,0,0
1/07/2021,Indonesia,Pahang,0,0,0
1/07/2021,Indonesia,Perak,0,0,0
1/07/2021,Indonesia,Perlis,3,3,0
1/07/2021,Indonesia,Pulau Pinang,32,7,25
1/07/2021,Indonesia,Sabah,0,0,0
1/07/2021,Indonesia,Sarawak,347,343,4
1/07/2021,Indonesia,Selangor,669,548,121
1/07/2021,Indonesia,Terengganu,0,0,0
1/07/2021,Indonesia,W.P. Labuan,6,6,0
1/07/2021,India,Johor,1,1,0
1/07/2021,India,Kedah,0,0,0
1/07/2021,India,Kelantan,0,0,0
1/07/2021,India,Melaka,0,0,0
1/07/2021,India,Negeri Sembilan,0,0,0
1/07/2021,India,Pahang,0,0,0
1/07/2021,India,Perak,0,0,0
1/07/2021,India,Perlis,0,0,0
1/07/2021,India,Pulau Pinang,0,0,0
1/07/2021,India,Sabah,0,0,0
1/07/2021,India,Sarawak,0,0,0
1/07/2021,India,Selangor,47,25,22
1/07/2021,India,Terengganu,0,0,0
1/07/2021,India,W.P. Labuan,0,0,0
1/07/2021, British Indian Ocean Territory,Pulau Pinang,0,0,0
1/07/2021, British Indian Ocean Territory,Selangor,0,0,0
1/07/2021,Ireland,Johor,0,0,0
1/07/2021,Ireland,Kedah,0,0,0
1/07/2021,Ireland,Kelantan,0,0,0
1/07/2021,Ireland,Negeri Sembilan,0,0,0
1/07/2021,Ireland,Pahang,0,0,0
1/07/2021,Ireland,Perak,0,0,0
1/07/2021,Ireland,Perlis,0,0,0
1/07/2021,Ireland,Pulau Pinang,0,0,0
1/07/2021,Ireland,Sabah,0,0,0
1/07/2021,Ireland,Sarawak,0,0,0
1/07/2021,Ireland,Selangor,20,12,8
1/07/2021,Ireland,Terengganu,0,0,0
1/07/2021,Ireland,W.P. Labuan,0,0,0
1/07/2021,"Iran, Islamic Republic of",Johor,0,0,0
1/07/2021,"Iran, Islamic Republic of",Kedah,0,0,0
1/07/2021,"Iran, Islamic Republic of",Kelantan,0,0,0
1/07/2021,"Iran, Islamic Republic of",Perak,0,0,0
1/07/2021,"Iran, Islamic Republic of",Perlis,0,0,0
1/07/2021,"Iran, Islamic Republic of",Pulau Pinang,0,0,0
1/07/2021,"Iran, Islamic Republic of",Sabah,0,0,0
1/07/2021,"Iran, Islamic Republic of",Sarawak,0,0,0
1/07/2021,"Iran, Islamic Republic of",Selangor,23,14,9
1/07/2021,"Iran, Islamic Republic of",W.P. Labuan,0,0,0
1/07/2021,Iraq,Johor,0,0,0
1/07/2021,Iraq,Kedah,0,0,0
1/07/2021,Iraq,Kelantan,0,0,0
1/07/2021,Iraq,Melaka,0,0,0
1/07/2021,Iraq,Pahang,0,0,0
1/07/2021,Iraq,Perak,0,0,0
1/07/2021,Iraq,Perlis,0,0,0
1/07/2021,Iraq,Pulau Pinang,0,0,0
1/07/2021,Iraq,Sabah,0,0,0
1/07/2021,Iraq,Sarawak,0,0,0
1/07/2021,Iraq,Selangor,16,12,4
1/07/2021,Iceland,Johor,0,0,0
1/07/2021,Iceland,Kedah,0,0,0
1/07/2021,Iceland,Kelantan,0,0,0
1/07/2021,Iceland,Perak,0,0,0
1/07/2021,Iceland,Perlis,0,0,0
1/07/2021,Iceland,Pulau Pinang,0,0,0
1/07/2021,Iceland,Sabah,0,0,0
1/07/2021,Iceland,Sarawak,0,0,0
1/07/2021,Iceland,Selangor,0,0,0
1/07/2021,Iceland,W.P. Labuan,0,0,0
1/07/2021,Israel,Pulau Pinang,0,0,0
1/07/2021,Italy,Johor,0,0,0
1/07/2021,Italy,Kedah,0,0,0
1/07/2021,Italy,Kelantan,0,0,0
1/07/2021,Italy,Melaka,0,0,0
1/07/2021,Italy,Negeri Sembilan,0,0,0
1/07/2021,Italy,Pahang,0,0,0
1/07/2021,Italy,Perak,0,0,0
1/07/2021,Italy,Perlis,0,0,0
1/07/2021,Italy,Pulau Pinang,0,0,0
1/07/2021,Italy,Sabah,0,0,0
1/07/2021,Italy,Sarawak,0,0,0
1/07/2021,Italy,Selangor,29,25,4
1/07/2021,Italy,W.P. Labuan,0,0,0
1/07/2021,Jamaica,Johor,0,0,0
1/07/2021,Jamaica,Kedah,0,0,0
1/07/2021,Jamaica,Perak,0,0,0
1/07/2021,Jamaica,Pulau Pinang,0,0,0
1/07/2021,Jamaica,Sabah,0,0,0
1/07/2021,Jamaica,Sarawak,0,0,0
1/07/2021,Jamaica,Selangor,0,0,0
1/07/2021,Jamaica,W.P. Labuan,0,0,0
1/07/2021,Jordan,Johor,0,0,0
1/07/2021,Jordan,Kedah,0,0,0
1/07/2021,Jordan,Kelantan,0,0,0
1/07/2021,Jordan,Melaka,0,0,0
1/07/2021,Jordan,Perlis,0,0,0
1/07/2021,Jordan,Pulau Pinang,0,0,0
1/07/2021,Jordan,Sabah,0,0,0
1/07/2021,Jordan,Sarawak,0,0,0
1/07/2021,Jordan,Selangor,8,7,1
1/07/2021,Jordan,W.P. Labuan,0,0,0
1/07/2021,Japan,Johor,0,0,0
1/07/2021,Japan,Kedah,0,0,0
1/07/2021,Japan,Kelantan,0,0,0
1/07/2021,Japan,Melaka,0,0,0
1/07/2021,Japan,Negeri Sembilan,0,0,0
1/07/2021,Japan,Pahang,0,0,0
1/07/2021,Japan,Perak,0,0,0
1/07/2021,Japan,Perlis,0,0,0
1/07/2021,Japan,Pulau Pinang,16,8,8
1/07/2021,Japan,Sabah,0,0,0
1/07/2021,Japan,Sarawak,8,8,0
1/07/2021,Japan,Selangor,281,159,122
1/07/2021,Japan,W.P. Labuan,0,0,0
1/07/2021,Kazakhstan,Johor,0,0,0
1/07/2021,Kazakhstan,Kedah,0,0,0
1/07/2021,Kazakhstan,Kelantan,0,0,0
1/07/2021,Kazakhstan,Melaka,0,0,0
1/07/2021,Kazakhstan,Perak,0,0,0
1/07/2021,Kazakhstan,Perlis,0,0,0
1/07/2021,Kazakhstan,Pulau Pinang,0,0,0
1/07/2021,Kazakhstan,Sabah,0,0,0
1/07/2021,Kazakhstan,Sarawak,0,0,0
1/07/2021,Kazakhstan,Selangor,7,5,2
1/07/2021,Kazakhstan,W.P. Labuan,0,0,0
1/07/2021,Kenya,Johor,0,0,0
1/07/2021,Kenya,Kedah,0,0,0
1/07/2021,Kenya,Kelantan,0,0,0
1/07/2021,Kenya,Perak,0,0,0
1/07/2021,Kenya,Perlis,0,0,0
1/07/2021,Kenya,Pulau Pinang,0,0,0
1/07/2021,Kenya,Sabah,0,0,0
1/07/2021,Kenya,Sarawak,0,0,0
1/07/2021,Kenya,Selangor,8,3,5
1/07/2021,Kyrgyzstan,Johor,0,0,0
1/07/2021,Kyrgyzstan,Kedah,0,0,0
1/07/2021,Kyrgyzstan,Kelantan,0,0,0
1/07/2021,Kyrgyzstan,Perak,0,0,0
1/07/2021,Kyrgyzstan,Perlis,0,0,0
1/07/2021,Kyrgyzstan,Pulau Pinang,0,0,0
1/07/2021,Kyrgyzstan,Sabah,0,0,0
1/07/2021,Kyrgyzstan,Sarawak,0,0,0
1/07/2021,Kyrgyzstan,Selangor,6,2,4
1/07/2021,Cambodia,Johor,0,0,0
1/07/2021,Cambodia,Kedah,0,0,0
1/07/2021,Cambodia,Kelantan,0,0,0
1/07/2021,Cambodia,Melaka,0,0,0
1/07/2021,Cambodia,Negeri Sembilan,0,0,0
1/07/2021,Cambodia,Pahang,0,0,0
1/07/2021,Cambodia,Perak,0,0,0
1/07/2021,Cambodia,Perlis,0,0,0
1/07/2021,Cambodia,Pulau Pinang,0,0,0
1/07/2021,Cambodia,Sabah,0,0,0
1/07/2021,Cambodia,Sarawak,0,0,0
1/07/2021,Cambodia,Selangor,118,115,3
1/07/2021,Cambodia,W.P. Labuan,0,0,0
1/07/2021,Kiribati,Johor,0,0,0
1/07/2021,Kiribati,Sabah,0,0,0
1/07/2021,Kiribati,Selangor,4,4,0
1/07/2021,Saint Kitts and Nevis,Johor,0,0,0
1/07/2021,Saint Kitts and Nevis,Kedah,0,0,0
1/07/2021,Saint Kitts and Nevis,Perlis,0,0,0
1/07/2021,Saint Kitts and Nevis,Pulau Pinang,0,0,0
1/07/2021,Saint Kitts and Nevis,Sabah,0,0,0
1/07/2021,Saint Kitts and Nevis,Selangor,0,0,0
1/07/2021,Saint Kitts and Nevis,W.P. Labuan,0,0,0
1/07/2021,"Korea, Republic of",Johor,1,1,0
1/07/2021,"Korea, Republic of",Kedah,0,0,0
1/07/2021,"Korea, Republic of",Kelantan,0,0,0
1/07/2021,"Korea, Republic of",Melaka,0,0,0
1/07/2021,"Korea, Republic of",Negeri Sembilan,0,0,0
1/07/2021,"Korea, Republic of",Pahang,0,0,0
1/07/2021,"Korea, Republic of",Perak,0,0,0
1/07/2021,"Korea, Republic of",Perlis,0,0,0
1/07/2021,"Korea, Republic of",Pulau Pinang,9,5,4
1/07/2021,"Korea, Republic of",Sabah,0,0,0
1/07/2021,"Korea, Republic of",Sarawak,13,8,5
1/07/2021,"Korea, Republic of",Selangor,259,180,79
1/07/2021,"Korea, Republic of",Terengganu,0,0,0
1/07/2021,"Korea, Republic of",W.P. Labuan,0,0,0
1/07/2021,Kuwait,Johor,0,0,0
1/07/2021,Kuwait,Kedah,0,0,0
1/07/2021,Kuwait,Kelantan,0,0,0
1/07/2021,Kuwait,Perak,0,0,0
1/07/2021,Kuwait,Perlis,0,0,0
1/07/2021,Kuwait,Pulau Pinang,0,0,0
1/07/2021,Kuwait,Sabah,0,0,0
1/07/2021,Kuwait,Sarawak,0,0,0
1/07/2021,Kuwait,Selangor,8,3,5
1/07/2021,Kuwait,W.P. Labuan,0,0,0
1/07/2021, Lao People's Democratic Republic,Johor,0,0,0
1/07/2021, Lao People's Democratic Republic,Kedah,0,0,0
1/07/2021, Lao People's Democratic Republic,Kelantan,0,0,0
1/07/2021, Lao People's Democratic Republic,Melaka,0,0,0
1/07/2021, Lao People's Democratic Republic,Perak,0,0,0
1/07/2021, Lao People's Democratic Republic,Perlis,0,0,0
1/07/2021, Lao People's Democratic Republic,Pulau Pinang,0,0,0
1/07/2021, Lao People's Democratic Republic,Sabah,0,0,0
1/07/2021, Lao People's Democratic Republic,Sarawak,0,0,0
1/07/2021, Lao People's Democratic Republic,Selangor,96,95,1
1/07/2021, Lao People's Democratic Republic,W.P. Labuan,0,0,0
1/07/2021,Lebanon,Johor,0,0,0
1/07/2021,Lebanon,Kedah,0,0,0
1/07/2021,Lebanon,Kelantan,0,0,0
1/07/2021,Lebanon,Pahang,0,0,0
1/07/2021,Lebanon,Perak,0,0,0
1/07/2021,Lebanon,Perlis,0,0,0
1/07/2021,Lebanon,Pulau Pinang,0,0,0
1/07/2021,Lebanon,Sabah,0,0,0
1/07/2021,Lebanon,Sarawak,0,0,0
1/07/2021,Lebanon,Selangor,2,2,0
1/07/2021,Lebanon,W.P. Labuan,0,0,0
1/07/2021,Liberia,Johor,0,0,0
1/07/2021,Liberia,Kedah,0,0,0
1/07/2021,Liberia,Sabah,0,0,0
1/07/2021,Liberia,Sarawak,0,0,0
1/07/2021,Liberia,Selangor,1,0,1
1/07/2021,Libya,Johor,0,0,0
1/07/2021,Libya,Kedah,0,0,0
1/07/2021,Libya,Perlis,0,0,0
1/07/2021,Libya,Pulau Pinang,0,0,0
1/07/2021,Libya,Sabah,0,0,0
1/07/2021,Libya,Sarawak,0,0,0
1/07/2021,Libya,Selangor,14,13,1
1/07/2021,Saint Lucia,Johor,0,0,0
1/07/2021,Saint Lucia,Kedah,0,0,0
1/07/2021,Saint Lucia,Pulau Pinang,0,0,0
1/07/2021,Saint Lucia,Sarawak,0,0,0
1/07/2021,Saint Lucia,Selangor,0,0,0
1/07/2021,Liechtenstein,Johor,0,0,0
1/07/2021,Liechtenstein,Kedah,0,0,0
1/07/2021,Liechtenstein,Perlis,0,0,0
1/07/2021,Liechtenstein,Pulau Pinang,0,0,0
1/07/2021,Liechtenstein,Sabah,0,0,0
1/07/2021,Liechtenstein,Sarawak,0,0,0
1/07/2021,Liechtenstein,Selangor,0,0,0
1/07/2021,LKA,Johor,0,0,0
1/07/2021,LKA,Kedah,0,0,0
1/07/2021,LKA,Kelantan,0,0,0
1/07/2021,LKA,Melaka,0,0,0
1/07/2021,LKA,Pahang,0,0,0
1/07/2021,LKA,Perak,0,0,0
1/07/2021,LKA,Perlis,0,0,0
1/07/2021,LKA,Pulau Pinang,0,0,0
1/07/2021,LKA,Sabah,0,0,0
1/07/2021,LKA,Sarawak,0,0,0
1/07/2021,LKA,Selangor,8,4,4
1/07/2021,LKA,W.P. Labuan,0,0,0
1/07/2021,Lesotho,Johor,0,0,0
1/07/2021,Lesotho,Kedah,0,0,0
1/07/2021,Lesotho,Pulau Pinang,0,0,0
1/07/2021,Lesotho,Sarawak,0,0,0
1/07/2021,Lesotho,Selangor,0,0,0
1/07/2021,Lithuania,Johor,0,0,0
1/07/2021,Lithuania,Kedah,0,0,0
1/07/2021,Lithuania,Kelantan,0,0,0
1/07/2021,Lithuania,Pahang,0,0,0
1/07/2021,Lithuania,Perak,0,0,0
1/07/2021,Lithuania,Perlis,0,0,0
1/07/2021,Lithuania,Pulau Pinang,0,0,0
1/07/2021,Lithuania,Sabah,0,0,0
1/07/2021,Lithuania,Sarawak,0,0,0
1/07/2021,Lithuania,Selangor,1,1,0
1/07/2021,Lithuania,W.P. Labuan,0,0,0
1/07/2021,Luxembourg,Johor,0,0,0
1/07/2021,Luxembourg,Kedah,0,0,0
1/07/2021,Luxembourg,Kelantan,0,0,0
1/07/2021,Luxembourg,Perak,0,0,0
1/07/2021,Luxembourg,Perlis,0,0,0
1/07/2021,Luxembourg,Pulau Pinang,0,0,0
1/07/2021,Luxembourg,Sabah,0,0,0
1/07/2021,Luxembourg,Sarawak,0,0,0
1/07/2021,Luxembourg,Selangor,0,0,0
1/07/2021,Latvia,Johor,0,0,0
1/07/2021,Latvia,Kedah,0,0,0
1/07/2021,Latvia,Kelantan,0,0,0
1/07/2021,Latvia,Pahang,0,0,0
1/07/2021,Latvia,Perak,0,0,0
1/07/2021,Latvia,Perlis,0,0,0
1/07/2021,Latvia,Pulau Pinang,0,0,0
1/07/2021,Latvia,Sabah,0,0,0
1/07/2021,Latvia,Sarawak,0,0,0
1/07/2021,Latvia,Selangor,0,0,0
1/07/2021,Latvia,W.P. Labuan,0,0,0
1/07/2021,Macao,Johor,0,0,0
1/07/2021,Macao,Pahang,0,0,0
1/07/2021,Macao,Perak,0,0,0
1/07/2021,Macao,Selangor,0,0,0
1/07/2021,Macao,W.P. Labuan,0,0,0
1/07/2021,Morocco,Johor,0,0,0
1/07/2021,Morocco,Kedah,0,0,0
1/07/2021,Morocco,Kelantan,0,0,0
1/07/2021,Morocco,Melaka,0,0,0
1/07/2021,Morocco,Pahang,0,0,0
1/07/2021,Morocco,Perak,0,0,0
1/07/2021,Morocco,Perlis,0,0,0
1/07/2021,Morocco,Pulau Pinang,0,0,0
1/07/2021,Morocco,Sabah,0,0,0
1/07/2021,Morocco,Sarawak,0,0,0
1/07/2021,Morocco,Selangor,0,0,0
1/07/2021,Morocco,W.P. Labuan,0,0,0
1/07/2021,Monaco,Johor,0,0,0
1/07/2021,Monaco,Kedah,0,0,0
1/07/2021,Monaco,Sabah,0,0,0
1/07/2021,Monaco,Selangor,0,0,0
1/07/2021,"Moldova, Republic of",Johor,0,0,0
1/07/2021,"Moldova, Republic of",Kedah,0,0,0
1/07/2021,"Moldova, Republic of",Kelantan,0,0,0
1/07/2021,"Moldova, Republic of",Negeri Sembilan,0,0,0
1/07/2021,"Moldova, Republic of",Perlis,0,0,0
1/07/2021,"Moldova, Republic of",Pulau Pinang,0,0,0
1/07/2021,"Moldova, Republic of",Sabah,0,0,0
1/07/2021,"Moldova, Republic of",Sarawak,0,0,0
1/07/2021,"Moldova, Republic of",Selangor,0,0,0
1/07/2021,Madagascar,Johor,0,0,0
1/07/2021,Madagascar,Kedah,0,0,0
1/07/2021,Madagascar,Perak,0,0,0
1/07/2021,Madagascar,Perlis,0,0,0
1/07/2021,Madagascar,Pulau Pinang,0,0,0
1/07/2021,Madagascar,Sabah,0,0,0
1/07/2021,Madagascar,Sarawak,0,0,0
1/07/2021,Madagascar,Selangor,0,0,0
1/07/2021,Maldives,Johor,0,0,0
1/07/2021,Maldives,Kedah,0,0,0
1/07/2021,Maldives,Kelantan,0,0,0
1/07/2021,Maldives,Perak,0,0,0
1/07/2021,Maldives,Perlis,0,0,0
1/07/2021,Maldives,Pulau Pinang,0,0,0
1/07/2021,Maldives,Sabah,0,0,0
1/07/2021,Maldives,Sarawak,0,0,0
1/07/2021,Maldives,Selangor,24,8,16
1/07/2021,Mexico,Johor,0,0,0
1/07/2021,Mexico,Kedah,0,0,0
1/07/2021,Mexico,Kelantan,0,0,0
1/07/2021,Mexico,Pahang,0,0,0
1/07/2021,Mexico,Perak,0,0,0
1/07/2021,Mexico,Perlis,0,0,0
1/07/2021,Mexico,Pulau Pinang,0,0,0
1/07/2021,Mexico,Sabah,0,0,0
1/07/2021,Mexico,Sarawak,0,0,0
1/07/2021,Mexico,Selangor,13,9,4
1/07/2021,Mexico,W.P. Labuan,0,0,0
1/07/2021,Marshall Islands,Johor,0,0,0
1/07/2021,Marshall Islands,Kedah,0,0,0
1/07/2021,Marshall Islands,Perak,0,0,0
1/07/2021,Marshall Islands,Pulau Pinang,0,0,0
1/07/2021,Marshall Islands,Sabah,0,0,0
1/07/2021,Marshall Islands,Selangor,0,0,0
1/07/2021,North Macedonia,Johor,0,0,0
1/07/2021,North Macedonia,Kedah,0,0,0
1/07/2021,North Macedonia,Perak,0,0,0
1/07/2021,North Macedonia,Pulau Pinang,0,0,0
1/07/2021,North Macedonia,Sabah,0,0,0
1/07/2021,North Macedonia,Sarawak,0,0,0
1/07/2021,North Macedonia,Selangor,0,0,0
1/07/2021,Mali,Johor,0,0,0
1/07/2021,Mali,Sabah,0,0,0
1/07/2021,Mali,Selangor,0,0,0
1/07/2021,Malta,Johor,0,0,0
1/07/2021,Malta,Kedah,0,0,0
1/07/2021,Malta,Kelantan,0,0,0
1/07/2021,Malta,Perak,0,0,0
1/07/2021,Malta,Perlis,0,0,0
1/07/2021,Malta,Pulau Pinang,0,0,0
1/07/2021,Malta,Sabah,0,0,0
1/07/2021,Malta,Sarawak,0,0,0
1/07/2021,Malta,Selangor,0,0,0
1/07/2021,Malta,W.P. Labuan,0,0,0
1/07/2021,Myanmar,Johor,0,0,0
1/07/2021,Myanmar,Kedah,0,0,0
1/07/2021,Myanmar,Kelantan,0,0,0
1/07/2021,Myanmar,Negeri Sembilan,0,0,0
1/07/2021,Myanmar,Pahang,0,0,0
1/07/2021,Myanmar,Perak,0,0,0
1/07/2021,Myanmar,Perlis,0,0,0
1/07/2021,Myanmar,Pulau Pinang,0,0,0
1/07/2021,Myanmar,Sabah,0,0,0
1/07/2021,Myanmar,Sarawak,0,0,0
1/07/2021,Myanmar,Selangor,112,105,7
1/07/2021,Myanmar,Terengganu,0,0,0
1/07/2021,Myanmar,W.P. Labuan,0,0,0
1/07/2021,Montenegro,Johor,0,0,0
1/07/2021,Montenegro,Kedah,0,0,0
1/07/2021,Montenegro,Pulau Pinang,0,0,0
1/07/2021,Montenegro,Sabah,0,0,0
1/07/2021,Montenegro,Sarawak,0,0,0
1/07/2021,Montenegro,Selangor,5,4,1
1/07/2021,Mongolia,Johor,0,0,0
1/07/2021,Mongolia,Kedah,0,0,0
1/07/2021,Mongolia,Kelantan,0,0,0
1/07/2021,Mongolia,Perak,0,0,0
1/07/2021,Mongolia,Perlis,0,0,0
1/07/2021,Mongolia,Pulau Pinang,0,0,0
1/07/2021,Mongolia,Sabah,0,0,0
1/07/2021,Mongolia,Sarawak,0,0,0
1/07/2021,Mongolia,Selangor,0,0,0
1/07/2021,Northern Mariana Islands,Selangor,0,0,0
1/07/2021,Mozambique,Johor,0,0,0
1/07/2021,Mozambique,Kedah,0,0,0
1/07/2021,Mozambique,Perak,0,0,0
1/07/2021,Mozambique,Pulau Pinang,0,0,0
1/07/2021,Mozambique,Sabah,0,0,0
1/07/2021,Mozambique,Sarawak,0,0,0
1/07/2021,Mozambique,Selangor,0,0,0
1/07/2021,Mauritania,Johor,0,0,0
1/07/2021,Mauritania,Kedah,0,0,0
1/07/2021,Mauritania,Pulau Pinang,0,0,0
1/07/2021,Mauritania,Sabah,0,0,0
1/07/2021,Mauritania,Sarawak,0,0,0
1/07/2021,Mauritania,Selangor,1,1,0
1/07/2021,Mauritius,Johor,0,0,0
1/07/2021,Mauritius,Kedah,0,0,0
1/07/2021,Mauritius,Kelantan,0,0,0
1/07/2021,Mauritius,Pahang,0,0,0
1/07/2021,Mauritius,Perak,0,0,0
1/07/2021,Mauritius,Perlis,0,0,0
1/07/2021,Mauritius,Pulau Pinang,0,0,0
1/07/2021,Mauritius,Sabah,0,0,0
1/07/2021,Mauritius,Sarawak,0,0,0
1/07/2021,Mauritius,Selangor,5,4,1
1/07/2021,Malawi,Johor,0,0,0
1/07/2021,Malawi,Pulau Pinang,0,0,0
1/07/2021,Malawi,Sabah,0,0,0
1/07/2021,Malawi,Sarawak,0,0,0
1/07/2021,Malawi,Selangor,1,1,0
1/07/2021,Mayotte,Selangor,0,0,0
1/07/2021,Namibia,Johor,0,0,0
1/07/2021,Namibia,Kedah,0,0,0
1/07/2021,Namibia,Perak,0,0,0
1/07/2021,Namibia,Perlis,0,0,0
1/07/2021,Namibia,Pulau Pinang,0,0,0
1/07/2021,Namibia,Sabah,0,0,0
1/07/2021,Namibia,Sarawak,0,0,0
1/07/2021,Namibia,Selangor,0,0,0
1/07/2021,New Caledonia,Selangor,0,0,0
1/07/2021,Niger,Johor,0,0,0
1/07/2021,Niger,Sabah,0,0,0
1/07/2021,Niger,Selangor,0,0,0
1/07/2021,Nigeria,Johor,0,0,0
1/07/2021,Nigeria,Kedah,0,0,0
1/07/2021,Nigeria,Perlis,0,0,0
1/07/2021,Nigeria,Pulau Pinang,0,0,0
1/07/2021,Nigeria,Sabah,0,0,0
1/07/2021,Nigeria,Sarawak,0,0,0
1/07/2021,Nigeria,Selangor,65,58,7
1/07/2021,Nicaragua,Johor,0,0,0
1/07/2021,Nicaragua,Kedah,0,0,0
1/07/2021,Nicaragua,Pulau Pinang,0,0,0
1/07/2021,Nicaragua,Sabah,0,0,0
1/07/2021,Nicaragua,Selangor,3,1,2
1/07/2021,Netherlands,Johor,0,0,0
1/07/2021,Netherlands,Kedah,0,0,0
1/07/2021,Netherlands,Kelantan,0,0,0
1/07/2021,Netherlands,Melaka,0,0,0
1/07/2021,Netherlands,Negeri Sembilan,0,0,0
1/07/2021,Netherlands,Pahang,0,0,0
1/07/2021,Netherlands,Perak,0,0,0
1/07/2021,Netherlands,Perlis,0,0,0
1/07/2021,Netherlands,Pulau Pinang,2,1,1
1/07/2021,Netherlands,Sabah,0,0,0
1/07/2021,Netherlands,Sarawak,1,1,0
1/07/2021,Netherlands,Selangor,54,36,18
1/07/2021,Netherlands,Terengganu,0,0,0
1/07/2021,Netherlands,W.P. Labuan,0,0,0
1/07/2021,Norway,Johor,0,0,0
1/07/2021,Norway,Kedah,0,0,0
1/07/2021,Norway,Kelantan,0,0,0
1/07/2021,Norway,Melaka,0,0,0
1/07/2021,Norway,Pahang,0,0,0
1/07/2021,Norway,Perak,0,0,0
1/07/2021,Norway,Perlis,0,0,0
1/07/2021,Norway,Pulau Pinang,0,0,0
1/07/2021,Norway,Sabah,0,0,0
1/07/2021,Norway,Sarawak,0,0,0
1/07/2021,Norway,Selangor,13,9,4
1/07/2021,Norway,W.P. Labuan,0,0,0
1/07/2021,Nepal,Johor,0,0,0
1/07/2021,Nepal,Kedah,0,0,0
1/07/2021,Nepal,Pahang,0,0,0
1/07/2021,Nepal,Perak,0,0,0
1/07/2021,Nepal,Perlis,0,0,0
1/07/2021,Nepal,Pulau Pinang,0,0,0
1/07/2021,Nepal,Sabah,0,0,0
1/07/2021,Nepal,Sarawak,0,0,0
1/07/2021,Nepal,Selangor,1,1,0
1/07/2021,Nepal,W.P. Labuan,0,0,0
1/07/2021,Nauru,Johor,0,0,0
1/07/2021,Nauru,Pulau Pinang,0,0,0
1/07/2021,Nauru,Selangor,0,0,0
1/07/2021,New Zealand,Johor,0,0,0
1/07/2021,New Zealand,Kedah,0,0,0
1/07/2021,New Zealand,Kelantan,0,0,0
1/07/2021,New Zealand,Melaka,0,0,0
1/07/2021,New Zealand,Negeri Sembilan,0,0,0
1/07/2021,New Zealand,Pahang,0,0,0
1/07/2021,New Zealand,Perak,0,0,0
1/07/2021,New Zealand,Perlis,0,0,0
1/07/2021,New Zealand,Pulau Pinang,2,2,0
1/07/2021,New Zealand,Sabah,0,0,0
1/07/2021,New Zealand,Sarawak,0,0,0
1/07/2021,New Zealand,Selangor,23,17,6
1/07/2021,New Zealand,Terengganu,0,0,0
1/07/2021,New Zealand,W.P. Labuan,0,0,0
1/07/2021,Oman,Johor,0,0,0
1/07/2021,Oman,Kedah,0,0,0
1/07/2021,Oman,Kelantan,0,0,0
1/07/2021,Oman,Melaka,0,0,0
1/07/2021,Oman,Perak,0,0,0
1/07/2021,Oman,Perlis,0,0,0
1/07/2021,Oman,Pulau Pinang,0,0,0
1/07/2021,Oman,Sabah,0,0,0
1/07/2021,Oman,Sarawak,0,0,0
1/07/2021,Oman,Selangor,9,8,1
1/07/2021,Pakistan,Johor,0,0,0
1/07/2021,Pakistan,Kedah,0,0,0
1/07/2021,Pakistan,Kelantan,0,0,0
1/07/2021,Pakistan,Melaka,0,0,0
1/07/2021,Pakistan,Negeri Sembilan,0,0,0
1/07/2021,Pakistan,Pahang,0,0,0
1/07/2021,Pakistan,Perak,0,0,0
1/07/2021,Pakistan,Perlis,0,0,0
1/07/2021,Pakistan,Pulau Pinang,0,0,0
1/07/2021,Pakistan,Sabah,0,0,0
1/07/2021,Pakistan,Sarawak,0,0,0
1/07/2021,Pakistan,Selangor,6,5,1
1/07/2021,Pakistan,W.P. Labuan,0,0,0
1/07/2021,Panama,Johor,0,0,0
1/07/2021,Panama,Kedah,0,0,0
1/07/2021,Panama,Perak,0,0,0
1/07/2021,Panama,Perlis,0,0,0
1/07/2021,Panama,Pulau Pinang,0,0,0
1/07/2021,Panama,Sabah,0,0,0
1/07/2021,Panama,Sarawak,0,0,0
1/07/2021,Panama,Selangor,5,4,1
1/07/2021,Peru,Johor,0,0,0
1/07/2021,Peru,Kedah,0,0,0
1/07/2021,Peru,Kelantan,0,0,0
1/07/2021,Peru,Pahang,0,0,0
1/07/2021,Peru,Perak,0,0,0
1/07/2021,Peru,Perlis,0,0,0
1/07/2021,Peru,Pulau Pinang,0,0,0
1/07/2021,Peru,Sabah,0,0,0
1/07/2021,Peru,Sarawak,0,0,0
1/07/2021,Peru,Selangor,1,1,0
1/07/2021,Peru,W.P. Labuan,0,0,0
1/07/2021,Philippines,Johor,6,4,2
1/07/2021,Philippines,Kedah,0,0,0
1/07/2021,Philippines,Kelantan,0,0,0
1/07/2021,Philippines,Melaka,0,0,0
1/07/2021,Philippines,Negeri Sembilan,0,0,0
1/07/2021,Philippines,Pahang,0,0,0
1/07/2021,Philippines,Perak,0,0,0
1/07/2021,Philippines,Perlis,0,0,0
1/07/2021,Philippines,Pulau Pinang,5,2,3
1/07/2021,Philippines,Sabah,1,1,0
1/07/2021,Philippines,Sarawak,35,35,0
1/07/2021,Philippines,Selangor,634,508,126
1/07/2021,Philippines,Terengganu,0,0,0
1/07/2021,Philippines,W.P. Labuan,9,9,0
1/07/2021,Palau,Johor,0,0,0
1/07/2021,Palau,Pulau Pinang,0,0,0
1/07/2021,Palau,Selangor,0,0,0
1/07/2021,Papua New Guinea,Johor,0,0,0
1/07/2021,Papua New Guinea,Kedah,0,0,0
1/07/2021,Papua New Guinea,Kelantan,0,0,0
1/07/2021,Papua New Guinea,Perak,0,0,0
1/07/2021,Papua New Guinea,Pulau Pinang,0,0,0
1/07/2021,Papua New Guinea,Sabah,0,0,0
1/07/2021,Papua New Guinea,Sarawak,0,0,0
1/07/2021,Papua New Guinea,Selangor,0,0,0
1/07/2021,Poland,Johor,0,0,0
1/07/2021,Poland,Kedah,0,0,0
1/07/2021,Poland,Kelantan,0,0,0
1/07/2021,Poland,Melaka,0,0,0
1/07/2021,Poland,Negeri Sembilan,0,0,0
1/07/2021,Poland,Pahang,0,0,0
1/07/2021,Poland,Perak,0,0,0
1/07/2021,Poland,Perlis,0,0,0
1/07/2021,Poland,Pulau Pinang,0,0,0
1/07/2021,Poland,Sabah,0,0,0
1/07/2021,Poland,Sarawak,0,0,0
1/07/2021,Poland,Selangor,25,21,4
1/07/2021,Poland,Terengganu,0,0,0
1/07/2021,Poland,W.P. Labuan,0,0,0
1/07/2021,"North Korea, Democratic People's Republic of",Selangor,0,0,0
1/07/2021,Portugal,Johor,0,0,0
1/07/2021,Portugal,Kedah,0,0,0
1/07/2021,Portugal,Kelantan,0,0,0
1/07/2021,Portugal,Melaka,0,0,0
1/07/2021,Portugal,Pahang,0,0,0
1/07/2021,Portugal,Perak,0,0,0
1/07/2021,Portugal,Perlis,0,0,0
1/07/2021,Portugal,Pulau Pinang,0,0,0
1/07/2021,Portugal,Sabah,0,0,0
1/07/2021,Portugal,Sarawak,0,0,0
1/07/2021,Portugal,Selangor,9,5,4
1/07/2021,Portugal,W.P. Labuan,0,0,0
1/07/2021,Paraguay,Johor,0,0,0
1/07/2021,Paraguay,Kedah,0,0,0
1/07/2021,Paraguay,Perak,0,0,0
1/07/2021,Paraguay,Perlis,0,0,0
1/07/2021,Paraguay,Pulau Pinang,0,0,0
1/07/2021,Paraguay,Sabah,0,0,0
1/07/2021,Paraguay,Sarawak,0,0,0
1/07/2021,Paraguay,Selangor,0,0,0
1/07/2021,"Palestine, State of",Johor,0,0,0
1/07/2021,"Palestine, State of",Kedah,0,0,0
1/07/2021,"Palestine, State of",Kelantan,0,0,0
1/07/2021,"Palestine, State of",Melaka,0,0,0
1/07/2021,"Palestine, State of",Perak,0,0,0
1/07/2021,"Palestine, State of",Perlis,0,0,0
1/07/2021,"Palestine, State of",Pulau Pinang,0,0,0
1/07/2021,"Palestine, State of",Sabah,0,0,0
1/07/2021,"Palestine, State of",Sarawak,0,0,0
1/07/2021,"Palestine, State of",Selangor,2,2,0
1/07/2021,Qatar,Johor,0,0,0
1/07/2021,Qatar,Kedah,0,0,0
1/07/2021,Qatar,Perlis,0,0,0
1/07/2021,Qatar,Pulau Pinang,0,0,0
1/07/2021,Qatar,Sabah,0,0,0
1/07/2021,Qatar,Sarawak,0,0,0
1/07/2021,Qatar,Selangor,0,0,0
1/07/2021,Réunion,Johor,0,0,0
1/07/2021,Réunion,Sarawak,0,0,0
1/07/2021,Romania,Johor,1,1,0
1/07/2021,Romania,Kedah,0,0,0
1/07/2021,Romania,Kelantan,0,0,0
1/07/2021,Romania,Negeri Sembilan,0,0,0
1/07/2021,Romania,Pahang,0,0,0
1/07/2021,Romania,Perak,0,0,0
1/07/2021,Romania,Perlis,0,0,0
1/07/2021,Romania,Pulau Pinang,0,0,0
1/07/2021,Romania,Sabah,0,0,0
1/07/2021,Romania,Sarawak,0,0,0
1/07/2021,Romania,Selangor,12,8,4
1/07/2021,Romania,W.P. Labuan,0,0,0
1/07/2021,Russian Federation (Russia),Johor,1,1,0
1/07/2021,Russian Federation (Russia),Kedah,3,1,2
1/07/2021,Russian Federation (Russia),Kelantan,0,0,0
1/07/2021,Russian Federation (Russia),Melaka,0,0,0
1/07/2021,Russian Federation (Russia),Negeri Sembilan,0,0,0
1/07/2021,Russian Federation (Russia),Pahang,0,0,0
1/07/2021,Russian Federation (Russia),Perak,0,0,0
1/07/2021,Russian Federation (Russia),Perlis,0,0,0
1/07/2021,Russian Federation (Russia),Pulau Pinang,0,0,0
1/07/2021,Russian Federation (Russia),Sabah,0,0,0
1/07/2021,Russian Federation (Russia),Sarawak,0,0,0
1/07/2021,Russian Federation (Russia),Selangor,65,50,15
1/07/2021,Russian Federation (Russia),W.P. Labuan,0,0,0
1/07/2021,Rwanda,Johor,0,0,0
1/07/2021,Rwanda,Kedah,0,0,0
1/07/2021,Rwanda,Pulau Pinang,0,0,0
1/07/2021,Rwanda,Selangor,1,0,1
1/07/2021,Saudi Arabia,Johor,0,0,0
1/07/2021,Saudi Arabia,Kedah,0,0,0
1/07/2021,Saudi Arabia,Kelantan,0,0,0
1/07/2021,Saudi Arabia,Melaka,0,0,0
1/07/2021,Saudi Arabia,Perak,0,0,0
1/07/2021,Saudi Arabia,Perlis,0,0,0
1/07/2021,Saudi Arabia,Pulau Pinang,0,0,0
1/07/2021,Saudi Arabia,Sabah,0,0,0
1/07/2021,Saudi Arabia,Sarawak,0,0,0
1/07/2021,Saudi Arabia,Selangor,51,27,24
1/07/2021,Saudi Arabia,W.P. Labuan,0,0,0
1/07/2021,Sudan,Johor,0,0,0
1/07/2021,Sudan,Kedah,0,0,0
1/07/2021,Sudan,Kelantan,0,0,0
1/07/2021,Sudan,Perlis,0,0,0
1/07/2021,Sudan,Pulau Pinang,0,0,0
1/07/2021,Sudan,Sabah,0,0,0
1/07/2021,Sudan,Sarawak,0,0,0
1/07/2021,Sudan,Selangor,23,17,6
1/07/2021,Sudan,W.P. Labuan,0,0,0
1/07/2021,Senegal,Johor,0,0,0
1/07/2021,Senegal,Kedah,0,0,0
1/07/2021,Senegal,Kelantan,0,0,0
1/07/2021,Senegal,Perak,0,0,0
1/07/2021,Senegal,Perlis,0,0,0
1/07/2021,Senegal,Pulau Pinang,0,0,0
1/07/2021,Senegal,Sabah,0,0,0
1/07/2021,Senegal,Sarawak,0,0,0
1/07/2021,Senegal,Selangor,9,4,5
1/07/2021,Singapore,Johor,101,81,20
1/07/2021,Singapore,Kedah,2,2,0
1/07/2021,Singapore,Kelantan,0,0,0
1/07/2021,Singapore,Melaka,0,0,0
1/07/2021,Singapore,Negeri Sembilan,0,0,0
1/07/2021,Singapore,Pahang,0,0,0
1/07/2021,Singapore,Perak,0,0,0
1/07/2021,Singapore,Perlis,2,2,0
1/07/2021,Singapore,Pulau Pinang,19,12,7
1/07/2021,Singapore,Sabah,0,0,0
1/07/2021,Singapore,Sarawak,3,1,2
1/07/2021,Singapore,Selangor,68,38,30
1/07/2021,Singapore,Terengganu,0,0,0
1/07/2021,Singapore,W.P. Labuan,0,0,0
1/07/2021,South Georgia and the South Sandwich Islands,Johor,0,0,0
1/07/2021,South Georgia and the South Sandwich Islands,Sabah,0,0,0
1/07/2021,South Georgia and the South Sandwich Islands,Selangor,0,0,0
1/07/2021,Saint Helena,Sarawak,0,0,0
1/07/2021,Solomon Islands,Johor,0,0,0
1/07/2021,Solomon Islands,Perlis,0,0,0
1/07/2021,Solomon Islands,Pulau Pinang,0,0,0
1/07/2021,Solomon Islands,Sabah,0,0,0
1/07/2021,Solomon Islands,Sarawak,0,0,0
1/07/2021,Solomon Islands,Selangor,0,0,0
1/07/2021,Solomon Islands,W.P. Labuan,0,0,0
1/07/2021,Sierra Leone,Johor,0,0,0
1/07/2021,Sierra Leone,Kedah,0,0,0
1/07/2021,Sierra Leone,Perak,0,0,0
1/07/2021,Sierra Leone,Pulau Pinang,0,0,0
1/07/2021,Sierra Leone,Sabah,0,0,0
1/07/2021,Sierra Leone,Selangor,3,3,0
1/07/2021,El Salvador,Johor,0,0,0
1/07/2021,El Salvador,Kedah,0,0,0
1/07/2021,El Salvador,Perak,0,0,0
1/07/2021,El Salvador,Perlis,0,0,0
1/07/2021,El Salvador,Pulau Pinang,0,0,0
1/07/2021,El Salvador,Sabah,0,0,0
1/07/2021,El Salvador,Selangor,0,0,0
1/07/2021,El Salvador,W.P. Labuan,0,0,0
1/07/2021,San Marino,Johor,0,0,0
1/07/2021,San Marino,Selangor,0,0,0
1/07/2021,Somalia,Johor,0,0,0
1/07/2021,Somalia,Kedah,0,0,0
1/07/2021,Somalia,Kelantan,0,0,0
1/07/2021,Somalia,Perlis,0,0,0
1/07/2021,Somalia,Sabah,0,0,0
1/07/2021,Somalia,Sarawak,0,0,0
1/07/2021,Somalia,Selangor,10,9,1
1/07/2021,Serbia,Johor,0,0,0
1/07/2021,Serbia,Kedah,0,0,0
1/07/2021,Serbia,Kelantan,0,0,0
1/07/2021,Serbia,Pahang,0,0,0
1/07/2021,Serbia,Perak,0,0,0
1/07/2021,Serbia,Perlis,0,0,0
1/07/2021,Serbia,Pulau Pinang,0,0,0
1/07/2021,Serbia,Sabah,0,0,0
1/07/2021,Serbia,Sarawak,0,0,0
1/07/2021,Serbia,Selangor,1,0,1
1/07/2021,South Sudan,Johor,0,0,0
1/07/2021,South Sudan,Kedah,0,0,0
1/07/2021,South Sudan,Sarawak,0,0,0
1/07/2021,South Sudan,Selangor,2,2,0
1/07/2021,South Sudan,W.P. Labuan,0,0,0
1/07/2021,Sao Tome and Principe,Selangor,0,0,0
1/07/2021,Suriname,Johor,0,0,0
1/07/2021,Suriname,Kedah,0,0,0
1/07/2021,Suriname,Kelantan,0,0,0
1/07/2021,Suriname,Perak,0,0,0
1/07/2021,Suriname,Perlis,0,0,0
1/07/2021,Suriname,Pulau Pinang,0,0,0
1/07/2021,Suriname,Sabah,0,0,0
1/07/2021,Suriname,Sarawak,0,0,0
1/07/2021,Suriname,Selangor,0,0,0
1/07/2021,Slovakia,Johor,0,0,0
1/07/2021,Slovakia,Kedah,0,0,0
1/07/2021,Slovakia,Kelantan,0,0,0
1/07/2021,Slovakia,Negeri Sembilan,0,0,0
1/07/2021,Slovakia,Pahang,0,0,0
1/07/2021,Slovakia,Perak,0,0,0
1/07/2021,Slovakia,Perlis,0,0,0
1/07/2021,Slovakia,Pulau Pinang,0,0,0
1/07/2021,Slovakia,Sabah,0,0,0
1/07/2021,Slovakia,Sarawak,0,0,0
1/07/2021,Slovakia,Selangor,2,2,0
1/07/2021,Slovakia,W.P. Labuan,0,0,0
1/07/2021,Slovenia,Johor,0,0,0
1/07/2021,Slovenia,Kedah,0,0,0
1/07/2021,Slovenia,Kelantan,0,0,0
1/07/2021,Slovenia,Perak,0,0,0
1/07/2021,Slovenia,Perlis,0,0,0
1/07/2021,Slovenia,Pulau Pinang,0,0,0
1/07/2021,Slovenia,Sabah,0,0,0
1/07/2021,Slovenia,Sarawak,0,0,0
1/07/2021,Slovenia,Selangor,0,0,0
1/07/2021,Slovenia,W.P. Labuan,0,0,0
1/07/2021,Sweden,Johor,0,0,0
1/07/2021,Sweden,Kedah,0,0,0
1/07/2021,Sweden,Kelantan,0,0,0
1/07/2021,Sweden,Melaka,0,0,0
1/07/2021,Sweden,Negeri Sembilan,0,0,0
1/07/2021,Sweden,Pahang,0,0,0
1/07/2021,Sweden,Perak,0,0,0
1/07/2021,Sweden,Perlis,0,0,0
1/07/2021,Sweden,Pulau Pinang,0,0,0
1/07/2021,Sweden,Sabah,0,0,0
1/07/2021,Sweden,Sarawak,0,0,0
1/07/2021,Sweden,Selangor,27,24,3
1/07/2021,Sweden,W.P. Labuan,0,0,0
1/07/2021,Eswatini,Johor,0,0,0
1/07/2021,Eswatini,Kedah,0,0,0
1/07/2021,Eswatini,Pulau Pinang,0,0,0
1/07/2021,Eswatini,Sabah,0,0,0
1/07/2021,Eswatini,Selangor,1,1,0
1/07/2021,Seychelles,Johor,1,1,0
1/07/2021,Seychelles,Kedah,0,0,0
1/07/2021,Seychelles,Pulau Pinang,0,0,0
1/07/2021,Seychelles,Sabah,0,0,0
1/07/2021,Seychelles,Sarawak,0,0,0
1/07/2021,Seychelles,Selangor,2,1,1
1/07/2021,Syrian Arab Republic,Johor,0,0,0
1/07/2021,Syrian Arab Republic,Kedah,0,0,0
1/07/2021,Syrian Arab Republic,Kelantan,0,0,0
1/07/2021,Syrian Arab Republic,Pahang,0,0,0
1/07/2021,Syrian Arab Republic,Perlis,0,0,0
1/07/2021,Syrian Arab Republic,Pulau Pinang,0,0,0
1/07/2021,Syrian Arab Republic,Sabah,0,0,0
1/07/2021,Syrian Arab Republic,Sarawak,0,0,0
1/07/2021,Syrian Arab Republic,Selangor,20,12,8
1/07/2021,Syrian Arab Republic,W.P. Labuan,0,0,0
1/07/2021,Turks and Caicos Islands,Perlis,0,0,0
1/07/2021,TCD,Johor,0,0,0
1/07/2021,TCD,Kedah,0,0,0
1/07/2021,TCD,Perlis,0,0,0
1/07/2021,TCD,Selangor,0,0,0
1/07/2021,Togo,Johor,0,0,0
1/07/2021,Togo,Perak,0,0,0
1/07/2021,Togo,Pulau Pinang,0,0,0
1/07/2021,Togo,Selangor,1,1,0
1/07/2021,Thailand,Johor,9,9,0
1/07/2021,Thailand,Kedah,17464,17428,36
1/07/2021,Thailand,Kelantan,3,1,2
1/07/2021,Thailand,Melaka,0,0,0
1/07/2021,Thailand,Negeri Sembilan,0,0,0
1/07/2021,Thailand,Pahang,0,0,0
1/07/2021,Thailand,Perak,0,0,0
1/07/2021,Thailand,Perlis,6956,6874,82
1/07/2021,Thailand,Pulau Pinang,33,28,5
1/07/2021,Thailand,Sabah,0,0,0
1/07/2021,Thailand,Sarawak,9,9,0
1/07/2021,Thailand,Selangor,154,83,71
1/07/2021,Thailand,Terengganu,0,0,0
1/07/2021,Thailand,W.P. Labuan,0,0,0
1/07/2021,Tajikistan,Johor,0,0,0
1/07/2021,Tajikistan,Kedah,0,0,0
1/07/2021,Tajikistan,Perlis,0,0,0
1/07/2021,Tajikistan,Pulau Pinang,0,0,0
1/07/2021,Tajikistan,Sabah,0,0,0
1/07/2021,Tajikistan,Selangor,9,5,4
1/07/2021,Tokelau,Selangor,0,0,0
1/07/2021,Turkmenistan,Johor,0,0,0
1/07/2021,Turkmenistan,Kedah,0,0,0
1/07/2021,Turkmenistan,Kelantan,0,0,0
1/07/2021,Turkmenistan,Perlis,0,0,0
1/07/2021,Turkmenistan,Pulau Pinang,0,0,0
1/07/2021,Turkmenistan,Sabah,0,0,0
1/07/2021,Turkmenistan,Sarawak,0,0,0
1/07/2021,Turkmenistan,Selangor,1,1,0
1/07/2021,Timor-Leste,Johor,0,0,0
1/07/2021,Timor-Leste,Kedah,0,0,0
1/07/2021,Timor-Leste,Perlis,0,0,0
1/07/2021,Timor-Leste,Pulau Pinang,0,0,0
1/07/2021,Timor-Leste,Sabah,0,0,0
1/07/2021,Timor-Leste,Sarawak,0,0,0
1/07/2021,Timor-Leste,Selangor,4,3,1
1/07/2021,Tonga,Johor,0,0,0
1/07/2021,Tonga,Pulau Pinang,0,0,0
1/07/2021,Tonga,Sarawak,0,0,0
1/07/2021,Tonga,Selangor,0,0,0
1/07/2021,Trinidad and Tobago,Johor,0,0,0
1/07/2021,Trinidad and Tobago,Kedah,0,0,0
1/07/2021,Trinidad and Tobago,Pahang,0,0,0
1/07/2021,Trinidad and Tobago,Pulau Pinang,0,0,0
1/07/2021,Trinidad and Tobago,Sabah,0,0,0
1/07/2021,Trinidad and Tobago,Sarawak,0,0,0
1/07/2021,Trinidad and Tobago,Selangor,2,0,2
1/07/2021,Tunisia,Johor,0,0,0
1/07/2021,Tunisia,Kedah,0,0,0
1/07/2021,Tunisia,Kelantan,0,0,0
1/07/2021,Tunisia,Melaka,0,0,0
1/07/2021,Tunisia,Perak,0,0,0
1/07/2021,Tunisia,Perlis,0,0,0
1/07/2021,Tunisia,Pulau Pinang,0,0,0
1/07/2021,Tunisia,Sabah,0,0,0
1/07/2021,Tunisia,Sarawak,0,0,0
1/07/2021,Tunisia,Selangor,1,1,0
1/07/2021,Tunisia,W.P. Labuan,0,0,0
1/07/2021,Türkiye,Johor,0,0,0
1/07/2021,Türkiye,Kedah,0,0,0
1/07/2021,Türkiye,Kelantan,0,0,0
1/07/2021,Türkiye,Melaka,0,0,0
1/07/2021,Türkiye,Negeri Sembilan,0,0,0
1/07/2021,Türkiye,Pahang,0,0,0
1/07/2021,Türkiye,Perak,0,0,0
1/07/2021,Türkiye,Perlis,0,0,0
1/07/2021,Türkiye,Pulau Pinang,0,0,0
1/07/2021,Türkiye,Sabah,0,0,0
1/07/2021,Türkiye,Sarawak,0,0,0
1/07/2021,Türkiye,Selangor,34,23,11
1/07/2021,Türkiye,W.P. Labuan,0,0,0
1/07/2021,Tuvalu,Selangor,0,0,0
1/07/2021,"Taiwan, Province of China",Johor,0,0,0
1/07/2021,"Taiwan, Province of China",Kedah,0,0,0
1/07/2021,"Taiwan, Province of China",Kelantan,0,0,0
1/07/2021,"Taiwan, Province of China",Melaka,0,0,0
1/07/2021,"Taiwan, Province of China",Negeri Sembilan,0,0,0
1/07/2021,"Taiwan, Province of China",Pahang,0,0,0
1/07/2021,"Taiwan, Province of China",Perak,0,0,0
1/07/2021,"Taiwan, Province of China",Perlis,0,0,0
1/07/2021,"Taiwan, Province of China",Pulau Pinang,15,10,5
1/07/2021,"Taiwan, Province of China",Sabah,0,0,0
1/07/2021,"Taiwan, Province of China",Sarawak,0,0,0
1/07/2021,"Taiwan, Province of China",Selangor,47,23,24
1/07/2021,"Taiwan, Province of China",W.P. Labuan,0,0,0
1/07/2021,"Tanzania, United Republic of",Johor,0,0,0
1/07/2021,"Tanzania, United Republic of",Kedah,0,0,0
1/07/2021,"Tanzania, United Republic of",Perak,0,0,0
1/07/2021,"Tanzania, United Republic of",Perlis,0,0,0
1/07/2021,"Tanzania, United Republic of",Pulau Pinang,0,0,0
1/07/2021,"Tanzania, United Republic of",Sabah,0,0,0
1/07/2021,"Tanzania, United Republic of",Sarawak,0,0,0
1/07/2021,"Tanzania, United Republic of",Selangor,7,4,3
1/07/2021,Uganda,Johor,0,0,0
1/07/2021,Uganda,Kedah,0,0,0
1/07/2021,Uganda,Perak,0,0,0
1/07/2021,Uganda,Perlis,0,0,0
1/07/2021,Uganda,Pulau Pinang,0,0,0
1/07/2021,Uganda,Sabah,0,0,0
1/07/2021,Uganda,Sarawak,0,0,0
1/07/2021,Uganda,Selangor,1,1,0
1/07/2021,Ukraine,Johor,2,2,0
1/07/2021,Ukraine,Kedah,0,0,0
1/07/2021,Ukraine,Kelantan,0,0,0
1/07/2021,Ukraine,Melaka,0,0,0
1/07/2021,Ukraine,Negeri Sembilan,0,0,0
1/07/2021,Ukraine,Pahang,0,0,0
1/07/2021,Ukraine,Perak,0,0,0
1/07/2021,Ukraine,Perlis,0,0,0
1/07/2021,Ukraine,Pulau Pinang,0,0,0
1/07/2021,Ukraine,Sabah,0,0,0
1/07/2021,Ukraine,Sarawak,0,0,0
1/07/2021,Ukraine,Selangor,30,27,3
1/07/2021,Ukraine,W.P. Labuan,0,0,0
1/07/2021,Uruguay,Johor,0,0,0
1/07/2021,Uruguay,Kedah,0,0,0
1/07/2021,Uruguay,Kelantan,0,0,0
1/07/2021,Uruguay,Perak,0,0,0
1/07/2021,Uruguay,Perlis,0,0,0
1/07/2021,Uruguay,Pulau Pinang,0,0,0
1/07/2021,Uruguay,Sabah,0,0,0
1/07/2021,Uruguay,Sarawak,0,0,0
1/07/2021,Uruguay,Selangor,0,0,0
1/07/2021,Uruguay,W.P. Labuan,0,0,0
1/07/2021,United States of America,Johor,1,1,0
1/07/2021,United States of America,Kedah,0,0,0
1/07/2021,United States of America,Kelantan,0,0,0
1/07/2021,United States of America,Melaka,0,0,0
1/07/2021,United States of America,Negeri Sembilan,0,0,0
1/07/2021,United States of America,Pahang,0,0,0
1/07/2021,United States of America,Perak,1,0,1
1/07/2021,United States of America,Perlis,0,0,0
1/07/2021,United States of America,Pulau Pinang,14,8,6
1/07/2021,United States of America,Sabah,0,0,0
1/07/2021,United States of America,Sarawak,1,1,0
1/07/2021,United States of America,Selangor,444,224,220
1/07/2021,United States of America,Terengganu,0,0,0
1/07/2021,United States of America,W.P. Labuan,0,0,0
1/07/2021,Uzbekistan,Johor,0,0,0
1/07/2021,Uzbekistan,Kedah,0,0,0
1/07/2021,Uzbekistan,Kelantan,0,0,0
1/07/2021,Uzbekistan,Perak,0,0,0
1/07/2021,Uzbekistan,Perlis,0,0,0
1/07/2021,Uzbekistan,Pulau Pinang,0,0,0
1/07/2021,Uzbekistan,Sabah,0,0,0
1/07/2021,Uzbekistan,Sarawak,0,0,0
1/07/2021,Uzbekistan,Selangor,4,3,1
1/07/2021,Holy See,Johor,0,0,0
1/07/2021,Holy See,Sarawak,0,0,0
1/07/2021,Holy See,Selangor,1,1,0
1/07/2021,Saint Vincent and the Grenadines,Johor,0,0,0
1/07/2021,Saint Vincent and the Grenadines,Kedah,0,0,0
1/07/2021,Saint Vincent and the Grenadines,Pulau Pinang,0,0,0
1/07/2021,Saint Vincent and the Grenadines,Sarawak,0,0,0
1/07/2021,Saint Vincent and the Grenadines,Selangor,0,0,0
1/07/2021,"Venezuela, Bolivarian Republic of",Johor,0,0,0
1/07/2021,"Venezuela, Bolivarian Republic of",Kedah,0,0,0
1/07/2021,"Venezuela, Bolivarian Republic of",Kelantan,0,0,0
1/07/2021,"Venezuela, Bolivarian Republic of",Melaka,0,0,0
1/07/2021,"Venezuela, Bolivarian Republic of",Perak,0,0,0
1/07/2021,"Venezuela, Bolivarian Republic of",Perlis,0,0,0
1/07/2021,"Venezuela, Bolivarian Republic of",Pulau Pinang,0,0,0
1/07/2021,"Venezuela, Bolivarian Republic of",Sabah,0,0,0
1/07/2021,"Venezuela, Bolivarian Republic of",Sarawak,0,0,0
1/07/2021,"Venezuela, Bolivarian Republic of",Selangor,4,4,0
1/07/2021,"Venezuela, Bolivarian Republic of",W.P. Labuan,0,0,0
1/07/2021,Viet Nam,Johor,2,0,2
1/07/2021,Viet Nam,Kedah,0,0,0
1/07/2021,Viet Nam,Kelantan,0,0,0
1/07/2021,Viet Nam,Melaka,0,0,0
1/07/2021,Viet Nam,Negeri Sembilan,0,0,0
1/07/2021,Viet Nam,Pahang,0,0,0
1/07/2021,Viet Nam,Perak,0,0,0
1/07/2021,Viet Nam,Perlis,0,0,0
1/07/2021,Viet Nam,Pulau Pinang,0,0,0
1/07/2021,Viet Nam,Sabah,0,0,0
1/07/2021,Viet Nam,Sarawak,1,0,1
1/07/2021,Viet Nam,Selangor,51,19,32
1/07/2021,Viet Nam,Terengganu,0,0,0
1/07/2021,Viet Nam,W.P. Labuan,0,0,0
1/07/2021,Vanuatu,Johor,0,0,0
1/07/2021,Vanuatu,Kedah,0,0,0
1/07/2021,Vanuatu,Pulau Pinang,0,0,0
1/07/2021,Vanuatu,Sabah,0,0,0
1/07/2021,Vanuatu,Sarawak,0,0,0
1/07/2021,Vanuatu,Selangor,0,0,0
1/07/2021, Samoa,Johor,0,0,0
1/07/2021, Samoa,Sarawak,0,0,0
1/07/2021, Samoa,Selangor,0,0,0
1/07/2021,Yemen,Johor,0,0,0
1/07/2021,Yemen,Kedah,0,0,0
1/07/2021,Yemen,Kelantan,0,0,0
1/07/2021,Yemen,Melaka,0,0,0
1/07/2021,Yemen,Pahang,0,0,0
1/07/2021,Yemen,Perak,0,0,0
1/07/2021,Yemen,Perlis,0,0,0
1/07/2021,Yemen,Pulau Pinang,0,0,0
1/07/2021,Yemen,Sabah,0,0,0
1/07/2021,Yemen,Sarawak,0,0,0
1/07/2021,Yemen,Selangor,19,14,5
1/07/2021,Yemen,W.P. Labuan,0,0,0
1/07/2021,South Africa,Johor,0,0,0
1/07/2021,South Africa,Kedah,0,0,0
1/07/2021,South Africa,Kelantan,0,0,0
1/07/2021,South Africa,Melaka,0,0,0
1/07/2021,South Africa,Pahang,0,0,0
1/07/2021,South Africa,Perak,0,0,0
1/07/2021,South Africa,Perlis,0,0,0
1/07/2021,South Africa,Pulau Pinang,0,0,0
1/07/2021,South Africa,Sabah,0,0,0
1/07/2021,South Africa,Sarawak,1,0,1
1/07/2021,South Africa,Selangor,23,14,9
1/07/2021,South Africa,Terengganu,0,0,0
1/07/2021,South Africa,W.P. Labuan,0,0,0
1/07/2021,ZAR,Selangor,0,0,0
1/07/2021,Zambia,Johor,0,0,0
1/07/2021,Zambia,Kedah,0,0,0
1/07/2021,Zambia,Perak,0,0,0
1/07/2021,Zambia,Perlis,0,0,0
1/07/2021,Zambia,Pulau Pinang,0,0,0
1/07/2021,Zambia,Sabah,0,0,0
1/07/2021,Zambia,Sarawak,0,0,0
1/07/2021,Zambia,Selangor,1,1,0
1/07/2021,Zimbabwe,Johor,0,0,0
1/07/2021,Zimbabwe,Kedah,0,0,0
1/07/2021,Zimbabwe,Kelantan,0,0,0
1/07/2021,Zimbabwe,Perak,0,0,0
1/07/2021,Zimbabwe,Perlis,0,0,0
1/07/2021,Zimbabwe,Pulau Pinang,0,0,0
1/07/2021,Zimbabwe,Sabah,0,0,0
1/07/2021,Zimbabwe,Sarawak,0,0,0
1/07/2021,Zimbabwe,Selangor,3,1,2
1/08/2021,Aruba,Kedah,0,0,0
1/08/2021,Aruba,Pulau Pinang,0,0,0
1/08/2021,Afghanistan,Johor,0,0,0
1/08/2021,Afghanistan,Kedah,0,0,0
1/08/2021,Afghanistan,Perlis,0,0,0
1/08/2021,Afghanistan,Pulau Pinang,0,0,0
1/08/2021,Afghanistan,Sarawak,0,0,0
1/08/2021,Afghanistan,Selangor,15,12,3
1/08/2021,Angola,Johor,0,0,0
1/08/2021,Angola,Kedah,0,0,0
1/08/2021,Angola,Sabah,0,0,0
1/08/2021,Angola,Selangor,4,3,1
1/08/2021,Anguilla,Selangor,0,0,0
1/08/2021,Albania,Johor,0,0,0
1/08/2021,Albania,Kedah,0,0,0
1/08/2021,Albania,Perak,0,0,0
1/08/2021,Albania,Perlis,0,0,0
1/08/2021,Albania,Pulau Pinang,0,0,0
1/08/2021,Albania,Sabah,0,0,0
1/08/2021,Albania,Sarawak,0,0,0
1/08/2021,Albania,Selangor,0,0,0
1/08/2021,Andorra,Johor,0,0,0
1/08/2021,Andorra,Kedah,0,0,0
1/08/2021,Andorra,Perlis,0,0,0
1/08/2021,Andorra,Pulau Pinang,0,0,0
1/08/2021,Andorra,Selangor,0,0,0
1/08/2021,Antigua and Barbuda,Selangor,0,0,0
1/08/2021,United Arab Emirates,Johor,0,0,0
1/08/2021,United Arab Emirates,Kedah,0,0,0
1/08/2021,United Arab Emirates,Kelantan,0,0,0
1/08/2021,United Arab Emirates,Perak,0,0,0
1/08/2021,United Arab Emirates,Perlis,0,0,0
1/08/2021,United Arab Emirates,Pulau Pinang,0,0,0
1/08/2021,United Arab Emirates,Sabah,0,0,0
1/08/2021,United Arab Emirates,Sarawak,0,0,0
1/08/2021,United Arab Emirates,Selangor,1,1,0
1/08/2021,Argentina,Johor,0,0,0
1/08/2021,Argentina,Kedah,0,0,0
1/08/2021,Argentina,Kelantan,0,0,0
1/08/2021,Argentina,Melaka,0,0,0
1/08/2021,Argentina,Perak,0,0,0
1/08/2021,Argentina,Perlis,0,0,0
1/08/2021,Argentina,Pulau Pinang,0,0,0
1/08/2021,Argentina,Sabah,0,0,0
1/08/2021,Argentina,Sarawak,0,0,0
1/08/2021,Argentina,Selangor,19,13,6
1/08/2021,Argentina,W.P. Labuan,0,0,0
1/08/2021,Armenia,Johor,0,0,0
1/08/2021,Armenia,Kedah,0,0,0
1/08/2021,Armenia,Kelantan,0,0,0
1/08/2021,Armenia,Perak,0,0,0
1/08/2021,Armenia,Perlis,0,0,0
1/08/2021,Armenia,Pulau Pinang,0,0,0
1/08/2021,Armenia,Sabah,0,0,0
1/08/2021,Armenia,Sarawak,0,0,0
1/08/2021,Armenia,Selangor,0,0,0
1/08/2021,Antarctica,Selangor,0,0,0
1/08/2021,Antigua and Barbuda,Johor,0,0,0
1/08/2021,Antigua and Barbuda,Kedah,0,0,0
1/08/2021,Antigua and Barbuda,Pulau Pinang,0,0,0
1/08/2021,Antigua and Barbuda,Sarawak,0,0,0
1/08/2021,Antigua and Barbuda,Selangor,0,0,0
1/08/2021,Australia,Johor,0,0,0
1/08/2021,Australia,Kedah,0,0,0
1/08/2021,Australia,Kelantan,0,0,0
1/08/2021,Australia,Melaka,0,0,0
1/08/2021,Australia,Negeri Sembilan,0,0,0
1/08/2021,Australia,Pahang,0,0,0
1/08/2021,Australia,Perak,0,0,0
1/08/2021,Australia,Perlis,0,0,0
1/08/2021,Australia,Pulau Pinang,10,5,5
1/08/2021,Australia,Sabah,0,0,0
1/08/2021,Australia,Sarawak,0,0,0
1/08/2021,Australia,Selangor,137,73,64
1/08/2021,Australia,Terengganu,0,0,0
1/08/2021,Australia,W.P. Labuan,0,0,0
1/08/2021,Austria,Johor,0,0,0
1/08/2021,Austria,Kedah,0,0,0
1/08/2021,Austria,Kelantan,0,0,0
1/08/2021,Austria,Melaka,0,0,0
1/08/2021,Austria,Negeri Sembilan,0,0,0
1/08/2021,Austria,Pahang,0,0,0
1/08/2021,Austria,Perak,0,0,0
1/08/2021,Austria,Perlis,0,0,0
1/08/2021,Austria,Pulau Pinang,0,0,0
1/08/2021,Austria,Sabah,0,0,0
1/08/2021,Austria,Sarawak,0,0,0
1/08/2021,Austria,Selangor,29,19,10
1/08/2021,Austria,Terengganu,0,0,0
1/08/2021,Austria,W.P. Labuan,0,0,0
1/08/2021,Azerbaijan,Johor,0,0,0
1/08/2021,Azerbaijan,Kedah,0,0,0
1/08/2021,Azerbaijan,Kelantan,0,0,0
1/08/2021,Azerbaijan,Melaka,0,0,0
1/08/2021,Azerbaijan,Perlis,0,0,0
1/08/2021,Azerbaijan,Pulau Pinang,0,0,0
1/08/2021,Azerbaijan,Sabah,0,0,0
1/08/2021,Azerbaijan,Sarawak,0,0,0
1/08/2021,Azerbaijan,Selangor,11,5,6
1/08/2021,Azerbaijan,W.P. Labuan,0,0,0
1/08/2021,Burundi,Pulau Pinang,0,0,0
1/08/2021,Burundi,Sarawak,0,0,0
1/08/2021,Burundi,Selangor,2,1,1
1/08/2021,Belgium,Johor,0,0,0
1/08/2021,Belgium,Kedah,0,0,0
1/08/2021,Belgium,Kelantan,0,0,0
1/08/2021,Belgium,Melaka,0,0,0
1/08/2021,Belgium,Negeri Sembilan,0,0,0
1/08/2021,Belgium,Pahang,0,0,0
1/08/2021,Belgium,Perak,0,0,0
1/08/2021,Belgium,Perlis,0,0,0
1/08/2021,Belgium,Pulau Pinang,0,0,0
1/08/2021,Belgium,Sabah,0,0,0
1/08/2021,Belgium,Sarawak,0,0,0
1/08/2021,Belgium,Selangor,20,12,8
1/08/2021,Belgium,W.P. Labuan,0,0,0
1/08/2021,Benin,Johor,0,0,0
1/08/2021,Benin,Kedah,0,0,0
1/08/2021,Benin,Perak,0,0,0
1/08/2021,Benin,Pulau Pinang,0,0,0
1/08/2021,Benin,Sabah,0,0,0
1/08/2021,Benin,Sarawak,0,0,0
1/08/2021,Benin,Selangor,0,0,0
1/08/2021,Burkina Faso,Perak,0,0,0
1/08/2021,Burkina Faso,Pulau Pinang,0,0,0
1/08/2021,Burkina Faso,Selangor,0,0,0
1/08/2021,Bangladesh,Johor,0,0,0
1/08/2021,Bangladesh,Kedah,0,0,0
1/08/2021,Bangladesh,Kelantan,0,0,0
1/08/2021,Bangladesh,Melaka,0,0,0
1/08/2021,Bangladesh,Negeri Sembilan,0,0,0
1/08/2021,Bangladesh,Pahang,0,0,0
1/08/2021,Bangladesh,Perak,0,0,0
1/08/2021,Bangladesh,Perlis,0,0,0
1/08/2021,Bangladesh,Pulau Pinang,0,0,0
1/08/2021,Bangladesh,Sabah,0,0,0
1/08/2021,Bangladesh,Sarawak,0,0,0
1/08/2021,Bangladesh,Selangor,16,10,6
1/08/2021,Bangladesh,W.P. Labuan,0,0,0
1/08/2021,Bulgaria,Johor,0,0,0
1/08/2021,Bulgaria,Kedah,0,0,0
1/08/2021,Bulgaria,Kelantan,0,0,0
1/08/2021,Bulgaria,Pahang,0,0,0
1/08/2021,Bulgaria,Perak,0,0,0
1/08/2021,Bulgaria,Perlis,0,0,0
1/08/2021,Bulgaria,Pulau Pinang,0,0,0
1/08/2021,Bulgaria,Sabah,0,0,0
1/08/2021,Bulgaria,Sarawak,0,0,0
1/08/2021,Bulgaria,Selangor,14,13,1
1/08/2021,Bulgaria,W.P. Labuan,0,0,0
1/08/2021,Bahrain,Johor,0,0,0
1/08/2021,Bahrain,Kedah,0,0,0
1/08/2021,Bahrain,Kelantan,0,0,0
1/08/2021,Bahrain,Perlis,0,0,0
1/08/2021,Bahrain,Pulau Pinang,0,0,0
1/08/2021,Bahrain,Sabah,0,0,0
1/08/2021,Bahrain,Sarawak,0,0,0
1/08/2021,Bahrain,Selangor,0,0,0
1/08/2021,Bahamas,Johor,0,0,0
1/08/2021,Bahamas,Kedah,0,0,0
1/08/2021,Bahamas,Perak,0,0,0
1/08/2021,Bahamas,Sabah,0,0,0
1/08/2021,Bahamas,Sarawak,0,0,0
1/08/2021,Bahamas,Selangor,0,0,0
1/08/2021,Bosnia and Herzegovina,Johor,0,0,0
1/08/2021,Bosnia and Herzegovina,Kedah,0,0,0
1/08/2021,Bosnia and Herzegovina,Perlis,0,0,0
1/08/2021,Bosnia and Herzegovina,Pulau Pinang,0,0,0
1/08/2021,Bosnia and Herzegovina,Sabah,0,0,0
1/08/2021,Bosnia and Herzegovina,Sarawak,0,0,0
1/08/2021,Bosnia and Herzegovina,Selangor,12,6,6
1/08/2021,Belarus,Johor,0,0,0
1/08/2021,Belarus,Kedah,0,0,0
1/08/2021,Belarus,Kelantan,0,0,0
1/08/2021,Belarus,Pahang,0,0,0
1/08/2021,Belarus,Perak,0,0,0
1/08/2021,Belarus,Perlis,0,0,0
1/08/2021,Belarus,Pulau Pinang,0,0,0
1/08/2021,Belarus,Sabah,0,0,0
1/08/2021,Belarus,Sarawak,0,0,0
1/08/2021,Belarus,Selangor,0,0,0
1/08/2021,Belarus,W.P. Labuan,0,0,0
1/08/2021,Belize,Johor,0,0,0
1/08/2021,Belize,Pulau Pinang,0,0,0
1/08/2021,Belize,Sarawak,0,0,0
1/08/2021,Belize,Selangor,4,1,3
1/08/2021,Bermuda,Selangor,0,0,0
1/08/2021,Bolivia,Johor,0,0,0
1/08/2021,Bolivia,Kedah,0,0,0
1/08/2021,Bolivia,Melaka,0,0,0
1/08/2021,Bolivia,Perak,0,0,0
1/08/2021,Bolivia,Perlis,0,0,0
1/08/2021,Bolivia,Pulau Pinang,0,0,0
1/08/2021,Bolivia,Sabah,0,0,0
1/08/2021,Bolivia,Sarawak,0,0,0
1/08/2021,Bolivia,Selangor,0,0,0
1/08/2021,Brazil,Johor,0,0,0
1/08/2021,Brazil,Kedah,0,0,0
1/08/2021,Brazil,Kelantan,0,0,0
1/08/2021,Brazil,Melaka,0,0,0
1/08/2021,Brazil,Pahang,0,0,0
1/08/2021,Brazil,Perak,0,0,0
1/08/2021,Brazil,Perlis,0,0,0
1/08/2021,Brazil,Pulau Pinang,0,0,0
1/08/2021,Brazil,Sabah,2,2,0
1/08/2021,Brazil,Sarawak,0,0,0
1/08/2021,Brazil,Selangor,18,11,7
1/08/2021,Brazil,W.P. Labuan,0,0,0
1/08/2021,Barbados,Johor,0,0,0
1/08/2021,Barbados,Kedah,0,0,0
1/08/2021,Barbados,Perlis,0,0,0
1/08/2021,Barbados,Pulau Pinang,0,0,0
1/08/2021,Barbados,Selangor,1,0,1
1/08/2021,Brunei Darussalam,Johor,0,0,0
1/08/2021,Brunei Darussalam,Kedah,0,0,0
1/08/2021,Brunei Darussalam,Kelantan,0,0,0
1/08/2021,Brunei Darussalam,Melaka,0,0,0
1/08/2021,Brunei Darussalam,Pahang,0,0,0
1/08/2021,Brunei Darussalam,Perak,0,0,0
1/08/2021,Brunei Darussalam,Perlis,0,0,0
1/08/2021,Brunei Darussalam,Pulau Pinang,0,0,0
1/08/2021,Brunei Darussalam,Sabah,0,0,0
1/08/2021,Brunei Darussalam,Sarawak,297,294,3
1/08/2021,Brunei Darussalam,Selangor,12,3,9
1/08/2021,Brunei Darussalam,W.P. Labuan,0,0,0
1/08/2021,Bhutan,Johor,0,0,0
1/08/2021,Bhutan,Kedah,0,0,0
1/08/2021,Bhutan,Perak,0,0,0
1/08/2021,Bhutan,Perlis,0,0,0
1/08/2021,Bhutan,Pulau Pinang,0,0,0
1/08/2021,Bhutan,Sabah,0,0,0
1/08/2021,Bhutan,Sarawak,0,0,0
1/08/2021,Bhutan,Selangor,1,1,0
1/08/2021,Botswana,Johor,0,0,0
1/08/2021,Botswana,Kedah,0,0,0
1/08/2021,Botswana,Perlis,0,0,0
1/08/2021,Botswana,Pulau Pinang,0,0,0
1/08/2021,Botswana,Sabah,0,0,0
1/08/2021,Botswana,Sarawak,0,0,0
1/08/2021,Botswana,Selangor,2,2,0
1/08/2021,Central African Republic,Kedah,0,0,0
1/08/2021,Central African Republic,Selangor,0,0,0
1/08/2021,Canada,Johor,0,0,0
1/08/2021,Canada,Kedah,0,0,0
1/08/2021,Canada,Kelantan,0,0,0
1/08/2021,Canada,Melaka,0,0,0
1/08/2021,Canada,Negeri Sembilan,0,0,0
1/08/2021,Canada,Pahang,0,0,0
1/08/2021,Canada,Perak,0,0,0
1/08/2021,Canada,Perlis,0,0,0
1/08/2021,Canada,Pulau Pinang,1,0,1
1/08/2021,Canada,Sabah,0,0,0
1/08/2021,Canada,Sarawak,0,0,0
1/08/2021,Canada,Selangor,79,42,37
1/08/2021,Canada,Terengganu,0,0,0
1/08/2021,Canada,W.P. Labuan,0,0,0
1/08/2021,Cocos (Keeling) Islands,Selangor,0,0,0
1/08/2021,Switzerland,Johor,0,0,0
1/08/2021,Switzerland,Kedah,0,0,0
1/08/2021,Switzerland,Kelantan,0,0,0
1/08/2021,Switzerland,Melaka,0,0,0
1/08/2021,Switzerland,Negeri Sembilan,0,0,0
1/08/2021,Switzerland,Pahang,0,0,0
1/08/2021,Switzerland,Perak,0,0,0
1/08/2021,Switzerland,Perlis,0,0,0
1/08/2021,Switzerland,Pulau Pinang,0,0,0
1/08/2021,Switzerland,Sabah,0,0,0
1/08/2021,Switzerland,Sarawak,0,0,0
1/08/2021,Switzerland,Selangor,19,16,3
1/08/2021,Switzerland,W.P. Labuan,0,0,0
1/08/2021,Chile,Johor,0,0,0
1/08/2021,Chile,Kedah,0,0,0
1/08/2021,Chile,Kelantan,0,0,0
1/08/2021,Chile,Melaka,0,0,0
1/08/2021,Chile,Pahang,0,0,0
1/08/2021,Chile,Perak,0,0,0
1/08/2021,Chile,Perlis,0,0,0
1/08/2021,Chile,Pulau Pinang,0,0,0
1/08/2021,Chile,Sabah,0,0,0
1/08/2021,Chile,Sarawak,0,0,0
1/08/2021,Chile,Selangor,4,2,2
1/08/2021,China,Johor,1,1,0
1/08/2021,China,Kedah,0,0,0
1/08/2021,China,Kelantan,0,0,0
1/08/2021,China,Melaka,0,0,0
1/08/2021,China,Pahang,0,0,0
1/08/2021,China,Perak,0,0,0
1/08/2021,China,Perlis,0,0,0
1/08/2021,China,Pulau Pinang,1,1,0
1/08/2021,China,Sabah,0,0,0
1/08/2021,China,Sarawak,99,94,5
1/08/2021,China,Selangor,705,594,111
1/08/2021,China,Terengganu,0,0,0
1/08/2021,China,W.P. Labuan,0,0,0
1/08/2021,Côte d'Ivoire,Johor,0,0,0
1/08/2021,Côte d'Ivoire,Kedah,0,0,0
1/08/2021,Côte d'Ivoire,Pulau Pinang,0,0,0
1/08/2021,Côte d'Ivoire,Sabah,0,0,0
1/08/2021,Côte d'Ivoire,Sarawak,0,0,0
1/08/2021,Côte d'Ivoire,Selangor,0,0,0
1/08/2021,Cameroon,Johor,0,0,0
1/08/2021,Cameroon,Kedah,0,0,0
1/08/2021,Cameroon,Pulau Pinang,0,0,0
1/08/2021,Cameroon,Sabah,0,0,0
1/08/2021,Cameroon,Sarawak,0,0,0
1/08/2021,Cameroon,Selangor,3,2,1
1/08/2021,Congo,Johor,0,0,0
1/08/2021,Congo,Pulau Pinang,0,0,0
1/08/2021,Congo,Sarawak,0,0,0
1/08/2021,Congo,Selangor,1,1,0
1/08/2021,Congo,Johor,0,0,0
1/08/2021,Congo,Kedah,0,0,0
1/08/2021,Congo,Selangor,0,0,0
1/08/2021,Cook Islands,Selangor,0,0,0
1/08/2021,Colombia,Johor,0,0,0
1/08/2021,Colombia,Kedah,0,0,0
1/08/2021,Colombia,Perak,0,0,0
1/08/2021,Colombia,Pulau Pinang,0,0,0
1/08/2021,Colombia,Sabah,0,0,0
1/08/2021,Colombia,Sarawak,0,0,0
1/08/2021,Colombia,Selangor,7,4,3
1/08/2021,Colombia,W.P. Labuan,0,0,0
1/08/2021,Comoros,Johor,0,0,0
1/08/2021,Comoros,Kedah,0,0,0
1/08/2021,Comoros,Selangor,0,0,0
1/08/2021,Cabo Verde,Johor,0,0,0
1/08/2021,Cabo Verde,Kedah,0,0,0
1/08/2021,Cabo Verde,Pulau Pinang,0,0,0
1/08/2021,Cabo Verde,Sabah,0,0,0
1/08/2021,Cabo Verde,Selangor,0,0,0
1/08/2021,Costa Rica,Johor,0,0,0
1/08/2021,Costa Rica,Kedah,0,0,0
1/08/2021,Costa Rica,Perak,0,0,0
1/08/2021,Costa Rica,Perlis,0,0,0
1/08/2021,Costa Rica,Pulau Pinang,0,0,0
1/08/2021,Costa Rica,Sabah,0,0,0
1/08/2021,Costa Rica,Sarawak,0,0,0
1/08/2021,Costa Rica,Selangor,0,0,0
1/08/2021,Cuba,Johor,0,0,0
1/08/2021,Cuba,Kedah,0,0,0
1/08/2021,Cuba,Perlis,0,0,0
1/08/2021,Cuba,Pulau Pinang,0,0,0
1/08/2021,Cuba,Sabah,0,0,0
1/08/2021,Cuba,Sarawak,0,0,0
1/08/2021,Cuba,Selangor,0,0,0
1/08/2021,Cyprus,Johor,0,0,0
1/08/2021,Cyprus,Kedah,0,0,0
1/08/2021,Cyprus,Perak,0,0,0
1/08/2021,Cyprus,Perlis,0,0,0
1/08/2021,Cyprus,Pulau Pinang,0,0,0
1/08/2021,Cyprus,Sabah,0,0,0
1/08/2021,Cyprus,Sarawak,0,0,0
1/08/2021,Cyprus,Selangor,0,0,0
1/08/2021,Czechia,Johor,0,0,0
1/08/2021,Czechia,Kedah,0,0,0
1/08/2021,Czechia,Kelantan,0,0,0
1/08/2021,Czechia,Melaka,0,0,0
1/08/2021,Czechia,Negeri Sembilan,0,0,0
1/08/2021,Czechia,Perak,0,0,0
1/08/2021,Czechia,Perlis,0,0,0
1/08/2021,Czechia,Pulau Pinang,0,0,0
1/08/2021,Czechia,Sabah,0,0,0
1/08/2021,Czechia,Sarawak,0,0,0
1/08/2021,Czechia,Selangor,8,4,4
1/08/2021,Czechia,W.P. Labuan,0,0,0
1/08/2021,Germany,Johor,0,0,0
1/08/2021,Germany,Kedah,0,0,0
1/08/2021,Germany,Kelantan,0,0,0
1/08/2021,Germany,Melaka,0,0,0
1/08/2021,Germany,Negeri Sembilan,0,0,0
1/08/2021,Germany,Pahang,0,0,0
1/08/2021,Germany,Perak,0,0,0
1/08/2021,Germany,Perlis,0,0,0
1/08/2021,Germany,Pulau Pinang,6,3,3
1/08/2021,Germany,Sabah,0,0,0
1/08/2021,Germany,Sarawak,3,3,0
1/08/2021,Germany,Selangor,109,71,38
1/08/2021,Germany,Terengganu,0,0,0
1/08/2021,Germany,W.P. Labuan,0,0,0
1/08/2021,Djibouti,Johor,0,0,0
1/08/2021,Djibouti,Selangor,2,0,2
1/08/2021,Dominica,Johor,0,0,0
1/08/2021,Dominica,Kedah,0,0,0
1/08/2021,Dominica,Pulau Pinang,0,0,0
1/08/2021,Dominica,Sabah,0,0,0
1/08/2021,Dominica,Sarawak,0,0,0
1/08/2021,Dominica,Selangor,4,3,1
1/08/2021,Dominica,W.P. Labuan,0,0,0
1/08/2021,Denmark,Johor,0,0,0
1/08/2021,Denmark,Kedah,0,0,0
1/08/2021,Denmark,Kelantan,0,0,0
1/08/2021,Denmark,Melaka,0,0,0
1/08/2021,Denmark,Negeri Sembilan,0,0,0
1/08/2021,Denmark,Pahang,0,0,0
1/08/2021,Denmark,Perak,0,0,0
1/08/2021,Denmark,Perlis,0,0,0
1/08/2021,Denmark,Pulau Pinang,0,0,0
1/08/2021,Denmark,Sabah,0,0,0
1/08/2021,Denmark,Sarawak,0,0,0
1/08/2021,Denmark,Selangor,35,25,10
1/08/2021,Denmark,W.P. Labuan,0,0,0
1/08/2021,Dominican Republic,Johor,0,0,0
1/08/2021,Dominican Republic,Kedah,0,0,0
1/08/2021,Dominican Republic,Perak,0,0,0
1/08/2021,Dominican Republic,Perlis,0,0,0
1/08/2021,Dominican Republic,Pulau Pinang,0,0,0
1/08/2021,Dominican Republic,Sabah,0,0,0
1/08/2021,Dominican Republic,Sarawak,0,0,0
1/08/2021,Dominican Republic,Selangor,0,0,0
1/08/2021,Algeria,Johor,0,0,0
1/08/2021,Algeria,Kedah,0,0,0
1/08/2021,Algeria,Kelantan,0,0,0
1/08/2021,Algeria,Melaka,0,0,0
1/08/2021,Algeria,Perak,0,0,0
1/08/2021,Algeria,Perlis,0,0,0
1/08/2021,Algeria,Pulau Pinang,0,0,0
1/08/2021,Algeria,Sabah,0,0,0
1/08/2021,Algeria,Sarawak,0,0,0
1/08/2021,Algeria,Selangor,12,5,7
1/08/2021,Algeria,W.P. Labuan,0,0,0
1/08/2021,Ecuador,Johor,0,0,0
1/08/2021,Ecuador,Kedah,0,0,0
1/08/2021,Ecuador,Perak,0,0,0
1/08/2021,Ecuador,Perlis,0,0,0
1/08/2021,Ecuador,Pulau Pinang,0,0,0
1/08/2021,Ecuador,Sabah,0,0,0
1/08/2021,Ecuador,Sarawak,0,0,0
1/08/2021,Ecuador,Selangor,1,0,1
1/08/2021,Egypt,Johor,0,0,0
1/08/2021,Egypt,Kedah,0,0,0
1/08/2021,Egypt,Kelantan,0,0,0
1/08/2021,Egypt,Melaka,0,0,0
1/08/2021,Egypt,Pahang,0,0,0
1/08/2021,Egypt,Perak,0,0,0
1/08/2021,Egypt,Perlis,0,0,0
1/08/2021,Egypt,Pulau Pinang,0,0,0
1/08/2021,Egypt,Sabah,0,0,0
1/08/2021,Egypt,Sarawak,0,0,0
1/08/2021,Egypt,Selangor,81,61,20
1/08/2021,Egypt,Terengganu,0,0,0
1/08/2021,Egypt,W.P. Labuan,0,0,0
1/08/2021,Eritrea,Johor,0,0,0
1/08/2021,Eritrea,Pulau Pinang,0,0,0
1/08/2021,Eritrea,Sabah,0,0,0
1/08/2021,Eritrea,Selangor,0,0,0
1/08/2021,Spain,Johor,0,0,0
1/08/2021,Spain,Kedah,0,0,0
1/08/2021,Spain,Kelantan,0,0,0
1/08/2021,Spain,Melaka,0,0,0
1/08/2021,Spain,Negeri Sembilan,0,0,0
1/08/2021,Spain,Pahang,0,0,0
1/08/2021,Spain,Perak,0,0,0
1/08/2021,Spain,Perlis,0,0,0
1/08/2021,Spain,Pulau Pinang,0,0,0
1/08/2021,Spain,Sabah,0,0,0
1/08/2021,Spain,Sarawak,0,0,0
1/08/2021,Spain,Selangor,75,45,30
1/08/2021,Spain,W.P. Labuan,0,0,0
1/08/2021,Estonia,Johor,0,0,0
1/08/2021,Estonia,Kedah,0,0,0
1/08/2021,Estonia,Kelantan,0,0,0
1/08/2021,Estonia,Pahang,0,0,0
1/08/2021,Estonia,Perak,0,0,0
1/08/2021,Estonia,Perlis,0,0,0
1/08/2021,Estonia,Pulau Pinang,0,0,0
1/08/2021,Estonia,Sabah,0,0,0
1/08/2021,Estonia,Sarawak,0,0,0
1/08/2021,Estonia,Selangor,0,0,0
1/08/2021,Estonia,W.P. Labuan,0,0,0
1/08/2021,Ethiopia,Johor,0,0,0
1/08/2021,Ethiopia,Kedah,0,0,0
1/08/2021,Ethiopia,Pulau Pinang,0,0,0
1/08/2021,Ethiopia,Sarawak,0,0,0
1/08/2021,Ethiopia,Selangor,1,1,0
1/08/2021,Finland,Johor,0,0,0
1/08/2021,Finland,Kedah,0,0,0
1/08/2021,Finland,Kelantan,0,0,0
1/08/2021,Finland,Melaka,0,0,0
1/08/2021,Finland,Negeri Sembilan,0,0,0
1/08/2021,Finland,Pahang,0,0,0
1/08/2021,Finland,Perak,0,0,0
1/08/2021,Finland,Perlis,0,0,0
1/08/2021,Finland,Pulau Pinang,0,0,0
1/08/2021,Finland,Sabah,0,0,0
1/08/2021,Finland,Sarawak,0,0,0
1/08/2021,Finland,Selangor,16,12,4
1/08/2021,Finland,W.P. Labuan,0,0,0
1/08/2021,Fiji,Johor,0,0,0
1/08/2021,Fiji,Kedah,0,0,0
1/08/2021,Fiji,Kelantan,0,0,0
1/08/2021,Fiji,Perak,0,0,0
1/08/2021,Fiji,Perlis,0,0,0
1/08/2021,Fiji,Pulau Pinang,0,0,0
1/08/2021,Fiji,Sabah,0,0,0
1/08/2021,Fiji,Sarawak,0,0,0
1/08/2021,Fiji,Selangor,0,0,0
1/08/2021,France,Johor,0,0,0
1/08/2021,France,Kedah,0,0,0
1/08/2021,France,Kelantan,0,0,0
1/08/2021,France,Melaka,0,0,0
1/08/2021,France,Negeri Sembilan,0,0,0
1/08/2021,France,Pahang,0,0,0
1/08/2021,France,Perak,0,0,0
1/08/2021,France,Perlis,0,0,0
1/08/2021,France,Pulau Pinang,5,4,1
1/08/2021,France,Sabah,0,0,0
1/08/2021,France,Sarawak,1,1,0
1/08/2021,France,Selangor,417,243,174
1/08/2021,France,Terengganu,0,0,0
1/08/2021,France,W.P. Labuan,0,0,0
1/08/2021,"Micronesia, Federated States of",Johor,0,0,0
1/08/2021,"Micronesia, Federated States of",Pulau Pinang,0,0,0
1/08/2021,"Micronesia, Federated States of",Selangor,0,0,0
1/08/2021,Gabon,Johor,0,0,0
1/08/2021,Gabon,Pulau Pinang,0,0,0
1/08/2021,Gabon,Sarawak,0,0,0
1/08/2021,Gabon,Selangor,0,0,0
1/08/2021,United Kingdom of Great Britain and Northern Ireland,Johor,2,2,0
1/08/2021,United Kingdom of Great Britain and Northern Ireland,Kedah,0,0,0
1/08/2021,United Kingdom of Great Britain and Northern Ireland,Kelantan,0,0,0
1/08/2021,United Kingdom of Great Britain and Northern Ireland,Melaka,0,0,0
1/08/2021,United Kingdom of Great Britain and Northern Ireland,Negeri Sembilan,0,0,0
1/08/2021,United Kingdom of Great Britain and Northern Ireland,Pahang,0,0,0
1/08/2021,United Kingdom of Great Britain and Northern Ireland,Perak,0,0,0
1/08/2021,United Kingdom of Great Britain and Northern Ireland,Perlis,0,0,0
1/08/2021,United Kingdom of Great Britain and Northern Ireland,Pulau Pinang,26,9,17
1/08/2021,United Kingdom of Great Britain and Northern Ireland,Sabah,0,0,0
1/08/2021,United Kingdom of Great Britain and Northern Ireland,Sarawak,7,6,1
1/08/2021,United Kingdom of Great Britain and Northern Ireland,Selangor,627,364,263
1/08/2021,United Kingdom of Great Britain and Northern Ireland,Terengganu,0,0,0
1/08/2021,United Kingdom of Great Britain and Northern Ireland,W.P. Labuan,0,0,0
1/08/2021,Georgia,Johor,0,0,0
1/08/2021,Georgia,Kedah,0,0,0
1/08/2021,Georgia,Melaka,0,0,0
1/08/2021,Georgia,Perak,0,0,0
1/08/2021,Georgia,Perlis,0,0,0
1/08/2021,Georgia,Pulau Pinang,0,0,0
1/08/2021,Georgia,Sabah,0,0,0
1/08/2021,Georgia,Sarawak,0,0,0
1/08/2021,Georgia,Selangor,9,9,0
1/08/2021,Ghana,Johor,0,0,0
1/08/2021,Ghana,Kedah,0,0,0
1/08/2021,Ghana,Kelantan,0,0,0
1/08/2021,Ghana,Pulau Pinang,0,0,0
1/08/2021,Ghana,Sabah,0,0,0
1/08/2021,Ghana,Sarawak,0,0,0
1/08/2021,Ghana,Selangor,10,5,5
1/08/2021,Gibraltar,Johor,0,0,0
1/08/2021,Gibraltar,Sarawak,0,0,0
1/08/2021,Guinea,Johor,0,0,0
1/08/2021,Guinea,Kedah,0,0,0
1/08/2021,Guinea,Kelantan,0,0,0
1/08/2021,Guinea,Perlis,0,0,0
1/08/2021,Guinea,Pulau Pinang,0,0,0
1/08/2021,Guinea,Sabah,0,0,0
1/08/2021,Guinea,Sarawak,0,0,0
1/08/2021,Guinea,Selangor,4,3,1
1/08/2021,Guadeloupe,Selangor,0,0,0
1/08/2021,Gambia,Johor,0,0,0
1/08/2021,Gambia,Kedah,0,0,0
1/08/2021,Gambia,Kelantan,0,0,0
1/08/2021,Gambia,Pulau Pinang,0,0,0
1/08/2021,Gambia,Sabah,0,0,0
1/08/2021,Gambia,Sarawak,0,0,0
1/08/2021,Gambia,Selangor,0,0,0
1/08/2021,Guinea-Bissau,Johor,0,0,0
1/08/2021,Guinea-Bissau,Selangor,0,0,0
1/08/2021,Equatorial Guinea,Johor,0,0,0
1/08/2021,Equatorial Guinea,Selangor,0,0,0
1/08/2021,Greece,Johor,0,0,0
1/08/2021,Greece,Kedah,0,0,0
1/08/2021,Greece,Kelantan,0,0,0
1/08/2021,Greece,Melaka,0,0,0
1/08/2021,Greece,Negeri Sembilan,0,0,0
1/08/2021,Greece,Pahang,0,0,0
1/08/2021,Greece,Perak,0,0,0
1/08/2021,Greece,Perlis,0,0,0
1/08/2021,Greece,Pulau Pinang,0,0,0
1/08/2021,Greece,Sabah,0,0,0
1/08/2021,Greece,Sarawak,0,0,0
1/08/2021,Greece,Selangor,10,7,3
1/08/2021,Grenada,Johor,0,0,0
1/08/2021,Grenada,Kedah,0,0,0
1/08/2021,Grenada,Pulau Pinang,0,0,0
1/08/2021,Grenada,Sabah,0,0,0
1/08/2021,Grenada,Sarawak,0,0,0
1/08/2021,Grenada,Selangor,0,0,0
1/08/2021,Greenland,Johor,0,0,0
1/08/2021,Greenland,Selangor,0,0,0
1/08/2021,Guatemala,Johor,0,0,0
1/08/2021,Guatemala,Kedah,0,0,0
1/08/2021,Guatemala,Pahang,0,0,0
1/08/2021,Guatemala,Perak,0,0,0
1/08/2021,Guatemala,Pulau Pinang,0,0,0
1/08/2021,Guatemala,Sabah,0,0,0
1/08/2021,Guatemala,Sarawak,0,0,0
1/08/2021,Guatemala,Selangor,0,0,0
1/08/2021,Guatemala,W.P. Labuan,0,0,0
1/08/2021,Guyana,Johor,0,0,0
1/08/2021,Guyana,Kedah,0,0,0
1/08/2021,Guyana,Pulau Pinang,0,0,0
1/08/2021,Guyana,Sarawak,0,0,0
1/08/2021,Guyana,Selangor,0,0,0
1/08/2021,Hong Kong,Johor,0,0,0
1/08/2021,Hong Kong,Kedah,0,0,0
1/08/2021,Hong Kong,Kelantan,0,0,0
1/08/2021,Hong Kong,Pahang,0,0,0
1/08/2021,Hong Kong,Perak,0,0,0
1/08/2021,Hong Kong,Perlis,0,0,0
1/08/2021,Hong Kong,Pulau Pinang,3,1,2
1/08/2021,Hong Kong,Sabah,0,0,0
1/08/2021,Hong Kong,Sarawak,0,0,0
1/08/2021,Hong Kong,Selangor,0,0,0
1/08/2021,Hong Kong,Terengganu,0,0,0
1/08/2021,Heard Island and McDonald Islands,Johor,0,0,0
1/08/2021,Honduras,Johor,0,0,0
1/08/2021,Honduras,Kedah,0,0,0
1/08/2021,Honduras,Perak,0,0,0
1/08/2021,Honduras,Pulau Pinang,0,0,0
1/08/2021,Honduras,Sabah,0,0,0
1/08/2021,Honduras,Sarawak,0,0,0
1/08/2021,Honduras,Selangor,2,1,1
1/08/2021,Croatia,Johor,0,0,0
1/08/2021,Croatia,Kedah,0,0,0
1/08/2021,Croatia,Kelantan,0,0,0
1/08/2021,Croatia,Melaka,0,0,0
1/08/2021,Croatia,Pahang,0,0,0
1/08/2021,Croatia,Perak,0,0,0
1/08/2021,Croatia,Perlis,0,0,0
1/08/2021,Croatia,Pulau Pinang,0,0,0
1/08/2021,Croatia,Sabah,2,2,0
1/08/2021,Croatia,Sarawak,0,0,0
1/08/2021,Croatia,Selangor,23,22,1
1/08/2021,Haiti,Johor,0,0,0
1/08/2021,Haiti,Kedah,0,0,0
1/08/2021,Haiti,Kelantan,0,0,0
1/08/2021,Haiti,Perak,0,0,0
1/08/2021,Haiti,Pulau Pinang,0,0,0
1/08/2021,Haiti,Sabah,0,0,0
1/08/2021,Haiti,Selangor,0,0,0
1/08/2021,Hungary,Johor,0,0,0
1/08/2021,Hungary,Kedah,0,0,0
1/08/2021,Hungary,Kelantan,0,0,0
1/08/2021,Hungary,Pahang,0,0,0
1/08/2021,Hungary,Perak,0,0,0
1/08/2021,Hungary,Perlis,0,0,0
1/08/2021,Hungary,Pulau Pinang,2,0,2
1/08/2021,Hungary,Sabah,0,0,0
1/08/2021,Hungary,Sarawak,0,0,0
1/08/2021,Hungary,Selangor,8,7,1
1/08/2021,Hungary,W.P. Labuan,0,0,0
1/08/2021,Indonesia,Johor,61,49,12
1/08/2021,Indonesia,Kedah,5,5,0
1/08/2021,Indonesia,Kelantan,0,0,0
1/08/2021,Indonesia,Melaka,0,0,0
1/08/2021,Indonesia,Negeri Sembilan,0,0,0
1/08/2021,Indonesia,Pahang,0,0,0
1/08/2021,Indonesia,Perak,0,0,0
1/08/2021,Indonesia,Perlis,7,7,0
1/08/2021,Indonesia,Pulau Pinang,1,1,0
1/08/2021,Indonesia,Sabah,2,0,2
1/08/2021,Indonesia,Sarawak,206,200,6
1/08/2021,Indonesia,Selangor,601,409,192
1/08/2021,Indonesia,Terengganu,0,0,0
1/08/2021,Indonesia,W.P. Labuan,2,2,0
1/08/2021,India,Johor,17,17,0
1/08/2021,India,Kedah,0,0,0
1/08/2021,India,Kelantan,0,0,0
1/08/2021,India,Melaka,0,0,0
1/08/2021,India,Negeri Sembilan,0,0,0
1/08/2021,India,Pahang,0,0,0
1/08/2021,India,Perak,0,0,0
1/08/2021,India,Perlis,0,0,0
1/08/2021,India,Pulau Pinang,1,1,0
1/08/2021,India,Sabah,0,0,0
1/08/2021,India,Sarawak,0,0,0
1/08/2021,India,Selangor,50,33,17
1/08/2021,India,Terengganu,0,0,0
1/08/2021,India,W.P. Labuan,0,0,0
1/08/2021, British Indian Ocean Territory,Pulau Pinang,0,0,0
1/08/2021, British Indian Ocean Territory,Selangor,0,0,0
1/08/2021,Ireland,Johor,0,0,0
1/08/2021,Ireland,Kedah,0,0,0
1/08/2021,Ireland,Kelantan,0,0,0
1/08/2021,Ireland,Negeri Sembilan,0,0,0
1/08/2021,Ireland,Pahang,0,0,0
1/08/2021,Ireland,Perak,0,0,0
1/08/2021,Ireland,Perlis,0,0,0
1/08/2021,Ireland,Pulau Pinang,0,0,0
1/08/2021,Ireland,Sabah,0,0,0
1/08/2021,Ireland,Sarawak,0,0,0
1/08/2021,Ireland,Selangor,29,18,11
1/08/2021,Ireland,Terengganu,0,0,0
1/08/2021,Ireland,W.P. Labuan,0,0,0
1/08/2021,"Iran, Islamic Republic of",Johor,0,0,0
1/08/2021,"Iran, Islamic Republic of",Kedah,0,0,0
1/08/2021,"Iran, Islamic Republic of",Kelantan,0,0,0
1/08/2021,"Iran, Islamic Republic of",Perak,0,0,0
1/08/2021,"Iran, Islamic Republic of",Perlis,0,0,0
1/08/2021,"Iran, Islamic Republic of",Pulau Pinang,1,0,1
1/08/2021,"Iran, Islamic Republic of",Sabah,0,0,0
1/08/2021,"Iran, Islamic Republic of",Sarawak,0,0,0
1/08/2021,"Iran, Islamic Republic of",Selangor,45,33,12
1/08/2021,"Iran, Islamic Republic of",W.P. Labuan,0,0,0
1/08/2021,Iraq,Johor,0,0,0
1/08/2021,Iraq,Kedah,0,0,0
1/08/2021,Iraq,Kelantan,0,0,0
1/08/2021,Iraq,Melaka,0,0,0
1/08/2021,Iraq,Pahang,0,0,0
1/08/2021,Iraq,Perak,0,0,0
1/08/2021,Iraq,Perlis,0,0,0
1/08/2021,Iraq,Pulau Pinang,0,0,0
1/08/2021,Iraq,Sabah,0,0,0
1/08/2021,Iraq,Sarawak,0,0,0
1/08/2021,Iraq,Selangor,29,15,14
1/08/2021,Iceland,Johor,0,0,0
1/08/2021,Iceland,Kedah,0,0,0
1/08/2021,Iceland,Kelantan,0,0,0
1/08/2021,Iceland,Perak,0,0,0
1/08/2021,Iceland,Perlis,0,0,0
1/08/2021,Iceland,Pulau Pinang,0,0,0
1/08/2021,Iceland,Sabah,0,0,0
1/08/2021,Iceland,Sarawak,0,0,0
1/08/2021,Iceland,Selangor,0,0,0
1/08/2021,Iceland,W.P. Labuan,0,0,0
1/08/2021,Israel,Pulau Pinang,0,0,0
1/08/2021,Italy,Johor,0,0,0
1/08/2021,Italy,Kedah,0,0,0
1/08/2021,Italy,Kelantan,0,0,0
1/08/2021,Italy,Melaka,0,0,0
1/08/2021,Italy,Negeri Sembilan,0,0,0
1/08/2021,Italy,Pahang,0,0,0
1/08/2021,Italy,Perak,0,0,0
1/08/2021,Italy,Perlis,0,0,0
1/08/2021,Italy,Pulau Pinang,1,1,0
1/08/2021,Italy,Sabah,0,0,0
1/08/2021,Italy,Sarawak,1,1,0
1/08/2021,Italy,Selangor,65,43,22
1/08/2021,Italy,W.P. Labuan,0,0,0
1/08/2021,Jamaica,Johor,0,0,0
1/08/2021,Jamaica,Kedah,0,0,0
1/08/2021,Jamaica,Perak,0,0,0
1/08/2021,Jamaica,Pulau Pinang,0,0,0
1/08/2021,Jamaica,Sabah,0,0,0
1/08/2021,Jamaica,Sarawak,0,0,0
1/08/2021,Jamaica,Selangor,0,0,0
1/08/2021,Jamaica,W.P. Labuan,0,0,0
1/08/2021,Jordan,Johor,0,0,0
1/08/2021,Jordan,Kedah,0,0,0
1/08/2021,Jordan,Kelantan,0,0,0
1/08/2021,Jordan,Melaka,0,0,0
1/08/2021,Jordan,Perlis,0,0,0
1/08/2021,Jordan,Pulau Pinang,0,0,0
1/08/2021,Jordan,Sabah,0,0,0
1/08/2021,Jordan,Sarawak,0,0,0
1/08/2021,Jordan,Selangor,24,15,9
1/08/2021,Jordan,W.P. Labuan,0,0,0
1/08/2021,Japan,Johor,1,1,0
1/08/2021,Japan,Kedah,0,0,0
1/08/2021,Japan,Kelantan,0,0,0
1/08/2021,Japan,Melaka,0,0,0
1/08/2021,Japan,Negeri Sembilan,0,0,0
1/08/2021,Japan,Pahang,0,0,0
1/08/2021,Japan,Perak,1,1,0
1/08/2021,Japan,Perlis,0,0,0
1/08/2021,Japan,Pulau Pinang,22,16,6
1/08/2021,Japan,Sabah,0,0,0
1/08/2021,Japan,Sarawak,1,1,0
1/08/2021,Japan,Selangor,360,226,134
1/08/2021,Japan,W.P. Labuan,0,0,0
1/08/2021,Kazakhstan,Johor,0,0,0
1/08/2021,Kazakhstan,Kedah,0,0,0
1/08/2021,Kazakhstan,Kelantan,0,0,0
1/08/2021,Kazakhstan,Melaka,0,0,0
1/08/2021,Kazakhstan,Perak,0,0,0
1/08/2021,Kazakhstan,Perlis,0,0,0
1/08/2021,Kazakhstan,Pulau Pinang,0,0,0
1/08/2021,Kazakhstan,Sabah,0,0,0
1/08/2021,Kazakhstan,Sarawak,0,0,0
1/08/2021,Kazakhstan,Selangor,21,17,4
1/08/2021,Kazakhstan,W.P. Labuan,0,0,0
1/08/2021,Kenya,Johor,0,0,0
1/08/2021,Kenya,Kedah,0,0,0
1/08/2021,Kenya,Kelantan,0,0,0
1/08/2021,Kenya,Perak,0,0,0
1/08/2021,Kenya,Perlis,0,0,0
1/08/2021,Kenya,Pulau Pinang,0,0,0
1/08/2021,Kenya,Sabah,0,0,0
1/08/2021,Kenya,Sarawak,0,0,0
1/08/2021,Kenya,Selangor,8,4,4
1/08/2021,Kyrgyzstan,Johor,0,0,0
1/08/2021,Kyrgyzstan,Kedah,0,0,0
1/08/2021,Kyrgyzstan,Kelantan,0,0,0
1/08/2021,Kyrgyzstan,Perak,0,0,0
1/08/2021,Kyrgyzstan,Perlis,0,0,0
1/08/2021,Kyrgyzstan,Pulau Pinang,0,0,0
1/08/2021,Kyrgyzstan,Sabah,0,0,0
1/08/2021,Kyrgyzstan,Sarawak,0,0,0
1/08/2021,Kyrgyzstan,Selangor,8,8,0
1/08/2021,Cambodia,Johor,0,0,0
1/08/2021,Cambodia,Kedah,0,0,0
1/08/2021,Cambodia,Kelantan,0,0,0
1/08/2021,Cambodia,Melaka,0,0,0
1/08/2021,Cambodia,Negeri Sembilan,0,0,0
1/08/2021,Cambodia,Pahang,0,0,0
1/08/2021,Cambodia,Perak,0,0,0
1/08/2021,Cambodia,Perlis,0,0,0
1/08/2021,Cambodia,Pulau Pinang,1,0,1
1/08/2021,Cambodia,Sabah,0,0,0
1/08/2021,Cambodia,Sarawak,0,0,0
1/08/2021,Cambodia,Selangor,63,61,2
1/08/2021,Cambodia,W.P. Labuan,0,0,0
1/08/2021,Kiribati,Johor,0,0,0
1/08/2021,Kiribati,Sabah,0,0,0
1/08/2021,Kiribati,Selangor,0,0,0
1/08/2021,Saint Kitts and Nevis,Johor,0,0,0
1/08/2021,Saint Kitts and Nevis,Kedah,0,0,0
1/08/2021,Saint Kitts and Nevis,Perlis,0,0,0
1/08/2021,Saint Kitts and Nevis,Pulau Pinang,0,0,0
1/08/2021,Saint Kitts and Nevis,Sabah,0,0,0
1/08/2021,Saint Kitts and Nevis,Selangor,0,0,0
1/08/2021,Saint Kitts and Nevis,W.P. Labuan,0,0,0
1/08/2021,"Korea, Republic of",Johor,0,0,0
1/08/2021,"Korea, Republic of",Kedah,0,0,0
1/08/2021,"Korea, Republic of",Kelantan,0,0,0
1/08/2021,"Korea, Republic of",Melaka,0,0,0
1/08/2021,"Korea, Republic of",Negeri Sembilan,0,0,0
1/08/2021,"Korea, Republic of",Pahang,0,0,0
1/08/2021,"Korea, Republic of",Perak,0,0,0
1/08/2021,"Korea, Republic of",Perlis,0,0,0
1/08/2021,"Korea, Republic of",Pulau Pinang,12,6,6
1/08/2021,"Korea, Republic of",Sabah,0,0,0
1/08/2021,"Korea, Republic of",Sarawak,28,28,0
1/08/2021,"Korea, Republic of",Selangor,332,187,145
1/08/2021,"Korea, Republic of",Terengganu,0,0,0
1/08/2021,"Korea, Republic of",W.P. Labuan,0,0,0
1/08/2021,Kuwait,Johor,0,0,0
1/08/2021,Kuwait,Kedah,0,0,0
1/08/2021,Kuwait,Kelantan,0,0,0
1/08/2021,Kuwait,Perak,0,0,0
1/08/2021,Kuwait,Perlis,0,0,0
1/08/2021,Kuwait,Pulau Pinang,0,0,0
1/08/2021,Kuwait,Sabah,0,0,0
1/08/2021,Kuwait,Sarawak,0,0,0
1/08/2021,Kuwait,Selangor,10,8,2
1/08/2021,Kuwait,W.P. Labuan,0,0,0
1/08/2021, Lao People's Democratic Republic,Johor,0,0,0
1/08/2021, Lao People's Democratic Republic,Kedah,0,0,0
1/08/2021, Lao People's Democratic Republic,Kelantan,0,0,0
1/08/2021, Lao People's Democratic Republic,Melaka,0,0,0
1/08/2021, Lao People's Democratic Republic,Perak,0,0,0
1/08/2021, Lao People's Democratic Republic,Perlis,0,0,0
1/08/2021, Lao People's Democratic Republic,Pulau Pinang,0,0,0
1/08/2021, Lao People's Democratic Republic,Sabah,0,0,0
1/08/2021, Lao People's Democratic Republic,Sarawak,0,0,0
1/08/2021, Lao People's Democratic Republic,Selangor,202,202,0
1/08/2021, Lao People's Democratic Republic,W.P. Labuan,0,0,0
1/08/2021,Lebanon,Johor,0,0,0
1/08/2021,Lebanon,Kedah,0,0,0
1/08/2021,Lebanon,Kelantan,0,0,0
1/08/2021,Lebanon,Pahang,0,0,0
1/08/2021,Lebanon,Perak,0,0,0
1/08/2021,Lebanon,Perlis,0,0,0
1/08/2021,Lebanon,Pulau Pinang,0,0,0
1/08/2021,Lebanon,Sabah,0,0,0
1/08/2021,Lebanon,Sarawak,0,0,0
1/08/2021,Lebanon,Selangor,1,1,0
1/08/2021,Lebanon,W.P. Labuan,0,0,0
1/08/2021,Liberia,Johor,0,0,0
1/08/2021,Liberia,Kedah,0,0,0
1/08/2021,Liberia,Sabah,0,0,0
1/08/2021,Liberia,Sarawak,0,0,0
1/08/2021,Liberia,Selangor,1,1,0
1/08/2021,Libya,Johor,0,0,0
1/08/2021,Libya,Kedah,0,0,0
1/08/2021,Libya,Perlis,0,0,0
1/08/2021,Libya,Pulau Pinang,0,0,0
1/08/2021,Libya,Sabah,0,0,0
1/08/2021,Libya,Sarawak,0,0,0
1/08/2021,Libya,Selangor,28,23,5
1/08/2021,Saint Lucia,Johor,0,0,0
1/08/2021,Saint Lucia,Kedah,0,0,0
1/08/2021,Saint Lucia,Pulau Pinang,0,0,0
1/08/2021,Saint Lucia,Sarawak,0,0,0
1/08/2021,Saint Lucia,Selangor,0,0,0
1/08/2021,Liechtenstein,Johor,0,0,0
1/08/2021,Liechtenstein,Kedah,0,0,0
1/08/2021,Liechtenstein,Perlis,0,0,0
1/08/2021,Liechtenstein,Pulau Pinang,0,0,0
1/08/2021,Liechtenstein,Sabah,0,0,0
1/08/2021,Liechtenstein,Sarawak,0,0,0
1/08/2021,Liechtenstein,Selangor,0,0,0
1/08/2021,LKA,Johor,0,0,0
1/08/2021,LKA,Kedah,0,0,0
1/08/2021,LKA,Kelantan,0,0,0
1/08/2021,LKA,Melaka,0,0,0
1/08/2021,LKA,Pahang,0,0,0
1/08/2021,LKA,Perak,0,0,0
1/08/2021,LKA,Perlis,0,0,0
1/08/2021,LKA,Pulau Pinang,0,0,0
1/08/2021,LKA,Sabah,0,0,0
1/08/2021,LKA,Sarawak,0,0,0
1/08/2021,LKA,Selangor,5,4,1
1/08/2021,LKA,W.P. Labuan,0,0,0
1/08/2021,Lesotho,Johor,0,0,0
1/08/2021,Lesotho,Kedah,0,0,0
1/08/2021,Lesotho,Pulau Pinang,0,0,0
1/08/2021,Lesotho,Sarawak,0,0,0
1/08/2021,Lesotho,Selangor,0,0,0
1/08/2021,Lithuania,Johor,0,0,0
1/08/2021,Lithuania,Kedah,0,0,0
1/08/2021,Lithuania,Kelantan,0,0,0
1/08/2021,Lithuania,Pahang,0,0,0
1/08/2021,Lithuania,Perak,0,0,0
1/08/2021,Lithuania,Perlis,0,0,0
1/08/2021,Lithuania,Pulau Pinang,0,0,0
1/08/2021,Lithuania,Sabah,0,0,0
1/08/2021,Lithuania,Sarawak,0,0,0
1/08/2021,Lithuania,Selangor,5,5,0
1/08/2021,Lithuania,W.P. Labuan,0,0,0
1/08/2021,Luxembourg,Johor,0,0,0
1/08/2021,Luxembourg,Kedah,0,0,0
1/08/2021,Luxembourg,Kelantan,0,0,0
1/08/2021,Luxembourg,Perak,0,0,0
1/08/2021,Luxembourg,Perlis,0,0,0
1/08/2021,Luxembourg,Pulau Pinang,0,0,0
1/08/2021,Luxembourg,Sabah,0,0,0
1/08/2021,Luxembourg,Sarawak,0,0,0
1/08/2021,Luxembourg,Selangor,0,0,0
1/08/2021,Latvia,Johor,0,0,0
1/08/2021,Latvia,Kedah,0,0,0
1/08/2021,Latvia,Kelantan,0,0,0
1/08/2021,Latvia,Pahang,0,0,0
1/08/2021,Latvia,Perak,0,0,0
1/08/2021,Latvia,Perlis,0,0,0
1/08/2021,Latvia,Pulau Pinang,0,0,0
1/08/2021,Latvia,Sabah,0,0,0
1/08/2021,Latvia,Sarawak,0,0,0
1/08/2021,Latvia,Selangor,6,5,1
1/08/2021,Latvia,W.P. Labuan,0,0,0
1/08/2021,Macao,Johor,0,0,0
1/08/2021,Macao,Pahang,0,0,0
1/08/2021,Macao,Perak,0,0,0
1/08/2021,Macao,Selangor,0,0,0
1/08/2021,Macao,W.P. Labuan,0,0,0
1/08/2021,Morocco,Johor,0,0,0
1/08/2021,Morocco,Kedah,0,0,0
1/08/2021,Morocco,Kelantan,0,0,0
1/08/2021,Morocco,Melaka,0,0,0
1/08/2021,Morocco,Pahang,0,0,0
1/08/2021,Morocco,Perak,0,0,0
1/08/2021,Morocco,Perlis,0,0,0
1/08/2021,Morocco,Pulau Pinang,0,0,0
1/08/2021,Morocco,Sabah,0,0,0
1/08/2021,Morocco,Sarawak,0,0,0
1/08/2021,Morocco,Selangor,10,5,5
1/08/2021,Morocco,W.P. Labuan,0,0,0
1/08/2021,Monaco,Johor,0,0,0
1/08/2021,Monaco,Kedah,0,0,0
1/08/2021,Monaco,Sabah,0,0,0
1/08/2021,Monaco,Selangor,3,0,3
1/08/2021,"Moldova, Republic of",Johor,0,0,0
1/08/2021,"Moldova, Republic of",Kedah,0,0,0
1/08/2021,"Moldova, Republic of",Kelantan,0,0,0
1/08/2021,"Moldova, Republic of",Negeri Sembilan,0,0,0
1/08/2021,"Moldova, Republic of",Perlis,0,0,0
1/08/2021,"Moldova, Republic of",Pulau Pinang,0,0,0
1/08/2021,"Moldova, Republic of",Sabah,0,0,0
1/08/2021,"Moldova, Republic of",Sarawak,0,0,0
1/08/2021,"Moldova, Republic of",Selangor,0,0,0
1/08/2021,Madagascar,Johor,0,0,0
1/08/2021,Madagascar,Kedah,0,0,0
1/08/2021,Madagascar,Perak,0,0,0
1/08/2021,Madagascar,Perlis,0,0,0
1/08/2021,Madagascar,Pulau Pinang,0,0,0
1/08/2021,Madagascar,Sabah,0,0,0
1/08/2021,Madagascar,Sarawak,0,0,0
1/08/2021,Madagascar,Selangor,1,1,0
1/08/2021,Maldives,Johor,0,0,0
1/08/2021,Maldives,Kedah,0,0,0
1/08/2021,Maldives,Kelantan,0,0,0
1/08/2021,Maldives,Perak,0,0,0
1/08/2021,Maldives,Perlis,0,0,0
1/08/2021,Maldives,Pulau Pinang,1,1,0
1/08/2021,Maldives,Sabah,0,0,0
1/08/2021,Maldives,Sarawak,0,0,0
1/08/2021,Maldives,Selangor,56,29,27
1/08/2021,Mexico,Johor,0,0,0
1/08/2021,Mexico,Kedah,0,0,0
1/08/2021,Mexico,Kelantan,0,0,0
1/08/2021,Mexico,Pahang,0,0,0
1/08/2021,Mexico,Perak,0,0,0
1/08/2021,Mexico,Perlis,0,0,0
1/08/2021,Mexico,Pulau Pinang,0,0,0
1/08/2021,Mexico,Sabah,0,0,0
1/08/2021,Mexico,Sarawak,0,0,0
1/08/2021,Mexico,Selangor,14,10,4
1/08/2021,Mexico,W.P. Labuan,0,0,0
1/08/2021,Marshall Islands,Johor,0,0,0
1/08/2021,Marshall Islands,Kedah,0,0,0
1/08/2021,Marshall Islands,Perak,0,0,0
1/08/2021,Marshall Islands,Pulau Pinang,0,0,0
1/08/2021,Marshall Islands,Sabah,0,0,0
1/08/2021,Marshall Islands,Selangor,0,0,0
1/08/2021,North Macedonia,Johor,0,0,0
1/08/2021,North Macedonia,Kedah,0,0,0
1/08/2021,North Macedonia,Perak,0,0,0
1/08/2021,North Macedonia,Pulau Pinang,0,0,0
1/08/2021,North Macedonia,Sabah,0,0,0
1/08/2021,North Macedonia,Sarawak,0,0,0
1/08/2021,North Macedonia,Selangor,1,0,1
1/08/2021,Mali,Johor,0,0,0
1/08/2021,Mali,Sabah,0,0,0
1/08/2021,Mali,Selangor,0,0,0
1/08/2021,Malta,Johor,0,0,0
1/08/2021,Malta,Kedah,0,0,0
1/08/2021,Malta,Kelantan,0,0,0
1/08/2021,Malta,Perak,0,0,0
1/08/2021,Malta,Perlis,0,0,0
1/08/2021,Malta,Pulau Pinang,0,0,0
1/08/2021,Malta,Sabah,0,0,0
1/08/2021,Malta,Sarawak,0,0,0
1/08/2021,Malta,Selangor,0,0,0
1/08/2021,Malta,W.P. Labuan,0,0,0
1/08/2021,Myanmar,Johor,0,0,0
1/08/2021,Myanmar,Kedah,0,0,0
1/08/2021,Myanmar,Kelantan,0,0,0
1/08/2021,Myanmar,Negeri Sembilan,0,0,0
1/08/2021,Myanmar,Pahang,0,0,0
1/08/2021,Myanmar,Perak,0,0,0
1/08/2021,Myanmar,Perlis,0,0,0
1/08/2021,Myanmar,Pulau Pinang,0,0,0
1/08/2021,Myanmar,Sabah,0,0,0
1/08/2021,Myanmar,Sarawak,0,0,0
1/08/2021,Myanmar,Selangor,59,55,4
1/08/2021,Myanmar,Terengganu,0,0,0
1/08/2021,Myanmar,W.P. Labuan,0,0,0
1/08/2021,Montenegro,Johor,0,0,0
1/08/2021,Montenegro,Kedah,0,0,0
1/08/2021,Montenegro,Pulau Pinang,0,0,0
1/08/2021,Montenegro,Sabah,0,0,0
1/08/2021,Montenegro,Sarawak,0,0,0
1/08/2021,Montenegro,Selangor,5,5,0
1/08/2021,Mongolia,Johor,0,0,0
1/08/2021,Mongolia,Kedah,0,0,0
1/08/2021,Mongolia,Kelantan,0,0,0
1/08/2021,Mongolia,Perak,0,0,0
1/08/2021,Mongolia,Perlis,0,0,0
1/08/2021,Mongolia,Pulau Pinang,0,0,0
1/08/2021,Mongolia,Sabah,0,0,0
1/08/2021,Mongolia,Sarawak,0,0,0
1/08/2021,Mongolia,Selangor,1,0,1
1/08/2021,Northern Mariana Islands,Selangor,0,0,0
1/08/2021,Mozambique,Johor,0,0,0
1/08/2021,Mozambique,Kedah,0,0,0
1/08/2021,Mozambique,Perak,0,0,0
1/08/2021,Mozambique,Pulau Pinang,0,0,0
1/08/2021,Mozambique,Sabah,0,0,0
1/08/2021,Mozambique,Sarawak,0,0,0
1/08/2021,Mozambique,Selangor,8,6,2
1/08/2021,Mauritania,Johor,0,0,0
1/08/2021,Mauritania,Kedah,0,0,0
1/08/2021,Mauritania,Pulau Pinang,0,0,0
1/08/2021,Mauritania,Sabah,0,0,0
1/08/2021,Mauritania,Sarawak,0,0,0
1/08/2021,Mauritania,Selangor,0,0,0
1/08/2021,Mauritius,Johor,0,0,0
1/08/2021,Mauritius,Kedah,0,0,0
1/08/2021,Mauritius,Kelantan,0,0,0
1/08/2021,Mauritius,Pahang,0,0,0
1/08/2021,Mauritius,Perak,0,0,0
1/08/2021,Mauritius,Perlis,0,0,0
1/08/2021,Mauritius,Pulau Pinang,0,0,0
1/08/2021,Mauritius,Sabah,0,0,0
1/08/2021,Mauritius,Sarawak,0,0,0
1/08/2021,Mauritius,Selangor,6,1,5
1/08/2021,Malawi,Johor,0,0,0
1/08/2021,Malawi,Pulau Pinang,0,0,0
1/08/2021,Malawi,Sabah,0,0,0
1/08/2021,Malawi,Sarawak,0,0,0
1/08/2021,Malawi,Selangor,4,3,1
1/08/2021,Mayotte,Selangor,0,0,0
1/08/2021,Namibia,Johor,0,0,0
1/08/2021,Namibia,Kedah,0,0,0
1/08/2021,Namibia,Perak,0,0,0
1/08/2021,Namibia,Perlis,0,0,0
1/08/2021,Namibia,Pulau Pinang,0,0,0
1/08/2021,Namibia,Sabah,0,0,0
1/08/2021,Namibia,Sarawak,0,0,0
1/08/2021,Namibia,Selangor,0,0,0
1/08/2021,New Caledonia,Selangor,0,0,0
1/08/2021,Niger,Johor,0,0,0
1/08/2021,Niger,Sabah,0,0,0
1/08/2021,Niger,Selangor,0,0,0
1/08/2021,Nigeria,Johor,0,0,0
1/08/2021,Nigeria,Kedah,0,0,0
1/08/2021,Nigeria,Perlis,0,0,0
1/08/2021,Nigeria,Pulau Pinang,0,0,0
1/08/2021,Nigeria,Sabah,0,0,0
1/08/2021,Nigeria,Sarawak,1,1,0
1/08/2021,Nigeria,Selangor,88,80,8
1/08/2021,Nicaragua,Johor,0,0,0
1/08/2021,Nicaragua,Kedah,0,0,0
1/08/2021,Nicaragua,Pulau Pinang,0,0,0
1/08/2021,Nicaragua,Sabah,0,0,0
1/08/2021,Nicaragua,Selangor,0,0,0
1/08/2021,Netherlands,Johor,0,0,0
1/08/2021,Netherlands,Kedah,0,0,0
1/08/2021,Netherlands,Kelantan,0,0,0
1/08/2021,Netherlands,Melaka,0,0,0
1/08/2021,Netherlands,Negeri Sembilan,0,0,0
1/08/2021,Netherlands,Pahang,0,0,0
1/08/2021,Netherlands,Perak,0,0,0
1/08/2021,Netherlands,Perlis,0,0,0
1/08/2021,Netherlands,Pulau Pinang,0,0,0
1/08/2021,Netherlands,Sabah,0,0,0
1/08/2021,Netherlands,Sarawak,0,0,0
1/08/2021,Netherlands,Selangor,91,61,30
1/08/2021,Netherlands,Terengganu,0,0,0
1/08/2021,Netherlands,W.P. Labuan,0,0,0
1/08/2021,Norway,Johor,0,0,0
1/08/2021,Norway,Kedah,0,0,0
1/08/2021,Norway,Kelantan,0,0,0
1/08/2021,Norway,Melaka,0,0,0
1/08/2021,Norway,Pahang,0,0,0
1/08/2021,Norway,Perak,0,0,0
1/08/2021,Norway,Perlis,0,0,0
1/08/2021,Norway,Pulau Pinang,0,0,0
1/08/2021,Norway,Sabah,0,0,0
1/08/2021,Norway,Sarawak,1,1,0
1/08/2021,Norway,Selangor,23,19,4
1/08/2021,Norway,W.P. Labuan,0,0,0
1/08/2021,Nepal,Johor,0,0,0
1/08/2021,Nepal,Kedah,0,0,0
1/08/2021,Nepal,Pahang,0,0,0
1/08/2021,Nepal,Perak,0,0,0
1/08/2021,Nepal,Perlis,0,0,0
1/08/2021,Nepal,Pulau Pinang,0,0,0
1/08/2021,Nepal,Sabah,0,0,0
1/08/2021,Nepal,Sarawak,0,0,0
1/08/2021,Nepal,Selangor,0,0,0
1/08/2021,Nepal,W.P. Labuan,0,0,0
1/08/2021,Nauru,Johor,0,0,0
1/08/2021,Nauru,Pulau Pinang,0,0,0
1/08/2021,Nauru,Selangor,0,0,0
1/08/2021,New Zealand,Johor,0,0,0
1/08/2021,New Zealand,Kedah,0,0,0
1/08/2021,New Zealand,Kelantan,0,0,0
1/08/2021,New Zealand,Melaka,0,0,0
1/08/2021,New Zealand,Negeri Sembilan,0,0,0
1/08/2021,New Zealand,Pahang,0,0,0
1/08/2021,New Zealand,Perak,0,0,0
1/08/2021,New Zealand,Perlis,0,0,0
1/08/2021,New Zealand,Pulau Pinang,0,0,0
1/08/2021,New Zealand,Sabah,0,0,0
1/08/2021,New Zealand,Sarawak,0,0,0
1/08/2021,New Zealand,Selangor,21,10,11
1/08/2021,New Zealand,Terengganu,0,0,0
1/08/2021,New Zealand,W.P. Labuan,0,0,0
1/08/2021,Oman,Johor,0,0,0
1/08/2021,Oman,Kedah,0,0,0
1/08/2021,Oman,Kelantan,0,0,0
1/08/2021,Oman,Melaka,0,0,0
1/08/2021,Oman,Perak,0,0,0
1/08/2021,Oman,Perlis,0,0,0
1/08/2021,Oman,Pulau Pinang,0,0,0
1/08/2021,Oman,Sabah,0,0,0
1/08/2021,Oman,Sarawak,0,0,0
1/08/2021,Oman,Selangor,18,15,3
1/08/2021,Pakistan,Johor,2,2,0
1/08/2021,Pakistan,Kedah,0,0,0
1/08/2021,Pakistan,Kelantan,0,0,0
1/08/2021,Pakistan,Melaka,0,0,0
1/08/2021,Pakistan,Negeri Sembilan,0,0,0
1/08/2021,Pakistan,Pahang,0,0,0
1/08/2021,Pakistan,Perak,0,0,0
1/08/2021,Pakistan,Perlis,0,0,0
1/08/2021,Pakistan,Pulau Pinang,0,0,0
1/08/2021,Pakistan,Sabah,0,0,0
1/08/2021,Pakistan,Sarawak,0,0,0
1/08/2021,Pakistan,Selangor,29,22,7
1/08/2021,Pakistan,W.P. Labuan,0,0,0
1/08/2021,Panama,Johor,0,0,0
1/08/2021,Panama,Kedah,0,0,0
1/08/2021,Panama,Perak,0,0,0
1/08/2021,Panama,Perlis,0,0,0
1/08/2021,Panama,Pulau Pinang,0,0,0
1/08/2021,Panama,Sabah,0,0,0
1/08/2021,Panama,Sarawak,0,0,0
1/08/2021,Panama,Selangor,2,1,1
1/08/2021,Peru,Johor,0,0,0
1/08/2021,Peru,Kedah,0,0,0
1/08/2021,Peru,Kelantan,0,0,0
1/08/2021,Peru,Pahang,0,0,0
1/08/2021,Peru,Perak,0,0,0
1/08/2021,Peru,Perlis,0,0,0
1/08/2021,Peru,Pulau Pinang,0,0,0
1/08/2021,Peru,Sabah,0,0,0
1/08/2021,Peru,Sarawak,0,0,0
1/08/2021,Peru,Selangor,4,2,2
1/08/2021,Peru,W.P. Labuan,0,0,0
1/08/2021,Philippines,Johor,2,1,1
1/08/2021,Philippines,Kedah,0,0,0
1/08/2021,Philippines,Kelantan,0,0,0
1/08/2021,Philippines,Melaka,0,0,0
1/08/2021,Philippines,Negeri Sembilan,0,0,0
1/08/2021,Philippines,Pahang,0,0,0
1/08/2021,Philippines,Perak,0,0,0
1/08/2021,Philippines,Perlis,0,0,0
1/08/2021,Philippines,Pulau Pinang,6,2,4
1/08/2021,Philippines,Sabah,1,1,0
1/08/2021,Philippines,Sarawak,40,37,3
1/08/2021,Philippines,Selangor,361,290,71
1/08/2021,Philippines,Terengganu,0,0,0
1/08/2021,Philippines,W.P. Labuan,7,7,0
1/08/2021,Palau,Johor,0,0,0
1/08/2021,Palau,Pulau Pinang,0,0,0
1/08/2021,Palau,Selangor,0,0,0
1/08/2021,Papua New Guinea,Johor,0,0,0
1/08/2021,Papua New Guinea,Kedah,0,0,0
1/08/2021,Papua New Guinea,Kelantan,0,0,0
1/08/2021,Papua New Guinea,Perak,0,0,0
1/08/2021,Papua New Guinea,Pulau Pinang,0,0,0
1/08/2021,Papua New Guinea,Sabah,0,0,0
1/08/2021,Papua New Guinea,Sarawak,0,0,0
1/08/2021,Papua New Guinea,Selangor,0,0,0
1/08/2021,Poland,Johor,0,0,0
1/08/2021,Poland,Kedah,0,0,0
1/08/2021,Poland,Kelantan,0,0,0
1/08/2021,Poland,Melaka,0,0,0
1/08/2021,Poland,Negeri Sembilan,0,0,0
1/08/2021,Poland,Pahang,0,0,0
1/08/2021,Poland,Perak,0,0,0
1/08/2021,Poland,Perlis,0,0,0
1/08/2021,Poland,Pulau Pinang,0,0,0
1/08/2021,Poland,Sabah,0,0,0
1/08/2021,Poland,Sarawak,0,0,0
1/08/2021,Poland,Selangor,37,32,5
1/08/2021,Poland,Terengganu,0,0,0
1/08/2021,Poland,W.P. Labuan,0,0,0
1/08/2021,"North Korea, Democratic People's Republic of",Selangor,0,0,0
1/08/2021,Portugal,Johor,0,0,0
1/08/2021,Portugal,Kedah,0,0,0
1/08/2021,Portugal,Kelantan,0,0,0
1/08/2021,Portugal,Melaka,0,0,0
1/08/2021,Portugal,Pahang,0,0,0
1/08/2021,Portugal,Perak,0,0,0
1/08/2021,Portugal,Perlis,0,0,0
1/08/2021,Portugal,Pulau Pinang,0,0,0
1/08/2021,Portugal,Sabah,0,0,0
1/08/2021,Portugal,Sarawak,0,0,0
1/08/2021,Portugal,Selangor,18,5,13
1/08/2021,Portugal,W.P. Labuan,0,0,0
1/08/2021,Paraguay,Johor,0,0,0
1/08/2021,Paraguay,Kedah,0,0,0
1/08/2021,Paraguay,Perak,0,0,0
1/08/2021,Paraguay,Perlis,0,0,0
1/08/2021,Paraguay,Pulau Pinang,0,0,0
1/08/2021,Paraguay,Sabah,0,0,0
1/08/2021,Paraguay,Sarawak,0,0,0
1/08/2021,Paraguay,Selangor,0,0,0
1/08/2021,"Palestine, State of",Johor,0,0,0
1/08/2021,"Palestine, State of",Kedah,0,0,0
1/08/2021,"Palestine, State of",Kelantan,0,0,0
1/08/2021,"Palestine, State of",Melaka,0,0,0
1/08/2021,"Palestine, State of",Perak,0,0,0
1/08/2021,"Palestine, State of",Perlis,0,0,0
1/08/2021,"Palestine, State of",Pulau Pinang,0,0,0
1/08/2021,"Palestine, State of",Sabah,0,0,0
1/08/2021,"Palestine, State of",Sarawak,0,0,0
1/08/2021,"Palestine, State of",Selangor,14,9,5
1/08/2021,Qatar,Johor,0,0,0
1/08/2021,Qatar,Kedah,0,0,0
1/08/2021,Qatar,Perlis,0,0,0
1/08/2021,Qatar,Pulau Pinang,0,0,0
1/08/2021,Qatar,Sabah,0,0,0
1/08/2021,Qatar,Sarawak,0,0,0
1/08/2021,Qatar,Selangor,19,12,7
1/08/2021,Réunion,Johor,0,0,0
1/08/2021,Réunion,Sarawak,0,0,0
1/08/2021,Romania,Johor,0,0,0
1/08/2021,Romania,Kedah,0,0,0
1/08/2021,Romania,Kelantan,0,0,0
1/08/2021,Romania,Negeri Sembilan,0,0,0
1/08/2021,Romania,Pahang,0,0,0
1/08/2021,Romania,Perak,0,0,0
1/08/2021,Romania,Perlis,0,0,0
1/08/2021,Romania,Pulau Pinang,0,0,0
1/08/2021,Romania,Sabah,0,0,0
1/08/2021,Romania,Sarawak,1,1,0
1/08/2021,Romania,Selangor,25,19,6
1/08/2021,Romania,W.P. Labuan,0,0,0
1/08/2021,Russian Federation (Russia),Johor,6,6,0
1/08/2021,Russian Federation (Russia),Kedah,0,0,0
1/08/2021,Russian Federation (Russia),Kelantan,0,0,0
1/08/2021,Russian Federation (Russia),Melaka,0,0,0
1/08/2021,Russian Federation (Russia),Negeri Sembilan,0,0,0
1/08/2021,Russian Federation (Russia),Pahang,0,0,0
1/08/2021,Russian Federation (Russia),Perak,0,0,0
1/08/2021,Russian Federation (Russia),Perlis,0,0,0
1/08/2021,Russian Federation (Russia),Pulau Pinang,0,0,0
1/08/2021,Russian Federation (Russia),Sabah,0,0,0
1/08/2021,Russian Federation (Russia),Sarawak,0,0,0
1/08/2021,Russian Federation (Russia),Selangor,85,63,22
1/08/2021,Russian Federation (Russia),W.P. Labuan,0,0,0
1/08/2021,Rwanda,Johor,0,0,0
1/08/2021,Rwanda,Kedah,0,0,0
1/08/2021,Rwanda,Pulau Pinang,0,0,0
1/08/2021,Rwanda,Selangor,2,1,1
1/08/2021,Saudi Arabia,Johor,0,0,0
1/08/2021,Saudi Arabia,Kedah,0,0,0
1/08/2021,Saudi Arabia,Kelantan,0,0,0
1/08/2021,Saudi Arabia,Melaka,0,0,0
1/08/2021,Saudi Arabia,Perak,0,0,0
1/08/2021,Saudi Arabia,Perlis,0,0,0
1/08/2021,Saudi Arabia,Pulau Pinang,0,0,0
1/08/2021,Saudi Arabia,Sabah,0,0,0
1/08/2021,Saudi Arabia,Sarawak,0,0,0
1/08/2021,Saudi Arabia,Selangor,123,75,48
1/08/2021,Saudi Arabia,W.P. Labuan,0,0,0
1/08/2021,Sudan,Johor,0,0,0
1/08/2021,Sudan,Kedah,0,0,0
1/08/2021,Sudan,Kelantan,0,0,0
1/08/2021,Sudan,Perlis,0,0,0
1/08/2021,Sudan,Pulau Pinang,0,0,0
1/08/2021,Sudan,Sabah,0,0,0
1/08/2021,Sudan,Sarawak,0,0,0
1/08/2021,Sudan,Selangor,33,22,11
1/08/2021,Sudan,W.P. Labuan,0,0,0
1/08/2021,Senegal,Johor,0,0,0
1/08/2021,Senegal,Kedah,0,0,0
1/08/2021,Senegal,Kelantan,0,0,0
1/08/2021,Senegal,Perak,0,0,0
1/08/2021,Senegal,Perlis,0,0,0
1/08/2021,Senegal,Pulau Pinang,0,0,0
1/08/2021,Senegal,Sabah,0,0,0
1/08/2021,Senegal,Sarawak,0,0,0
1/08/2021,Senegal,Selangor,15,11,4
1/08/2021,Singapore,Johor,81,63,18
1/08/2021,Singapore,Kedah,3,3,0
1/08/2021,Singapore,Kelantan,0,0,0
1/08/2021,Singapore,Melaka,0,0,0
1/08/2021,Singapore,Negeri Sembilan,0,0,0
1/08/2021,Singapore,Pahang,0,0,0
1/08/2021,Singapore,Perak,1,0,1
1/08/2021,Singapore,Perlis,0,0,0
1/08/2021,Singapore,Pulau Pinang,12,6,6
1/08/2021,Singapore,Sabah,0,0,0
1/08/2021,Singapore,Sarawak,4,4,0
1/08/2021,Singapore,Selangor,107,75,32
1/08/2021,Singapore,Terengganu,0,0,0
1/08/2021,Singapore,W.P. Labuan,0,0,0
1/08/2021,South Georgia and the South Sandwich Islands,Johor,0,0,0
1/08/2021,South Georgia and the South Sandwich Islands,Sabah,0,0,0
1/08/2021,South Georgia and the South Sandwich Islands,Selangor,0,0,0
1/08/2021,Saint Helena,Sarawak,0,0,0
1/08/2021,Solomon Islands,Johor,0,0,0
1/08/2021,Solomon Islands,Perlis,0,0,0
1/08/2021,Solomon Islands,Pulau Pinang,0,0,0
1/08/2021,Solomon Islands,Sabah,0,0,0
1/08/2021,Solomon Islands,Sarawak,0,0,0
1/08/2021,Solomon Islands,Selangor,0,0,0
1/08/2021,Solomon Islands,W.P. Labuan,0,0,0
1/08/2021,Sierra Leone,Johor,0,0,0
1/08/2021,Sierra Leone,Kedah,0,0,0
1/08/2021,Sierra Leone,Perak,0,0,0
1/08/2021,Sierra Leone,Pulau Pinang,0,0,0
1/08/2021,Sierra Leone,Sabah,0,0,0
1/08/2021,Sierra Leone,Selangor,0,0,0
1/08/2021,El Salvador,Johor,0,0,0
1/08/2021,El Salvador,Kedah,0,0,0
1/08/2021,El Salvador,Perak,0,0,0
1/08/2021,El Salvador,Perlis,0,0,0
1/08/2021,El Salvador,Pulau Pinang,0,0,0
1/08/2021,El Salvador,Sabah,0,0,0
1/08/2021,El Salvador,Selangor,0,0,0
1/08/2021,El Salvador,W.P. Labuan,0,0,0
1/08/2021,San Marino,Johor,0,0,0
1/08/2021,San Marino,Selangor,0,0,0
1/08/2021,Somalia,Johor,0,0,0
1/08/2021,Somalia,Kedah,0,0,0
1/08/2021,Somalia,Kelantan,0,0,0
1/08/2021,Somalia,Perlis,0,0,0
1/08/2021,Somalia,Sabah,0,0,0
1/08/2021,Somalia,Sarawak,0,0,0
1/08/2021,Somalia,Selangor,19,9,10
1/08/2021,Serbia,Johor,0,0,0
1/08/2021,Serbia,Kedah,0,0,0
1/08/2021,Serbia,Kelantan,0,0,0
1/08/2021,Serbia,Pahang,0,0,0
1/08/2021,Serbia,Perak,0,0,0
1/08/2021,Serbia,Perlis,0,0,0
1/08/2021,Serbia,Pulau Pinang,0,0,0
1/08/2021,Serbia,Sabah,0,0,0
1/08/2021,Serbia,Sarawak,0,0,0
1/08/2021,Serbia,Selangor,6,3,3
1/08/2021,South Sudan,Johor,0,0,0
1/08/2021,South Sudan,Kedah,0,0,0
1/08/2021,South Sudan,Sarawak,0,0,0
1/08/2021,South Sudan,Selangor,3,3,0
1/08/2021,South Sudan,W.P. Labuan,0,0,0
1/08/2021,Sao Tome and Principe,Selangor,0,0,0
1/08/2021,Suriname,Johor,0,0,0
1/08/2021,Suriname,Kedah,0,0,0
1/08/2021,Suriname,Kelantan,0,0,0
1/08/2021,Suriname,Perak,0,0,0
1/08/2021,Suriname,Perlis,0,0,0
1/08/2021,Suriname,Pulau Pinang,0,0,0
1/08/2021,Suriname,Sabah,0,0,0
1/08/2021,Suriname,Sarawak,0,0,0
1/08/2021,Suriname,Selangor,0,0,0
1/08/2021,Slovakia,Johor,0,0,0
1/08/2021,Slovakia,Kedah,0,0,0
1/08/2021,Slovakia,Kelantan,0,0,0
1/08/2021,Slovakia,Negeri Sembilan,0,0,0
1/08/2021,Slovakia,Pahang,0,0,0
1/08/2021,Slovakia,Perak,0,0,0
1/08/2021,Slovakia,Perlis,0,0,0
1/08/2021,Slovakia,Pulau Pinang,0,0,0
1/08/2021,Slovakia,Sabah,0,0,0
1/08/2021,Slovakia,Sarawak,0,0,0
1/08/2021,Slovakia,Selangor,11,6,5
1/08/2021,Slovakia,W.P. Labuan,0,0,0
1/08/2021,Slovenia,Johor,0,0,0
1/08/2021,Slovenia,Kedah,0,0,0
1/08/2021,Slovenia,Kelantan,0,0,0
1/08/2021,Slovenia,Perak,0,0,0
1/08/2021,Slovenia,Perlis,0,0,0
1/08/2021,Slovenia,Pulau Pinang,0,0,0
1/08/2021,Slovenia,Sabah,0,0,0
1/08/2021,Slovenia,Sarawak,0,0,0
1/08/2021,Slovenia,Selangor,2,1,1
1/08/2021,Slovenia,W.P. Labuan,0,0,0
1/08/2021,Sweden,Johor,0,0,0
1/08/2021,Sweden,Kedah,0,0,0
1/08/2021,Sweden,Kelantan,0,0,0
1/08/2021,Sweden,Melaka,0,0,0
1/08/2021,Sweden,Negeri Sembilan,0,0,0
1/08/2021,Sweden,Pahang,0,0,0
1/08/2021,Sweden,Perak,0,0,0
1/08/2021,Sweden,Perlis,0,0,0
1/08/2021,Sweden,Pulau Pinang,0,0,0
1/08/2021,Sweden,Sabah,0,0,0
1/08/2021,Sweden,Sarawak,0,0,0
1/08/2021,Sweden,Selangor,35,26,9
1/08/2021,Sweden,W.P. Labuan,0,0,0
1/08/2021,Eswatini,Johor,0,0,0
1/08/2021,Eswatini,Kedah,0,0,0
1/08/2021,Eswatini,Pulau Pinang,0,0,0
1/08/2021,Eswatini,Sabah,0,0,0
1/08/2021,Eswatini,Selangor,0,0,0
1/08/2021,Seychelles,Johor,0,0,0
1/08/2021,Seychelles,Kedah,0,0,0
1/08/2021,Seychelles,Pulau Pinang,0,0,0
1/08/2021,Seychelles,Sabah,0,0,0
1/08/2021,Seychelles,Sarawak,0,0,0
1/08/2021,Seychelles,Selangor,4,3,1
1/08/2021,Syrian Arab Republic,Johor,0,0,0
1/08/2021,Syrian Arab Republic,Kedah,0,0,0
1/08/2021,Syrian Arab Republic,Kelantan,0,0,0
1/08/2021,Syrian Arab Republic,Pahang,0,0,0
1/08/2021,Syrian Arab Republic,Perlis,0,0,0
1/08/2021,Syrian Arab Republic,Pulau Pinang,0,0,0
1/08/2021,Syrian Arab Republic,Sabah,0,0,0
1/08/2021,Syrian Arab Republic,Sarawak,0,0,0
1/08/2021,Syrian Arab Republic,Selangor,22,15,7
1/08/2021,Syrian Arab Republic,W.P. Labuan,0,0,0
1/08/2021,Turks and Caicos Islands,Perlis,0,0,0
1/08/2021,TCD,Johor,0,0,0
1/08/2021,TCD,Kedah,0,0,0
1/08/2021,TCD,Perlis,0,0,0
1/08/2021,TCD,Selangor,2,1,1
1/08/2021,Togo,Johor,0,0,0
1/08/2021,Togo,Perak,0,0,0
1/08/2021,Togo,Pulau Pinang,0,0,0
1/08/2021,Togo,Selangor,0,0,0
1/08/2021,Thailand,Johor,12,12,0
1/08/2021,Thailand,Kedah,16335,16295,40
1/08/2021,Thailand,Kelantan,0,0,0
1/08/2021,Thailand,Melaka,0,0,0
1/08/2021,Thailand,Negeri Sembilan,0,0,0
1/08/2021,Thailand,Pahang,0,0,0
1/08/2021,Thailand,Perak,0,0,0
1/08/2021,Thailand,Perlis,7375,7314,61
1/08/2021,Thailand,Pulau Pinang,126,124,2
1/08/2021,Thailand,Sabah,0,0,0
1/08/2021,Thailand,Sarawak,10,9,1
1/08/2021,Thailand,Selangor,196,144,52
1/08/2021,Thailand,Terengganu,0,0,0
1/08/2021,Thailand,W.P. Labuan,0,0,0
1/08/2021,Tajikistan,Johor,0,0,0
1/08/2021,Tajikistan,Kedah,0,0,0
1/08/2021,Tajikistan,Perlis,0,0,0
1/08/2021,Tajikistan,Pulau Pinang,0,0,0
1/08/2021,Tajikistan,Sabah,0,0,0
1/08/2021,Tajikistan,Selangor,2,2,0
1/08/2021,Tokelau,Selangor,0,0,0
1/08/2021,Turkmenistan,Johor,0,0,0
1/08/2021,Turkmenistan,Kedah,0,0,0
1/08/2021,Turkmenistan,Kelantan,0,0,0
1/08/2021,Turkmenistan,Perlis,0,0,0
1/08/2021,Turkmenistan,Pulau Pinang,0,0,0
1/08/2021,Turkmenistan,Sabah,0,0,0
1/08/2021,Turkmenistan,Sarawak,0,0,0
1/08/2021,Turkmenistan,Selangor,2,1,1
1/08/2021,Timor-Leste,Johor,0,0,0
1/08/2021,Timor-Leste,Kedah,0,0,0
1/08/2021,Timor-Leste,Perlis,0,0,0
1/08/2021,Timor-Leste,Pulau Pinang,0,0,0
1/08/2021,Timor-Leste,Sabah,0,0,0
1/08/2021,Timor-Leste,Sarawak,0,0,0
1/08/2021,Timor-Leste,Selangor,1,0,1
1/08/2021,Tonga,Johor,0,0,0
1/08/2021,Tonga,Pulau Pinang,0,0,0
1/08/2021,Tonga,Sarawak,0,0,0
1/08/2021,Tonga,Selangor,0,0,0
1/08/2021,Trinidad and Tobago,Johor,0,0,0
1/08/2021,Trinidad and Tobago,Kedah,0,0,0
1/08/2021,Trinidad and Tobago,Pahang,0,0,0
1/08/2021,Trinidad and Tobago,Pulau Pinang,0,0,0
1/08/2021,Trinidad and Tobago,Sabah,0,0,0
1/08/2021,Trinidad and Tobago,Sarawak,0,0,0
1/08/2021,Trinidad and Tobago,Selangor,0,0,0
1/08/2021,Tunisia,Johor,0,0,0
1/08/2021,Tunisia,Kedah,0,0,0
1/08/2021,Tunisia,Kelantan,0,0,0
1/08/2021,Tunisia,Melaka,0,0,0
1/08/2021,Tunisia,Perak,0,0,0
1/08/2021,Tunisia,Perlis,0,0,0
1/08/2021,Tunisia,Pulau Pinang,0,0,0
1/08/2021,Tunisia,Sabah,0,0,0
1/08/2021,Tunisia,Sarawak,0,0,0
1/08/2021,Tunisia,Selangor,2,1,1
1/08/2021,Tunisia,W.P. Labuan,0,0,0
1/08/2021,Türkiye,Johor,0,0,0
1/08/2021,Türkiye,Kedah,0,0,0
1/08/2021,Türkiye,Kelantan,0,0,0
1/08/2021,Türkiye,Melaka,0,0,0
1/08/2021,Türkiye,Negeri Sembilan,0,0,0
1/08/2021,Türkiye,Pahang,0,0,0
1/08/2021,Türkiye,Perak,0,0,0
1/08/2021,Türkiye,Perlis,0,0,0
1/08/2021,Türkiye,Pulau Pinang,0,0,0
1/08/2021,Türkiye,Sabah,0,0,0
1/08/2021,Türkiye,Sarawak,0,0,0
1/08/2021,Türkiye,Selangor,66,45,21
1/08/2021,Türkiye,W.P. Labuan,0,0,0
1/08/2021,Tuvalu,Selangor,0,0,0
1/08/2021,"Taiwan, Province of China",Johor,0,0,0
1/08/2021,"Taiwan, Province of China",Kedah,0,0,0
1/08/2021,"Taiwan, Province of China",Kelantan,0,0,0
1/08/2021,"Taiwan, Province of China",Melaka,0,0,0
1/08/2021,"Taiwan, Province of China",Negeri Sembilan,0,0,0
1/08/2021,"Taiwan, Province of China",Pahang,0,0,0
1/08/2021,"Taiwan, Province of China",Perak,0,0,0
1/08/2021,"Taiwan, Province of China",Perlis,0,0,0
1/08/2021,"Taiwan, Province of China",Pulau Pinang,8,5,3
1/08/2021,"Taiwan, Province of China",Sabah,0,0,0
1/08/2021,"Taiwan, Province of China",Sarawak,1,1,0
1/08/2021,"Taiwan, Province of China",Selangor,73,55,18
1/08/2021,"Taiwan, Province of China",W.P. Labuan,0,0,0
1/08/2021,"Tanzania, United Republic of",Johor,0,0,0
1/08/2021,"Tanzania, United Republic of",Kedah,0,0,0
1/08/2021,"Tanzania, United Republic of",Perak,0,0,0
1/08/2021,"Tanzania, United Republic of",Perlis,0,0,0
1/08/2021,"Tanzania, United Republic of",Pulau Pinang,0,0,0
1/08/2021,"Tanzania, United Republic of",Sabah,0,0,0
1/08/2021,"Tanzania, United Republic of",Sarawak,0,0,0
1/08/2021,"Tanzania, United Republic of",Selangor,16,14,2
1/08/2021,Uganda,Johor,0,0,0
1/08/2021,Uganda,Kedah,0,0,0
1/08/2021,Uganda,Perak,0,0,0
1/08/2021,Uganda,Perlis,0,0,0
1/08/2021,Uganda,Pulau Pinang,0,0,0
1/08/2021,Uganda,Sabah,0,0,0
1/08/2021,Uganda,Sarawak,0,0,0
1/08/2021,Uganda,Selangor,2,1,1
1/08/2021,Ukraine,Johor,0,0,0
1/08/2021,Ukraine,Kedah,0,0,0
1/08/2021,Ukraine,Kelantan,0,0,0
1/08/2021,Ukraine,Melaka,0,0,0
1/08/2021,Ukraine,Negeri Sembilan,0,0,0
1/08/2021,Ukraine,Pahang,0,0,0
1/08/2021,Ukraine,Perak,0,0,0
1/08/2021,Ukraine,Perlis,0,0,0
1/08/2021,Ukraine,Pulau Pinang,0,0,0
1/08/2021,Ukraine,Sabah,0,0,0
1/08/2021,Ukraine,Sarawak,0,0,0
1/08/2021,Ukraine,Selangor,100,95,5
1/08/2021,Ukraine,W.P. Labuan,0,0,0
1/08/2021,Uruguay,Johor,0,0,0
1/08/2021,Uruguay,Kedah,0,0,0
1/08/2021,Uruguay,Kelantan,0,0,0
1/08/2021,Uruguay,Perak,0,0,0
1/08/2021,Uruguay,Perlis,0,0,0
1/08/2021,Uruguay,Pulau Pinang,0,0,0
1/08/2021,Uruguay,Sabah,0,0,0
1/08/2021,Uruguay,Sarawak,0,0,0
1/08/2021,Uruguay,Selangor,0,0,0
1/08/2021,Uruguay,W.P. Labuan,0,0,0
1/08/2021,United States of America,Johor,0,0,0
1/08/2021,United States of America,Kedah,0,0,0
1/08/2021,United States of America,Kelantan,0,0,0
1/08/2021,United States of America,Melaka,0,0,0
1/08/2021,United States of America,Negeri Sembilan,0,0,0
1/08/2021,United States of America,Pahang,0,0,0
1/08/2021,United States of America,Perak,0,0,0
1/08/2021,United States of America,Perlis,0,0,0
1/08/2021,United States of America,Pulau Pinang,11,8,3
1/08/2021,United States of America,Sabah,0,0,0
1/08/2021,United States of America,Sarawak,0,0,0
1/08/2021,United States of America,Selangor,262,156,106
1/08/2021,United States of America,Terengganu,0,0,0
1/08/2021,United States of America,W.P. Labuan,0,0,0
1/08/2021,Uzbekistan,Johor,0,0,0
1/08/2021,Uzbekistan,Kedah,0,0,0
1/08/2021,Uzbekistan,Kelantan,0,0,0
1/08/2021,Uzbekistan,Perak,0,0,0
1/08/2021,Uzbekistan,Perlis,0,0,0
1/08/2021,Uzbekistan,Pulau Pinang,0,0,0
1/08/2021,Uzbekistan,Sabah,0,0,0
1/08/2021,Uzbekistan,Sarawak,0,0,0
1/08/2021,Uzbekistan,Selangor,9,5,4
1/08/2021,Holy See,Johor,0,0,0
1/08/2021,Holy See,Sarawak,0,0,0
1/08/2021,Holy See,Selangor,0,0,0
1/08/2021,Saint Vincent and the Grenadines,Johor,0,0,0
1/08/2021,Saint Vincent and the Grenadines,Kedah,0,0,0
1/08/2021,Saint Vincent and the Grenadines,Pulau Pinang,0,0,0
1/08/2021,Saint Vincent and the Grenadines,Sarawak,0,0,0
1/08/2021,Saint Vincent and the Grenadines,Selangor,0,0,0
1/08/2021,"Venezuela, Bolivarian Republic of",Johor,0,0,0
1/08/2021,"Venezuela, Bolivarian Republic of",Kedah,0,0,0
1/08/2021,"Venezuela, Bolivarian Republic of",Kelantan,0,0,0
1/08/2021,"Venezuela, Bolivarian Republic of",Melaka,0,0,0
1/08/2021,"Venezuela, Bolivarian Republic of",Perak,0,0,0
1/08/2021,"Venezuela, Bolivarian Republic of",Perlis,0,0,0
1/08/2021,"Venezuela, Bolivarian Republic of",Pulau Pinang,0,0,0
1/08/2021,"Venezuela, Bolivarian Republic of",Sabah,0,0,0
1/08/2021,"Venezuela, Bolivarian Republic of",Sarawak,0,0,0
1/08/2021,"Venezuela, Bolivarian Republic of",Selangor,7,5,2
1/08/2021,"Venezuela, Bolivarian Republic of",W.P. Labuan,0,0,0
1/08/2021,Viet Nam,Johor,0,0,0
1/08/2021,Viet Nam,Kedah,0,0,0
1/08/2021,Viet Nam,Kelantan,0,0,0
1/08/2021,Viet Nam,Melaka,0,0,0
1/08/2021,Viet Nam,Negeri Sembilan,0,0,0
1/08/2021,Viet Nam,Pahang,0,0,0
1/08/2021,Viet Nam,Perak,0,0,0
1/08/2021,Viet Nam,Perlis,0,0,0
1/08/2021,Viet Nam,Pulau Pinang,0,0,0
1/08/2021,Viet Nam,Sabah,0,0,0
1/08/2021,Viet Nam,Sarawak,0,0,0
1/08/2021,Viet Nam,Selangor,35,22,13
1/08/2021,Viet Nam,Terengganu,0,0,0
1/08/2021,Viet Nam,W.P. Labuan,0,0,0
1/08/2021,Vanuatu,Johor,0,0,0
1/08/2021,Vanuatu,Kedah,0,0,0
1/08/2021,Vanuatu,Pulau Pinang,0,0,0
1/08/2021,Vanuatu,Sabah,0,0,0
1/08/2021,Vanuatu,Sarawak,0,0,0
1/08/2021,Vanuatu,Selangor,0,0,0
1/08/2021, Samoa,Johor,0,0,0
1/08/2021, Samoa,Sarawak,0,0,0
1/08/2021, Samoa,Selangor,0,0,0
1/08/2021,Yemen,Johor,0,0,0
1/08/2021,Yemen,Kedah,0,0,0
1/08/2021,Yemen,Kelantan,0,0,0
1/08/2021,Yemen,Melaka,0,0,0
1/08/2021,Yemen,Pahang,0,0,0
1/08/2021,Yemen,Perak,0,0,0
1/08/2021,Yemen,Perlis,0,0,0
1/08/2021,Yemen,Pulau Pinang,0,0,0
1/08/2021,Yemen,Sabah,0,0,0
1/08/2021,Yemen,Sarawak,0,0,0
1/08/2021,Yemen,Selangor,63,40,23
1/08/2021,Yemen,W.P. Labuan,0,0,0
1/08/2021,South Africa,Johor,0,0,0
1/08/2021,South Africa,Kedah,0,0,0
1/08/2021,South Africa,Kelantan,0,0,0
1/08/2021,South Africa,Melaka,0,0,0
1/08/2021,South Africa,Pahang,0,0,0
1/08/2021,South Africa,Perak,0,0,0
1/08/2021,South Africa,Perlis,0,0,0
1/08/2021,South Africa,Pulau Pinang,0,0,0
1/08/2021,South Africa,Sabah,0,0,0
1/08/2021,South Africa,Sarawak,0,0,0
1/08/2021,South Africa,Selangor,30,20,10
1/08/2021,South Africa,Terengganu,0,0,0
1/08/2021,South Africa,W.P. Labuan,0,0,0
1/08/2021,ZAR,Selangor,0,0,0
1/08/2021,Zambia,Johor,0,0,0
1/08/2021,Zambia,Kedah,0,0,0
1/08/2021,Zambia,Perak,0,0,0
1/08/2021,Zambia,Perlis,0,0,0
1/08/2021,Zambia,Pulau Pinang,0,0,0
1/08/2021,Zambia,Sabah,0,0,0
1/08/2021,Zambia,Sarawak,0,0,0
1/08/2021,Zambia,Selangor,8,4,4
1/08/2021,Zimbabwe,Johor,0,0,0
1/08/2021,Zimbabwe,Kedah,0,0,0
1/08/2021,Zimbabwe,Kelantan,0,0,0
1/08/2021,Zimbabwe,Perak,0,0,0
1/08/2021,Zimbabwe,Perlis,0,0,0
1/08/2021,Zimbabwe,Pulau Pinang,0,0,0
1/08/2021,Zimbabwe,Sabah,0,0,0
1/08/2021,Zimbabwe,Sarawak,0,0,0
1/08/2021,Zimbabwe,Selangor,15,4,11
1/09/2021,Aruba,Kedah,0,0,0
1/09/2021,Aruba,Pulau Pinang,0,0,0
1/09/2021,Afghanistan,Johor,0,0,0
1/09/2021,Afghanistan,Kedah,0,0,0
1/09/2021,Afghanistan,Perlis,0,0,0
1/09/2021,Afghanistan,Pulau Pinang,0,0,0
1/09/2021,Afghanistan,Sarawak,0,0,0
1/09/2021,Afghanistan,Selangor,8,4,4
1/09/2021,Angola,Johor,0,0,0
1/09/2021,Angola,Kedah,0,0,0
1/09/2021,Angola,Sabah,0,0,0
1/09/2021,Angola,Selangor,0,0,0
1/09/2021,Anguilla,Selangor,0,0,0
1/09/2021,Albania,Johor,0,0,0
1/09/2021,Albania,Kedah,0,0,0
1/09/2021,Albania,Perak,0,0,0
1/09/2021,Albania,Perlis,0,0,0
1/09/2021,Albania,Pulau Pinang,0,0,0
1/09/2021,Albania,Sabah,0,0,0
1/09/2021,Albania,Sarawak,0,0,0
1/09/2021,Albania,Selangor,2,1,1
1/09/2021,Andorra,Johor,0,0,0
1/09/2021,Andorra,Kedah,0,0,0
1/09/2021,Andorra,Perlis,0,0,0
1/09/2021,Andorra,Pulau Pinang,0,0,0
1/09/2021,Andorra,Selangor,0,0,0
1/09/2021,Antigua and Barbuda,Selangor,0,0,0
1/09/2021,United Arab Emirates,Johor,0,0,0
1/09/2021,United Arab Emirates,Kedah,0,0,0
1/09/2021,United Arab Emirates,Kelantan,0,0,0
1/09/2021,United Arab Emirates,Perak,0,0,0
1/09/2021,United Arab Emirates,Perlis,0,0,0
1/09/2021,United Arab Emirates,Pulau Pinang,0,0,0
1/09/2021,United Arab Emirates,Sabah,0,0,0
1/09/2021,United Arab Emirates,Sarawak,43,43,0
1/09/2021,United Arab Emirates,Selangor,2,1,1
1/09/2021,Argentina,Johor,0,0,0
1/09/2021,Argentina,Kedah,0,0,0
1/09/2021,Argentina,Kelantan,0,0,0
1/09/2021,Argentina,Melaka,0,0,0
1/09/2021,Argentina,Perak,0,0,0
1/09/2021,Argentina,Perlis,0,0,0
1/09/2021,Argentina,Pulau Pinang,0,0,0
1/09/2021,Argentina,Sabah,0,0,0
1/09/2021,Argentina,Sarawak,0,0,0
1/09/2021,Argentina,Selangor,4,1,3
1/09/2021,Argentina,W.P. Labuan,0,0,0
1/09/2021,Armenia,Johor,0,0,0
1/09/2021,Armenia,Kedah,0,0,0
1/09/2021,Armenia,Kelantan,0,0,0
1/09/2021,Armenia,Perak,0,0,0
1/09/2021,Armenia,Perlis,0,0,0
1/09/2021,Armenia,Pulau Pinang,0,0,0
1/09/2021,Armenia,Sabah,0,0,0
1/09/2021,Armenia,Sarawak,0,0,0
1/09/2021,Armenia,Selangor,0,0,0
1/09/2021,Antarctica,Selangor,0,0,0
1/09/2021,Antigua and Barbuda,Johor,0,0,0
1/09/2021,Antigua and Barbuda,Kedah,0,0,0
1/09/2021,Antigua and Barbuda,Pulau Pinang,0,0,0
1/09/2021,Antigua and Barbuda,Sarawak,0,0,0
1/09/2021,Antigua and Barbuda,Selangor,0,0,0
1/09/2021,Australia,Johor,1,1,0
1/09/2021,Australia,Kedah,0,0,0
1/09/2021,Australia,Kelantan,0,0,0
1/09/2021,Australia,Melaka,0,0,0
1/09/2021,Australia,Negeri Sembilan,0,0,0
1/09/2021,Australia,Pahang,0,0,0
1/09/2021,Australia,Perak,0,0,0
1/09/2021,Australia,Perlis,0,0,0
1/09/2021,Australia,Pulau Pinang,4,3,1
1/09/2021,Australia,Sabah,0,0,0
1/09/2021,Australia,Sarawak,0,0,0
1/09/2021,Australia,Selangor,96,63,33
1/09/2021,Australia,Terengganu,0,0,0
1/09/2021,Australia,W.P. Labuan,0,0,0
1/09/2021,Austria,Johor,0,0,0
1/09/2021,Austria,Kedah,0,0,0
1/09/2021,Austria,Kelantan,1,1,0
1/09/2021,Austria,Melaka,0,0,0
1/09/2021,Austria,Negeri Sembilan,0,0,0
1/09/2021,Austria,Pahang,0,0,0
1/09/2021,Austria,Perak,0,0,0
1/09/2021,Austria,Perlis,0,0,0
1/09/2021,Austria,Pulau Pinang,1,0,1
1/09/2021,Austria,Sabah,0,0,0
1/09/2021,Austria,Sarawak,0,0,0
1/09/2021,Austria,Selangor,31,27,4
1/09/2021,Austria,Terengganu,0,0,0
1/09/2021,Austria,W.P. Labuan,0,0,0
1/09/2021,Azerbaijan,Johor,0,0,0
1/09/2021,Azerbaijan,Kedah,0,0,0
1/09/2021,Azerbaijan,Kelantan,0,0,0
1/09/2021,Azerbaijan,Melaka,0,0,0
1/09/2021,Azerbaijan,Perlis,0,0,0
1/09/2021,Azerbaijan,Pulau Pinang,0,0,0
1/09/2021,Azerbaijan,Sabah,0,0,0
1/09/2021,Azerbaijan,Sarawak,0,0,0
1/09/2021,Azerbaijan,Selangor,2,1,1
1/09/2021,Azerbaijan,W.P. Labuan,0,0,0
1/09/2021,Burundi,Pulau Pinang,0,0,0
1/09/2021,Burundi,Sarawak,0,0,0
1/09/2021,Burundi,Selangor,0,0,0
1/09/2021,Belgium,Johor,0,0,0
1/09/2021,Belgium,Kedah,0,0,0
1/09/2021,Belgium,Kelantan,0,0,0
1/09/2021,Belgium,Melaka,0,0,0
1/09/2021,Belgium,Negeri Sembilan,0,0,0
1/09/2021,Belgium,Pahang,0,0,0
1/09/2021,Belgium,Perak,0,0,0
1/09/2021,Belgium,Perlis,0,0,0
1/09/2021,Belgium,Pulau Pinang,2,1,1
1/09/2021,Belgium,Sabah,0,0,0
1/09/2021,Belgium,Sarawak,0,0,0
1/09/2021,Belgium,Selangor,26,13,13
1/09/2021,Belgium,W.P. Labuan,0,0,0
1/09/2021,Benin,Johor,0,0,0
1/09/2021,Benin,Kedah,0,0,0
1/09/2021,Benin,Perak,0,0,0
1/09/2021,Benin,Pulau Pinang,0,0,0
1/09/2021,Benin,Sabah,0,0,0
1/09/2021,Benin,Sarawak,0,0,0
1/09/2021,Benin,Selangor,0,0,0
1/09/2021,Burkina Faso,Perak,0,0,0
1/09/2021,Burkina Faso,Pulau Pinang,0,0,0
1/09/2021,Burkina Faso,Selangor,1,0,1
1/09/2021,Bangladesh,Johor,2,2,0
1/09/2021,Bangladesh,Kedah,0,0,0
1/09/2021,Bangladesh,Kelantan,0,0,0
1/09/2021,Bangladesh,Melaka,0,0,0
1/09/2021,Bangladesh,Negeri Sembilan,0,0,0
1/09/2021,Bangladesh,Pahang,0,0,0
1/09/2021,Bangladesh,Perak,0,0,0
1/09/2021,Bangladesh,Perlis,0,0,0
1/09/2021,Bangladesh,Pulau Pinang,0,0,0
1/09/2021,Bangladesh,Sabah,0,0,0
1/09/2021,Bangladesh,Sarawak,1,1,0
1/09/2021,Bangladesh,Selangor,31,22,9
1/09/2021,Bangladesh,W.P. Labuan,0,0,0
1/09/2021,Bulgaria,Johor,0,0,0
1/09/2021,Bulgaria,Kedah,0,0,0
1/09/2021,Bulgaria,Kelantan,0,0,0
1/09/2021,Bulgaria,Pahang,0,0,0
1/09/2021,Bulgaria,Perak,0,0,0
1/09/2021,Bulgaria,Perlis,0,0,0
1/09/2021,Bulgaria,Pulau Pinang,0,0,0
1/09/2021,Bulgaria,Sabah,0,0,0
1/09/2021,Bulgaria,Sarawak,0,0,0
1/09/2021,Bulgaria,Selangor,9,7,2
1/09/2021,Bulgaria,W.P. Labuan,0,0,0
1/09/2021,Bahrain,Johor,0,0,0
1/09/2021,Bahrain,Kedah,0,0,0
1/09/2021,Bahrain,Kelantan,0,0,0
1/09/2021,Bahrain,Perlis,0,0,0
1/09/2021,Bahrain,Pulau Pinang,0,0,0
1/09/2021,Bahrain,Sabah,0,0,0
1/09/2021,Bahrain,Sarawak,0,0,0
1/09/2021,Bahrain,Selangor,0,0,0
1/09/2021,Bahamas,Johor,0,0,0
1/09/2021,Bahamas,Kedah,0,0,0
1/09/2021,Bahamas,Perak,0,0,0
1/09/2021,Bahamas,Sabah,0,0,0
1/09/2021,Bahamas,Sarawak,0,0,0
1/09/2021,Bahamas,Selangor,0,0,0
1/09/2021,Bosnia and Herzegovina,Johor,0,0,0
1/09/2021,Bosnia and Herzegovina,Kedah,0,0,0
1/09/2021,Bosnia and Herzegovina,Perlis,0,0,0
1/09/2021,Bosnia and Herzegovina,Pulau Pinang,0,0,0
1/09/2021,Bosnia and Herzegovina,Sabah,0,0,0
1/09/2021,Bosnia and Herzegovina,Sarawak,0,0,0
1/09/2021,Bosnia and Herzegovina,Selangor,4,2,2
1/09/2021,Belarus,Johor,0,0,0
1/09/2021,Belarus,Kedah,0,0,0
1/09/2021,Belarus,Kelantan,0,0,0
1/09/2021,Belarus,Pahang,0,0,0
1/09/2021,Belarus,Perak,0,0,0
1/09/2021,Belarus,Perlis,0,0,0
1/09/2021,Belarus,Pulau Pinang,0,0,0
1/09/2021,Belarus,Sabah,0,0,0
1/09/2021,Belarus,Sarawak,0,0,0
1/09/2021,Belarus,Selangor,2,1,1
1/09/2021,Belarus,W.P. Labuan,0,0,0
1/09/2021,Belize,Johor,0,0,0
1/09/2021,Belize,Pulau Pinang,0,0,0
1/09/2021,Belize,Sarawak,0,0,0
1/09/2021,Belize,Selangor,0,0,0
1/09/2021,Bermuda,Selangor,0,0,0
1/09/2021,Bolivia,Johor,0,0,0
1/09/2021,Bolivia,Kedah,0,0,0
1/09/2021,Bolivia,Melaka,0,0,0
1/09/2021,Bolivia,Perak,0,0,0
1/09/2021,Bolivia,Perlis,0,0,0
1/09/2021,Bolivia,Pulau Pinang,0,0,0
1/09/2021,Bolivia,Sabah,0,0,0
1/09/2021,Bolivia,Sarawak,0,0,0
1/09/2021,Bolivia,Selangor,0,0,0
1/09/2021,Brazil,Johor,0,0,0
1/09/2021,Brazil,Kedah,0,0,0
1/09/2021,Brazil,Kelantan,0,0,0
1/09/2021,Brazil,Melaka,0,0,0
1/09/2021,Brazil,Pahang,0,0,0
1/09/2021,Brazil,Perak,0,0,0
1/09/2021,Brazil,Perlis,0,0,0
1/09/2021,Brazil,Pulau Pinang,0,0,0
1/09/2021,Brazil,Sabah,0,0,0
1/09/2021,Brazil,Sarawak,0,0,0
1/09/2021,Brazil,Selangor,11,5,6
1/09/2021,Brazil,W.P. Labuan,0,0,0
1/09/2021,Barbados,Johor,0,0,0
1/09/2021,Barbados,Kedah,0,0,0
1/09/2021,Barbados,Perlis,0,0,0
1/09/2021,Barbados,Pulau Pinang,0,0,0
1/09/2021,Barbados,Selangor,1,1,0
1/09/2021,Brunei Darussalam,Johor,0,0,0
1/09/2021,Brunei Darussalam,Kedah,0,0,0
1/09/2021,Brunei Darussalam,Kelantan,0,0,0
1/09/2021,Brunei Darussalam,Melaka,0,0,0
1/09/2021,Brunei Darussalam,Pahang,0,0,0
1/09/2021,Brunei Darussalam,Perak,0,0,0
1/09/2021,Brunei Darussalam,Perlis,0,0,0
1/09/2021,Brunei Darussalam,Pulau Pinang,0,0,0
1/09/2021,Brunei Darussalam,Sabah,0,0,0
1/09/2021,Brunei Darussalam,Sarawak,234,234,0
1/09/2021,Brunei Darussalam,Selangor,38,32,6
1/09/2021,Brunei Darussalam,W.P. Labuan,0,0,0
1/09/2021,Bhutan,Johor,0,0,0
1/09/2021,Bhutan,Kedah,0,0,0
1/09/2021,Bhutan,Perak,0,0,0
1/09/2021,Bhutan,Perlis,0,0,0
1/09/2021,Bhutan,Pulau Pinang,0,0,0
1/09/2021,Bhutan,Sabah,0,0,0
1/09/2021,Bhutan,Sarawak,0,0,0
1/09/2021,Bhutan,Selangor,1,1,0
1/09/2021,Botswana,Johor,0,0,0
1/09/2021,Botswana,Kedah,0,0,0
1/09/2021,Botswana,Perlis,0,0,0
1/09/2021,Botswana,Pulau Pinang,0,0,0
1/09/2021,Botswana,Sabah,0,0,0
1/09/2021,Botswana,Sarawak,0,0,0
1/09/2021,Botswana,Selangor,0,0,0
1/09/2021,Central African Republic,Kedah,0,0,0
1/09/2021,Central African Republic,Selangor,0,0,0
1/09/2021,Canada,Johor,0,0,0
1/09/2021,Canada,Kedah,0,0,0
1/09/2021,Canada,Kelantan,0,0,0
1/09/2021,Canada,Melaka,0,0,0
1/09/2021,Canada,Negeri Sembilan,0,0,0
1/09/2021,Canada,Pahang,0,0,0
1/09/2021,Canada,Perak,0,0,0
1/09/2021,Canada,Perlis,0,0,0
1/09/2021,Canada,Pulau Pinang,1,1,0
1/09/2021,Canada,Sabah,0,0,0
1/09/2021,Canada,Sarawak,0,0,0
1/09/2021,Canada,Selangor,58,45,13
1/09/2021,Canada,Terengganu,0,0,0
1/09/2021,Canada,W.P. Labuan,0,0,0
1/09/2021,Cocos (Keeling) Islands,Selangor,0,0,0
1/09/2021,Switzerland,Johor,0,0,0
1/09/2021,Switzerland,Kedah,0,0,0
1/09/2021,Switzerland,Kelantan,0,0,0
1/09/2021,Switzerland,Melaka,0,0,0
1/09/2021,Switzerland,Negeri Sembilan,0,0,0
1/09/2021,Switzerland,Pahang,0,0,0
1/09/2021,Switzerland,Perak,0,0,0
1/09/2021,Switzerland,Perlis,0,0,0
1/09/2021,Switzerland,Pulau Pinang,1,1,0
1/09/2021,Switzerland,Sabah,0,0,0
1/09/2021,Switzerland,Sarawak,0,0,0
1/09/2021,Switzerland,Selangor,22,16,6
1/09/2021,Switzerland,W.P. Labuan,0,0,0
1/09/2021,Chile,Johor,0,0,0
1/09/2021,Chile,Kedah,0,0,0
1/09/2021,Chile,Kelantan,0,0,0
1/09/2021,Chile,Melaka,0,0,0
1/09/2021,Chile,Pahang,0,0,0
1/09/2021,Chile,Perak,0,0,0
1/09/2021,Chile,Perlis,0,0,0
1/09/2021,Chile,Pulau Pinang,0,0,0
1/09/2021,Chile,Sabah,0,0,0
1/09/2021,Chile,Sarawak,0,0,0
1/09/2021,Chile,Selangor,1,1,0
1/09/2021,China,Johor,2,2,0
1/09/2021,China,Kedah,0,0,0
1/09/2021,China,Kelantan,0,0,0
1/09/2021,China,Melaka,0,0,0
1/09/2021,China,Pahang,0,0,0
1/09/2021,China,Perak,0,0,0
1/09/2021,China,Perlis,0,0,0
1/09/2021,China,Pulau Pinang,3,1,2
1/09/2021,China,Sabah,0,0,0
1/09/2021,China,Sarawak,144,133,11
1/09/2021,China,Selangor,935,753,182
1/09/2021,China,Terengganu,0,0,0
1/09/2021,China,W.P. Labuan,0,0,0
1/09/2021,Côte d'Ivoire,Johor,0,0,0
1/09/2021,Côte d'Ivoire,Kedah,0,0,0
1/09/2021,Côte d'Ivoire,Pulau Pinang,0,0,0
1/09/2021,Côte d'Ivoire,Sabah,0,0,0
1/09/2021,Côte d'Ivoire,Sarawak,0,0,0
1/09/2021,Côte d'Ivoire,Selangor,0,0,0
1/09/2021,Cameroon,Johor,0,0,0
1/09/2021,Cameroon,Kedah,0,0,0
1/09/2021,Cameroon,Pulau Pinang,0,0,0
1/09/2021,Cameroon,Sabah,0,0,0
1/09/2021,Cameroon,Sarawak,0,0,0
1/09/2021,Cameroon,Selangor,3,1,2
1/09/2021,Congo,Johor,0,0,0
1/09/2021,Congo,Pulau Pinang,0,0,0
1/09/2021,Congo,Sarawak,0,0,0
1/09/2021,Congo,Selangor,0,0,0
1/09/2021,Congo,Johor,0,0,0
1/09/2021,Congo,Kedah,0,0,0
1/09/2021,Congo,Selangor,0,0,0
1/09/2021,Cook Islands,Selangor,0,0,0
1/09/2021,Colombia,Johor,0,0,0
1/09/2021,Colombia,Kedah,0,0,0
1/09/2021,Colombia,Perak,0,0,0
1/09/2021,Colombia,Pulau Pinang,0,0,0
1/09/2021,Colombia,Sabah,0,0,0
1/09/2021,Colombia,Sarawak,0,0,0
1/09/2021,Colombia,Selangor,9,5,4
1/09/2021,Colombia,W.P. Labuan,0,0,0
1/09/2021,Comoros,Johor,0,0,0
1/09/2021,Comoros,Kedah,0,0,0
1/09/2021,Comoros,Selangor,6,4,2
1/09/2021,Cabo Verde,Johor,0,0,0
1/09/2021,Cabo Verde,Kedah,0,0,0
1/09/2021,Cabo Verde,Pulau Pinang,0,0,0
1/09/2021,Cabo Verde,Sabah,0,0,0
1/09/2021,Cabo Verde,Selangor,0,0,0
1/09/2021,Costa Rica,Johor,0,0,0
1/09/2021,Costa Rica,Kedah,0,0,0
1/09/2021,Costa Rica,Perak,0,0,0
1/09/2021,Costa Rica,Perlis,0,0,0
1/09/2021,Costa Rica,Pulau Pinang,0,0,0
1/09/2021,Costa Rica,Sabah,0,0,0
1/09/2021,Costa Rica,Sarawak,0,0,0
1/09/2021,Costa Rica,Selangor,0,0,0
1/09/2021,Cuba,Johor,0,0,0
1/09/2021,Cuba,Kedah,0,0,0
1/09/2021,Cuba,Perlis,0,0,0
1/09/2021,Cuba,Pulau Pinang,0,0,0
1/09/2021,Cuba,Sabah,0,0,0
1/09/2021,Cuba,Sarawak,0,0,0
1/09/2021,Cuba,Selangor,0,0,0
1/09/2021,Cyprus,Johor,0,0,0
1/09/2021,Cyprus,Kedah,0,0,0
1/09/2021,Cyprus,Perak,0,0,0
1/09/2021,Cyprus,Perlis,0,0,0
1/09/2021,Cyprus,Pulau Pinang,0,0,0
1/09/2021,Cyprus,Sabah,0,0,0
1/09/2021,Cyprus,Sarawak,0,0,0
1/09/2021,Cyprus,Selangor,0,0,0
1/09/2021,Czechia,Johor,0,0,0
1/09/2021,Czechia,Kedah,0,0,0
1/09/2021,Czechia,Kelantan,0,0,0
1/09/2021,Czechia,Melaka,0,0,0
1/09/2021,Czechia,Negeri Sembilan,0,0,0
1/09/2021,Czechia,Perak,0,0,0
1/09/2021,Czechia,Perlis,0,0,0
1/09/2021,Czechia,Pulau Pinang,0,0,0
1/09/2021,Czechia,Sabah,0,0,0
1/09/2021,Czechia,Sarawak,0,0,0
1/09/2021,Czechia,Selangor,3,2,1
1/09/2021,Czechia,W.P. Labuan,0,0,0
1/09/2021,Germany,Johor,2,2,0
1/09/2021,Germany,Kedah,0,0,0
1/09/2021,Germany,Kelantan,0,0,0
1/09/2021,Germany,Melaka,0,0,0
1/09/2021,Germany,Negeri Sembilan,0,0,0
1/09/2021,Germany,Pahang,0,0,0
1/09/2021,Germany,Perak,0,0,0
1/09/2021,Germany,Perlis,0,0,0
1/09/2021,Germany,Pulau Pinang,8,5,3
1/09/2021,Germany,Sabah,0,0,0
1/09/2021,Germany,Sarawak,1,1,0
1/09/2021,Germany,Selangor,148,110,38
1/09/2021,Germany,Terengganu,0,0,0
1/09/2021,Germany,W.P. Labuan,0,0,0
1/09/2021,Djibouti,Johor,0,0,0
1/09/2021,Djibouti,Selangor,1,1,0
1/09/2021,Dominica,Johor,0,0,0
1/09/2021,Dominica,Kedah,0,0,0
1/09/2021,Dominica,Pulau Pinang,0,0,0
1/09/2021,Dominica,Sabah,0,0,0
1/09/2021,Dominica,Sarawak,0,0,0
1/09/2021,Dominica,Selangor,0,0,0
1/09/2021,Dominica,W.P. Labuan,0,0,0
1/09/2021,Denmark,Johor,0,0,0
1/09/2021,Denmark,Kedah,0,0,0
1/09/2021,Denmark,Kelantan,0,0,0
1/09/2021,Denmark,Melaka,0,0,0
1/09/2021,Denmark,Negeri Sembilan,0,0,0
1/09/2021,Denmark,Pahang,0,0,0
1/09/2021,Denmark,Perak,0,0,0
1/09/2021,Denmark,Perlis,0,0,0
1/09/2021,Denmark,Pulau Pinang,3,2,1
1/09/2021,Denmark,Sabah,0,0,0
1/09/2021,Denmark,Sarawak,0,0,0
1/09/2021,Denmark,Selangor,36,30,6
1/09/2021,Denmark,W.P. Labuan,0,0,0
1/09/2021,Dominican Republic,Johor,0,0,0
1/09/2021,Dominican Republic,Kedah,0,0,0
1/09/2021,Dominican Republic,Perak,0,0,0
1/09/2021,Dominican Republic,Perlis,0,0,0
1/09/2021,Dominican Republic,Pulau Pinang,0,0,0
1/09/2021,Dominican Republic,Sabah,0,0,0
1/09/2021,Dominican Republic,Sarawak,0,0,0
1/09/2021,Dominican Republic,Selangor,0,0,0
1/09/2021,Algeria,Johor,0,0,0
1/09/2021,Algeria,Kedah,0,0,0
1/09/2021,Algeria,Kelantan,0,0,0
1/09/2021,Algeria,Melaka,0,0,0
1/09/2021,Algeria,Perak,0,0,0
1/09/2021,Algeria,Perlis,0,0,0
1/09/2021,Algeria,Pulau Pinang,0,0,0
1/09/2021,Algeria,Sabah,0,0,0
1/09/2021,Algeria,Sarawak,0,0,0
1/09/2021,Algeria,Selangor,26,12,14
1/09/2021,Algeria,W.P. Labuan,0,0,0
1/09/2021,Ecuador,Johor,0,0,0
1/09/2021,Ecuador,Kedah,0,0,0
1/09/2021,Ecuador,Perak,0,0,0
1/09/2021,Ecuador,Perlis,0,0,0
1/09/2021,Ecuador,Pulau Pinang,0,0,0
1/09/2021,Ecuador,Sabah,0,0,0
1/09/2021,Ecuador,Sarawak,0,0,0
1/09/2021,Ecuador,Selangor,0,0,0
1/09/2021,Egypt,Johor,0,0,0
1/09/2021,Egypt,Kedah,0,0,0
1/09/2021,Egypt,Kelantan,0,0,0
1/09/2021,Egypt,Melaka,0,0,0
1/09/2021,Egypt,Pahang,0,0,0
1/09/2021,Egypt,Perak,0,0,0
1/09/2021,Egypt,Perlis,0,0,0
1/09/2021,Egypt,Pulau Pinang,0,0,0
1/09/2021,Egypt,Sabah,0,0,0
1/09/2021,Egypt,Sarawak,1,1,0
1/09/2021,Egypt,Selangor,72,53,19
1/09/2021,Egypt,Terengganu,0,0,0
1/09/2021,Egypt,W.P. Labuan,0,0,0
1/09/2021,Eritrea,Johor,0,0,0
1/09/2021,Eritrea,Pulau Pinang,0,0,0
1/09/2021,Eritrea,Sabah,0,0,0
1/09/2021,Eritrea,Selangor,1,1,0
1/09/2021,Spain,Johor,0,0,0
1/09/2021,Spain,Kedah,0,0,0
1/09/2021,Spain,Kelantan,0,0,0
1/09/2021,Spain,Melaka,0,0,0
1/09/2021,Spain,Negeri Sembilan,0,0,0
1/09/2021,Spain,Pahang,0,0,0
1/09/2021,Spain,Perak,0,0,0
1/09/2021,Spain,Perlis,0,0,0
1/09/2021,Spain,Pulau Pinang,2,1,1
1/09/2021,Spain,Sabah,0,0,0
1/09/2021,Spain,Sarawak,0,0,0
1/09/2021,Spain,Selangor,41,31,10
1/09/2021,Spain,W.P. Labuan,0,0,0
1/09/2021,Estonia,Johor,0,0,0
1/09/2021,Estonia,Kedah,0,0,0
1/09/2021,Estonia,Kelantan,0,0,0
1/09/2021,Estonia,Pahang,0,0,0
1/09/2021,Estonia,Perak,0,0,0
1/09/2021,Estonia,Perlis,0,0,0
1/09/2021,Estonia,Pulau Pinang,0,0,0
1/09/2021,Estonia,Sabah,0,0,0
1/09/2021,Estonia,Sarawak,0,0,0
1/09/2021,Estonia,Selangor,4,1,3
1/09/2021,Estonia,W.P. Labuan,0,0,0
1/09/2021,Ethiopia,Johor,1,1,0
1/09/2021,Ethiopia,Kedah,0,0,0
1/09/2021,Ethiopia,Pulau Pinang,0,0,0
1/09/2021,Ethiopia,Sarawak,0,0,0
1/09/2021,Ethiopia,Selangor,4,4,0
1/09/2021,Finland,Johor,0,0,0
1/09/2021,Finland,Kedah,0,0,0
1/09/2021,Finland,Kelantan,0,0,0
1/09/2021,Finland,Melaka,0,0,0
1/09/2021,Finland,Negeri Sembilan,0,0,0
1/09/2021,Finland,Pahang,0,0,0
1/09/2021,Finland,Perak,0,0,0
1/09/2021,Finland,Perlis,0,0,0
1/09/2021,Finland,Pulau Pinang,1,1,0
1/09/2021,Finland,Sabah,0,0,0
1/09/2021,Finland,Sarawak,0,0,0
1/09/2021,Finland,Selangor,23,19,4
1/09/2021,Finland,W.P. Labuan,0,0,0
1/09/2021,Fiji,Johor,0,0,0
1/09/2021,Fiji,Kedah,0,0,0
1/09/2021,Fiji,Kelantan,0,0,0
1/09/2021,Fiji,Perak,0,0,0
1/09/2021,Fiji,Perlis,0,0,0
1/09/2021,Fiji,Pulau Pinang,0,0,0
1/09/2021,Fiji,Sabah,0,0,0
1/09/2021,Fiji,Sarawak,0,0,0
1/09/2021,Fiji,Selangor,0,0,0
1/09/2021,France,Johor,0,0,0
1/09/2021,France,Kedah,0,0,0
1/09/2021,France,Kelantan,0,0,0
1/09/2021,France,Melaka,0,0,0
1/09/2021,France,Negeri Sembilan,0,0,0
1/09/2021,France,Pahang,0,0,0
1/09/2021,France,Perak,0,0,0
1/09/2021,France,Perlis,0,0,0
1/09/2021,France,Pulau Pinang,5,3,2
1/09/2021,France,Sabah,0,0,0
1/09/2021,France,Sarawak,2,2,0
1/09/2021,France,Selangor,243,168,75
1/09/2021,France,Terengganu,0,0,0
1/09/2021,France,W.P. Labuan,0,0,0
1/09/2021,"Micronesia, Federated States of",Johor,0,0,0
1/09/2021,"Micronesia, Federated States of",Pulau Pinang,0,0,0
1/09/2021,"Micronesia, Federated States of",Selangor,0,0,0
1/09/2021,Gabon,Johor,0,0,0
1/09/2021,Gabon,Pulau Pinang,0,0,0
1/09/2021,Gabon,Sarawak,0,0,0
1/09/2021,Gabon,Selangor,2,1,1
1/09/2021,United Kingdom of Great Britain and Northern Ireland,Johor,2,1,1
1/09/2021,United Kingdom of Great Britain and Northern Ireland,Kedah,0,0,0
1/09/2021,United Kingdom of Great Britain and Northern Ireland,Kelantan,0,0,0
1/09/2021,United Kingdom of Great Britain and Northern Ireland,Melaka,0,0,0
1/09/2021,United Kingdom of Great Britain and Northern Ireland,Negeri Sembilan,0,0,0
1/09/2021,United Kingdom of Great Britain and Northern Ireland,Pahang,0,0,0
1/09/2021,United Kingdom of Great Britain and Northern Ireland,Perak,0,0,0
1/09/2021,United Kingdom of Great Britain and Northern Ireland,Perlis,0,0,0
1/09/2021,United Kingdom of Great Britain and Northern Ireland,Pulau Pinang,18,11,7
1/09/2021,United Kingdom of Great Britain and Northern Ireland,Sabah,0,0,0
1/09/2021,United Kingdom of Great Britain and Northern Ireland,Sarawak,1,1,0
1/09/2021,United Kingdom of Great Britain and Northern Ireland,Selangor,348,271,77
1/09/2021,United Kingdom of Great Britain and Northern Ireland,Terengganu,0,0,0
1/09/2021,United Kingdom of Great Britain and Northern Ireland,W.P. Labuan,0,0,0
1/09/2021,Georgia,Johor,0,0,0
1/09/2021,Georgia,Kedah,0,0,0
1/09/2021,Georgia,Melaka,0,0,0
1/09/2021,Georgia,Perak,0,0,0
1/09/2021,Georgia,Perlis,0,0,0
1/09/2021,Georgia,Pulau Pinang,0,0,0
1/09/2021,Georgia,Sabah,0,0,0
1/09/2021,Georgia,Sarawak,0,0,0
1/09/2021,Georgia,Selangor,3,3,0
1/09/2021,Ghana,Johor,0,0,0
1/09/2021,Ghana,Kedah,0,0,0
1/09/2021,Ghana,Kelantan,0,0,0
1/09/2021,Ghana,Pulau Pinang,0,0,0
1/09/2021,Ghana,Sabah,0,0,0
1/09/2021,Ghana,Sarawak,0,0,0
1/09/2021,Ghana,Selangor,5,3,2
1/09/2021,Gibraltar,Johor,0,0,0
1/09/2021,Gibraltar,Sarawak,0,0,0
1/09/2021,Guinea,Johor,0,0,0
1/09/2021,Guinea,Kedah,0,0,0
1/09/2021,Guinea,Kelantan,0,0,0
1/09/2021,Guinea,Perlis,0,0,0
1/09/2021,Guinea,Pulau Pinang,0,0,0
1/09/2021,Guinea,Sabah,0,0,0
1/09/2021,Guinea,Sarawak,0,0,0
1/09/2021,Guinea,Selangor,11,6,5
1/09/2021,Guadeloupe,Selangor,0,0,0
1/09/2021,Gambia,Johor,0,0,0
1/09/2021,Gambia,Kedah,0,0,0
1/09/2021,Gambia,Kelantan,0,0,0
1/09/2021,Gambia,Pulau Pinang,0,0,0
1/09/2021,Gambia,Sabah,0,0,0
1/09/2021,Gambia,Sarawak,0,0,0
1/09/2021,Gambia,Selangor,6,4,2
1/09/2021,Guinea-Bissau,Johor,0,0,0
1/09/2021,Guinea-Bissau,Selangor,0,0,0
1/09/2021,Equatorial Guinea,Johor,0,0,0
1/09/2021,Equatorial Guinea,Selangor,0,0,0
1/09/2021,Greece,Johor,0,0,0
1/09/2021,Greece,Kedah,0,0,0
1/09/2021,Greece,Kelantan,0,0,0
1/09/2021,Greece,Melaka,0,0,0
1/09/2021,Greece,Negeri Sembilan,0,0,0
1/09/2021,Greece,Pahang,0,0,0
1/09/2021,Greece,Perak,0,0,0
1/09/2021,Greece,Perlis,0,0,0
1/09/2021,Greece,Pulau Pinang,0,0,0
1/09/2021,Greece,Sabah,0,0,0
1/09/2021,Greece,Sarawak,0,0,0
1/09/2021,Greece,Selangor,13,12,1
1/09/2021,Grenada,Johor,0,0,0
1/09/2021,Grenada,Kedah,0,0,0
1/09/2021,Grenada,Pulau Pinang,0,0,0
1/09/2021,Grenada,Sabah,0,0,0
1/09/2021,Grenada,Sarawak,0,0,0
1/09/2021,Grenada,Selangor,0,0,0
1/09/2021,Greenland,Johor,0,0,0
1/09/2021,Greenland,Selangor,0,0,0
1/09/2021,Guatemala,Johor,0,0,0
1/09/2021,Guatemala,Kedah,0,0,0
1/09/2021,Guatemala,Pahang,0,0,0
1/09/2021,Guatemala,Perak,0,0,0
1/09/2021,Guatemala,Pulau Pinang,0,0,0
1/09/2021,Guatemala,Sabah,0,0,0
1/09/2021,Guatemala,Sarawak,0,0,0
1/09/2021,Guatemala,Selangor,0,0,0
1/09/2021,Guatemala,W.P. Labuan,0,0,0
1/09/2021,Guyana,Johor,0,0,0
1/09/2021,Guyana,Kedah,0,0,0
1/09/2021,Guyana,Pulau Pinang,0,0,0
1/09/2021,Guyana,Sarawak,0,0,0
1/09/2021,Guyana,Selangor,0,0,0
1/09/2021,Hong Kong,Johor,0,0,0
1/09/2021,Hong Kong,Kedah,0,0,0
1/09/2021,Hong Kong,Kelantan,0,0,0
1/09/2021,Hong Kong,Pahang,0,0,0
1/09/2021,Hong Kong,Perak,0,0,0
1/09/2021,Hong Kong,Perlis,0,0,0
1/09/2021,Hong Kong,Pulau Pinang,5,4,1
1/09/2021,Hong Kong,Sabah,0,0,0
1/09/2021,Hong Kong,Sarawak,6,4,2
1/09/2021,Hong Kong,Selangor,0,0,0
1/09/2021,Hong Kong,Terengganu,0,0,0
1/09/2021,Heard Island and McDonald Islands,Johor,0,0,0
1/09/2021,Honduras,Johor,0,0,0
1/09/2021,Honduras,Kedah,0,0,0
1/09/2021,Honduras,Perak,0,0,0
1/09/2021,Honduras,Pulau Pinang,0,0,0
1/09/2021,Honduras,Sabah,0,0,0
1/09/2021,Honduras,Sarawak,0,0,0
1/09/2021,Honduras,Selangor,0,0,0
1/09/2021,Croatia,Johor,1,1,0
1/09/2021,Croatia,Kedah,0,0,0
1/09/2021,Croatia,Kelantan,0,0,0
1/09/2021,Croatia,Melaka,0,0,0
1/09/2021,Croatia,Pahang,0,0,0
1/09/2021,Croatia,Perak,0,0,0
1/09/2021,Croatia,Perlis,0,0,0
1/09/2021,Croatia,Pulau Pinang,0,0,0
1/09/2021,Croatia,Sabah,0,0,0
1/09/2021,Croatia,Sarawak,0,0,0
1/09/2021,Croatia,Selangor,21,17,4
1/09/2021,Haiti,Johor,0,0,0
1/09/2021,Haiti,Kedah,0,0,0
1/09/2021,Haiti,Kelantan,0,0,0
1/09/2021,Haiti,Perak,0,0,0
1/09/2021,Haiti,Pulau Pinang,0,0,0
1/09/2021,Haiti,Sabah,0,0,0
1/09/2021,Haiti,Selangor,0,0,0
1/09/2021,Hungary,Johor,0,0,0
1/09/2021,Hungary,Kedah,0,0,0
1/09/2021,Hungary,Kelantan,0,0,0
1/09/2021,Hungary,Pahang,0,0,0
1/09/2021,Hungary,Perak,0,0,0
1/09/2021,Hungary,Perlis,0,0,0
1/09/2021,Hungary,Pulau Pinang,0,0,0
1/09/2021,Hungary,Sabah,0,0,0
1/09/2021,Hungary,Sarawak,0,0,0
1/09/2021,Hungary,Selangor,17,8,9
1/09/2021,Hungary,W.P. Labuan,0,0,0
1/09/2021,Indonesia,Johor,64,50,14
1/09/2021,Indonesia,Kedah,7,7,0
1/09/2021,Indonesia,Kelantan,0,0,0
1/09/2021,Indonesia,Melaka,0,0,0
1/09/2021,Indonesia,Negeri Sembilan,0,0,0
1/09/2021,Indonesia,Pahang,0,0,0
1/09/2021,Indonesia,Perak,0,0,0
1/09/2021,Indonesia,Perlis,5,5,0
1/09/2021,Indonesia,Pulau Pinang,11,5,6
1/09/2021,Indonesia,Sabah,0,0,0
1/09/2021,Indonesia,Sarawak,136,131,5
1/09/2021,Indonesia,Selangor,972,608,364
1/09/2021,Indonesia,Terengganu,1,1,0
1/09/2021,Indonesia,W.P. Labuan,1,1,0
1/09/2021,India,Johor,2,2,0
1/09/2021,India,Kedah,0,0,0
1/09/2021,India,Kelantan,0,0,0
1/09/2021,India,Melaka,0,0,0
1/09/2021,India,Negeri Sembilan,0,0,0
1/09/2021,India,Pahang,0,0,0
1/09/2021,India,Perak,0,0,0
1/09/2021,India,Perlis,0,0,0
1/09/2021,India,Pulau Pinang,0,0,0
1/09/2021,India,Sabah,0,0,0
1/09/2021,India,Sarawak,2,2,0
1/09/2021,India,Selangor,180,131,49
1/09/2021,India,Terengganu,0,0,0
1/09/2021,India,W.P. Labuan,0,0,0
1/09/2021, British Indian Ocean Territory,Pulau Pinang,0,0,0
1/09/2021, British Indian Ocean Territory,Selangor,0,0,0
1/09/2021,Ireland,Johor,0,0,0
1/09/2021,Ireland,Kedah,0,0,0
1/09/2021,Ireland,Kelantan,0,0,0
1/09/2021,Ireland,Negeri Sembilan,0,0,0
1/09/2021,Ireland,Pahang,0,0,0
1/09/2021,Ireland,Perak,0,0,0
1/09/2021,Ireland,Perlis,0,0,0
1/09/2021,Ireland,Pulau Pinang,0,0,0
1/09/2021,Ireland,Sabah,0,0,0
1/09/2021,Ireland,Sarawak,0,0,0
1/09/2021,Ireland,Selangor,15,10,5
1/09/2021,Ireland,Terengganu,0,0,0
1/09/2021,Ireland,W.P. Labuan,0,0,0
1/09/2021,"Iran, Islamic Republic of",Johor,0,0,0
1/09/2021,"Iran, Islamic Republic of",Kedah,0,0,0
1/09/2021,"Iran, Islamic Republic of",Kelantan,0,0,0
1/09/2021,"Iran, Islamic Republic of",Perak,0,0,0
1/09/2021,"Iran, Islamic Republic of",Perlis,0,0,0
1/09/2021,"Iran, Islamic Republic of",Pulau Pinang,0,0,0
1/09/2021,"Iran, Islamic Republic of",Sabah,0,0,0
1/09/2021,"Iran, Islamic Republic of",Sarawak,0,0,0
1/09/2021,"Iran, Islamic Republic of",Selangor,45,27,18
1/09/2021,"Iran, Islamic Republic of",W.P. Labuan,0,0,0
1/09/2021,Iraq,Johor,0,0,0
1/09/2021,Iraq,Kedah,0,0,0
1/09/2021,Iraq,Kelantan,0,0,0
1/09/2021,Iraq,Melaka,0,0,0
1/09/2021,Iraq,Pahang,0,0,0
1/09/2021,Iraq,Perak,0,0,0
1/09/2021,Iraq,Perlis,0,0,0
1/09/2021,Iraq,Pulau Pinang,0,0,0
1/09/2021,Iraq,Sabah,0,0,0
1/09/2021,Iraq,Sarawak,0,0,0
1/09/2021,Iraq,Selangor,47,35,12
1/09/2021,Iceland,Johor,0,0,0
1/09/2021,Iceland,Kedah,0,0,0
1/09/2021,Iceland,Kelantan,0,0,0
1/09/2021,Iceland,Perak,0,0,0
1/09/2021,Iceland,Perlis,0,0,0
1/09/2021,Iceland,Pulau Pinang,0,0,0
1/09/2021,Iceland,Sabah,0,0,0
1/09/2021,Iceland,Sarawak,0,0,0
1/09/2021,Iceland,Selangor,1,1,0
1/09/2021,Iceland,W.P. Labuan,0,0,0
1/09/2021,Israel,Pulau Pinang,0,0,0
1/09/2021,Italy,Johor,0,0,0
1/09/2021,Italy,Kedah,0,0,0
1/09/2021,Italy,Kelantan,0,0,0
1/09/2021,Italy,Melaka,0,0,0
1/09/2021,Italy,Negeri Sembilan,0,0,0
1/09/2021,Italy,Pahang,0,0,0
1/09/2021,Italy,Perak,0,0,0
1/09/2021,Italy,Perlis,0,0,0
1/09/2021,Italy,Pulau Pinang,2,2,0
1/09/2021,Italy,Sabah,0,0,0
1/09/2021,Italy,Sarawak,0,0,0
1/09/2021,Italy,Selangor,83,62,21
1/09/2021,Italy,W.P. Labuan,0,0,0
1/09/2021,Jamaica,Johor,0,0,0
1/09/2021,Jamaica,Kedah,0,0,0
1/09/2021,Jamaica,Perak,0,0,0
1/09/2021,Jamaica,Pulau Pinang,0,0,0
1/09/2021,Jamaica,Sabah,0,0,0
1/09/2021,Jamaica,Sarawak,0,0,0
1/09/2021,Jamaica,Selangor,1,1,0
1/09/2021,Jamaica,W.P. Labuan,0,0,0
1/09/2021,Jordan,Johor,0,0,0
1/09/2021,Jordan,Kedah,0,0,0
1/09/2021,Jordan,Kelantan,0,0,0
1/09/2021,Jordan,Melaka,0,0,0
1/09/2021,Jordan,Perlis,0,0,0
1/09/2021,Jordan,Pulau Pinang,0,0,0
1/09/2021,Jordan,Sabah,0,0,0
1/09/2021,Jordan,Sarawak,0,0,0
1/09/2021,Jordan,Selangor,39,26,13
1/09/2021,Jordan,W.P. Labuan,0,0,0
1/09/2021,Japan,Johor,0,0,0
1/09/2021,Japan,Kedah,0,0,0
1/09/2021,Japan,Kelantan,0,0,0
1/09/2021,Japan,Melaka,0,0,0
1/09/2021,Japan,Negeri Sembilan,0,0,0
1/09/2021,Japan,Pahang,0,0,0
1/09/2021,Japan,Perak,0,0,0
1/09/2021,Japan,Perlis,0,0,0
1/09/2021,Japan,Pulau Pinang,31,16,15
1/09/2021,Japan,Sabah,0,0,0
1/09/2021,Japan,Sarawak,2,2,0
1/09/2021,Japan,Selangor,637,428,209
1/09/2021,Japan,W.P. Labuan,0,0,0
1/09/2021,Kazakhstan,Johor,0,0,0
1/09/2021,Kazakhstan,Kedah,0,0,0
1/09/2021,Kazakhstan,Kelantan,0,0,0
1/09/2021,Kazakhstan,Melaka,0,0,0
1/09/2021,Kazakhstan,Perak,0,0,0
1/09/2021,Kazakhstan,Perlis,0,0,0
1/09/2021,Kazakhstan,Pulau Pinang,0,0,0
1/09/2021,Kazakhstan,Sabah,0,0,0
1/09/2021,Kazakhstan,Sarawak,0,0,0
1/09/2021,Kazakhstan,Selangor,36,15,21
1/09/2021,Kazakhstan,W.P. Labuan,0,0,0
1/09/2021,Kenya,Johor,0,0,0
1/09/2021,Kenya,Kedah,0,0,0
1/09/2021,Kenya,Kelantan,0,0,0
1/09/2021,Kenya,Perak,0,0,0
1/09/2021,Kenya,Perlis,0,0,0
1/09/2021,Kenya,Pulau Pinang,0,0,0
1/09/2021,Kenya,Sabah,0,0,0
1/09/2021,Kenya,Sarawak,0,0,0
1/09/2021,Kenya,Selangor,37,27,10
1/09/2021,Kyrgyzstan,Johor,0,0,0
1/09/2021,Kyrgyzstan,Kedah,0,0,0
1/09/2021,Kyrgyzstan,Kelantan,0,0,0
1/09/2021,Kyrgyzstan,Perak,0,0,0
1/09/2021,Kyrgyzstan,Perlis,0,0,0
1/09/2021,Kyrgyzstan,Pulau Pinang,0,0,0
1/09/2021,Kyrgyzstan,Sabah,0,0,0
1/09/2021,Kyrgyzstan,Sarawak,0,0,0
1/09/2021,Kyrgyzstan,Selangor,0,0,0
1/09/2021,Cambodia,Johor,0,0,0
1/09/2021,Cambodia,Kedah,0,0,0
1/09/2021,Cambodia,Kelantan,0,0,0
1/09/2021,Cambodia,Melaka,0,0,0
1/09/2021,Cambodia,Negeri Sembilan,0,0,0
1/09/2021,Cambodia,Pahang,0,0,0
1/09/2021,Cambodia,Perak,0,0,0
1/09/2021,Cambodia,Perlis,0,0,0
1/09/2021,Cambodia,Pulau Pinang,1,0,1
1/09/2021,Cambodia,Sabah,0,0,0
1/09/2021,Cambodia,Sarawak,0,0,0
1/09/2021,Cambodia,Selangor,1,1,0
1/09/2021,Cambodia,W.P. Labuan,0,0,0
1/09/2021,Kiribati,Johor,0,0,0
1/09/2021,Kiribati,Sabah,0,0,0
1/09/2021,Kiribati,Selangor,0,0,0
1/09/2021,Saint Kitts and Nevis,Johor,0,0,0
1/09/2021,Saint Kitts and Nevis,Kedah,0,0,0
1/09/2021,Saint Kitts and Nevis,Perlis,0,0,0
1/09/2021,Saint Kitts and Nevis,Pulau Pinang,0,0,0
1/09/2021,Saint Kitts and Nevis,Sabah,0,0,0
1/09/2021,Saint Kitts and Nevis,Selangor,1,1,0
1/09/2021,Saint Kitts and Nevis,W.P. Labuan,0,0,0
1/09/2021,"Korea, Republic of",Johor,0,0,0
1/09/2021,"Korea, Republic of",Kedah,0,0,0
1/09/2021,"Korea, Republic of",Kelantan,0,0,0
1/09/2021,"Korea, Republic of",Melaka,0,0,0
1/09/2021,"Korea, Republic of",Negeri Sembilan,0,0,0
1/09/2021,"Korea, Republic of",Pahang,0,0,0
1/09/2021,"Korea, Republic of",Perak,0,0,0
1/09/2021,"Korea, Republic of",Perlis,0,0,0
1/09/2021,"Korea, Republic of",Pulau Pinang,15,7,8
1/09/2021,"Korea, Republic of",Sabah,0,0,0
1/09/2021,"Korea, Republic of",Sarawak,49,48,1
1/09/2021,"Korea, Republic of",Selangor,323,194,129
1/09/2021,"Korea, Republic of",Terengganu,0,0,0
1/09/2021,"Korea, Republic of",W.P. Labuan,0,0,0
1/09/2021,Kuwait,Johor,0,0,0
1/09/2021,Kuwait,Kedah,0,0,0
1/09/2021,Kuwait,Kelantan,0,0,0
1/09/2021,Kuwait,Perak,0,0,0
1/09/2021,Kuwait,Perlis,0,0,0
1/09/2021,Kuwait,Pulau Pinang,0,0,0
1/09/2021,Kuwait,Sabah,0,0,0
1/09/2021,Kuwait,Sarawak,0,0,0
1/09/2021,Kuwait,Selangor,2,2,0
1/09/2021,Kuwait,W.P. Labuan,0,0,0
1/09/2021, Lao People's Democratic Republic,Johor,0,0,0
1/09/2021, Lao People's Democratic Republic,Kedah,0,0,0
1/09/2021, Lao People's Democratic Republic,Kelantan,0,0,0
1/09/2021, Lao People's Democratic Republic,Melaka,0,0,0
1/09/2021, Lao People's Democratic Republic,Perak,0,0,0
1/09/2021, Lao People's Democratic Republic,Perlis,0,0,0
1/09/2021, Lao People's Democratic Republic,Pulau Pinang,0,0,0
1/09/2021, Lao People's Democratic Republic,Sabah,0,0,0
1/09/2021, Lao People's Democratic Republic,Sarawak,0,0,0
1/09/2021, Lao People's Democratic Republic,Selangor,23,23,0
1/09/2021, Lao People's Democratic Republic,W.P. Labuan,0,0,0
1/09/2021,Lebanon,Johor,0,0,0
1/09/2021,Lebanon,Kedah,0,0,0
1/09/2021,Lebanon,Kelantan,0,0,0
1/09/2021,Lebanon,Pahang,0,0,0
1/09/2021,Lebanon,Perak,0,0,0
1/09/2021,Lebanon,Perlis,0,0,0
1/09/2021,Lebanon,Pulau Pinang,0,0,0
1/09/2021,Lebanon,Sabah,0,0,0
1/09/2021,Lebanon,Sarawak,0,0,0
1/09/2021,Lebanon,Selangor,7,4,3
1/09/2021,Lebanon,W.P. Labuan,0,0,0
1/09/2021,Liberia,Johor,0,0,0
1/09/2021,Liberia,Kedah,0,0,0
1/09/2021,Liberia,Sabah,0,0,0
1/09/2021,Liberia,Sarawak,0,0,0
1/09/2021,Liberia,Selangor,2,2,0
1/09/2021,Libya,Johor,0,0,0
1/09/2021,Libya,Kedah,0,0,0
1/09/2021,Libya,Perlis,0,0,0
1/09/2021,Libya,Pulau Pinang,0,0,0
1/09/2021,Libya,Sabah,0,0,0
1/09/2021,Libya,Sarawak,0,0,0
1/09/2021,Libya,Selangor,41,36,5
1/09/2021,Saint Lucia,Johor,0,0,0
1/09/2021,Saint Lucia,Kedah,0,0,0
1/09/2021,Saint Lucia,Pulau Pinang,0,0,0
1/09/2021,Saint Lucia,Sarawak,0,0,0
1/09/2021,Saint Lucia,Selangor,0,0,0
1/09/2021,Liechtenstein,Johor,0,0,0
1/09/2021,Liechtenstein,Kedah,0,0,0
1/09/2021,Liechtenstein,Perlis,0,0,0
1/09/2021,Liechtenstein,Pulau Pinang,0,0,0
1/09/2021,Liechtenstein,Sabah,0,0,0
1/09/2021,Liechtenstein,Sarawak,0,0,0
1/09/2021,Liechtenstein,Selangor,0,0,0
1/09/2021,LKA,Johor,0,0,0
1/09/2021,LKA,Kedah,0,0,0
1/09/2021,LKA,Kelantan,0,0,0
1/09/2021,LKA,Melaka,0,0,0
1/09/2021,LKA,Pahang,0,0,0
1/09/2021,LKA,Perak,0,0,0
1/09/2021,LKA,Perlis,0,0,0
1/09/2021,LKA,Pulau Pinang,0,0,0
1/09/2021,LKA,Sabah,0,0,0
1/09/2021,LKA,Sarawak,0,0,0
1/09/2021,LKA,Selangor,4,4,0
1/09/2021,LKA,W.P. Labuan,0,0,0
1/09/2021,Lesotho,Johor,0,0,0
1/09/2021,Lesotho,Kedah,0,0,0
1/09/2021,Lesotho,Pulau Pinang,0,0,0
1/09/2021,Lesotho,Sarawak,0,0,0
1/09/2021,Lesotho,Selangor,0,0,0
1/09/2021,Lithuania,Johor,0,0,0
1/09/2021,Lithuania,Kedah,0,0,0
1/09/2021,Lithuania,Kelantan,0,0,0
1/09/2021,Lithuania,Pahang,0,0,0
1/09/2021,Lithuania,Perak,0,0,0
1/09/2021,Lithuania,Perlis,0,0,0
1/09/2021,Lithuania,Pulau Pinang,0,0,0
1/09/2021,Lithuania,Sabah,0,0,0
1/09/2021,Lithuania,Sarawak,0,0,0
1/09/2021,Lithuania,Selangor,6,3,3
1/09/2021,Lithuania,W.P. Labuan,0,0,0
1/09/2021,Luxembourg,Johor,0,0,0
1/09/2021,Luxembourg,Kedah,0,0,0
1/09/2021,Luxembourg,Kelantan,0,0,0
1/09/2021,Luxembourg,Perak,0,0,0
1/09/2021,Luxembourg,Perlis,0,0,0
1/09/2021,Luxembourg,Pulau Pinang,0,0,0
1/09/2021,Luxembourg,Sabah,0,0,0
1/09/2021,Luxembourg,Sarawak,0,0,0
1/09/2021,Luxembourg,Selangor,1,1,0
1/09/2021,Latvia,Johor,0,0,0
1/09/2021,Latvia,Kedah,0,0,0
1/09/2021,Latvia,Kelantan,0,0,0
1/09/2021,Latvia,Pahang,0,0,0
1/09/2021,Latvia,Perak,0,0,0
1/09/2021,Latvia,Perlis,0,0,0
1/09/2021,Latvia,Pulau Pinang,0,0,0
1/09/2021,Latvia,Sabah,0,0,0
1/09/2021,Latvia,Sarawak,0,0,0
1/09/2021,Latvia,Selangor,4,2,2
1/09/2021,Latvia,W.P. Labuan,0,0,0
1/09/2021,Macao,Johor,0,0,0
1/09/2021,Macao,Pahang,0,0,0
1/09/2021,Macao,Perak,0,0,0
1/09/2021,Macao,Selangor,0,0,0
1/09/2021,Macao,W.P. Labuan,0,0,0
1/09/2021,Morocco,Johor,0,0,0
1/09/2021,Morocco,Kedah,0,0,0
1/09/2021,Morocco,Kelantan,0,0,0
1/09/2021,Morocco,Melaka,0,0,0
1/09/2021,Morocco,Pahang,0,0,0
1/09/2021,Morocco,Perak,0,0,0
1/09/2021,Morocco,Perlis,0,0,0
1/09/2021,Morocco,Pulau Pinang,0,0,0
1/09/2021,Morocco,Sabah,0,0,0
1/09/2021,Morocco,Sarawak,0,0,0
1/09/2021,Morocco,Selangor,16,8,8
1/09/2021,Morocco,W.P. Labuan,0,0,0
1/09/2021,Monaco,Johor,0,0,0
1/09/2021,Monaco,Kedah,0,0,0
1/09/2021,Monaco,Sabah,0,0,0
1/09/2021,Monaco,Selangor,0,0,0
1/09/2021,"Moldova, Republic of",Johor,0,0,0
1/09/2021,"Moldova, Republic of",Kedah,0,0,0
1/09/2021,"Moldova, Republic of",Kelantan,1,1,0
1/09/2021,"Moldova, Republic of",Negeri Sembilan,0,0,0
1/09/2021,"Moldova, Republic of",Perlis,0,0,0
1/09/2021,"Moldova, Republic of",Pulau Pinang,0,0,0
1/09/2021,"Moldova, Republic of",Sabah,0,0,0
1/09/2021,"Moldova, Republic of",Sarawak,0,0,0
1/09/2021,"Moldova, Republic of",Selangor,0,0,0
1/09/2021,Madagascar,Johor,0,0,0
1/09/2021,Madagascar,Kedah,0,0,0
1/09/2021,Madagascar,Perak,0,0,0
1/09/2021,Madagascar,Perlis,0,0,0
1/09/2021,Madagascar,Pulau Pinang,0,0,0
1/09/2021,Madagascar,Sabah,0,0,0
1/09/2021,Madagascar,Sarawak,0,0,0
1/09/2021,Madagascar,Selangor,0,0,0
1/09/2021,Maldives,Johor,0,0,0
1/09/2021,Maldives,Kedah,0,0,0
1/09/2021,Maldives,Kelantan,0,0,0
1/09/2021,Maldives,Perak,0,0,0
1/09/2021,Maldives,Perlis,0,0,0
1/09/2021,Maldives,Pulau Pinang,0,0,0
1/09/2021,Maldives,Sabah,0,0,0
1/09/2021,Maldives,Sarawak,0,0,0
1/09/2021,Maldives,Selangor,52,20,32
1/09/2021,Mexico,Johor,0,0,0
1/09/2021,Mexico,Kedah,0,0,0
1/09/2021,Mexico,Kelantan,0,0,0
1/09/2021,Mexico,Pahang,0,0,0
1/09/2021,Mexico,Perak,0,0,0
1/09/2021,Mexico,Perlis,0,0,0
1/09/2021,Mexico,Pulau Pinang,2,1,1
1/09/2021,Mexico,Sabah,0,0,0
1/09/2021,Mexico,Sarawak,0,0,0
1/09/2021,Mexico,Selangor,10,7,3
1/09/2021,Mexico,W.P. Labuan,0,0,0
1/09/2021,Marshall Islands,Johor,0,0,0
1/09/2021,Marshall Islands,Kedah,0,0,0
1/09/2021,Marshall Islands,Perak,0,0,0
1/09/2021,Marshall Islands,Pulau Pinang,0,0,0
1/09/2021,Marshall Islands,Sabah,0,0,0
1/09/2021,Marshall Islands,Selangor,0,0,0
1/09/2021,North Macedonia,Johor,0,0,0
1/09/2021,North Macedonia,Kedah,0,0,0
1/09/2021,North Macedonia,Perak,0,0,0
1/09/2021,North Macedonia,Pulau Pinang,0,0,0
1/09/2021,North Macedonia,Sabah,0,0,0
1/09/2021,North Macedonia,Sarawak,0,0,0
1/09/2021,North Macedonia,Selangor,0,0,0
1/09/2021,Mali,Johor,0,0,0
1/09/2021,Mali,Sabah,0,0,0
1/09/2021,Mali,Selangor,0,0,0
1/09/2021,Malta,Johor,0,0,0
1/09/2021,Malta,Kedah,0,0,0
1/09/2021,Malta,Kelantan,0,0,0
1/09/2021,Malta,Perak,0,0,0
1/09/2021,Malta,Perlis,0,0,0
1/09/2021,Malta,Pulau Pinang,0,0,0
1/09/2021,Malta,Sabah,0,0,0
1/09/2021,Malta,Sarawak,0,0,0
1/09/2021,Malta,Selangor,2,2,0
1/09/2021,Malta,W.P. Labuan,0,0,0
1/09/2021,Myanmar,Johor,0,0,0
1/09/2021,Myanmar,Kedah,0,0,0
1/09/2021,Myanmar,Kelantan,0,0,0
1/09/2021,Myanmar,Negeri Sembilan,0,0,0
1/09/2021,Myanmar,Pahang,0,0,0
1/09/2021,Myanmar,Perak,0,0,0
1/09/2021,Myanmar,Perlis,0,0,0
1/09/2021,Myanmar,Pulau Pinang,0,0,0
1/09/2021,Myanmar,Sabah,0,0,0
1/09/2021,Myanmar,Sarawak,0,0,0
1/09/2021,Myanmar,Selangor,161,135,26
1/09/2021,Myanmar,Terengganu,0,0,0
1/09/2021,Myanmar,W.P. Labuan,0,0,0
1/09/2021,Montenegro,Johor,0,0,0
1/09/2021,Montenegro,Kedah,0,0,0
1/09/2021,Montenegro,Pulau Pinang,0,0,0
1/09/2021,Montenegro,Sabah,0,0,0
1/09/2021,Montenegro,Sarawak,0,0,0
1/09/2021,Montenegro,Selangor,5,5,0
1/09/2021,Mongolia,Johor,0,0,0
1/09/2021,Mongolia,Kedah,0,0,0
1/09/2021,Mongolia,Kelantan,0,0,0
1/09/2021,Mongolia,Perak,0,0,0
1/09/2021,Mongolia,Perlis,0,0,0
1/09/2021,Mongolia,Pulau Pinang,0,0,0
1/09/2021,Mongolia,Sabah,0,0,0
1/09/2021,Mongolia,Sarawak,0,0,0
1/09/2021,Mongolia,Selangor,2,0,2
1/09/2021,Northern Mariana Islands,Selangor,0,0,0
1/09/2021,Mozambique,Johor,0,0,0
1/09/2021,Mozambique,Kedah,0,0,0
1/09/2021,Mozambique,Perak,0,0,0
1/09/2021,Mozambique,Pulau Pinang,0,0,0
1/09/2021,Mozambique,Sabah,0,0,0
1/09/2021,Mozambique,Sarawak,0,0,0
1/09/2021,Mozambique,Selangor,3,2,1
1/09/2021,Mauritania,Johor,0,0,0
1/09/2021,Mauritania,Kedah,0,0,0
1/09/2021,Mauritania,Pulau Pinang,0,0,0
1/09/2021,Mauritania,Sabah,0,0,0
1/09/2021,Mauritania,Sarawak,0,0,0
1/09/2021,Mauritania,Selangor,5,4,1
1/09/2021,Mauritius,Johor,0,0,0
1/09/2021,Mauritius,Kedah,0,0,0
1/09/2021,Mauritius,Kelantan,0,0,0
1/09/2021,Mauritius,Pahang,0,0,0
1/09/2021,Mauritius,Perak,0,0,0
1/09/2021,Mauritius,Perlis,0,0,0
1/09/2021,Mauritius,Pulau Pinang,0,0,0
1/09/2021,Mauritius,Sabah,0,0,0
1/09/2021,Mauritius,Sarawak,0,0,0
1/09/2021,Mauritius,Selangor,7,4,3
1/09/2021,Malawi,Johor,0,0,0
1/09/2021,Malawi,Pulau Pinang,0,0,0
1/09/2021,Malawi,Sabah,0,0,0
1/09/2021,Malawi,Sarawak,0,0,0
1/09/2021,Malawi,Selangor,0,0,0
1/09/2021,Mayotte,Selangor,0,0,0
1/09/2021,Namibia,Johor,0,0,0
1/09/2021,Namibia,Kedah,0,0,0
1/09/2021,Namibia,Perak,0,0,0
1/09/2021,Namibia,Perlis,0,0,0
1/09/2021,Namibia,Pulau Pinang,0,0,0
1/09/2021,Namibia,Sabah,0,0,0
1/09/2021,Namibia,Sarawak,0,0,0
1/09/2021,Namibia,Selangor,3,1,2
1/09/2021,New Caledonia,Selangor,0,0,0
1/09/2021,Niger,Johor,0,0,0
1/09/2021,Niger,Sabah,0,0,0
1/09/2021,Niger,Selangor,1,1,0
1/09/2021,Nigeria,Johor,0,0,0
1/09/2021,Nigeria,Kedah,0,0,0
1/09/2021,Nigeria,Perlis,0,0,0
1/09/2021,Nigeria,Pulau Pinang,0,0,0
1/09/2021,Nigeria,Sabah,0,0,0
1/09/2021,Nigeria,Sarawak,0,0,0
1/09/2021,Nigeria,Selangor,94,86,8
1/09/2021,Nicaragua,Johor,0,0,0
1/09/2021,Nicaragua,Kedah,0,0,0
1/09/2021,Nicaragua,Pulau Pinang,0,0,0
1/09/2021,Nicaragua,Sabah,0,0,0
1/09/2021,Nicaragua,Selangor,0,0,0
1/09/2021,Netherlands,Johor,0,0,0
1/09/2021,Netherlands,Kedah,0,0,0
1/09/2021,Netherlands,Kelantan,0,0,0
1/09/2021,Netherlands,Melaka,0,0,0
1/09/2021,Netherlands,Negeri Sembilan,0,0,0
1/09/2021,Netherlands,Pahang,0,0,0
1/09/2021,Netherlands,Perak,0,0,0
1/09/2021,Netherlands,Perlis,0,0,0
1/09/2021,Netherlands,Pulau Pinang,2,2,0
1/09/2021,Netherlands,Sabah,0,0,0
1/09/2021,Netherlands,Sarawak,1,1,0
1/09/2021,Netherlands,Selangor,90,56,34
1/09/2021,Netherlands,Terengganu,0,0,0
1/09/2021,Netherlands,W.P. Labuan,0,0,0
1/09/2021,Norway,Johor,0,0,0
1/09/2021,Norway,Kedah,0,0,0
1/09/2021,Norway,Kelantan,0,0,0
1/09/2021,Norway,Melaka,0,0,0
1/09/2021,Norway,Pahang,0,0,0
1/09/2021,Norway,Perak,0,0,0
1/09/2021,Norway,Perlis,0,0,0
1/09/2021,Norway,Pulau Pinang,0,0,0
1/09/2021,Norway,Sabah,0,0,0
1/09/2021,Norway,Sarawak,2,2,0
1/09/2021,Norway,Selangor,19,15,4
1/09/2021,Norway,W.P. Labuan,0,0,0
1/09/2021,Nepal,Johor,0,0,0
1/09/2021,Nepal,Kedah,0,0,0
1/09/2021,Nepal,Pahang,0,0,0
1/09/2021,Nepal,Perak,0,0,0
1/09/2021,Nepal,Perlis,0,0,0
1/09/2021,Nepal,Pulau Pinang,0,0,0
1/09/2021,Nepal,Sabah,0,0,0
1/09/2021,Nepal,Sarawak,0,0,0
1/09/2021,Nepal,Selangor,2,1,1
1/09/2021,Nepal,W.P. Labuan,0,0,0
1/09/2021,Nauru,Johor,0,0,0
1/09/2021,Nauru,Pulau Pinang,0,0,0
1/09/2021,Nauru,Selangor,0,0,0
1/09/2021,New Zealand,Johor,0,0,0
1/09/2021,New Zealand,Kedah,0,0,0
1/09/2021,New Zealand,Kelantan,0,0,0
1/09/2021,New Zealand,Melaka,0,0,0
1/09/2021,New Zealand,Negeri Sembilan,0,0,0
1/09/2021,New Zealand,Pahang,0,0,0
1/09/2021,New Zealand,Perak,0,0,0
1/09/2021,New Zealand,Perlis,0,0,0
1/09/2021,New Zealand,Pulau Pinang,1,1,0
1/09/2021,New Zealand,Sabah,0,0,0
1/09/2021,New Zealand,Sarawak,0,0,0
1/09/2021,New Zealand,Selangor,12,9,3
1/09/2021,New Zealand,Terengganu,0,0,0
1/09/2021,New Zealand,W.P. Labuan,0,0,0
1/09/2021,Oman,Johor,0,0,0
1/09/2021,Oman,Kedah,0,0,0
1/09/2021,Oman,Kelantan,0,0,0
1/09/2021,Oman,Melaka,0,0,0
1/09/2021,Oman,Perak,0,0,0
1/09/2021,Oman,Perlis,0,0,0
1/09/2021,Oman,Pulau Pinang,0,0,0
1/09/2021,Oman,Sabah,0,0,0
1/09/2021,Oman,Sarawak,0,0,0
1/09/2021,Oman,Selangor,15,11,4
1/09/2021,Pakistan,Johor,0,0,0
1/09/2021,Pakistan,Kedah,0,0,0
1/09/2021,Pakistan,Kelantan,0,0,0
1/09/2021,Pakistan,Melaka,0,0,0
1/09/2021,Pakistan,Negeri Sembilan,0,0,0
1/09/2021,Pakistan,Pahang,0,0,0
1/09/2021,Pakistan,Perak,0,0,0
1/09/2021,Pakistan,Perlis,0,0,0
1/09/2021,Pakistan,Pulau Pinang,0,0,0
1/09/2021,Pakistan,Sabah,0,0,0
1/09/2021,Pakistan,Sarawak,0,0,0
1/09/2021,Pakistan,Selangor,23,14,9
1/09/2021,Pakistan,W.P. Labuan,0,0,0
1/09/2021,Panama,Johor,0,0,0
1/09/2021,Panama,Kedah,0,0,0
1/09/2021,Panama,Perak,0,0,0
1/09/2021,Panama,Perlis,0,0,0
1/09/2021,Panama,Pulau Pinang,0,0,0
1/09/2021,Panama,Sabah,0,0,0
1/09/2021,Panama,Sarawak,0,0,0
1/09/2021,Panama,Selangor,4,4,0
1/09/2021,Peru,Johor,0,0,0
1/09/2021,Peru,Kedah,0,0,0
1/09/2021,Peru,Kelantan,0,0,0
1/09/2021,Peru,Pahang,0,0,0
1/09/2021,Peru,Perak,0,0,0
1/09/2021,Peru,Perlis,0,0,0
1/09/2021,Peru,Pulau Pinang,0,0,0
1/09/2021,Peru,Sabah,0,0,0
1/09/2021,Peru,Sarawak,0,0,0
1/09/2021,Peru,Selangor,0,0,0
1/09/2021,Peru,W.P. Labuan,0,0,0
1/09/2021,Philippines,Johor,3,2,1
1/09/2021,Philippines,Kedah,0,0,0
1/09/2021,Philippines,Kelantan,0,0,0
1/09/2021,Philippines,Melaka,0,0,0
1/09/2021,Philippines,Negeri Sembilan,0,0,0
1/09/2021,Philippines,Pahang,0,0,0
1/09/2021,Philippines,Perak,0,0,0
1/09/2021,Philippines,Perlis,0,0,0
1/09/2021,Philippines,Pulau Pinang,3,1,2
1/09/2021,Philippines,Sabah,1,0,1
1/09/2021,Philippines,Sarawak,28,28,0
1/09/2021,Philippines,Selangor,456,398,58
1/09/2021,Philippines,Terengganu,0,0,0
1/09/2021,Philippines,W.P. Labuan,6,6,0
1/09/2021,Palau,Johor,0,0,0
1/09/2021,Palau,Pulau Pinang,0,0,0
1/09/2021,Palau,Selangor,0,0,0
1/09/2021,Papua New Guinea,Johor,0,0,0
1/09/2021,Papua New Guinea,Kedah,0,0,0
1/09/2021,Papua New Guinea,Kelantan,0,0,0
1/09/2021,Papua New Guinea,Perak,0,0,0
1/09/2021,Papua New Guinea,Pulau Pinang,0,0,0
1/09/2021,Papua New Guinea,Sabah,0,0,0
1/09/2021,Papua New Guinea,Sarawak,0,0,0
1/09/2021,Papua New Guinea,Selangor,0,0,0
1/09/2021,Poland,Johor,0,0,0
1/09/2021,Poland,Kedah,0,0,0
1/09/2021,Poland,Kelantan,0,0,0
1/09/2021,Poland,Melaka,0,0,0
1/09/2021,Poland,Negeri Sembilan,0,0,0
1/09/2021,Poland,Pahang,0,0,0
1/09/2021,Poland,Perak,0,0,0
1/09/2021,Poland,Perlis,0,0,0
1/09/2021,Poland,Pulau Pinang,0,0,0
1/09/2021,Poland,Sabah,0,0,0
1/09/2021,Poland,Sarawak,0,0,0
1/09/2021,Poland,Selangor,37,26,11
1/09/2021,Poland,Terengganu,0,0,0
1/09/2021,Poland,W.P. Labuan,0,0,0
1/09/2021,"North Korea, Democratic People's Republic of",Selangor,0,0,0
1/09/2021,Portugal,Johor,0,0,0
1/09/2021,Portugal,Kedah,0,0,0
1/09/2021,Portugal,Kelantan,0,0,0
1/09/2021,Portugal,Melaka,0,0,0
1/09/2021,Portugal,Pahang,0,0,0
1/09/2021,Portugal,Perak,0,0,0
1/09/2021,Portugal,Perlis,0,0,0
1/09/2021,Portugal,Pulau Pinang,0,0,0
1/09/2021,Portugal,Sabah,0,0,0
1/09/2021,Portugal,Sarawak,0,0,0
1/09/2021,Portugal,Selangor,10,6,4
1/09/2021,Portugal,W.P. Labuan,0,0,0
1/09/2021,Paraguay,Johor,0,0,0
1/09/2021,Paraguay,Kedah,0,0,0
1/09/2021,Paraguay,Perak,0,0,0
1/09/2021,Paraguay,Perlis,0,0,0
1/09/2021,Paraguay,Pulau Pinang,0,0,0
1/09/2021,Paraguay,Sabah,0,0,0
1/09/2021,Paraguay,Sarawak,0,0,0
1/09/2021,Paraguay,Selangor,0,0,0
1/09/2021,"Palestine, State of",Johor,0,0,0
1/09/2021,"Palestine, State of",Kedah,0,0,0
1/09/2021,"Palestine, State of",Kelantan,0,0,0
1/09/2021,"Palestine, State of",Melaka,0,0,0
1/09/2021,"Palestine, State of",Perak,0,0,0
1/09/2021,"Palestine, State of",Perlis,0,0,0
1/09/2021,"Palestine, State of",Pulau Pinang,0,0,0
1/09/2021,"Palestine, State of",Sabah,0,0,0
1/09/2021,"Palestine, State of",Sarawak,0,0,0
1/09/2021,"Palestine, State of",Selangor,24,19,5
1/09/2021,Qatar,Johor,0,0,0
1/09/2021,Qatar,Kedah,0,0,0
1/09/2021,Qatar,Perlis,0,0,0
1/09/2021,Qatar,Pulau Pinang,0,0,0
1/09/2021,Qatar,Sabah,0,0,0
1/09/2021,Qatar,Sarawak,0,0,0
1/09/2021,Qatar,Selangor,2,1,1
1/09/2021,Réunion,Johor,0,0,0
1/09/2021,Réunion,Sarawak,0,0,0
1/09/2021,Romania,Johor,0,0,0
1/09/2021,Romania,Kedah,0,0,0
1/09/2021,Romania,Kelantan,2,2,0
1/09/2021,Romania,Negeri Sembilan,0,0,0
1/09/2021,Romania,Pahang,0,0,0
1/09/2021,Romania,Perak,0,0,0
1/09/2021,Romania,Perlis,0,0,0
1/09/2021,Romania,Pulau Pinang,0,0,0
1/09/2021,Romania,Sabah,0,0,0
1/09/2021,Romania,Sarawak,1,1,0
1/09/2021,Romania,Selangor,30,24,6
1/09/2021,Romania,W.P. Labuan,0,0,0
1/09/2021,Russian Federation (Russia),Johor,0,0,0
1/09/2021,Russian Federation (Russia),Kedah,0,0,0
1/09/2021,Russian Federation (Russia),Kelantan,2,0,2
1/09/2021,Russian Federation (Russia),Melaka,0,0,0
1/09/2021,Russian Federation (Russia),Negeri Sembilan,0,0,0
1/09/2021,Russian Federation (Russia),Pahang,0,0,0
1/09/2021,Russian Federation (Russia),Perak,0,0,0
1/09/2021,Russian Federation (Russia),Perlis,0,0,0
1/09/2021,Russian Federation (Russia),Pulau Pinang,0,0,0
1/09/2021,Russian Federation (Russia),Sabah,0,0,0
1/09/2021,Russian Federation (Russia),Sarawak,0,0,0
1/09/2021,Russian Federation (Russia),Selangor,98,63,35
1/09/2021,Russian Federation (Russia),W.P. Labuan,0,0,0
1/09/2021,Rwanda,Johor,0,0,0
1/09/2021,Rwanda,Kedah,0,0,0
1/09/2021,Rwanda,Pulau Pinang,0,0,0
1/09/2021,Rwanda,Selangor,1,0,1
1/09/2021,Saudi Arabia,Johor,0,0,0
1/09/2021,Saudi Arabia,Kedah,0,0,0
1/09/2021,Saudi Arabia,Kelantan,0,0,0
1/09/2021,Saudi Arabia,Melaka,0,0,0
1/09/2021,Saudi Arabia,Perak,0,0,0
1/09/2021,Saudi Arabia,Perlis,0,0,0
1/09/2021,Saudi Arabia,Pulau Pinang,0,0,0
1/09/2021,Saudi Arabia,Sabah,0,0,0
1/09/2021,Saudi Arabia,Sarawak,0,0,0
1/09/2021,Saudi Arabia,Selangor,141,85,56
1/09/2021,Saudi Arabia,W.P. Labuan,0,0,0
1/09/2021,Sudan,Johor,0,0,0
1/09/2021,Sudan,Kedah,0,0,0
1/09/2021,Sudan,Kelantan,0,0,0
1/09/2021,Sudan,Perlis,0,0,0
1/09/2021,Sudan,Pulau Pinang,0,0,0
1/09/2021,Sudan,Sabah,0,0,0
1/09/2021,Sudan,Sarawak,0,0,0
1/09/2021,Sudan,Selangor,36,28,8
1/09/2021,Sudan,W.P. Labuan,0,0,0
1/09/2021,Senegal,Johor,0,0,0
1/09/2021,Senegal,Kedah,0,0,0
1/09/2021,Senegal,Kelantan,0,0,0
1/09/2021,Senegal,Perak,0,0,0
1/09/2021,Senegal,Perlis,0,0,0
1/09/2021,Senegal,Pulau Pinang,0,0,0
1/09/2021,Senegal,Sabah,0,0,0
1/09/2021,Senegal,Sarawak,0,0,0
1/09/2021,Senegal,Selangor,0,0,0
1/09/2021,Singapore,Johor,107,89,18
1/09/2021,Singapore,Kedah,0,0,0
1/09/2021,Singapore,Kelantan,0,0,0
1/09/2021,Singapore,Melaka,0,0,0
1/09/2021,Singapore,Negeri Sembilan,0,0,0
1/09/2021,Singapore,Pahang,0,0,0
1/09/2021,Singapore,Perak,2,0,2
1/09/2021,Singapore,Perlis,0,0,0
1/09/2021,Singapore,Pulau Pinang,19,12,7
1/09/2021,Singapore,Sabah,0,0,0
1/09/2021,Singapore,Sarawak,5,3,2
1/09/2021,Singapore,Selangor,103,76,27
1/09/2021,Singapore,Terengganu,0,0,0
1/09/2021,Singapore,W.P. Labuan,0,0,0
1/09/2021,South Georgia and the South Sandwich Islands,Johor,0,0,0
1/09/2021,South Georgia and the South Sandwich Islands,Sabah,0,0,0
1/09/2021,South Georgia and the South Sandwich Islands,Selangor,0,0,0
1/09/2021,Saint Helena,Sarawak,0,0,0
1/09/2021,Solomon Islands,Johor,0,0,0
1/09/2021,Solomon Islands,Perlis,0,0,0
1/09/2021,Solomon Islands,Pulau Pinang,0,0,0
1/09/2021,Solomon Islands,Sabah,0,0,0
1/09/2021,Solomon Islands,Sarawak,0,0,0
1/09/2021,Solomon Islands,Selangor,0,0,0
1/09/2021,Solomon Islands,W.P. Labuan,0,0,0
1/09/2021,Sierra Leone,Johor,0,0,0
1/09/2021,Sierra Leone,Kedah,0,0,0
1/09/2021,Sierra Leone,Perak,0,0,0
1/09/2021,Sierra Leone,Pulau Pinang,0,0,0
1/09/2021,Sierra Leone,Sabah,0,0,0
1/09/2021,Sierra Leone,Selangor,1,1,0
1/09/2021,El Salvador,Johor,0,0,0
1/09/2021,El Salvador,Kedah,0,0,0
1/09/2021,El Salvador,Perak,0,0,0
1/09/2021,El Salvador,Perlis,0,0,0
1/09/2021,El Salvador,Pulau Pinang,0,0,0
1/09/2021,El Salvador,Sabah,0,0,0
1/09/2021,El Salvador,Selangor,0,0,0
1/09/2021,El Salvador,W.P. Labuan,0,0,0
1/09/2021,San Marino,Johor,0,0,0
1/09/2021,San Marino,Selangor,0,0,0
1/09/2021,Somalia,Johor,0,0,0
1/09/2021,Somalia,Kedah,0,0,0
1/09/2021,Somalia,Kelantan,0,0,0
1/09/2021,Somalia,Perlis,0,0,0
1/09/2021,Somalia,Sabah,0,0,0
1/09/2021,Somalia,Sarawak,0,0,0
1/09/2021,Somalia,Selangor,45,41,4
1/09/2021,Serbia,Johor,0,0,0
1/09/2021,Serbia,Kedah,0,0,0
1/09/2021,Serbia,Kelantan,0,0,0
1/09/2021,Serbia,Pahang,0,0,0
1/09/2021,Serbia,Perak,0,0,0
1/09/2021,Serbia,Perlis,0,0,0
1/09/2021,Serbia,Pulau Pinang,0,0,0
1/09/2021,Serbia,Sabah,0,0,0
1/09/2021,Serbia,Sarawak,0,0,0
1/09/2021,Serbia,Selangor,0,0,0
1/09/2021,South Sudan,Johor,0,0,0
1/09/2021,South Sudan,Kedah,0,0,0
1/09/2021,South Sudan,Sarawak,0,0,0
1/09/2021,South Sudan,Selangor,0,0,0
1/09/2021,South Sudan,W.P. Labuan,0,0,0
1/09/2021,Sao Tome and Principe,Selangor,0,0,0
1/09/2021,Suriname,Johor,0,0,0
1/09/2021,Suriname,Kedah,0,0,0
1/09/2021,Suriname,Kelantan,0,0,0
1/09/2021,Suriname,Perak,0,0,0
1/09/2021,Suriname,Perlis,0,0,0
1/09/2021,Suriname,Pulau Pinang,0,0,0
1/09/2021,Suriname,Sabah,0,0,0
1/09/2021,Suriname,Sarawak,0,0,0
1/09/2021,Suriname,Selangor,0,0,0
1/09/2021,Slovakia,Johor,0,0,0
1/09/2021,Slovakia,Kedah,0,0,0
1/09/2021,Slovakia,Kelantan,0,0,0
1/09/2021,Slovakia,Negeri Sembilan,0,0,0
1/09/2021,Slovakia,Pahang,0,0,0
1/09/2021,Slovakia,Perak,0,0,0
1/09/2021,Slovakia,Perlis,0,0,0
1/09/2021,Slovakia,Pulau Pinang,0,0,0
1/09/2021,Slovakia,Sabah,0,0,0
1/09/2021,Slovakia,Sarawak,0,0,0
1/09/2021,Slovakia,Selangor,6,5,1
1/09/2021,Slovakia,W.P. Labuan,0,0,0
1/09/2021,Slovenia,Johor,0,0,0
1/09/2021,Slovenia,Kedah,0,0,0
1/09/2021,Slovenia,Kelantan,0,0,0
1/09/2021,Slovenia,Perak,0,0,0
1/09/2021,Slovenia,Perlis,0,0,0
1/09/2021,Slovenia,Pulau Pinang,0,0,0
1/09/2021,Slovenia,Sabah,0,0,0
1/09/2021,Slovenia,Sarawak,0,0,0
1/09/2021,Slovenia,Selangor,0,0,0
1/09/2021,Slovenia,W.P. Labuan,0,0,0
1/09/2021,Sweden,Johor,0,0,0
1/09/2021,Sweden,Kedah,0,0,0
1/09/2021,Sweden,Kelantan,0,0,0
1/09/2021,Sweden,Melaka,0,0,0
1/09/2021,Sweden,Negeri Sembilan,0,0,0
1/09/2021,Sweden,Pahang,0,0,0
1/09/2021,Sweden,Perak,0,0,0
1/09/2021,Sweden,Perlis,0,0,0
1/09/2021,Sweden,Pulau Pinang,0,0,0
1/09/2021,Sweden,Sabah,0,0,0
1/09/2021,Sweden,Sarawak,0,0,0
1/09/2021,Sweden,Selangor,51,38,13
1/09/2021,Sweden,W.P. Labuan,0,0,0
1/09/2021,Eswatini,Johor,0,0,0
1/09/2021,Eswatini,Kedah,0,0,0
1/09/2021,Eswatini,Pulau Pinang,0,0,0
1/09/2021,Eswatini,Sabah,0,0,0
1/09/2021,Eswatini,Selangor,0,0,0
1/09/2021,Seychelles,Johor,0,0,0
1/09/2021,Seychelles,Kedah,0,0,0
1/09/2021,Seychelles,Pulau Pinang,0,0,0
1/09/2021,Seychelles,Sabah,0,0,0
1/09/2021,Seychelles,Sarawak,0,0,0
1/09/2021,Seychelles,Selangor,18,5,13
1/09/2021,Syrian Arab Republic,Johor,0,0,0
1/09/2021,Syrian Arab Republic,Kedah,0,0,0
1/09/2021,Syrian Arab Republic,Kelantan,0,0,0
1/09/2021,Syrian Arab Republic,Pahang,0,0,0
1/09/2021,Syrian Arab Republic,Perlis,0,0,0
1/09/2021,Syrian Arab Republic,Pulau Pinang,0,0,0
1/09/2021,Syrian Arab Republic,Sabah,0,0,0
1/09/2021,Syrian Arab Republic,Sarawak,0,0,0
1/09/2021,Syrian Arab Republic,Selangor,22,16,6
1/09/2021,Syrian Arab Republic,W.P. Labuan,0,0,0
1/09/2021,Turks and Caicos Islands,Perlis,0,0,0
1/09/2021,TCD,Johor,0,0,0
1/09/2021,TCD,Kedah,0,0,0
1/09/2021,TCD,Perlis,0,0,0
1/09/2021,TCD,Selangor,2,2,0
1/09/2021,Togo,Johor,0,0,0
1/09/2021,Togo,Perak,0,0,0
1/09/2021,Togo,Pulau Pinang,0,0,0
1/09/2021,Togo,Selangor,0,0,0
1/09/2021,Thailand,Johor,16,16,0
1/09/2021,Thailand,Kedah,18826,18780,46
1/09/2021,Thailand,Kelantan,0,0,0
1/09/2021,Thailand,Melaka,0,0,0
1/09/2021,Thailand,Negeri Sembilan,0,0,0
1/09/2021,Thailand,Pahang,0,0,0
1/09/2021,Thailand,Perak,0,0,0
1/09/2021,Thailand,Perlis,7738,7657,81
1/09/2021,Thailand,Pulau Pinang,101,100,1
1/09/2021,Thailand,Sabah,0,0,0
1/09/2021,Thailand,Sarawak,15,14,1
1/09/2021,Thailand,Selangor,153,97,56
1/09/2021,Thailand,Terengganu,0,0,0
1/09/2021,Thailand,W.P. Labuan,0,0,0
1/09/2021,Tajikistan,Johor,0,0,0
1/09/2021,Tajikistan,Kedah,0,0,0
1/09/2021,Tajikistan,Perlis,0,0,0
1/09/2021,Tajikistan,Pulau Pinang,0,0,0
1/09/2021,Tajikistan,Sabah,0,0,0
1/09/2021,Tajikistan,Selangor,1,0,1
1/09/2021,Tokelau,Selangor,0,0,0
1/09/2021,Turkmenistan,Johor,0,0,0
1/09/2021,Turkmenistan,Kedah,0,0,0
1/09/2021,Turkmenistan,Kelantan,0,0,0
1/09/2021,Turkmenistan,Perlis,0,0,0
1/09/2021,Turkmenistan,Pulau Pinang,0,0,0
1/09/2021,Turkmenistan,Sabah,0,0,0
1/09/2021,Turkmenistan,Sarawak,0,0,0
1/09/2021,Turkmenistan,Selangor,1,0,1
1/09/2021,Timor-Leste,Johor,0,0,0
1/09/2021,Timor-Leste,Kedah,0,0,0
1/09/2021,Timor-Leste,Perlis,0,0,0
1/09/2021,Timor-Leste,Pulau Pinang,0,0,0
1/09/2021,Timor-Leste,Sabah,0,0,0
1/09/2021,Timor-Leste,Sarawak,0,0,0
1/09/2021,Timor-Leste,Selangor,0,0,0
1/09/2021,Tonga,Johor,0,0,0
1/09/2021,Tonga,Pulau Pinang,0,0,0
1/09/2021,Tonga,Sarawak,0,0,0
1/09/2021,Tonga,Selangor,0,0,0
1/09/2021,Trinidad and Tobago,Johor,0,0,0
1/09/2021,Trinidad and Tobago,Kedah,0,0,0
1/09/2021,Trinidad and Tobago,Pahang,0,0,0
1/09/2021,Trinidad and Tobago,Pulau Pinang,0,0,0
1/09/2021,Trinidad and Tobago,Sabah,0,0,0
1/09/2021,Trinidad and Tobago,Sarawak,0,0,0
1/09/2021,Trinidad and Tobago,Selangor,1,1,0
1/09/2021,Tunisia,Johor,0,0,0
1/09/2021,Tunisia,Kedah,0,0,0
1/09/2021,Tunisia,Kelantan,0,0,0
1/09/2021,Tunisia,Melaka,0,0,0
1/09/2021,Tunisia,Perak,0,0,0
1/09/2021,Tunisia,Perlis,0,0,0
1/09/2021,Tunisia,Pulau Pinang,0,0,0
1/09/2021,Tunisia,Sabah,0,0,0
1/09/2021,Tunisia,Sarawak,0,0,0
1/09/2021,Tunisia,Selangor,10,3,7
1/09/2021,Tunisia,W.P. Labuan,0,0,0
1/09/2021,Türkiye,Johor,0,0,0
1/09/2021,Türkiye,Kedah,0,0,0
1/09/2021,Türkiye,Kelantan,0,0,0
1/09/2021,Türkiye,Melaka,0,0,0
1/09/2021,Türkiye,Negeri Sembilan,0,0,0
1/09/2021,Türkiye,Pahang,0,0,0
1/09/2021,Türkiye,Perak,0,0,0
1/09/2021,Türkiye,Perlis,0,0,0
1/09/2021,Türkiye,Pulau Pinang,0,0,0
1/09/2021,Türkiye,Sabah,0,0,0
1/09/2021,Türkiye,Sarawak,0,0,0
1/09/2021,Türkiye,Selangor,54,40,14
1/09/2021,Türkiye,W.P. Labuan,0,0,0
1/09/2021,Tuvalu,Selangor,0,0,0
1/09/2021,"Taiwan, Province of China",Johor,0,0,0
1/09/2021,"Taiwan, Province of China",Kedah,0,0,0
1/09/2021,"Taiwan, Province of China",Kelantan,0,0,0
1/09/2021,"Taiwan, Province of China",Melaka,0,0,0
1/09/2021,"Taiwan, Province of China",Negeri Sembilan,0,0,0
1/09/2021,"Taiwan, Province of China",Pahang,0,0,0
1/09/2021,"Taiwan, Province of China",Perak,0,0,0
1/09/2021,"Taiwan, Province of China",Perlis,0,0,0
1/09/2021,"Taiwan, Province of China",Pulau Pinang,13,10,3
1/09/2021,"Taiwan, Province of China",Sabah,0,0,0
1/09/2021,"Taiwan, Province of China",Sarawak,0,0,0
1/09/2021,"Taiwan, Province of China",Selangor,40,27,13
1/09/2021,"Taiwan, Province of China",W.P. Labuan,0,0,0
1/09/2021,"Tanzania, United Republic of",Johor,0,0,0
1/09/2021,"Tanzania, United Republic of",Kedah,0,0,0
1/09/2021,"Tanzania, United Republic of",Perak,0,0,0
1/09/2021,"Tanzania, United Republic of",Perlis,0,0,0
1/09/2021,"Tanzania, United Republic of",Pulau Pinang,0,0,0
1/09/2021,"Tanzania, United Republic of",Sabah,0,0,0
1/09/2021,"Tanzania, United Republic of",Sarawak,0,0,0
1/09/2021,"Tanzania, United Republic of",Selangor,16,11,5
1/09/2021,Uganda,Johor,0,0,0
1/09/2021,Uganda,Kedah,0,0,0
1/09/2021,Uganda,Perak,0,0,0
1/09/2021,Uganda,Perlis,0,0,0
1/09/2021,Uganda,Pulau Pinang,0,0,0
1/09/2021,Uganda,Sabah,0,0,0
1/09/2021,Uganda,Sarawak,0,0,0
1/09/2021,Uganda,Selangor,7,2,5
1/09/2021,Ukraine,Johor,2,2,0
1/09/2021,Ukraine,Kedah,0,0,0
1/09/2021,Ukraine,Kelantan,0,0,0
1/09/2021,Ukraine,Melaka,0,0,0
1/09/2021,Ukraine,Negeri Sembilan,0,0,0
1/09/2021,Ukraine,Pahang,0,0,0
1/09/2021,Ukraine,Perak,0,0,0
1/09/2021,Ukraine,Perlis,0,0,0
1/09/2021,Ukraine,Pulau Pinang,0,0,0
1/09/2021,Ukraine,Sabah,0,0,0
1/09/2021,Ukraine,Sarawak,0,0,0
1/09/2021,Ukraine,Selangor,49,45,4
1/09/2021,Ukraine,W.P. Labuan,0,0,0
1/09/2021,Uruguay,Johor,0,0,0
1/09/2021,Uruguay,Kedah,0,0,0
1/09/2021,Uruguay,Kelantan,0,0,0
1/09/2021,Uruguay,Perak,0,0,0
1/09/2021,Uruguay,Perlis,0,0,0
1/09/2021,Uruguay,Pulau Pinang,0,0,0
1/09/2021,Uruguay,Sabah,0,0,0
1/09/2021,Uruguay,Sarawak,0,0,0
1/09/2021,Uruguay,Selangor,1,0,1
1/09/2021,Uruguay,W.P. Labuan,0,0,0
1/09/2021,United States of America,Johor,0,0,0
1/09/2021,United States of America,Kedah,0,0,0
1/09/2021,United States of America,Kelantan,0,0,0
1/09/2021,United States of America,Melaka,0,0,0
1/09/2021,United States of America,Negeri Sembilan,0,0,0
1/09/2021,United States of America,Pahang,0,0,0
1/09/2021,United States of America,Perak,0,0,0
1/09/2021,United States of America,Perlis,0,0,0
1/09/2021,United States of America,Pulau Pinang,11,6,5
1/09/2021,United States of America,Sabah,1,1,0
1/09/2021,United States of America,Sarawak,0,0,0
1/09/2021,United States of America,Selangor,226,143,83
1/09/2021,United States of America,Terengganu,0,0,0
1/09/2021,United States of America,W.P. Labuan,0,0,0
1/09/2021,Uzbekistan,Johor,0,0,0
1/09/2021,Uzbekistan,Kedah,0,0,0
1/09/2021,Uzbekistan,Kelantan,0,0,0
1/09/2021,Uzbekistan,Perak,0,0,0
1/09/2021,Uzbekistan,Perlis,0,0,0
1/09/2021,Uzbekistan,Pulau Pinang,0,0,0
1/09/2021,Uzbekistan,Sabah,0,0,0
1/09/2021,Uzbekistan,Sarawak,0,0,0
1/09/2021,Uzbekistan,Selangor,12,8,4
1/09/2021,Holy See,Johor,0,0,0
1/09/2021,Holy See,Sarawak,0,0,0
1/09/2021,Holy See,Selangor,0,0,0
1/09/2021,Saint Vincent and the Grenadines,Johor,0,0,0
1/09/2021,Saint Vincent and the Grenadines,Kedah,0,0,0
1/09/2021,Saint Vincent and the Grenadines,Pulau Pinang,0,0,0
1/09/2021,Saint Vincent and the Grenadines,Sarawak,0,0,0
1/09/2021,Saint Vincent and the Grenadines,Selangor,0,0,0
1/09/2021,"Venezuela, Bolivarian Republic of",Johor,0,0,0
1/09/2021,"Venezuela, Bolivarian Republic of",Kedah,0,0,0
1/09/2021,"Venezuela, Bolivarian Republic of",Kelantan,0,0,0
1/09/2021,"Venezuela, Bolivarian Republic of",Melaka,0,0,0
1/09/2021,"Venezuela, Bolivarian Republic of",Perak,0,0,0
1/09/2021,"Venezuela, Bolivarian Republic of",Perlis,0,0,0
1/09/2021,"Venezuela, Bolivarian Republic of",Pulau Pinang,0,0,0
1/09/2021,"Venezuela, Bolivarian Republic of",Sabah,0,0,0
1/09/2021,"Venezuela, Bolivarian Republic of",Sarawak,0,0,0
1/09/2021,"Venezuela, Bolivarian Republic of",Selangor,5,3,2
1/09/2021,"Venezuela, Bolivarian Republic of",W.P. Labuan,0,0,0
1/09/2021,Viet Nam,Johor,1,0,1
1/09/2021,Viet Nam,Kedah,0,0,0
1/09/2021,Viet Nam,Kelantan,0,0,0
1/09/2021,Viet Nam,Melaka,0,0,0
1/09/2021,Viet Nam,Negeri Sembilan,0,0,0
1/09/2021,Viet Nam,Pahang,0,0,0
1/09/2021,Viet Nam,Perak,0,0,0
1/09/2021,Viet Nam,Perlis,0,0,0
1/09/2021,Viet Nam,Pulau Pinang,0,0,0
1/09/2021,Viet Nam,Sabah,0,0,0
1/09/2021,Viet Nam,Sarawak,0,0,0
1/09/2021,Viet Nam,Selangor,57,22,35
1/09/2021,Viet Nam,Terengganu,0,0,0
1/09/2021,Viet Nam,W.P. Labuan,0,0,0
1/09/2021,Vanuatu,Johor,0,0,0
1/09/2021,Vanuatu,Kedah,0,0,0
1/09/2021,Vanuatu,Pulau Pinang,0,0,0
1/09/2021,Vanuatu,Sabah,0,0,0
1/09/2021,Vanuatu,Sarawak,0,0,0
1/09/2021,Vanuatu,Selangor,1,1,0
1/09/2021, Samoa,Johor,0,0,0
1/09/2021, Samoa,Sarawak,0,0,0
1/09/2021, Samoa,Selangor,0,0,0
1/09/2021,Yemen,Johor,0,0,0
1/09/2021,Yemen,Kedah,0,0,0
1/09/2021,Yemen,Kelantan,0,0,0
1/09/2021,Yemen,Melaka,0,0,0
1/09/2021,Yemen,Pahang,0,0,0
1/09/2021,Yemen,Perak,0,0,0
1/09/2021,Yemen,Perlis,0,0,0
1/09/2021,Yemen,Pulau Pinang,0,0,0
1/09/2021,Yemen,Sabah,0,0,0
1/09/2021,Yemen,Sarawak,0,0,0
1/09/2021,Yemen,Selangor,98,69,29
1/09/2021,Yemen,W.P. Labuan,0,0,0
1/09/2021,South Africa,Johor,0,0,0
1/09/2021,South Africa,Kedah,0,0,0
1/09/2021,South Africa,Kelantan,0,0,0
1/09/2021,South Africa,Melaka,0,0,0
1/09/2021,South Africa,Pahang,0,0,0
1/09/2021,South Africa,Perak,0,0,0
1/09/2021,South Africa,Perlis,0,0,0
1/09/2021,South Africa,Pulau Pinang,0,0,0
1/09/2021,South Africa,Sabah,0,0,0
1/09/2021,South Africa,Sarawak,0,0,0
1/09/2021,South Africa,Selangor,61,48,13
1/09/2021,South Africa,Terengganu,0,0,0
1/09/2021,South Africa,W.P. Labuan,0,0,0
1/09/2021,ZAR,Selangor,0,0,0
1/09/2021,Zambia,Johor,0,0,0
1/09/2021,Zambia,Kedah,0,0,0
1/09/2021,Zambia,Perak,0,0,0
1/09/2021,Zambia,Perlis,0,0,0
1/09/2021,Zambia,Pulau Pinang,0,0,0
1/09/2021,Zambia,Sabah,0,0,0
1/09/2021,Zambia,Sarawak,0,0,0
1/09/2021,Zambia,Selangor,9,5,4
1/09/2021,Zimbabwe,Johor,0,0,0
1/09/2021,Zimbabwe,Kedah,0,0,0
1/09/2021,Zimbabwe,Kelantan,0,0,0
1/09/2021,Zimbabwe,Perak,0,0,0
1/09/2021,Zimbabwe,Perlis,0,0,0
1/09/2021,Zimbabwe,Pulau Pinang,0,0,0
1/09/2021,Zimbabwe,Sabah,0,0,0
1/09/2021,Zimbabwe,Sarawak,0,0,0
1/09/2021,Zimbabwe,Selangor,8,3,5
1/10/2021,Aruba,Kedah,0,0,0
1/10/2021,Aruba,Pulau Pinang,0,0,0
1/10/2021,Afghanistan,Johor,0,0,0
1/10/2021,Afghanistan,Kedah,0,0,0
1/10/2021,Afghanistan,Perlis,0,0,0
1/10/2021,Afghanistan,Pulau Pinang,0,0,0
1/10/2021,Afghanistan,Sarawak,0,0,0
1/10/2021,Afghanistan,Selangor,16,11,5
1/10/2021,Angola,Johor,0,0,0
1/10/2021,Angola,Kedah,0,0,0
1/10/2021,Angola,Sabah,0,0,0
1/10/2021,Angola,Selangor,0,0,0
1/10/2021,Anguilla,Selangor,0,0,0
1/10/2021,Albania,Johor,0,0,0
1/10/2021,Albania,Kedah,0,0,0
1/10/2021,Albania,Perak,0,0,0
1/10/2021,Albania,Perlis,0,0,0
1/10/2021,Albania,Pulau Pinang,0,0,0
1/10/2021,Albania,Sabah,0,0,0
1/10/2021,Albania,Sarawak,0,0,0
1/10/2021,Albania,Selangor,1,1,0
1/10/2021,Andorra,Johor,0,0,0
1/10/2021,Andorra,Kedah,0,0,0
1/10/2021,Andorra,Perlis,0,0,0
1/10/2021,Andorra,Pulau Pinang,0,0,0
1/10/2021,Andorra,Selangor,0,0,0
1/10/2021,Antigua and Barbuda,Selangor,0,0,0
1/10/2021,United Arab Emirates,Johor,0,0,0
1/10/2021,United Arab Emirates,Kedah,0,0,0
1/10/2021,United Arab Emirates,Kelantan,0,0,0
1/10/2021,United Arab Emirates,Perak,0,0,0
1/10/2021,United Arab Emirates,Perlis,0,0,0
1/10/2021,United Arab Emirates,Pulau Pinang,0,0,0
1/10/2021,United Arab Emirates,Sabah,0,0,0
1/10/2021,United Arab Emirates,Sarawak,0,0,0
1/10/2021,United Arab Emirates,Selangor,2,2,0
1/10/2021,Argentina,Johor,0,0,0
1/10/2021,Argentina,Kedah,0,0,0
1/10/2021,Argentina,Kelantan,0,0,0
1/10/2021,Argentina,Melaka,0,0,0
1/10/2021,Argentina,Perak,0,0,0
1/10/2021,Argentina,Perlis,0,0,0
1/10/2021,Argentina,Pulau Pinang,0,0,0
1/10/2021,Argentina,Sabah,0,0,0
1/10/2021,Argentina,Sarawak,0,0,0
1/10/2021,Argentina,Selangor,12,7,5
1/10/2021,Argentina,W.P. Labuan,0,0,0
1/10/2021,Armenia,Johor,0,0,0
1/10/2021,Armenia,Kedah,0,0,0
1/10/2021,Armenia,Kelantan,0,0,0
1/10/2021,Armenia,Perak,0,0,0
1/10/2021,Armenia,Perlis,0,0,0
1/10/2021,Armenia,Pulau Pinang,0,0,0
1/10/2021,Armenia,Sabah,0,0,0
1/10/2021,Armenia,Sarawak,0,0,0
1/10/2021,Armenia,Selangor,0,0,0
1/10/2021,Antarctica,Selangor,0,0,0
1/10/2021,Antigua and Barbuda,Johor,0,0,0
1/10/2021,Antigua and Barbuda,Kedah,0,0,0
1/10/2021,Antigua and Barbuda,Pulau Pinang,0,0,0
1/10/2021,Antigua and Barbuda,Sarawak,0,0,0
1/10/2021,Antigua and Barbuda,Selangor,0,0,0
1/10/2021,Australia,Johor,2,2,0
1/10/2021,Australia,Kedah,0,0,0
1/10/2021,Australia,Kelantan,0,0,0
1/10/2021,Australia,Melaka,0,0,0
1/10/2021,Australia,Negeri Sembilan,0,0,0
1/10/2021,Australia,Pahang,0,0,0
1/10/2021,Australia,Perak,0,0,0
1/10/2021,Australia,Perlis,0,0,0
1/10/2021,Australia,Pulau Pinang,4,2,2
1/10/2021,Australia,Sabah,0,0,0
1/10/2021,Australia,Sarawak,2,2,0
1/10/2021,Australia,Selangor,117,79,38
1/10/2021,Australia,Terengganu,0,0,0
1/10/2021,Australia,W.P. Labuan,0,0,0
1/10/2021,Austria,Johor,0,0,0
1/10/2021,Austria,Kedah,0,0,0
1/10/2021,Austria,Kelantan,0,0,0
1/10/2021,Austria,Melaka,0,0,0
1/10/2021,Austria,Negeri Sembilan,0,0,0
1/10/2021,Austria,Pahang,0,0,0
1/10/2021,Austria,Perak,0,0,0
1/10/2021,Austria,Perlis,0,0,0
1/10/2021,Austria,Pulau Pinang,1,0,1
1/10/2021,Austria,Sabah,0,0,0
1/10/2021,Austria,Sarawak,2,2,0
1/10/2021,Austria,Selangor,23,20,3
1/10/2021,Austria,Terengganu,0,0,0
1/10/2021,Austria,W.P. Labuan,0,0,0
1/10/2021,Azerbaijan,Johor,0,0,0
1/10/2021,Azerbaijan,Kedah,0,0,0
1/10/2021,Azerbaijan,Kelantan,0,0,0
1/10/2021,Azerbaijan,Melaka,0,0,0
1/10/2021,Azerbaijan,Perlis,0,0,0
1/10/2021,Azerbaijan,Pulau Pinang,0,0,0
1/10/2021,Azerbaijan,Sabah,0,0,0
1/10/2021,Azerbaijan,Sarawak,0,0,0
1/10/2021,Azerbaijan,Selangor,6,2,4
1/10/2021,Azerbaijan,W.P. Labuan,0,0,0
1/10/2021,Burundi,Pulau Pinang,0,0,0
1/10/2021,Burundi,Sarawak,0,0,0
1/10/2021,Burundi,Selangor,0,0,0
1/10/2021,Belgium,Johor,0,0,0
1/10/2021,Belgium,Kedah,0,0,0
1/10/2021,Belgium,Kelantan,0,0,0
1/10/2021,Belgium,Melaka,0,0,0
1/10/2021,Belgium,Negeri Sembilan,0,0,0
1/10/2021,Belgium,Pahang,0,0,0
1/10/2021,Belgium,Perak,0,0,0
1/10/2021,Belgium,Perlis,0,0,0
1/10/2021,Belgium,Pulau Pinang,1,1,0
1/10/2021,Belgium,Sabah,0,0,0
1/10/2021,Belgium,Sarawak,0,0,0
1/10/2021,Belgium,Selangor,21,15,6
1/10/2021,Belgium,W.P. Labuan,0,0,0
1/10/2021,Benin,Johor,0,0,0
1/10/2021,Benin,Kedah,0,0,0
1/10/2021,Benin,Perak,0,0,0
1/10/2021,Benin,Pulau Pinang,0,0,0
1/10/2021,Benin,Sabah,0,0,0
1/10/2021,Benin,Sarawak,0,0,0
1/10/2021,Benin,Selangor,0,0,0
1/10/2021,Burkina Faso,Perak,0,0,0
1/10/2021,Burkina Faso,Pulau Pinang,0,0,0
1/10/2021,Burkina Faso,Selangor,0,0,0
1/10/2021,Bangladesh,Johor,1,1,0
1/10/2021,Bangladesh,Kedah,0,0,0
1/10/2021,Bangladesh,Kelantan,0,0,0
1/10/2021,Bangladesh,Melaka,0,0,0
1/10/2021,Bangladesh,Negeri Sembilan,0,0,0
1/10/2021,Bangladesh,Pahang,0,0,0
1/10/2021,Bangladesh,Perak,0,0,0
1/10/2021,Bangladesh,Perlis,0,0,0
1/10/2021,Bangladesh,Pulau Pinang,1,1,0
1/10/2021,Bangladesh,Sabah,0,0,0
1/10/2021,Bangladesh,Sarawak,0,0,0
1/10/2021,Bangladesh,Selangor,215,153,62
1/10/2021,Bangladesh,W.P. Labuan,0,0,0
1/10/2021,Bulgaria,Johor,0,0,0
1/10/2021,Bulgaria,Kedah,0,0,0
1/10/2021,Bulgaria,Kelantan,0,0,0
1/10/2021,Bulgaria,Pahang,0,0,0
1/10/2021,Bulgaria,Perak,0,0,0
1/10/2021,Bulgaria,Perlis,0,0,0
1/10/2021,Bulgaria,Pulau Pinang,0,0,0
1/10/2021,Bulgaria,Sabah,0,0,0
1/10/2021,Bulgaria,Sarawak,0,0,0
1/10/2021,Bulgaria,Selangor,18,15,3
1/10/2021,Bulgaria,W.P. Labuan,0,0,0
1/10/2021,Bahrain,Johor,0,0,0
1/10/2021,Bahrain,Kedah,0,0,0
1/10/2021,Bahrain,Kelantan,0,0,0
1/10/2021,Bahrain,Perlis,0,0,0
1/10/2021,Bahrain,Pulau Pinang,0,0,0
1/10/2021,Bahrain,Sabah,0,0,0
1/10/2021,Bahrain,Sarawak,0,0,0
1/10/2021,Bahrain,Selangor,7,5,2
1/10/2021,Bahamas,Johor,0,0,0
1/10/2021,Bahamas,Kedah,0,0,0
1/10/2021,Bahamas,Perak,0,0,0
1/10/2021,Bahamas,Sabah,0,0,0
1/10/2021,Bahamas,Sarawak,0,0,0
1/10/2021,Bahamas,Selangor,0,0,0
1/10/2021,Bosnia and Herzegovina,Johor,0,0,0
1/10/2021,Bosnia and Herzegovina,Kedah,0,0,0
1/10/2021,Bosnia and Herzegovina,Perlis,0,0,0
1/10/2021,Bosnia and Herzegovina,Pulau Pinang,0,0,0
1/10/2021,Bosnia and Herzegovina,Sabah,0,0,0
1/10/2021,Bosnia and Herzegovina,Sarawak,1,1,0
1/10/2021,Bosnia and Herzegovina,Selangor,6,3,3
1/10/2021,Belarus,Johor,0,0,0
1/10/2021,Belarus,Kedah,0,0,0
1/10/2021,Belarus,Kelantan,0,0,0
1/10/2021,Belarus,Pahang,0,0,0
1/10/2021,Belarus,Perak,0,0,0
1/10/2021,Belarus,Perlis,0,0,0
1/10/2021,Belarus,Pulau Pinang,0,0,0
1/10/2021,Belarus,Sabah,0,0,0
1/10/2021,Belarus,Sarawak,0,0,0
1/10/2021,Belarus,Selangor,3,1,2
1/10/2021,Belarus,W.P. Labuan,0,0,0
1/10/2021,Belize,Johor,0,0,0
1/10/2021,Belize,Pulau Pinang,0,0,0
1/10/2021,Belize,Sarawak,0,0,0
1/10/2021,Belize,Selangor,0,0,0
1/10/2021,Bermuda,Selangor,0,0,0
1/10/2021,Bolivia,Johor,0,0,0
1/10/2021,Bolivia,Kedah,0,0,0
1/10/2021,Bolivia,Melaka,0,0,0
1/10/2021,Bolivia,Perak,0,0,0
1/10/2021,Bolivia,Perlis,0,0,0
1/10/2021,Bolivia,Pulau Pinang,0,0,0
1/10/2021,Bolivia,Sabah,0,0,0
1/10/2021,Bolivia,Sarawak,0,0,0
1/10/2021,Bolivia,Selangor,1,1,0
1/10/2021,Brazil,Johor,0,0,0
1/10/2021,Brazil,Kedah,1,0,1
1/10/2021,Brazil,Kelantan,0,0,0
1/10/2021,Brazil,Melaka,0,0,0
1/10/2021,Brazil,Pahang,0,0,0
1/10/2021,Brazil,Perak,0,0,0
1/10/2021,Brazil,Perlis,0,0,0
1/10/2021,Brazil,Pulau Pinang,0,0,0
1/10/2021,Brazil,Sabah,0,0,0
1/10/2021,Brazil,Sarawak,0,0,0
1/10/2021,Brazil,Selangor,28,19,9
1/10/2021,Brazil,W.P. Labuan,0,0,0
1/10/2021,Barbados,Johor,0,0,0
1/10/2021,Barbados,Kedah,0,0,0
1/10/2021,Barbados,Perlis,0,0,0
1/10/2021,Barbados,Pulau Pinang,0,0,0
1/10/2021,Barbados,Selangor,0,0,0
1/10/2021,Brunei Darussalam,Johor,0,0,0
1/10/2021,Brunei Darussalam,Kedah,0,0,0
1/10/2021,Brunei Darussalam,Kelantan,0,0,0
1/10/2021,Brunei Darussalam,Melaka,0,0,0
1/10/2021,Brunei Darussalam,Pahang,0,0,0
1/10/2021,Brunei Darussalam,Perak,0,0,0
1/10/2021,Brunei Darussalam,Perlis,0,0,0
1/10/2021,Brunei Darussalam,Pulau Pinang,0,0,0
1/10/2021,Brunei Darussalam,Sabah,0,0,0
1/10/2021,Brunei Darussalam,Sarawak,210,208,2
1/10/2021,Brunei Darussalam,Selangor,27,15,12
1/10/2021,Brunei Darussalam,W.P. Labuan,0,0,0
1/10/2021,Bhutan,Johor,0,0,0
1/10/2021,Bhutan,Kedah,0,0,0
1/10/2021,Bhutan,Perak,0,0,0
1/10/2021,Bhutan,Perlis,0,0,0
1/10/2021,Bhutan,Pulau Pinang,0,0,0
1/10/2021,Bhutan,Sabah,0,0,0
1/10/2021,Bhutan,Sarawak,0,0,0
1/10/2021,Bhutan,Selangor,0,0,0
1/10/2021,Botswana,Johor,0,0,0
1/10/2021,Botswana,Kedah,0,0,0
1/10/2021,Botswana,Perlis,0,0,0
1/10/2021,Botswana,Pulau Pinang,0,0,0
1/10/2021,Botswana,Sabah,0,0,0
1/10/2021,Botswana,Sarawak,0,0,0
1/10/2021,Botswana,Selangor,5,3,2
1/10/2021,Central African Republic,Kedah,0,0,0
1/10/2021,Central African Republic,Selangor,0,0,0
1/10/2021,Canada,Johor,0,0,0
1/10/2021,Canada,Kedah,0,0,0
1/10/2021,Canada,Kelantan,0,0,0
1/10/2021,Canada,Melaka,0,0,0
1/10/2021,Canada,Negeri Sembilan,0,0,0
1/10/2021,Canada,Pahang,0,0,0
1/10/2021,Canada,Perak,0,0,0
1/10/2021,Canada,Perlis,0,0,0
1/10/2021,Canada,Pulau Pinang,0,0,0
1/10/2021,Canada,Sabah,0,0,0
1/10/2021,Canada,Sarawak,0,0,0
1/10/2021,Canada,Selangor,68,50,18
1/10/2021,Canada,Terengganu,0,0,0
1/10/2021,Canada,W.P. Labuan,0,0,0
1/10/2021,Cocos (Keeling) Islands,Selangor,0,0,0
1/10/2021,Switzerland,Johor,0,0,0
1/10/2021,Switzerland,Kedah,0,0,0
1/10/2021,Switzerland,Kelantan,0,0,0
1/10/2021,Switzerland,Melaka,0,0,0
1/10/2021,Switzerland,Negeri Sembilan,0,0,0
1/10/2021,Switzerland,Pahang,0,0,0
1/10/2021,Switzerland,Perak,0,0,0
1/10/2021,Switzerland,Perlis,0,0,0
1/10/2021,Switzerland,Pulau Pinang,2,1,1
1/10/2021,Switzerland,Sabah,0,0,0
1/10/2021,Switzerland,Sarawak,0,0,0
1/10/2021,Switzerland,Selangor,41,26,15
1/10/2021,Switzerland,W.P. Labuan,0,0,0
1/10/2021,Chile,Johor,0,0,0
1/10/2021,Chile,Kedah,0,0,0
1/10/2021,Chile,Kelantan,0,0,0
1/10/2021,Chile,Melaka,0,0,0
1/10/2021,Chile,Pahang,0,0,0
1/10/2021,Chile,Perak,0,0,0
1/10/2021,Chile,Perlis,0,0,0
1/10/2021,Chile,Pulau Pinang,0,0,0
1/10/2021,Chile,Sabah,0,0,0
1/10/2021,Chile,Sarawak,0,0,0
1/10/2021,Chile,Selangor,15,9,6
1/10/2021,China,Johor,15,13,2
1/10/2021,China,Kedah,0,0,0
1/10/2021,China,Kelantan,0,0,0
1/10/2021,China,Melaka,0,0,0
1/10/2021,China,Pahang,0,0,0
1/10/2021,China,Perak,0,0,0
1/10/2021,China,Perlis,0,0,0
1/10/2021,China,Pulau Pinang,5,4,1
1/10/2021,China,Sabah,4,3,1
1/10/2021,China,Sarawak,31,28,3
1/10/2021,China,Selangor,1141,880,261
1/10/2021,China,Terengganu,0,0,0
1/10/2021,China,W.P. Labuan,0,0,0
1/10/2021,Côte d'Ivoire,Johor,0,0,0
1/10/2021,Côte d'Ivoire,Kedah,0,0,0
1/10/2021,Côte d'Ivoire,Pulau Pinang,0,0,0
1/10/2021,Côte d'Ivoire,Sabah,0,0,0
1/10/2021,Côte d'Ivoire,Sarawak,0,0,0
1/10/2021,Côte d'Ivoire,Selangor,1,0,1
1/10/2021,Cameroon,Johor,0,0,0
1/10/2021,Cameroon,Kedah,0,0,0
1/10/2021,Cameroon,Pulau Pinang,0,0,0
1/10/2021,Cameroon,Sabah,0,0,0
1/10/2021,Cameroon,Sarawak,0,0,0
1/10/2021,Cameroon,Selangor,5,3,2
1/10/2021,Congo,Johor,0,0,0
1/10/2021,Congo,Pulau Pinang,0,0,0
1/10/2021,Congo,Sarawak,0,0,0
1/10/2021,Congo,Selangor,6,3,3
1/10/2021,Congo,Johor,0,0,0
1/10/2021,Congo,Kedah,0,0,0
1/10/2021,Congo,Selangor,1,1,0
1/10/2021,Cook Islands,Selangor,0,0,0
1/10/2021,Colombia,Johor,0,0,0
1/10/2021,Colombia,Kedah,0,0,0
1/10/2021,Colombia,Perak,0,0,0
1/10/2021,Colombia,Pulau Pinang,1,0,1
1/10/2021,Colombia,Sabah,0,0,0
1/10/2021,Colombia,Sarawak,0,0,0
1/10/2021,Colombia,Selangor,6,4,2
1/10/2021,Colombia,W.P. Labuan,0,0,0
1/10/2021,Comoros,Johor,0,0,0
1/10/2021,Comoros,Kedah,0,0,0
1/10/2021,Comoros,Selangor,2,2,0
1/10/2021,Cabo Verde,Johor,0,0,0
1/10/2021,Cabo Verde,Kedah,0,0,0
1/10/2021,Cabo Verde,Pulau Pinang,0,0,0
1/10/2021,Cabo Verde,Sabah,0,0,0
1/10/2021,Cabo Verde,Selangor,0,0,0
1/10/2021,Costa Rica,Johor,0,0,0
1/10/2021,Costa Rica,Kedah,0,0,0
1/10/2021,Costa Rica,Perak,0,0,0
1/10/2021,Costa Rica,Perlis,0,0,0
1/10/2021,Costa Rica,Pulau Pinang,0,0,0
1/10/2021,Costa Rica,Sabah,0,0,0
1/10/2021,Costa Rica,Sarawak,0,0,0
1/10/2021,Costa Rica,Selangor,2,1,1
1/10/2021,Cuba,Johor,0,0,0
1/10/2021,Cuba,Kedah,0,0,0
1/10/2021,Cuba,Perlis,0,0,0
1/10/2021,Cuba,Pulau Pinang,0,0,0
1/10/2021,Cuba,Sabah,0,0,0
1/10/2021,Cuba,Sarawak,0,0,0
1/10/2021,Cuba,Selangor,0,0,0
1/10/2021,Cyprus,Johor,0,0,0
1/10/2021,Cyprus,Kedah,0,0,0
1/10/2021,Cyprus,Perak,0,0,0
1/10/2021,Cyprus,Perlis,0,0,0
1/10/2021,Cyprus,Pulau Pinang,0,0,0
1/10/2021,Cyprus,Sabah,0,0,0
1/10/2021,Cyprus,Sarawak,0,0,0
1/10/2021,Cyprus,Selangor,0,0,0
1/10/2021,Czechia,Johor,0,0,0
1/10/2021,Czechia,Kedah,0,0,0
1/10/2021,Czechia,Kelantan,0,0,0
1/10/2021,Czechia,Melaka,0,0,0
1/10/2021,Czechia,Negeri Sembilan,0,0,0
1/10/2021,Czechia,Perak,0,0,0
1/10/2021,Czechia,Perlis,0,0,0
1/10/2021,Czechia,Pulau Pinang,0,0,0
1/10/2021,Czechia,Sabah,0,0,0
1/10/2021,Czechia,Sarawak,0,0,0
1/10/2021,Czechia,Selangor,4,4,0
1/10/2021,Czechia,W.P. Labuan,0,0,0
1/10/2021,Germany,Johor,1,1,0
1/10/2021,Germany,Kedah,0,0,0
1/10/2021,Germany,Kelantan,0,0,0
1/10/2021,Germany,Melaka,0,0,0
1/10/2021,Germany,Negeri Sembilan,0,0,0
1/10/2021,Germany,Pahang,0,0,0
1/10/2021,Germany,Perak,0,0,0
1/10/2021,Germany,Perlis,0,0,0
1/10/2021,Germany,Pulau Pinang,6,4,2
1/10/2021,Germany,Sabah,0,0,0
1/10/2021,Germany,Sarawak,2,2,0
1/10/2021,Germany,Selangor,122,100,22
1/10/2021,Germany,Terengganu,0,0,0
1/10/2021,Germany,W.P. Labuan,0,0,0
1/10/2021,Djibouti,Johor,0,0,0
1/10/2021,Djibouti,Selangor,2,0,2
1/10/2021,Dominica,Johor,0,0,0
1/10/2021,Dominica,Kedah,0,0,0
1/10/2021,Dominica,Pulau Pinang,0,0,0
1/10/2021,Dominica,Sabah,0,0,0
1/10/2021,Dominica,Sarawak,0,0,0
1/10/2021,Dominica,Selangor,0,0,0
1/10/2021,Dominica,W.P. Labuan,0,0,0
1/10/2021,Denmark,Johor,0,0,0
1/10/2021,Denmark,Kedah,0,0,0
1/10/2021,Denmark,Kelantan,0,0,0
1/10/2021,Denmark,Melaka,0,0,0
1/10/2021,Denmark,Negeri Sembilan,0,0,0
1/10/2021,Denmark,Pahang,0,0,0
1/10/2021,Denmark,Perak,0,0,0
1/10/2021,Denmark,Perlis,0,0,0
1/10/2021,Denmark,Pulau Pinang,2,2,0
1/10/2021,Denmark,Sabah,0,0,0
1/10/2021,Denmark,Sarawak,0,0,0
1/10/2021,Denmark,Selangor,28,19,9
1/10/2021,Denmark,W.P. Labuan,0,0,0
1/10/2021,Dominican Republic,Johor,0,0,0
1/10/2021,Dominican Republic,Kedah,0,0,0
1/10/2021,Dominican Republic,Perak,0,0,0
1/10/2021,Dominican Republic,Perlis,0,0,0
1/10/2021,Dominican Republic,Pulau Pinang,0,0,0
1/10/2021,Dominican Republic,Sabah,0,0,0
1/10/2021,Dominican Republic,Sarawak,0,0,0
1/10/2021,Dominican Republic,Selangor,0,0,0
1/10/2021,Algeria,Johor,0,0,0
1/10/2021,Algeria,Kedah,0,0,0
1/10/2021,Algeria,Kelantan,0,0,0
1/10/2021,Algeria,Melaka,0,0,0
1/10/2021,Algeria,Perak,0,0,0
1/10/2021,Algeria,Perlis,0,0,0
1/10/2021,Algeria,Pulau Pinang,0,0,0
1/10/2021,Algeria,Sabah,0,0,0
1/10/2021,Algeria,Sarawak,0,0,0
1/10/2021,Algeria,Selangor,11,9,2
1/10/2021,Algeria,W.P. Labuan,0,0,0
1/10/2021,Ecuador,Johor,0,0,0
1/10/2021,Ecuador,Kedah,0,0,0
1/10/2021,Ecuador,Perak,0,0,0
1/10/2021,Ecuador,Perlis,0,0,0
1/10/2021,Ecuador,Pulau Pinang,0,0,0
1/10/2021,Ecuador,Sabah,0,0,0
1/10/2021,Ecuador,Sarawak,0,0,0
1/10/2021,Ecuador,Selangor,1,1,0
1/10/2021,Egypt,Johor,1,1,0
1/10/2021,Egypt,Kedah,0,0,0
1/10/2021,Egypt,Kelantan,0,0,0
1/10/2021,Egypt,Melaka,0,0,0
1/10/2021,Egypt,Pahang,0,0,0
1/10/2021,Egypt,Perak,0,0,0
1/10/2021,Egypt,Perlis,0,0,0
1/10/2021,Egypt,Pulau Pinang,0,0,0
1/10/2021,Egypt,Sabah,0,0,0
1/10/2021,Egypt,Sarawak,0,0,0
1/10/2021,Egypt,Selangor,164,124,40
1/10/2021,Egypt,Terengganu,0,0,0
1/10/2021,Egypt,W.P. Labuan,0,0,0
1/10/2021,Eritrea,Johor,0,0,0
1/10/2021,Eritrea,Pulau Pinang,0,0,0
1/10/2021,Eritrea,Sabah,0,0,0
1/10/2021,Eritrea,Selangor,2,1,1
1/10/2021,Spain,Johor,0,0,0
1/10/2021,Spain,Kedah,0,0,0
1/10/2021,Spain,Kelantan,0,0,0
1/10/2021,Spain,Melaka,0,0,0
1/10/2021,Spain,Negeri Sembilan,0,0,0
1/10/2021,Spain,Pahang,0,0,0
1/10/2021,Spain,Perak,0,0,0
1/10/2021,Spain,Perlis,0,0,0
1/10/2021,Spain,Pulau Pinang,0,0,0
1/10/2021,Spain,Sabah,0,0,0
1/10/2021,Spain,Sarawak,0,0,0
1/10/2021,Spain,Selangor,19,13,6
1/10/2021,Spain,W.P. Labuan,0,0,0
1/10/2021,Estonia,Johor,0,0,0
1/10/2021,Estonia,Kedah,0,0,0
1/10/2021,Estonia,Kelantan,0,0,0
1/10/2021,Estonia,Pahang,0,0,0
1/10/2021,Estonia,Perak,0,0,0
1/10/2021,Estonia,Perlis,0,0,0
1/10/2021,Estonia,Pulau Pinang,0,0,0
1/10/2021,Estonia,Sabah,0,0,0
1/10/2021,Estonia,Sarawak,0,0,0
1/10/2021,Estonia,Selangor,1,1,0
1/10/2021,Estonia,W.P. Labuan,0,0,0
1/10/2021,Ethiopia,Johor,0,0,0
1/10/2021,Ethiopia,Kedah,0,0,0
1/10/2021,Ethiopia,Pulau Pinang,0,0,0
1/10/2021,Ethiopia,Sarawak,0,0,0
1/10/2021,Ethiopia,Selangor,4,2,2
1/10/2021,Finland,Johor,0,0,0
1/10/2021,Finland,Kedah,0,0,0
1/10/2021,Finland,Kelantan,0,0,0
1/10/2021,Finland,Melaka,0,0,0
1/10/2021,Finland,Negeri Sembilan,0,0,0
1/10/2021,Finland,Pahang,0,0,0
1/10/2021,Finland,Perak,0,0,0
1/10/2021,Finland,Perlis,0,0,0
1/10/2021,Finland,Pulau Pinang,0,0,0
1/10/2021,Finland,Sabah,0,0,0
1/10/2021,Finland,Sarawak,0,0,0
1/10/2021,Finland,Selangor,12,7,5
1/10/2021,Finland,W.P. Labuan,0,0,0
1/10/2021,Fiji,Johor,0,0,0
1/10/2021,Fiji,Kedah,0,0,0
1/10/2021,Fiji,Kelantan,0,0,0
1/10/2021,Fiji,Perak,0,0,0
1/10/2021,Fiji,Perlis,0,0,0
1/10/2021,Fiji,Pulau Pinang,0,0,0
1/10/2021,Fiji,Sabah,0,0,0
1/10/2021,Fiji,Sarawak,0,0,0
1/10/2021,Fiji,Selangor,0,0,0
1/10/2021,France,Johor,0,0,0
1/10/2021,France,Kedah,0,0,0
1/10/2021,France,Kelantan,0,0,0
1/10/2021,France,Melaka,0,0,0
1/10/2021,France,Negeri Sembilan,0,0,0
1/10/2021,France,Pahang,0,0,0
1/10/2021,France,Perak,0,0,0
1/10/2021,France,Perlis,0,0,0
1/10/2021,France,Pulau Pinang,5,3,2
1/10/2021,France,Sabah,0,0,0
1/10/2021,France,Sarawak,0,0,0
1/10/2021,France,Selangor,180,120,60
1/10/2021,France,Terengganu,0,0,0
1/10/2021,France,W.P. Labuan,0,0,0
1/10/2021,"Micronesia, Federated States of",Johor,0,0,0
1/10/2021,"Micronesia, Federated States of",Pulau Pinang,0,0,0
1/10/2021,"Micronesia, Federated States of",Selangor,0,0,0
1/10/2021,Gabon,Johor,0,0,0
1/10/2021,Gabon,Pulau Pinang,0,0,0
1/10/2021,Gabon,Sarawak,0,0,0
1/10/2021,Gabon,Selangor,1,1,0
1/10/2021,United Kingdom of Great Britain and Northern Ireland,Johor,0,0,0
1/10/2021,United Kingdom of Great Britain and Northern Ireland,Kedah,1,0,1
1/10/2021,United Kingdom of Great Britain and Northern Ireland,Kelantan,0,0,0
1/10/2021,United Kingdom of Great Britain and Northern Ireland,Melaka,0,0,0
1/10/2021,United Kingdom of Great Britain and Northern Ireland,Negeri Sembilan,0,0,0
1/10/2021,United Kingdom of Great Britain and Northern Ireland,Pahang,0,0,0
1/10/2021,United Kingdom of Great Britain and Northern Ireland,Perak,1,0,1
1/10/2021,United Kingdom of Great Britain and Northern Ireland,Perlis,0,0,0
1/10/2021,United Kingdom of Great Britain and Northern Ireland,Pulau Pinang,17,9,8
1/10/2021,United Kingdom of Great Britain and Northern Ireland,Sabah,0,0,0
1/10/2021,United Kingdom of Great Britain and Northern Ireland,Sarawak,3,2,1
1/10/2021,United Kingdom of Great Britain and Northern Ireland,Selangor,350,242,108
1/10/2021,United Kingdom of Great Britain and Northern Ireland,Terengganu,0,0,0
1/10/2021,United Kingdom of Great Britain and Northern Ireland,W.P. Labuan,0,0,0
1/10/2021,Georgia,Johor,0,0,0
1/10/2021,Georgia,Kedah,0,0,0
1/10/2021,Georgia,Melaka,0,0,0
1/10/2021,Georgia,Perak,0,0,0
1/10/2021,Georgia,Perlis,0,0,0
1/10/2021,Georgia,Pulau Pinang,0,0,0
1/10/2021,Georgia,Sabah,0,0,0
1/10/2021,Georgia,Sarawak,0,0,0
1/10/2021,Georgia,Selangor,2,1,1
1/10/2021,Ghana,Johor,0,0,0
1/10/2021,Ghana,Kedah,0,0,0
1/10/2021,Ghana,Kelantan,0,0,0
1/10/2021,Ghana,Pulau Pinang,0,0,0
1/10/2021,Ghana,Sabah,0,0,0
1/10/2021,Ghana,Sarawak,0,0,0
1/10/2021,Ghana,Selangor,6,3,3
1/10/2021,Gibraltar,Johor,0,0,0
1/10/2021,Gibraltar,Sarawak,0,0,0
1/10/2021,Guinea,Johor,0,0,0
1/10/2021,Guinea,Kedah,0,0,0
1/10/2021,Guinea,Kelantan,0,0,0
1/10/2021,Guinea,Perlis,0,0,0
1/10/2021,Guinea,Pulau Pinang,0,0,0
1/10/2021,Guinea,Sabah,0,0,0
1/10/2021,Guinea,Sarawak,0,0,0
1/10/2021,Guinea,Selangor,10,7,3
1/10/2021,Guadeloupe,Selangor,0,0,0
1/10/2021,Gambia,Johor,0,0,0
1/10/2021,Gambia,Kedah,0,0,0
1/10/2021,Gambia,Kelantan,0,0,0
1/10/2021,Gambia,Pulau Pinang,0,0,0
1/10/2021,Gambia,Sabah,0,0,0
1/10/2021,Gambia,Sarawak,0,0,0
1/10/2021,Gambia,Selangor,1,1,0
1/10/2021,Guinea-Bissau,Johor,0,0,0
1/10/2021,Guinea-Bissau,Selangor,0,0,0
1/10/2021,Equatorial Guinea,Johor,0,0,0
1/10/2021,Equatorial Guinea,Selangor,0,0,0
1/10/2021,Greece,Johor,0,0,0
1/10/2021,Greece,Kedah,0,0,0
1/10/2021,Greece,Kelantan,0,0,0
1/10/2021,Greece,Melaka,0,0,0
1/10/2021,Greece,Negeri Sembilan,0,0,0
1/10/2021,Greece,Pahang,0,0,0
1/10/2021,Greece,Perak,0,0,0
1/10/2021,Greece,Perlis,0,0,0
1/10/2021,Greece,Pulau Pinang,0,0,0
1/10/2021,Greece,Sabah,0,0,0
1/10/2021,Greece,Sarawak,0,0,0
1/10/2021,Greece,Selangor,9,7,2
1/10/2021,Grenada,Johor,0,0,0
1/10/2021,Grenada,Kedah,0,0,0
1/10/2021,Grenada,Pulau Pinang,0,0,0
1/10/2021,Grenada,Sabah,0,0,0
1/10/2021,Grenada,Sarawak,0,0,0
1/10/2021,Grenada,Selangor,3,1,2
1/10/2021,Greenland,Johor,0,0,0
1/10/2021,Greenland,Selangor,0,0,0
1/10/2021,Guatemala,Johor,0,0,0
1/10/2021,Guatemala,Kedah,0,0,0
1/10/2021,Guatemala,Pahang,0,0,0
1/10/2021,Guatemala,Perak,0,0,0
1/10/2021,Guatemala,Pulau Pinang,0,0,0
1/10/2021,Guatemala,Sabah,0,0,0
1/10/2021,Guatemala,Sarawak,0,0,0
1/10/2021,Guatemala,Selangor,2,2,0
1/10/2021,Guatemala,W.P. Labuan,0,0,0
1/10/2021,Guyana,Johor,0,0,0
1/10/2021,Guyana,Kedah,0,0,0
1/10/2021,Guyana,Pulau Pinang,0,0,0
1/10/2021,Guyana,Sarawak,0,0,0
1/10/2021,Guyana,Selangor,0,0,0
1/10/2021,Hong Kong,Johor,0,0,0
1/10/2021,Hong Kong,Kedah,0,0,0
1/10/2021,Hong Kong,Kelantan,0,0,0
1/10/2021,Hong Kong,Pahang,0,0,0
1/10/2021,Hong Kong,Perak,0,0,0
1/10/2021,Hong Kong,Perlis,0,0,0
1/10/2021,Hong Kong,Pulau Pinang,1,0,1
1/10/2021,Hong Kong,Sabah,0,0,0
1/10/2021,Hong Kong,Sarawak,49,47,2
1/10/2021,Hong Kong,Selangor,0,0,0
1/10/2021,Hong Kong,Terengganu,0,0,0
1/10/2021,Heard Island and McDonald Islands,Johor,0,0,0
1/10/2021,Honduras,Johor,0,0,0
1/10/2021,Honduras,Kedah,0,0,0
1/10/2021,Honduras,Perak,0,0,0
1/10/2021,Honduras,Pulau Pinang,0,0,0
1/10/2021,Honduras,Sabah,0,0,0
1/10/2021,Honduras,Sarawak,0,0,0
1/10/2021,Honduras,Selangor,2,2,0
1/10/2021,Croatia,Johor,0,0,0
1/10/2021,Croatia,Kedah,0,0,0
1/10/2021,Croatia,Kelantan,0,0,0
1/10/2021,Croatia,Melaka,0,0,0
1/10/2021,Croatia,Pahang,0,0,0
1/10/2021,Croatia,Perak,0,0,0
1/10/2021,Croatia,Perlis,0,0,0
1/10/2021,Croatia,Pulau Pinang,0,0,0
1/10/2021,Croatia,Sabah,0,0,0
1/10/2021,Croatia,Sarawak,1,1,0
1/10/2021,Croatia,Selangor,10,10,0
1/10/2021,Haiti,Johor,0,0,0
1/10/2021,Haiti,Kedah,0,0,0
1/10/2021,Haiti,Kelantan,0,0,0
1/10/2021,Haiti,Perak,0,0,0
1/10/2021,Haiti,Pulau Pinang,0,0,0
1/10/2021,Haiti,Sabah,0,0,0
1/10/2021,Haiti,Selangor,0,0,0
1/10/2021,Hungary,Johor,0,0,0
1/10/2021,Hungary,Kedah,0,0,0
1/10/2021,Hungary,Kelantan,0,0,0
1/10/2021,Hungary,Pahang,0,0,0
1/10/2021,Hungary,Perak,0,0,0
1/10/2021,Hungary,Perlis,0,0,0
1/10/2021,Hungary,Pulau Pinang,0,0,0
1/10/2021,Hungary,Sabah,0,0,0
1/10/2021,Hungary,Sarawak,0,0,0
1/10/2021,Hungary,Selangor,8,3,5
1/10/2021,Hungary,W.P. Labuan,0,0,0
1/10/2021,Indonesia,Johor,73,56,17
1/10/2021,Indonesia,Kedah,4,4,0
1/10/2021,Indonesia,Kelantan,0,0,0
1/10/2021,Indonesia,Melaka,0,0,0
1/10/2021,Indonesia,Negeri Sembilan,0,0,0
1/10/2021,Indonesia,Pahang,0,0,0
1/10/2021,Indonesia,Perak,2,0,2
1/10/2021,Indonesia,Perlis,8,8,0
1/10/2021,Indonesia,Pulau Pinang,36,14,22
1/10/2021,Indonesia,Sabah,1,0,1
1/10/2021,Indonesia,Sarawak,149,146,3
1/10/2021,Indonesia,Selangor,1241,658,583
1/10/2021,Indonesia,Terengganu,0,0,0
1/10/2021,Indonesia,W.P. Labuan,0,0,0
1/10/2021,India,Johor,10,10,0
1/10/2021,India,Kedah,1,1,0
1/10/2021,India,Kelantan,0,0,0
1/10/2021,India,Melaka,0,0,0
1/10/2021,India,Negeri Sembilan,0,0,0
1/10/2021,India,Pahang,0,0,0
1/10/2021,India,Perak,0,0,0
1/10/2021,India,Perlis,0,0,0
1/10/2021,India,Pulau Pinang,5,3,2
1/10/2021,India,Sabah,1,1,0
1/10/2021,India,Sarawak,2,2,0
1/10/2021,India,Selangor,926,695,231
1/10/2021,India,Terengganu,0,0,0
1/10/2021,India,W.P. Labuan,0,0,0
1/10/2021, British Indian Ocean Territory,Pulau Pinang,0,0,0
1/10/2021, British Indian Ocean Territory,Selangor,0,0,0
1/10/2021,Ireland,Johor,1,1,0
1/10/2021,Ireland,Kedah,0,0,0
1/10/2021,Ireland,Kelantan,0,0,0
1/10/2021,Ireland,Negeri Sembilan,0,0,0
1/10/2021,Ireland,Pahang,0,0,0
1/10/2021,Ireland,Perak,0,0,0
1/10/2021,Ireland,Perlis,0,0,0
1/10/2021,Ireland,Pulau Pinang,2,2,0
1/10/2021,Ireland,Sabah,0,0,0
1/10/2021,Ireland,Sarawak,0,0,0
1/10/2021,Ireland,Selangor,17,11,6
1/10/2021,Ireland,Terengganu,0,0,0
1/10/2021,Ireland,W.P. Labuan,0,0,0
1/10/2021,"Iran, Islamic Republic of",Johor,0,0,0
1/10/2021,"Iran, Islamic Republic of",Kedah,0,0,0
1/10/2021,"Iran, Islamic Republic of",Kelantan,0,0,0
1/10/2021,"Iran, Islamic Republic of",Perak,0,0,0
1/10/2021,"Iran, Islamic Republic of",Perlis,0,0,0
1/10/2021,"Iran, Islamic Republic of",Pulau Pinang,0,0,0
1/10/2021,"Iran, Islamic Republic of",Sabah,0,0,0
1/10/2021,"Iran, Islamic Republic of",Sarawak,0,0,0
1/10/2021,"Iran, Islamic Republic of",Selangor,92,47,45
1/10/2021,"Iran, Islamic Republic of",W.P. Labuan,0,0,0
1/10/2021,Iraq,Johor,0,0,0
1/10/2021,Iraq,Kedah,0,0,0
1/10/2021,Iraq,Kelantan,0,0,0
1/10/2021,Iraq,Melaka,0,0,0
1/10/2021,Iraq,Pahang,0,0,0
1/10/2021,Iraq,Perak,0,0,0
1/10/2021,Iraq,Perlis,0,0,0
1/10/2021,Iraq,Pulau Pinang,0,0,0
1/10/2021,Iraq,Sabah,0,0,0
1/10/2021,Iraq,Sarawak,0,0,0
1/10/2021,Iraq,Selangor,69,49,20
1/10/2021,Iceland,Johor,0,0,0
1/10/2021,Iceland,Kedah,0,0,0
1/10/2021,Iceland,Kelantan,0,0,0
1/10/2021,Iceland,Perak,0,0,0
1/10/2021,Iceland,Perlis,0,0,0
1/10/2021,Iceland,Pulau Pinang,0,0,0
1/10/2021,Iceland,Sabah,0,0,0
1/10/2021,Iceland,Sarawak,0,0,0
1/10/2021,Iceland,Selangor,0,0,0
1/10/2021,Iceland,W.P. Labuan,0,0,0
1/10/2021,Israel,Pulau Pinang,0,0,0
1/10/2021,Italy,Johor,0,0,0
1/10/2021,Italy,Kedah,0,0,0
1/10/2021,Italy,Kelantan,0,0,0
1/10/2021,Italy,Melaka,0,0,0
1/10/2021,Italy,Negeri Sembilan,0,0,0
1/10/2021,Italy,Pahang,0,0,0
1/10/2021,Italy,Perak,0,0,0
1/10/2021,Italy,Perlis,0,0,0
1/10/2021,Italy,Pulau Pinang,0,0,0
1/10/2021,Italy,Sabah,0,0,0
1/10/2021,Italy,Sarawak,3,3,0
1/10/2021,Italy,Selangor,78,53,25
1/10/2021,Italy,W.P. Labuan,0,0,0
1/10/2021,Jamaica,Johor,0,0,0
1/10/2021,Jamaica,Kedah,0,0,0
1/10/2021,Jamaica,Perak,0,0,0
1/10/2021,Jamaica,Pulau Pinang,0,0,0
1/10/2021,Jamaica,Sabah,0,0,0
1/10/2021,Jamaica,Sarawak,0,0,0
1/10/2021,Jamaica,Selangor,1,0,1
1/10/2021,Jamaica,W.P. Labuan,0,0,0
1/10/2021,Jordan,Johor,0,0,0
1/10/2021,Jordan,Kedah,0,0,0
1/10/2021,Jordan,Kelantan,0,0,0
1/10/2021,Jordan,Melaka,0,0,0
1/10/2021,Jordan,Perlis,0,0,0
1/10/2021,Jordan,Pulau Pinang,0,0,0
1/10/2021,Jordan,Sabah,0,0,0
1/10/2021,Jordan,Sarawak,0,0,0
1/10/2021,Jordan,Selangor,66,43,23
1/10/2021,Jordan,W.P. Labuan,0,0,0
1/10/2021,Japan,Johor,0,0,0
1/10/2021,Japan,Kedah,0,0,0
1/10/2021,Japan,Kelantan,0,0,0
1/10/2021,Japan,Melaka,0,0,0
1/10/2021,Japan,Negeri Sembilan,0,0,0
1/10/2021,Japan,Pahang,0,0,0
1/10/2021,Japan,Perak,2,1,1
1/10/2021,Japan,Perlis,0,0,0
1/10/2021,Japan,Pulau Pinang,69,38,31
1/10/2021,Japan,Sabah,0,0,0
1/10/2021,Japan,Sarawak,4,4,0
1/10/2021,Japan,Selangor,834,541,293
1/10/2021,Japan,W.P. Labuan,0,0,0
1/10/2021,Kazakhstan,Johor,0,0,0
1/10/2021,Kazakhstan,Kedah,0,0,0
1/10/2021,Kazakhstan,Kelantan,0,0,0
1/10/2021,Kazakhstan,Melaka,0,0,0
1/10/2021,Kazakhstan,Perak,0,0,0
1/10/2021,Kazakhstan,Perlis,0,0,0
1/10/2021,Kazakhstan,Pulau Pinang,0,0,0
1/10/2021,Kazakhstan,Sabah,0,0,0
1/10/2021,Kazakhstan,Sarawak,0,0,0
1/10/2021,Kazakhstan,Selangor,23,9,14
1/10/2021,Kazakhstan,W.P. Labuan,0,0,0
1/10/2021,Kenya,Johor,0,0,0
1/10/2021,Kenya,Kedah,0,0,0
1/10/2021,Kenya,Kelantan,0,0,0
1/10/2021,Kenya,Perak,0,0,0
1/10/2021,Kenya,Perlis,0,0,0
1/10/2021,Kenya,Pulau Pinang,0,0,0
1/10/2021,Kenya,Sabah,0,0,0
1/10/2021,Kenya,Sarawak,0,0,0
1/10/2021,Kenya,Selangor,15,4,11
1/10/2021,Kyrgyzstan,Johor,0,0,0
1/10/2021,Kyrgyzstan,Kedah,0,0,0
1/10/2021,Kyrgyzstan,Kelantan,0,0,0
1/10/2021,Kyrgyzstan,Perak,0,0,0
1/10/2021,Kyrgyzstan,Perlis,0,0,0
1/10/2021,Kyrgyzstan,Pulau Pinang,0,0,0
1/10/2021,Kyrgyzstan,Sabah,0,0,0
1/10/2021,Kyrgyzstan,Sarawak,0,0,0
1/10/2021,Kyrgyzstan,Selangor,4,1,3
1/10/2021,Cambodia,Johor,0,0,0
1/10/2021,Cambodia,Kedah,0,0,0
1/10/2021,Cambodia,Kelantan,0,0,0
1/10/2021,Cambodia,Melaka,0,0,0
1/10/2021,Cambodia,Negeri Sembilan,0,0,0
1/10/2021,Cambodia,Pahang,0,0,0
1/10/2021,Cambodia,Perak,0,0,0
1/10/2021,Cambodia,Perlis,0,0,0
1/10/2021,Cambodia,Pulau Pinang,0,0,0
1/10/2021,Cambodia,Sabah,0,0,0
1/10/2021,Cambodia,Sarawak,0,0,0
1/10/2021,Cambodia,Selangor,36,34,2
1/10/2021,Cambodia,W.P. Labuan,0,0,0
1/10/2021,Kiribati,Johor,0,0,0
1/10/2021,Kiribati,Sabah,0,0,0
1/10/2021,Kiribati,Selangor,0,0,0
1/10/2021,Saint Kitts and Nevis,Johor,0,0,0
1/10/2021,Saint Kitts and Nevis,Kedah,0,0,0
1/10/2021,Saint Kitts and Nevis,Perlis,0,0,0
1/10/2021,Saint Kitts and Nevis,Pulau Pinang,0,0,0
1/10/2021,Saint Kitts and Nevis,Sabah,0,0,0
1/10/2021,Saint Kitts and Nevis,Selangor,3,2,1
1/10/2021,Saint Kitts and Nevis,W.P. Labuan,0,0,0
1/10/2021,"Korea, Republic of",Johor,0,0,0
1/10/2021,"Korea, Republic of",Kedah,0,0,0
1/10/2021,"Korea, Republic of",Kelantan,0,0,0
1/10/2021,"Korea, Republic of",Melaka,0,0,0
1/10/2021,"Korea, Republic of",Negeri Sembilan,0,0,0
1/10/2021,"Korea, Republic of",Pahang,0,0,0
1/10/2021,"Korea, Republic of",Perak,0,0,0
1/10/2021,"Korea, Republic of",Perlis,0,0,0
1/10/2021,"Korea, Republic of",Pulau Pinang,11,5,6
1/10/2021,"Korea, Republic of",Sabah,2,2,0
1/10/2021,"Korea, Republic of",Sarawak,36,31,5
1/10/2021,"Korea, Republic of",Selangor,627,423,204
1/10/2021,"Korea, Republic of",Terengganu,0,0,0
1/10/2021,"Korea, Republic of",W.P. Labuan,0,0,0
1/10/2021,Kuwait,Johor,0,0,0
1/10/2021,Kuwait,Kedah,0,0,0
1/10/2021,Kuwait,Kelantan,0,0,0
1/10/2021,Kuwait,Perak,0,0,0
1/10/2021,Kuwait,Perlis,0,0,0
1/10/2021,Kuwait,Pulau Pinang,0,0,0
1/10/2021,Kuwait,Sabah,0,0,0
1/10/2021,Kuwait,Sarawak,0,0,0
1/10/2021,Kuwait,Selangor,9,4,5
1/10/2021,Kuwait,W.P. Labuan,0,0,0
1/10/2021, Lao People's Democratic Republic,Johor,0,0,0
1/10/2021, Lao People's Democratic Republic,Kedah,0,0,0
1/10/2021, Lao People's Democratic Republic,Kelantan,0,0,0
1/10/2021, Lao People's Democratic Republic,Melaka,0,0,0
1/10/2021, Lao People's Democratic Republic,Perak,0,0,0
1/10/2021, Lao People's Democratic Republic,Perlis,0,0,0
1/10/2021, Lao People's Democratic Republic,Pulau Pinang,0,0,0
1/10/2021, Lao People's Democratic Republic,Sabah,0,0,0
1/10/2021, Lao People's Democratic Republic,Sarawak,0,0,0
1/10/2021, Lao People's Democratic Republic,Selangor,1,0,1
1/10/2021, Lao People's Democratic Republic,W.P. Labuan,0,0,0
1/10/2021,Lebanon,Johor,0,0,0
1/10/2021,Lebanon,Kedah,0,0,0
1/10/2021,Lebanon,Kelantan,0,0,0
1/10/2021,Lebanon,Pahang,0,0,0
1/10/2021,Lebanon,Perak,0,0,0
1/10/2021,Lebanon,Perlis,0,0,0
1/10/2021,Lebanon,Pulau Pinang,0,0,0
1/10/2021,Lebanon,Sabah,0,0,0
1/10/2021,Lebanon,Sarawak,0,0,0
1/10/2021,Lebanon,Selangor,14,10,4
1/10/2021,Lebanon,W.P. Labuan,0,0,0
1/10/2021,Liberia,Johor,0,0,0
1/10/2021,Liberia,Kedah,0,0,0
1/10/2021,Liberia,Sabah,0,0,0
1/10/2021,Liberia,Sarawak,0,0,0
1/10/2021,Liberia,Selangor,2,1,1
1/10/2021,Libya,Johor,0,0,0
1/10/2021,Libya,Kedah,0,0,0
1/10/2021,Libya,Perlis,0,0,0
1/10/2021,Libya,Pulau Pinang,0,0,0
1/10/2021,Libya,Sabah,0,0,0
1/10/2021,Libya,Sarawak,0,0,0
1/10/2021,Libya,Selangor,76,56,20
1/10/2021,Saint Lucia,Johor,0,0,0
1/10/2021,Saint Lucia,Kedah,0,0,0
1/10/2021,Saint Lucia,Pulau Pinang,0,0,0
1/10/2021,Saint Lucia,Sarawak,0,0,0
1/10/2021,Saint Lucia,Selangor,0,0,0
1/10/2021,Liechtenstein,Johor,0,0,0
1/10/2021,Liechtenstein,Kedah,0,0,0
1/10/2021,Liechtenstein,Perlis,0,0,0
1/10/2021,Liechtenstein,Pulau Pinang,0,0,0
1/10/2021,Liechtenstein,Sabah,0,0,0
1/10/2021,Liechtenstein,Sarawak,0,0,0
1/10/2021,Liechtenstein,Selangor,1,1,0
1/10/2021,LKA,Johor,0,0,0
1/10/2021,LKA,Kedah,0,0,0
1/10/2021,LKA,Kelantan,0,0,0
1/10/2021,LKA,Melaka,0,0,0
1/10/2021,LKA,Pahang,0,0,0
1/10/2021,LKA,Perak,0,0,0
1/10/2021,LKA,Perlis,0,0,0
1/10/2021,LKA,Pulau Pinang,1,0,1
1/10/2021,LKA,Sabah,0,0,0
1/10/2021,LKA,Sarawak,0,0,0
1/10/2021,LKA,Selangor,62,39,23
1/10/2021,LKA,W.P. Labuan,0,0,0
1/10/2021,Lesotho,Johor,0,0,0
1/10/2021,Lesotho,Kedah,0,0,0
1/10/2021,Lesotho,Pulau Pinang,0,0,0
1/10/2021,Lesotho,Sarawak,0,0,0
1/10/2021,Lesotho,Selangor,0,0,0
1/10/2021,Lithuania,Johor,0,0,0
1/10/2021,Lithuania,Kedah,0,0,0
1/10/2021,Lithuania,Kelantan,0,0,0
1/10/2021,Lithuania,Pahang,0,0,0
1/10/2021,Lithuania,Perak,0,0,0
1/10/2021,Lithuania,Perlis,0,0,0
1/10/2021,Lithuania,Pulau Pinang,0,0,0
1/10/2021,Lithuania,Sabah,0,0,0
1/10/2021,Lithuania,Sarawak,1,1,0
1/10/2021,Lithuania,Selangor,5,3,2
1/10/2021,Lithuania,W.P. Labuan,0,0,0
1/10/2021,Luxembourg,Johor,0,0,0
1/10/2021,Luxembourg,Kedah,0,0,0
1/10/2021,Luxembourg,Kelantan,0,0,0
1/10/2021,Luxembourg,Perak,0,0,0
1/10/2021,Luxembourg,Perlis,0,0,0
1/10/2021,Luxembourg,Pulau Pinang,0,0,0
1/10/2021,Luxembourg,Sabah,0,0,0
1/10/2021,Luxembourg,Sarawak,0,0,0
1/10/2021,Luxembourg,Selangor,4,4,0
1/10/2021,Latvia,Johor,0,0,0
1/10/2021,Latvia,Kedah,0,0,0
1/10/2021,Latvia,Kelantan,0,0,0
1/10/2021,Latvia,Pahang,0,0,0
1/10/2021,Latvia,Perak,0,0,0
1/10/2021,Latvia,Perlis,0,0,0
1/10/2021,Latvia,Pulau Pinang,0,0,0
1/10/2021,Latvia,Sabah,0,0,0
1/10/2021,Latvia,Sarawak,0,0,0
1/10/2021,Latvia,Selangor,1,1,0
1/10/2021,Latvia,W.P. Labuan,0,0,0
1/10/2021,Macao,Johor,0,0,0
1/10/2021,Macao,Pahang,0,0,0
1/10/2021,Macao,Perak,0,0,0
1/10/2021,Macao,Selangor,0,0,0
1/10/2021,Macao,W.P. Labuan,0,0,0
1/10/2021,Morocco,Johor,0,0,0
1/10/2021,Morocco,Kedah,0,0,0
1/10/2021,Morocco,Kelantan,0,0,0
1/10/2021,Morocco,Melaka,0,0,0
1/10/2021,Morocco,Pahang,0,0,0
1/10/2021,Morocco,Perak,0,0,0
1/10/2021,Morocco,Perlis,0,0,0
1/10/2021,Morocco,Pulau Pinang,0,0,0
1/10/2021,Morocco,Sabah,0,0,0
1/10/2021,Morocco,Sarawak,0,0,0
1/10/2021,Morocco,Selangor,8,2,6
1/10/2021,Morocco,W.P. Labuan,0,0,0
1/10/2021,Monaco,Johor,0,0,0
1/10/2021,Monaco,Kedah,0,0,0
1/10/2021,Monaco,Sabah,0,0,0
1/10/2021,Monaco,Selangor,0,0,0
1/10/2021,"Moldova, Republic of",Johor,0,0,0
1/10/2021,"Moldova, Republic of",Kedah,0,0,0
1/10/2021,"Moldova, Republic of",Kelantan,0,0,0
1/10/2021,"Moldova, Republic of",Negeri Sembilan,0,0,0
1/10/2021,"Moldova, Republic of",Perlis,0,0,0
1/10/2021,"Moldova, Republic of",Pulau Pinang,0,0,0
1/10/2021,"Moldova, Republic of",Sabah,0,0,0
1/10/2021,"Moldova, Republic of",Sarawak,0,0,0
1/10/2021,"Moldova, Republic of",Selangor,0,0,0
1/10/2021,Madagascar,Johor,0,0,0
1/10/2021,Madagascar,Kedah,0,0,0
1/10/2021,Madagascar,Perak,0,0,0
1/10/2021,Madagascar,Perlis,0,0,0
1/10/2021,Madagascar,Pulau Pinang,0,0,0
1/10/2021,Madagascar,Sabah,0,0,0
1/10/2021,Madagascar,Sarawak,0,0,0
1/10/2021,Madagascar,Selangor,0,0,0
1/10/2021,Maldives,Johor,0,0,0
1/10/2021,Maldives,Kedah,0,0,0
1/10/2021,Maldives,Kelantan,0,0,0
1/10/2021,Maldives,Perak,0,0,0
1/10/2021,Maldives,Perlis,0,0,0
1/10/2021,Maldives,Pulau Pinang,0,0,0
1/10/2021,Maldives,Sabah,0,0,0
1/10/2021,Maldives,Sarawak,0,0,0
1/10/2021,Maldives,Selangor,94,32,62
1/10/2021,Mexico,Johor,0,0,0
1/10/2021,Mexico,Kedah,0,0,0
1/10/2021,Mexico,Kelantan,0,0,0
1/10/2021,Mexico,Pahang,0,0,0
1/10/2021,Mexico,Perak,0,0,0
1/10/2021,Mexico,Perlis,0,0,0
1/10/2021,Mexico,Pulau Pinang,0,0,0
1/10/2021,Mexico,Sabah,0,0,0
1/10/2021,Mexico,Sarawak,0,0,0
1/10/2021,Mexico,Selangor,7,6,1
1/10/2021,Mexico,W.P. Labuan,0,0,0
1/10/2021,Marshall Islands,Johor,0,0,0
1/10/2021,Marshall Islands,Kedah,0,0,0
1/10/2021,Marshall Islands,Perak,0,0,0
1/10/2021,Marshall Islands,Pulau Pinang,0,0,0
1/10/2021,Marshall Islands,Sabah,0,0,0
1/10/2021,Marshall Islands,Selangor,1,1,0
1/10/2021,North Macedonia,Johor,0,0,0
1/10/2021,North Macedonia,Kedah,0,0,0
1/10/2021,North Macedonia,Perak,0,0,0
1/10/2021,North Macedonia,Pulau Pinang,0,0,0
1/10/2021,North Macedonia,Sabah,0,0,0
1/10/2021,North Macedonia,Sarawak,0,0,0
1/10/2021,North Macedonia,Selangor,4,2,2
1/10/2021,Mali,Johor,0,0,0
1/10/2021,Mali,Sabah,0,0,0
1/10/2021,Mali,Selangor,3,3,0
1/10/2021,Malta,Johor,0,0,0
1/10/2021,Malta,Kedah,0,0,0
1/10/2021,Malta,Kelantan,0,0,0
1/10/2021,Malta,Perak,0,0,0
1/10/2021,Malta,Perlis,0,0,0
1/10/2021,Malta,Pulau Pinang,0,0,0
1/10/2021,Malta,Sabah,0,0,0
1/10/2021,Malta,Sarawak,0,0,0
1/10/2021,Malta,Selangor,0,0,0
1/10/2021,Malta,W.P. Labuan,0,0,0
1/10/2021,Myanmar,Johor,0,0,0
1/10/2021,Myanmar,Kedah,0,0,0
1/10/2021,Myanmar,Kelantan,0,0,0
1/10/2021,Myanmar,Negeri Sembilan,0,0,0
1/10/2021,Myanmar,Pahang,0,0,0
1/10/2021,Myanmar,Perak,0,0,0
1/10/2021,Myanmar,Perlis,0,0,0
1/10/2021,Myanmar,Pulau Pinang,0,0,0
1/10/2021,Myanmar,Sabah,1,1,0
1/10/2021,Myanmar,Sarawak,2,1,1
1/10/2021,Myanmar,Selangor,177,145,32
1/10/2021,Myanmar,Terengganu,0,0,0
1/10/2021,Myanmar,W.P. Labuan,0,0,0
1/10/2021,Montenegro,Johor,0,0,0
1/10/2021,Montenegro,Kedah,0,0,0
1/10/2021,Montenegro,Pulau Pinang,0,0,0
1/10/2021,Montenegro,Sabah,0,0,0
1/10/2021,Montenegro,Sarawak,0,0,0
1/10/2021,Montenegro,Selangor,1,1,0
1/10/2021,Mongolia,Johor,0,0,0
1/10/2021,Mongolia,Kedah,0,0,0
1/10/2021,Mongolia,Kelantan,0,0,0
1/10/2021,Mongolia,Perak,0,0,0
1/10/2021,Mongolia,Perlis,0,0,0
1/10/2021,Mongolia,Pulau Pinang,0,0,0
1/10/2021,Mongolia,Sabah,0,0,0
1/10/2021,Mongolia,Sarawak,0,0,0
1/10/2021,Mongolia,Selangor,3,0,3
1/10/2021,Northern Mariana Islands,Selangor,0,0,0
1/10/2021,Mozambique,Johor,0,0,0
1/10/2021,Mozambique,Kedah,0,0,0
1/10/2021,Mozambique,Perak,0,0,0
1/10/2021,Mozambique,Pulau Pinang,0,0,0
1/10/2021,Mozambique,Sabah,0,0,0
1/10/2021,Mozambique,Sarawak,0,0,0
1/10/2021,Mozambique,Selangor,7,4,3
1/10/2021,Mauritania,Johor,0,0,0
1/10/2021,Mauritania,Kedah,0,0,0
1/10/2021,Mauritania,Pulau Pinang,0,0,0
1/10/2021,Mauritania,Sabah,0,0,0
1/10/2021,Mauritania,Sarawak,0,0,0
1/10/2021,Mauritania,Selangor,3,2,1
1/10/2021,Mauritius,Johor,0,0,0
1/10/2021,Mauritius,Kedah,0,0,0
1/10/2021,Mauritius,Kelantan,0,0,0
1/10/2021,Mauritius,Pahang,0,0,0
1/10/2021,Mauritius,Perak,0,0,0
1/10/2021,Mauritius,Perlis,0,0,0
1/10/2021,Mauritius,Pulau Pinang,0,0,0
1/10/2021,Mauritius,Sabah,0,0,0
1/10/2021,Mauritius,Sarawak,0,0,0
1/10/2021,Mauritius,Selangor,11,6,5
1/10/2021,Malawi,Johor,0,0,0
1/10/2021,Malawi,Pulau Pinang,0,0,0
1/10/2021,Malawi,Sabah,0,0,0
1/10/2021,Malawi,Sarawak,0,0,0
1/10/2021,Malawi,Selangor,1,0,1
1/10/2021,Mayotte,Selangor,0,0,0
1/10/2021,Namibia,Johor,0,0,0
1/10/2021,Namibia,Kedah,0,0,0
1/10/2021,Namibia,Perak,0,0,0
1/10/2021,Namibia,Perlis,0,0,0
1/10/2021,Namibia,Pulau Pinang,0,0,0
1/10/2021,Namibia,Sabah,0,0,0
1/10/2021,Namibia,Sarawak,0,0,0
1/10/2021,Namibia,Selangor,0,0,0
1/10/2021,New Caledonia,Selangor,0,0,0
1/10/2021,Niger,Johor,0,0,0
1/10/2021,Niger,Sabah,0,0,0
1/10/2021,Niger,Selangor,0,0,0
1/10/2021,Nigeria,Johor,0,0,0
1/10/2021,Nigeria,Kedah,0,0,0
1/10/2021,Nigeria,Perlis,0,0,0
1/10/2021,Nigeria,Pulau Pinang,0,0,0
1/10/2021,Nigeria,Sabah,0,0,0
1/10/2021,Nigeria,Sarawak,2,2,0
1/10/2021,Nigeria,Selangor,118,94,24
1/10/2021,Nicaragua,Johor,0,0,0
1/10/2021,Nicaragua,Kedah,0,0,0
1/10/2021,Nicaragua,Pulau Pinang,0,0,0
1/10/2021,Nicaragua,Sabah,0,0,0
1/10/2021,Nicaragua,Selangor,0,0,0
1/10/2021,Netherlands,Johor,1,1,0
1/10/2021,Netherlands,Kedah,0,0,0
1/10/2021,Netherlands,Kelantan,0,0,0
1/10/2021,Netherlands,Melaka,0,0,0
1/10/2021,Netherlands,Negeri Sembilan,0,0,0
1/10/2021,Netherlands,Pahang,0,0,0
1/10/2021,Netherlands,Perak,0,0,0
1/10/2021,Netherlands,Perlis,0,0,0
1/10/2021,Netherlands,Pulau Pinang,12,7,5
1/10/2021,Netherlands,Sabah,0,0,0
1/10/2021,Netherlands,Sarawak,5,4,1
1/10/2021,Netherlands,Selangor,76,61,15
1/10/2021,Netherlands,Terengganu,0,0,0
1/10/2021,Netherlands,W.P. Labuan,0,0,0
1/10/2021,Norway,Johor,0,0,0
1/10/2021,Norway,Kedah,0,0,0
1/10/2021,Norway,Kelantan,0,0,0
1/10/2021,Norway,Melaka,0,0,0
1/10/2021,Norway,Pahang,0,0,0
1/10/2021,Norway,Perak,0,0,0
1/10/2021,Norway,Perlis,0,0,0
1/10/2021,Norway,Pulau Pinang,0,0,0
1/10/2021,Norway,Sabah,0,0,0
1/10/2021,Norway,Sarawak,0,0,0
1/10/2021,Norway,Selangor,14,10,4
1/10/2021,Norway,W.P. Labuan,0,0,0
1/10/2021,Nepal,Johor,0,0,0
1/10/2021,Nepal,Kedah,0,0,0
1/10/2021,Nepal,Pahang,0,0,0
1/10/2021,Nepal,Perak,0,0,0
1/10/2021,Nepal,Perlis,0,0,0
1/10/2021,Nepal,Pulau Pinang,0,0,0
1/10/2021,Nepal,Sabah,0,0,0
1/10/2021,Nepal,Sarawak,0,0,0
1/10/2021,Nepal,Selangor,16,12,4
1/10/2021,Nepal,W.P. Labuan,0,0,0
1/10/2021,Nauru,Johor,0,0,0
1/10/2021,Nauru,Pulau Pinang,0,0,0
1/10/2021,Nauru,Selangor,0,0,0
1/10/2021,New Zealand,Johor,0,0,0
1/10/2021,New Zealand,Kedah,0,0,0
1/10/2021,New Zealand,Kelantan,0,0,0
1/10/2021,New Zealand,Melaka,0,0,0
1/10/2021,New Zealand,Negeri Sembilan,0,0,0
1/10/2021,New Zealand,Pahang,0,0,0
1/10/2021,New Zealand,Perak,0,0,0
1/10/2021,New Zealand,Perlis,0,0,0
1/10/2021,New Zealand,Pulau Pinang,0,0,0
1/10/2021,New Zealand,Sabah,0,0,0
1/10/2021,New Zealand,Sarawak,0,0,0
1/10/2021,New Zealand,Selangor,19,15,4
1/10/2021,New Zealand,Terengganu,0,0,0
1/10/2021,New Zealand,W.P. Labuan,0,0,0
1/10/2021,Oman,Johor,0,0,0
1/10/2021,Oman,Kedah,0,0,0
1/10/2021,Oman,Kelantan,0,0,0
1/10/2021,Oman,Melaka,0,0,0
1/10/2021,Oman,Perak,0,0,0
1/10/2021,Oman,Perlis,0,0,0
1/10/2021,Oman,Pulau Pinang,0,0,0
1/10/2021,Oman,Sabah,0,0,0
1/10/2021,Oman,Sarawak,0,0,0
1/10/2021,Oman,Selangor,29,14,15
1/10/2021,Pakistan,Johor,1,1,0
1/10/2021,Pakistan,Kedah,0,0,0
1/10/2021,Pakistan,Kelantan,0,0,0
1/10/2021,Pakistan,Melaka,0,0,0
1/10/2021,Pakistan,Negeri Sembilan,0,0,0
1/10/2021,Pakistan,Pahang,0,0,0
1/10/2021,Pakistan,Perak,0,0,0
1/10/2021,Pakistan,Perlis,0,0,0
1/10/2021,Pakistan,Pulau Pinang,0,0,0
1/10/2021,Pakistan,Sabah,0,0,0
1/10/2021,Pakistan,Sarawak,0,0,0
1/10/2021,Pakistan,Selangor,204,157,47
1/10/2021,Pakistan,W.P. Labuan,0,0,0
1/10/2021,Panama,Johor,0,0,0
1/10/2021,Panama,Kedah,0,0,0
1/10/2021,Panama,Perak,0,0,0
1/10/2021,Panama,Perlis,0,0,0
1/10/2021,Panama,Pulau Pinang,0,0,0
1/10/2021,Panama,Sabah,0,0,0
1/10/2021,Panama,Sarawak,0,0,0
1/10/2021,Panama,Selangor,1,0,1
1/10/2021,Peru,Johor,0,0,0
1/10/2021,Peru,Kedah,0,0,0
1/10/2021,Peru,Kelantan,0,0,0
1/10/2021,Peru,Pahang,0,0,0
1/10/2021,Peru,Perak,0,0,0
1/10/2021,Peru,Perlis,0,0,0
1/10/2021,Peru,Pulau Pinang,0,0,0
1/10/2021,Peru,Sabah,0,0,0
1/10/2021,Peru,Sarawak,0,0,0
1/10/2021,Peru,Selangor,3,3,0
1/10/2021,Peru,W.P. Labuan,0,0,0
1/10/2021,Philippines,Johor,9,6,3
1/10/2021,Philippines,Kedah,0,0,0
1/10/2021,Philippines,Kelantan,0,0,0
1/10/2021,Philippines,Melaka,0,0,0
1/10/2021,Philippines,Negeri Sembilan,0,0,0
1/10/2021,Philippines,Pahang,0,0,0
1/10/2021,Philippines,Perak,0,0,0
1/10/2021,Philippines,Perlis,0,0,0
1/10/2021,Philippines,Pulau Pinang,8,6,2
1/10/2021,Philippines,Sabah,0,0,0
1/10/2021,Philippines,Sarawak,42,42,0
1/10/2021,Philippines,Selangor,394,286,108
1/10/2021,Philippines,Terengganu,0,0,0
1/10/2021,Philippines,W.P. Labuan,0,0,0
1/10/2021,Palau,Johor,0,0,0
1/10/2021,Palau,Pulau Pinang,0,0,0
1/10/2021,Palau,Selangor,0,0,0
1/10/2021,Papua New Guinea,Johor,0,0,0
1/10/2021,Papua New Guinea,Kedah,0,0,0
1/10/2021,Papua New Guinea,Kelantan,0,0,0
1/10/2021,Papua New Guinea,Perak,0,0,0
1/10/2021,Papua New Guinea,Pulau Pinang,0,0,0
1/10/2021,Papua New Guinea,Sabah,0,0,0
1/10/2021,Papua New Guinea,Sarawak,0,0,0
1/10/2021,Papua New Guinea,Selangor,0,0,0
1/10/2021,Poland,Johor,0,0,0
1/10/2021,Poland,Kedah,0,0,0
1/10/2021,Poland,Kelantan,0,0,0
1/10/2021,Poland,Melaka,0,0,0
1/10/2021,Poland,Negeri Sembilan,0,0,0
1/10/2021,Poland,Pahang,0,0,0
1/10/2021,Poland,Perak,0,0,0
1/10/2021,Poland,Perlis,0,0,0
1/10/2021,Poland,Pulau Pinang,0,0,0
1/10/2021,Poland,Sabah,0,0,0
1/10/2021,Poland,Sarawak,2,2,0
1/10/2021,Poland,Selangor,18,15,3
1/10/2021,Poland,Terengganu,0,0,0
1/10/2021,Poland,W.P. Labuan,0,0,0
1/10/2021,"North Korea, Democratic People's Republic of",Selangor,0,0,0
1/10/2021,Portugal,Johor,0,0,0
1/10/2021,Portugal,Kedah,0,0,0
1/10/2021,Portugal,Kelantan,0,0,0
1/10/2021,Portugal,Melaka,0,0,0
1/10/2021,Portugal,Pahang,0,0,0
1/10/2021,Portugal,Perak,0,0,0
1/10/2021,Portugal,Perlis,0,0,0
1/10/2021,Portugal,Pulau Pinang,1,0,1
1/10/2021,Portugal,Sabah,0,0,0
1/10/2021,Portugal,Sarawak,0,0,0
1/10/2021,Portugal,Selangor,13,8,5
1/10/2021,Portugal,W.P. Labuan,0,0,0
1/10/2021,Paraguay,Johor,0,0,0
1/10/2021,Paraguay,Kedah,0,0,0
1/10/2021,Paraguay,Perak,0,0,0
1/10/2021,Paraguay,Perlis,0,0,0
1/10/2021,Paraguay,Pulau Pinang,0,0,0
1/10/2021,Paraguay,Sabah,0,0,0
1/10/2021,Paraguay,Sarawak,0,0,0
1/10/2021,Paraguay,Selangor,0,0,0
1/10/2021,"Palestine, State of",Johor,0,0,0
1/10/2021,"Palestine, State of",Kedah,0,0,0
1/10/2021,"Palestine, State of",Kelantan,0,0,0
1/10/2021,"Palestine, State of",Melaka,0,0,0
1/10/2021,"Palestine, State of",Perak,0,0,0
1/10/2021,"Palestine, State of",Perlis,0,0,0
1/10/2021,"Palestine, State of",Pulau Pinang,0,0,0
1/10/2021,"Palestine, State of",Sabah,0,0,0
1/10/2021,"Palestine, State of",Sarawak,0,0,0
1/10/2021,"Palestine, State of",Selangor,37,35,2
1/10/2021,Qatar,Johor,0,0,0
1/10/2021,Qatar,Kedah,0,0,0
1/10/2021,Qatar,Perlis,0,0,0
1/10/2021,Qatar,Pulau Pinang,0,0,0
1/10/2021,Qatar,Sabah,0,0,0
1/10/2021,Qatar,Sarawak,0,0,0
1/10/2021,Qatar,Selangor,2,2,0
1/10/2021,Réunion,Johor,0,0,0
1/10/2021,Réunion,Sarawak,0,0,0
1/10/2021,Romania,Johor,1,1,0
1/10/2021,Romania,Kedah,0,0,0
1/10/2021,Romania,Kelantan,0,0,0
1/10/2021,Romania,Negeri Sembilan,0,0,0
1/10/2021,Romania,Pahang,0,0,0
1/10/2021,Romania,Perak,0,0,0
1/10/2021,Romania,Perlis,0,0,0
1/10/2021,Romania,Pulau Pinang,0,0,0
1/10/2021,Romania,Sabah,0,0,0
1/10/2021,Romania,Sarawak,0,0,0
1/10/2021,Romania,Selangor,21,12,9
1/10/2021,Romania,W.P. Labuan,0,0,0
1/10/2021,Russian Federation (Russia),Johor,2,1,1
1/10/2021,Russian Federation (Russia),Kedah,0,0,0
1/10/2021,Russian Federation (Russia),Kelantan,0,0,0
1/10/2021,Russian Federation (Russia),Melaka,0,0,0
1/10/2021,Russian Federation (Russia),Negeri Sembilan,0,0,0
1/10/2021,Russian Federation (Russia),Pahang,0,0,0
1/10/2021,Russian Federation (Russia),Perak,0,0,0
1/10/2021,Russian Federation (Russia),Perlis,0,0,0
1/10/2021,Russian Federation (Russia),Pulau Pinang,0,0,0
1/10/2021,Russian Federation (Russia),Sabah,0,0,0
1/10/2021,Russian Federation (Russia),Sarawak,0,0,0
1/10/2021,Russian Federation (Russia),Selangor,54,32,22
1/10/2021,Russian Federation (Russia),W.P. Labuan,0,0,0
1/10/2021,Rwanda,Johor,0,0,0
1/10/2021,Rwanda,Kedah,0,0,0
1/10/2021,Rwanda,Pulau Pinang,0,0,0
1/10/2021,Rwanda,Selangor,1,1,0
1/10/2021,Saudi Arabia,Johor,0,0,0
1/10/2021,Saudi Arabia,Kedah,0,0,0
1/10/2021,Saudi Arabia,Kelantan,0,0,0
1/10/2021,Saudi Arabia,Melaka,0,0,0
1/10/2021,Saudi Arabia,Perak,0,0,0
1/10/2021,Saudi Arabia,Perlis,0,0,0
1/10/2021,Saudi Arabia,Pulau Pinang,0,0,0
1/10/2021,Saudi Arabia,Sabah,0,0,0
1/10/2021,Saudi Arabia,Sarawak,0,0,0
1/10/2021,Saudi Arabia,Selangor,139,91,48
1/10/2021,Saudi Arabia,W.P. Labuan,0,0,0
1/10/2021,Sudan,Johor,0,0,0
1/10/2021,Sudan,Kedah,0,0,0
1/10/2021,Sudan,Kelantan,0,0,0
1/10/2021,Sudan,Perlis,0,0,0
1/10/2021,Sudan,Pulau Pinang,0,0,0
1/10/2021,Sudan,Sabah,0,0,0
1/10/2021,Sudan,Sarawak,0,0,0
1/10/2021,Sudan,Selangor,93,61,32
1/10/2021,Sudan,W.P. Labuan,0,0,0
1/10/2021,Senegal,Johor,0,0,0
1/10/2021,Senegal,Kedah,0,0,0
1/10/2021,Senegal,Kelantan,0,0,0
1/10/2021,Senegal,Perak,0,0,0
1/10/2021,Senegal,Perlis,0,0,0
1/10/2021,Senegal,Pulau Pinang,0,0,0
1/10/2021,Senegal,Sabah,0,0,0
1/10/2021,Senegal,Sarawak,0,0,0
1/10/2021,Senegal,Selangor,3,1,2
1/10/2021,Singapore,Johor,158,131,27
1/10/2021,Singapore,Kedah,1,1,0
1/10/2021,Singapore,Kelantan,0,0,0
1/10/2021,Singapore,Melaka,0,0,0
1/10/2021,Singapore,Negeri Sembilan,0,0,0
1/10/2021,Singapore,Pahang,0,0,0
1/10/2021,Singapore,Perak,2,1,1
1/10/2021,Singapore,Perlis,2,2,0
1/10/2021,Singapore,Pulau Pinang,19,11,8
1/10/2021,Singapore,Sabah,0,0,0
1/10/2021,Singapore,Sarawak,12,9,3
1/10/2021,Singapore,Selangor,194,128,66
1/10/2021,Singapore,Terengganu,0,0,0
1/10/2021,Singapore,W.P. Labuan,0,0,0
1/10/2021,South Georgia and the South Sandwich Islands,Johor,0,0,0
1/10/2021,South Georgia and the South Sandwich Islands,Sabah,0,0,0
1/10/2021,South Georgia and the South Sandwich Islands,Selangor,0,0,0
1/10/2021,Saint Helena,Sarawak,0,0,0
1/10/2021,Solomon Islands,Johor,0,0,0
1/10/2021,Solomon Islands,Perlis,0,0,0
1/10/2021,Solomon Islands,Pulau Pinang,0,0,0
1/10/2021,Solomon Islands,Sabah,0,0,0
1/10/2021,Solomon Islands,Sarawak,0,0,0
1/10/2021,Solomon Islands,Selangor,0,0,0
1/10/2021,Solomon Islands,W.P. Labuan,0,0,0
1/10/2021,Sierra Leone,Johor,0,0,0
1/10/2021,Sierra Leone,Kedah,0,0,0
1/10/2021,Sierra Leone,Perak,0,0,0
1/10/2021,Sierra Leone,Pulau Pinang,0,0,0
1/10/2021,Sierra Leone,Sabah,0,0,0
1/10/2021,Sierra Leone,Selangor,3,1,2
1/10/2021,El Salvador,Johor,0,0,0
1/10/2021,El Salvador,Kedah,0,0,0
1/10/2021,El Salvador,Perak,0,0,0
1/10/2021,El Salvador,Perlis,0,0,0
1/10/2021,El Salvador,Pulau Pinang,0,0,0
1/10/2021,El Salvador,Sabah,0,0,0
1/10/2021,El Salvador,Selangor,0,0,0
1/10/2021,El Salvador,W.P. Labuan,0,0,0
1/10/2021,San Marino,Johor,0,0,0
1/10/2021,San Marino,Selangor,0,0,0
1/10/2021,Somalia,Johor,0,0,0
1/10/2021,Somalia,Kedah,0,0,0
1/10/2021,Somalia,Kelantan,0,0,0
1/10/2021,Somalia,Perlis,0,0,0
1/10/2021,Somalia,Sabah,0,0,0
1/10/2021,Somalia,Sarawak,0,0,0
1/10/2021,Somalia,Selangor,78,63,15
1/10/2021,Serbia,Johor,0,0,0
1/10/2021,Serbia,Kedah,0,0,0
1/10/2021,Serbia,Kelantan,0,0,0
1/10/2021,Serbia,Pahang,0,0,0
1/10/2021,Serbia,Perak,0,0,0
1/10/2021,Serbia,Perlis,0,0,0
1/10/2021,Serbia,Pulau Pinang,0,0,0
1/10/2021,Serbia,Sabah,0,0,0
1/10/2021,Serbia,Sarawak,0,0,0
1/10/2021,Serbia,Selangor,3,2,1
1/10/2021,South Sudan,Johor,0,0,0
1/10/2021,South Sudan,Kedah,0,0,0
1/10/2021,South Sudan,Sarawak,0,0,0
1/10/2021,South Sudan,Selangor,5,4,1
1/10/2021,South Sudan,W.P. Labuan,0,0,0
1/10/2021,Sao Tome and Principe,Selangor,0,0,0
1/10/2021,Suriname,Johor,0,0,0
1/10/2021,Suriname,Kedah,0,0,0
1/10/2021,Suriname,Kelantan,0,0,0
1/10/2021,Suriname,Perak,0,0,0
1/10/2021,Suriname,Perlis,0,0,0
1/10/2021,Suriname,Pulau Pinang,0,0,0
1/10/2021,Suriname,Sabah,0,0,0
1/10/2021,Suriname,Sarawak,0,0,0
1/10/2021,Suriname,Selangor,0,0,0
1/10/2021,Slovakia,Johor,0,0,0
1/10/2021,Slovakia,Kedah,0,0,0
1/10/2021,Slovakia,Kelantan,0,0,0
1/10/2021,Slovakia,Negeri Sembilan,0,0,0
1/10/2021,Slovakia,Pahang,0,0,0
1/10/2021,Slovakia,Perak,0,0,0
1/10/2021,Slovakia,Perlis,0,0,0
1/10/2021,Slovakia,Pulau Pinang,0,0,0
1/10/2021,Slovakia,Sabah,0,0,0
1/10/2021,Slovakia,Sarawak,0,0,0
1/10/2021,Slovakia,Selangor,11,9,2
1/10/2021,Slovakia,W.P. Labuan,0,0,0
1/10/2021,Slovenia,Johor,0,0,0
1/10/2021,Slovenia,Kedah,0,0,0
1/10/2021,Slovenia,Kelantan,0,0,0
1/10/2021,Slovenia,Perak,0,0,0
1/10/2021,Slovenia,Perlis,0,0,0
1/10/2021,Slovenia,Pulau Pinang,0,0,0
1/10/2021,Slovenia,Sabah,0,0,0
1/10/2021,Slovenia,Sarawak,0,0,0
1/10/2021,Slovenia,Selangor,4,3,1
1/10/2021,Slovenia,W.P. Labuan,0,0,0
1/10/2021,Sweden,Johor,0,0,0
1/10/2021,Sweden,Kedah,0,0,0
1/10/2021,Sweden,Kelantan,0,0,0
1/10/2021,Sweden,Melaka,0,0,0
1/10/2021,Sweden,Negeri Sembilan,0,0,0
1/10/2021,Sweden,Pahang,0,0,0
1/10/2021,Sweden,Perak,0,0,0
1/10/2021,Sweden,Perlis,0,0,0
1/10/2021,Sweden,Pulau Pinang,0,0,0
1/10/2021,Sweden,Sabah,0,0,0
1/10/2021,Sweden,Sarawak,0,0,0
1/10/2021,Sweden,Selangor,39,33,6
1/10/2021,Sweden,W.P. Labuan,0,0,0
1/10/2021,Eswatini,Johor,0,0,0
1/10/2021,Eswatini,Kedah,0,0,0
1/10/2021,Eswatini,Pulau Pinang,0,0,0
1/10/2021,Eswatini,Sabah,0,0,0
1/10/2021,Eswatini,Selangor,0,0,0
1/10/2021,Seychelles,Johor,0,0,0
1/10/2021,Seychelles,Kedah,0,0,0
1/10/2021,Seychelles,Pulau Pinang,0,0,0
1/10/2021,Seychelles,Sabah,0,0,0
1/10/2021,Seychelles,Sarawak,1,1,0
1/10/2021,Seychelles,Selangor,10,5,5
1/10/2021,Syrian Arab Republic,Johor,0,0,0
1/10/2021,Syrian Arab Republic,Kedah,0,0,0
1/10/2021,Syrian Arab Republic,Kelantan,0,0,0
1/10/2021,Syrian Arab Republic,Pahang,0,0,0
1/10/2021,Syrian Arab Republic,Perlis,0,0,0
1/10/2021,Syrian Arab Republic,Pulau Pinang,0,0,0
1/10/2021,Syrian Arab Republic,Sabah,0,0,0
1/10/2021,Syrian Arab Republic,Sarawak,0,0,0
1/10/2021,Syrian Arab Republic,Selangor,53,45,8
1/10/2021,Syrian Arab Republic,W.P. Labuan,0,0,0
1/10/2021,Turks and Caicos Islands,Perlis,0,0,0
1/10/2021,TCD,Johor,0,0,0
1/10/2021,TCD,Kedah,0,0,0
1/10/2021,TCD,Perlis,0,0,0
1/10/2021,TCD,Selangor,1,1,0
1/10/2021,Togo,Johor,0,0,0
1/10/2021,Togo,Perak,0,0,0
1/10/2021,Togo,Pulau Pinang,0,0,0
1/10/2021,Togo,Selangor,0,0,0
1/10/2021,Thailand,Johor,27,27,0
1/10/2021,Thailand,Kedah,19375,19336,39
1/10/2021,Thailand,Kelantan,0,0,0
1/10/2021,Thailand,Melaka,0,0,0
1/10/2021,Thailand,Negeri Sembilan,0,0,0
1/10/2021,Thailand,Pahang,0,0,0
1/10/2021,Thailand,Perak,0,0,0
1/10/2021,Thailand,Perlis,7946,7835,111
1/10/2021,Thailand,Pulau Pinang,40,36,4
1/10/2021,Thailand,Sabah,1,0,1
1/10/2021,Thailand,Sarawak,1,1,0
1/10/2021,Thailand,Selangor,154,68,86
1/10/2021,Thailand,Terengganu,0,0,0
1/10/2021,Thailand,W.P. Labuan,0,0,0
1/10/2021,Tajikistan,Johor,0,0,0
1/10/2021,Tajikistan,Kedah,0,0,0
1/10/2021,Tajikistan,Perlis,0,0,0
1/10/2021,Tajikistan,Pulau Pinang,0,0,0
1/10/2021,Tajikistan,Sabah,0,0,0
1/10/2021,Tajikistan,Selangor,2,2,0
1/10/2021,Tokelau,Selangor,0,0,0
1/10/2021,Turkmenistan,Johor,0,0,0
1/10/2021,Turkmenistan,Kedah,0,0,0
1/10/2021,Turkmenistan,Kelantan,0,0,0
1/10/2021,Turkmenistan,Perlis,0,0,0
1/10/2021,Turkmenistan,Pulau Pinang,0,0,0
1/10/2021,Turkmenistan,Sabah,0,0,0
1/10/2021,Turkmenistan,Sarawak,0,0,0
1/10/2021,Turkmenistan,Selangor,3,0,3
1/10/2021,Timor-Leste,Johor,0,0,0
1/10/2021,Timor-Leste,Kedah,0,0,0
1/10/2021,Timor-Leste,Perlis,0,0,0
1/10/2021,Timor-Leste,Pulau Pinang,0,0,0
1/10/2021,Timor-Leste,Sabah,0,0,0
1/10/2021,Timor-Leste,Sarawak,0,0,0
1/10/2021,Timor-Leste,Selangor,3,3,0
1/10/2021,Tonga,Johor,0,0,0
1/10/2021,Tonga,Pulau Pinang,0,0,0
1/10/2021,Tonga,Sarawak,0,0,0
1/10/2021,Tonga,Selangor,0,0,0
1/10/2021,Trinidad and Tobago,Johor,0,0,0
1/10/2021,Trinidad and Tobago,Kedah,0,0,0
1/10/2021,Trinidad and Tobago,Pahang,0,0,0
1/10/2021,Trinidad and Tobago,Pulau Pinang,0,0,0
1/10/2021,Trinidad and Tobago,Sabah,0,0,0
1/10/2021,Trinidad and Tobago,Sarawak,0,0,0
1/10/2021,Trinidad and Tobago,Selangor,1,1,0
1/10/2021,Tunisia,Johor,0,0,0
1/10/2021,Tunisia,Kedah,0,0,0
1/10/2021,Tunisia,Kelantan,0,0,0
1/10/2021,Tunisia,Melaka,0,0,0
1/10/2021,Tunisia,Perak,0,0,0
1/10/2021,Tunisia,Perlis,0,0,0
1/10/2021,Tunisia,Pulau Pinang,0,0,0
1/10/2021,Tunisia,Sabah,0,0,0
1/10/2021,Tunisia,Sarawak,0,0,0
1/10/2021,Tunisia,Selangor,10,6,4
1/10/2021,Tunisia,W.P. Labuan,0,0,0
1/10/2021,Türkiye,Johor,1,1,0
1/10/2021,Türkiye,Kedah,0,0,0
1/10/2021,Türkiye,Kelantan,0,0,0
1/10/2021,Türkiye,Melaka,0,0,0
1/10/2021,Türkiye,Negeri Sembilan,0,0,0
1/10/2021,Türkiye,Pahang,0,0,0
1/10/2021,Türkiye,Perak,0,0,0
1/10/2021,Türkiye,Perlis,0,0,0
1/10/2021,Türkiye,Pulau Pinang,0,0,0
1/10/2021,Türkiye,Sabah,0,0,0
1/10/2021,Türkiye,Sarawak,2,2,0
1/10/2021,Türkiye,Selangor,82,51,31
1/10/2021,Türkiye,W.P. Labuan,0,0,0
1/10/2021,Tuvalu,Selangor,0,0,0
1/10/2021,"Taiwan, Province of China",Johor,0,0,0
1/10/2021,"Taiwan, Province of China",Kedah,0,0,0
1/10/2021,"Taiwan, Province of China",Kelantan,0,0,0
1/10/2021,"Taiwan, Province of China",Melaka,0,0,0
1/10/2021,"Taiwan, Province of China",Negeri Sembilan,0,0,0
1/10/2021,"Taiwan, Province of China",Pahang,0,0,0
1/10/2021,"Taiwan, Province of China",Perak,0,0,0
1/10/2021,"Taiwan, Province of China",Perlis,0,0,0
1/10/2021,"Taiwan, Province of China",Pulau Pinang,19,14,5
1/10/2021,"Taiwan, Province of China",Sabah,0,0,0
1/10/2021,"Taiwan, Province of China",Sarawak,2,1,1
1/10/2021,"Taiwan, Province of China",Selangor,63,37,26
1/10/2021,"Taiwan, Province of China",W.P. Labuan,0,0,0
1/10/2021,"Tanzania, United Republic of",Johor,0,0,0
1/10/2021,"Tanzania, United Republic of",Kedah,0,0,0
1/10/2021,"Tanzania, United Republic of",Perak,0,0,0
1/10/2021,"Tanzania, United Republic of",Perlis,0,0,0
1/10/2021,"Tanzania, United Republic of",Pulau Pinang,0,0,0
1/10/2021,"Tanzania, United Republic of",Sabah,0,0,0
1/10/2021,"Tanzania, United Republic of",Sarawak,0,0,0
1/10/2021,"Tanzania, United Republic of",Selangor,11,2,9
1/10/2021,Uganda,Johor,0,0,0
1/10/2021,Uganda,Kedah,0,0,0
1/10/2021,Uganda,Perak,0,0,0
1/10/2021,Uganda,Perlis,0,0,0
1/10/2021,Uganda,Pulau Pinang,0,0,0
1/10/2021,Uganda,Sabah,0,0,0
1/10/2021,Uganda,Sarawak,0,0,0
1/10/2021,Uganda,Selangor,5,4,1
1/10/2021,Ukraine,Johor,1,1,0
1/10/2021,Ukraine,Kedah,0,0,0
1/10/2021,Ukraine,Kelantan,0,0,0
1/10/2021,Ukraine,Melaka,0,0,0
1/10/2021,Ukraine,Negeri Sembilan,0,0,0
1/10/2021,Ukraine,Pahang,0,0,0
1/10/2021,Ukraine,Perak,0,0,0
1/10/2021,Ukraine,Perlis,0,0,0
1/10/2021,Ukraine,Pulau Pinang,0,0,0
1/10/2021,Ukraine,Sabah,0,0,0
1/10/2021,Ukraine,Sarawak,1,1,0
1/10/2021,Ukraine,Selangor,44,32,12
1/10/2021,Ukraine,W.P. Labuan,0,0,0
1/10/2021,Uruguay,Johor,0,0,0
1/10/2021,Uruguay,Kedah,0,0,0
1/10/2021,Uruguay,Kelantan,0,0,0
1/10/2021,Uruguay,Perak,0,0,0
1/10/2021,Uruguay,Perlis,0,0,0
1/10/2021,Uruguay,Pulau Pinang,0,0,0
1/10/2021,Uruguay,Sabah,0,0,0
1/10/2021,Uruguay,Sarawak,0,0,0
1/10/2021,Uruguay,Selangor,2,0,2
1/10/2021,Uruguay,W.P. Labuan,0,0,0
1/10/2021,United States of America,Johor,0,0,0
1/10/2021,United States of America,Kedah,0,0,0
1/10/2021,United States of America,Kelantan,0,0,0
1/10/2021,United States of America,Melaka,0,0,0
1/10/2021,United States of America,Negeri Sembilan,0,0,0
1/10/2021,United States of America,Pahang,0,0,0
1/10/2021,United States of America,Perak,0,0,0
1/10/2021,United States of America,Perlis,0,0,0
1/10/2021,United States of America,Pulau Pinang,11,6,5
1/10/2021,United States of America,Sabah,0,0,0
1/10/2021,United States of America,Sarawak,1,0,1
1/10/2021,United States of America,Selangor,252,186,66
1/10/2021,United States of America,Terengganu,0,0,0
1/10/2021,United States of America,W.P. Labuan,0,0,0
1/10/2021,Uzbekistan,Johor,0,0,0
1/10/2021,Uzbekistan,Kedah,0,0,0
1/10/2021,Uzbekistan,Kelantan,0,0,0
1/10/2021,Uzbekistan,Perak,0,0,0
1/10/2021,Uzbekistan,Perlis,0,0,0
1/10/2021,Uzbekistan,Pulau Pinang,0,0,0
1/10/2021,Uzbekistan,Sabah,0,0,0
1/10/2021,Uzbekistan,Sarawak,0,0,0
1/10/2021,Uzbekistan,Selangor,36,26,10
1/10/2021,Holy See,Johor,0,0,0
1/10/2021,Holy See,Sarawak,0,0,0
1/10/2021,Holy See,Selangor,0,0,0
1/10/2021,Saint Vincent and the Grenadines,Johor,0,0,0
1/10/2021,Saint Vincent and the Grenadines,Kedah,0,0,0
1/10/2021,Saint Vincent and the Grenadines,Pulau Pinang,0,0,0
1/10/2021,Saint Vincent and the Grenadines,Sarawak,0,0,0
1/10/2021,Saint Vincent and the Grenadines,Selangor,0,0,0
1/10/2021,"Venezuela, Bolivarian Republic of",Johor,0,0,0
1/10/2021,"Venezuela, Bolivarian Republic of",Kedah,0,0,0
1/10/2021,"Venezuela, Bolivarian Republic of",Kelantan,0,0,0
1/10/2021,"Venezuela, Bolivarian Republic of",Melaka,0,0,0
1/10/2021,"Venezuela, Bolivarian Republic of",Perak,0,0,0
1/10/2021,"Venezuela, Bolivarian Republic of",Perlis,0,0,0
1/10/2021,"Venezuela, Bolivarian Republic of",Pulau Pinang,0,0,0
1/10/2021,"Venezuela, Bolivarian Republic of",Sabah,0,0,0
1/10/2021,"Venezuela, Bolivarian Republic of",Sarawak,0,0,0
1/10/2021,"Venezuela, Bolivarian Republic of",Selangor,1,1,0
1/10/2021,"Venezuela, Bolivarian Republic of",W.P. Labuan,0,0,0
1/10/2021,Viet Nam,Johor,1,0,1
1/10/2021,Viet Nam,Kedah,0,0,0
1/10/2021,Viet Nam,Kelantan,0,0,0
1/10/2021,Viet Nam,Melaka,0,0,0
1/10/2021,Viet Nam,Negeri Sembilan,0,0,0
1/10/2021,Viet Nam,Pahang,0,0,0
1/10/2021,Viet Nam,Perak,0,0,0
1/10/2021,Viet Nam,Perlis,0,0,0
1/10/2021,Viet Nam,Pulau Pinang,1,0,1
1/10/2021,Viet Nam,Sabah,0,0,0
1/10/2021,Viet Nam,Sarawak,1,0,1
1/10/2021,Viet Nam,Selangor,152,62,90
1/10/2021,Viet Nam,Terengganu,0,0,0
1/10/2021,Viet Nam,W.P. Labuan,0,0,0
1/10/2021,Vanuatu,Johor,0,0,0
1/10/2021,Vanuatu,Kedah,0,0,0
1/10/2021,Vanuatu,Pulau Pinang,0,0,0
1/10/2021,Vanuatu,Sabah,0,0,0
1/10/2021,Vanuatu,Sarawak,0,0,0
1/10/2021,Vanuatu,Selangor,0,0,0
1/10/2021, Samoa,Johor,0,0,0
1/10/2021, Samoa,Sarawak,0,0,0
1/10/2021, Samoa,Selangor,0,0,0
1/10/2021,Yemen,Johor,0,0,0
1/10/2021,Yemen,Kedah,0,0,0
1/10/2021,Yemen,Kelantan,0,0,0
1/10/2021,Yemen,Melaka,0,0,0
1/10/2021,Yemen,Pahang,0,0,0
1/10/2021,Yemen,Perak,0,0,0
1/10/2021,Yemen,Perlis,0,0,0
1/10/2021,Yemen,Pulau Pinang,0,0,0
1/10/2021,Yemen,Sabah,0,0,0
1/10/2021,Yemen,Sarawak,0,0,0
1/10/2021,Yemen,Selangor,206,165,41
1/10/2021,Yemen,W.P. Labuan,0,0,0
1/10/2021,South Africa,Johor,0,0,0
1/10/2021,South Africa,Kedah,0,0,0
1/10/2021,South Africa,Kelantan,0,0,0
1/10/2021,South Africa,Melaka,0,0,0
1/10/2021,South Africa,Pahang,0,0,0
1/10/2021,South Africa,Perak,0,0,0
1/10/2021,South Africa,Perlis,0,0,0
1/10/2021,South Africa,Pulau Pinang,0,0,0
1/10/2021,South Africa,Sabah,0,0,0
1/10/2021,South Africa,Sarawak,0,0,0
1/10/2021,South Africa,Selangor,38,25,13
1/10/2021,South Africa,Terengganu,0,0,0
1/10/2021,South Africa,W.P. Labuan,0,0,0
1/10/2021,ZAR,Selangor,0,0,0
1/10/2021,Zambia,Johor,0,0,0
1/10/2021,Zambia,Kedah,0,0,0
1/10/2021,Zambia,Perak,0,0,0
1/10/2021,Zambia,Perlis,0,0,0
1/10/2021,Zambia,Pulau Pinang,0,0,0
1/10/2021,Zambia,Sabah,0,0,0
1/10/2021,Zambia,Sarawak,0,0,0
1/10/2021,Zambia,Selangor,10,3,7
1/10/2021,Zimbabwe,Johor,0,0,0
1/10/2021,Zimbabwe,Kedah,0,0,0
1/10/2021,Zimbabwe,Kelantan,0,0,0
1/10/2021,Zimbabwe,Perak,0,0,0
1/10/2021,Zimbabwe,Perlis,0,0,0
1/10/2021,Zimbabwe,Pulau Pinang,0,0,0
1/10/2021,Zimbabwe,Sabah,0,0,0
1/10/2021,Zimbabwe,Sarawak,0,0,0
1/10/2021,Zimbabwe,Selangor,19,7,12
1/11/2021,Aruba,Kedah,0,0,0
1/11/2021,Aruba,Pulau Pinang,0,0,0
1/11/2021,Afghanistan,Johor,0,0,0
1/11/2021,Afghanistan,Kedah,0,0,0
1/11/2021,Afghanistan,Perlis,0,0,0
1/11/2021,Afghanistan,Pulau Pinang,0,0,0
1/11/2021,Afghanistan,Sarawak,0,0,0
1/11/2021,Afghanistan,Selangor,57,36,21
1/11/2021,Angola,Johor,0,0,0
1/11/2021,Angola,Kedah,0,0,0
1/11/2021,Angola,Sabah,0,0,0
1/11/2021,Angola,Selangor,0,0,0
1/11/2021,Anguilla,Selangor,0,0,0
1/11/2021,Albania,Johor,0,0,0
1/11/2021,Albania,Kedah,0,0,0
1/11/2021,Albania,Perak,0,0,0
1/11/2021,Albania,Perlis,0,0,0
1/11/2021,Albania,Pulau Pinang,0,0,0
1/11/2021,Albania,Sabah,0,0,0
1/11/2021,Albania,Sarawak,0,0,0
1/11/2021,Albania,Selangor,0,0,0
1/11/2021,Andorra,Johor,0,0,0
1/11/2021,Andorra,Kedah,0,0,0
1/11/2021,Andorra,Perlis,0,0,0
1/11/2021,Andorra,Pulau Pinang,0,0,0
1/11/2021,Andorra,Selangor,0,0,0
1/11/2021,Antigua and Barbuda,Selangor,0,0,0
1/11/2021,United Arab Emirates,Johor,0,0,0
1/11/2021,United Arab Emirates,Kedah,0,0,0
1/11/2021,United Arab Emirates,Kelantan,0,0,0
1/11/2021,United Arab Emirates,Perak,0,0,0
1/11/2021,United Arab Emirates,Perlis,0,0,0
1/11/2021,United Arab Emirates,Pulau Pinang,0,0,0
1/11/2021,United Arab Emirates,Sabah,0,0,0
1/11/2021,United Arab Emirates,Sarawak,0,0,0
1/11/2021,United Arab Emirates,Selangor,2,1,1
1/11/2021,Argentina,Johor,0,0,0
1/11/2021,Argentina,Kedah,0,0,0
1/11/2021,Argentina,Kelantan,0,0,0
1/11/2021,Argentina,Melaka,0,0,0
1/11/2021,Argentina,Perak,0,0,0
1/11/2021,Argentina,Perlis,0,0,0
1/11/2021,Argentina,Pulau Pinang,0,0,0
1/11/2021,Argentina,Sabah,0,0,0
1/11/2021,Argentina,Sarawak,0,0,0
1/11/2021,Argentina,Selangor,1,0,1
1/11/2021,Argentina,W.P. Labuan,0,0,0
1/11/2021,Armenia,Johor,0,0,0
1/11/2021,Armenia,Kedah,0,0,0
1/11/2021,Armenia,Kelantan,0,0,0
1/11/2021,Armenia,Perak,0,0,0
1/11/2021,Armenia,Perlis,0,0,0
1/11/2021,Armenia,Pulau Pinang,0,0,0
1/11/2021,Armenia,Sabah,0,0,0
1/11/2021,Armenia,Sarawak,0,0,0
1/11/2021,Armenia,Selangor,0,0,0
1/11/2021,Antarctica,Selangor,0,0,0
1/11/2021,Antigua and Barbuda,Johor,0,0,0
1/11/2021,Antigua and Barbuda,Kedah,0,0,0
1/11/2021,Antigua and Barbuda,Pulau Pinang,0,0,0
1/11/2021,Antigua and Barbuda,Sarawak,0,0,0
1/11/2021,Antigua and Barbuda,Selangor,1,0,1
1/11/2021,Australia,Johor,0,0,0
1/11/2021,Australia,Kedah,0,0,0
1/11/2021,Australia,Kelantan,0,0,0
1/11/2021,Australia,Melaka,0,0,0
1/11/2021,Australia,Negeri Sembilan,0,0,0
1/11/2021,Australia,Pahang,0,0,0
1/11/2021,Australia,Perak,0,0,0
1/11/2021,Australia,Perlis,0,0,0
1/11/2021,Australia,Pulau Pinang,12,6,6
1/11/2021,Australia,Sabah,5,3,2
1/11/2021,Australia,Sarawak,4,3,1
1/11/2021,Australia,Selangor,200,129,71
1/11/2021,Australia,Terengganu,0,0,0
1/11/2021,Australia,W.P. Labuan,0,0,0
1/11/2021,Austria,Johor,0,0,0
1/11/2021,Austria,Kedah,0,0,0
1/11/2021,Austria,Kelantan,0,0,0
1/11/2021,Austria,Melaka,0,0,0
1/11/2021,Austria,Negeri Sembilan,0,0,0
1/11/2021,Austria,Pahang,0,0,0
1/11/2021,Austria,Perak,0,0,0
1/11/2021,Austria,Perlis,0,0,0
1/11/2021,Austria,Pulau Pinang,2,1,1
1/11/2021,Austria,Sabah,0,0,0
1/11/2021,Austria,Sarawak,1,1,0
1/11/2021,Austria,Selangor,28,21,7
1/11/2021,Austria,Terengganu,0,0,0
1/11/2021,Austria,W.P. Labuan,0,0,0
1/11/2021,Azerbaijan,Johor,0,0,0
1/11/2021,Azerbaijan,Kedah,0,0,0
1/11/2021,Azerbaijan,Kelantan,0,0,0
1/11/2021,Azerbaijan,Melaka,0,0,0
1/11/2021,Azerbaijan,Perlis,0,0,0
1/11/2021,Azerbaijan,Pulau Pinang,0,0,0
1/11/2021,Azerbaijan,Sabah,0,0,0
1/11/2021,Azerbaijan,Sarawak,0,0,0
1/11/2021,Azerbaijan,Selangor,7,6,1
1/11/2021,Azerbaijan,W.P. Labuan,0,0,0
1/11/2021,Burundi,Pulau Pinang,0,0,0
1/11/2021,Burundi,Sarawak,0,0,0
1/11/2021,Burundi,Selangor,0,0,0
1/11/2021,Belgium,Johor,0,0,0
1/11/2021,Belgium,Kedah,0,0,0
1/11/2021,Belgium,Kelantan,0,0,0
1/11/2021,Belgium,Melaka,0,0,0
1/11/2021,Belgium,Negeri Sembilan,0,0,0
1/11/2021,Belgium,Pahang,0,0,0
1/11/2021,Belgium,Perak,0,0,0
1/11/2021,Belgium,Perlis,0,0,0
1/11/2021,Belgium,Pulau Pinang,3,2,1
1/11/2021,Belgium,Sabah,0,0,0
1/11/2021,Belgium,Sarawak,1,1,0
1/11/2021,Belgium,Selangor,21,18,3
1/11/2021,Belgium,W.P. Labuan,0,0,0
1/11/2021,Benin,Johor,0,0,0
1/11/2021,Benin,Kedah,0,0,0
1/11/2021,Benin,Perak,0,0,0
1/11/2021,Benin,Pulau Pinang,0,0,0
1/11/2021,Benin,Sabah,0,0,0
1/11/2021,Benin,Sarawak,0,0,0
1/11/2021,Benin,Selangor,0,0,0
1/11/2021,Burkina Faso,Perak,0,0,0
1/11/2021,Burkina Faso,Pulau Pinang,0,0,0
1/11/2021,Burkina Faso,Selangor,1,1,0
1/11/2021,Bangladesh,Johor,4,1,3
1/11/2021,Bangladesh,Kedah,0,0,0
1/11/2021,Bangladesh,Kelantan,0,0,0
1/11/2021,Bangladesh,Melaka,0,0,0
1/11/2021,Bangladesh,Negeri Sembilan,0,0,0
1/11/2021,Bangladesh,Pahang,0,0,0
1/11/2021,Bangladesh,Perak,0,0,0
1/11/2021,Bangladesh,Perlis,0,0,0
1/11/2021,Bangladesh,Pulau Pinang,1,1,0
1/11/2021,Bangladesh,Sabah,0,0,0
1/11/2021,Bangladesh,Sarawak,1,1,0
1/11/2021,Bangladesh,Selangor,1092,947,145
1/11/2021,Bangladesh,W.P. Labuan,0,0,0
1/11/2021,Bulgaria,Johor,0,0,0
1/11/2021,Bulgaria,Kedah,0,0,0
1/11/2021,Bulgaria,Kelantan,0,0,0
1/11/2021,Bulgaria,Pahang,0,0,0
1/11/2021,Bulgaria,Perak,0,0,0
1/11/2021,Bulgaria,Perlis,0,0,0
1/11/2021,Bulgaria,Pulau Pinang,0,0,0
1/11/2021,Bulgaria,Sabah,0,0,0
1/11/2021,Bulgaria,Sarawak,0,0,0
1/11/2021,Bulgaria,Selangor,15,14,1
1/11/2021,Bulgaria,W.P. Labuan,0,0,0
1/11/2021,Bahrain,Johor,0,0,0
1/11/2021,Bahrain,Kedah,0,0,0
1/11/2021,Bahrain,Kelantan,0,0,0
1/11/2021,Bahrain,Perlis,0,0,0
1/11/2021,Bahrain,Pulau Pinang,0,0,0
1/11/2021,Bahrain,Sabah,0,0,0
1/11/2021,Bahrain,Sarawak,0,0,0
1/11/2021,Bahrain,Selangor,4,2,2
1/11/2021,Bahamas,Johor,0,0,0
1/11/2021,Bahamas,Kedah,0,0,0
1/11/2021,Bahamas,Perak,0,0,0
1/11/2021,Bahamas,Sabah,0,0,0
1/11/2021,Bahamas,Sarawak,0,0,0
1/11/2021,Bahamas,Selangor,0,0,0
1/11/2021,Bosnia and Herzegovina,Johor,0,0,0
1/11/2021,Bosnia and Herzegovina,Kedah,0,0,0
1/11/2021,Bosnia and Herzegovina,Perlis,0,0,0
1/11/2021,Bosnia and Herzegovina,Pulau Pinang,0,0,0
1/11/2021,Bosnia and Herzegovina,Sabah,0,0,0
1/11/2021,Bosnia and Herzegovina,Sarawak,0,0,0
1/11/2021,Bosnia and Herzegovina,Selangor,2,1,1
1/11/2021,Belarus,Johor,0,0,0
1/11/2021,Belarus,Kedah,0,0,0
1/11/2021,Belarus,Kelantan,0,0,0
1/11/2021,Belarus,Pahang,0,0,0
1/11/2021,Belarus,Perak,0,0,0
1/11/2021,Belarus,Perlis,0,0,0
1/11/2021,Belarus,Pulau Pinang,0,0,0
1/11/2021,Belarus,Sabah,0,0,0
1/11/2021,Belarus,Sarawak,0,0,0
1/11/2021,Belarus,Selangor,0,0,0
1/11/2021,Belarus,W.P. Labuan,0,0,0
1/11/2021,Belize,Johor,0,0,0
1/11/2021,Belize,Pulau Pinang,0,0,0
1/11/2021,Belize,Sarawak,0,0,0
1/11/2021,Belize,Selangor,1,0,1
1/11/2021,Bermuda,Selangor,0,0,0
1/11/2021,Bolivia,Johor,0,0,0
1/11/2021,Bolivia,Kedah,0,0,0
1/11/2021,Bolivia,Melaka,0,0,0
1/11/2021,Bolivia,Perak,0,0,0
1/11/2021,Bolivia,Perlis,0,0,0
1/11/2021,Bolivia,Pulau Pinang,0,0,0
1/11/2021,Bolivia,Sabah,0,0,0
1/11/2021,Bolivia,Sarawak,0,0,0
1/11/2021,Bolivia,Selangor,0,0,0
1/11/2021,Brazil,Johor,0,0,0
1/11/2021,Brazil,Kedah,0,0,0
1/11/2021,Brazil,Kelantan,0,0,0
1/11/2021,Brazil,Melaka,0,0,0
1/11/2021,Brazil,Pahang,0,0,0
1/11/2021,Brazil,Perak,0,0,0
1/11/2021,Brazil,Perlis,0,0,0
1/11/2021,Brazil,Pulau Pinang,0,0,0
1/11/2021,Brazil,Sabah,0,0,0
1/11/2021,Brazil,Sarawak,0,0,0
1/11/2021,Brazil,Selangor,32,22,10
1/11/2021,Brazil,W.P. Labuan,0,0,0
1/11/2021,Barbados,Johor,0,0,0
1/11/2021,Barbados,Kedah,0,0,0
1/11/2021,Barbados,Perlis,0,0,0
1/11/2021,Barbados,Pulau Pinang,0,0,0
1/11/2021,Barbados,Selangor,1,1,0
1/11/2021,Brunei Darussalam,Johor,0,0,0
1/11/2021,Brunei Darussalam,Kedah,0,0,0
1/11/2021,Brunei Darussalam,Kelantan,0,0,0
1/11/2021,Brunei Darussalam,Melaka,0,0,0
1/11/2021,Brunei Darussalam,Pahang,0,0,0
1/11/2021,Brunei Darussalam,Perak,0,0,0
1/11/2021,Brunei Darussalam,Perlis,0,0,0
1/11/2021,Brunei Darussalam,Pulau Pinang,0,0,0
1/11/2021,Brunei Darussalam,Sabah,0,0,0
1/11/2021,Brunei Darussalam,Sarawak,312,310,2
1/11/2021,Brunei Darussalam,Selangor,40,20,20
1/11/2021,Brunei Darussalam,W.P. Labuan,1,1,0
1/11/2021,Bhutan,Johor,0,0,0
1/11/2021,Bhutan,Kedah,0,0,0
1/11/2021,Bhutan,Perak,0,0,0
1/11/2021,Bhutan,Perlis,0,0,0
1/11/2021,Bhutan,Pulau Pinang,0,0,0
1/11/2021,Bhutan,Sabah,0,0,0
1/11/2021,Bhutan,Sarawak,0,0,0
1/11/2021,Bhutan,Selangor,3,2,1
1/11/2021,Botswana,Johor,0,0,0
1/11/2021,Botswana,Kedah,0,0,0
1/11/2021,Botswana,Perlis,0,0,0
1/11/2021,Botswana,Pulau Pinang,0,0,0
1/11/2021,Botswana,Sabah,0,0,0
1/11/2021,Botswana,Sarawak,0,0,0
1/11/2021,Botswana,Selangor,0,0,0
1/11/2021,Central African Republic,Kedah,0,0,0
1/11/2021,Central African Republic,Selangor,1,1,0
1/11/2021,Canada,Johor,1,1,0
1/11/2021,Canada,Kedah,0,0,0
1/11/2021,Canada,Kelantan,0,0,0
1/11/2021,Canada,Melaka,0,0,0
1/11/2021,Canada,Negeri Sembilan,0,0,0
1/11/2021,Canada,Pahang,0,0,0
1/11/2021,Canada,Perak,0,0,0
1/11/2021,Canada,Perlis,0,0,0
1/11/2021,Canada,Pulau Pinang,4,2,2
1/11/2021,Canada,Sabah,0,0,0
1/11/2021,Canada,Sarawak,1,1,0
1/11/2021,Canada,Selangor,79,44,35
1/11/2021,Canada,Terengganu,0,0,0
1/11/2021,Canada,W.P. Labuan,0,0,0
1/11/2021,Cocos (Keeling) Islands,Selangor,0,0,0
1/11/2021,Switzerland,Johor,0,0,0
1/11/2021,Switzerland,Kedah,0,0,0
1/11/2021,Switzerland,Kelantan,0,0,0
1/11/2021,Switzerland,Melaka,0,0,0
1/11/2021,Switzerland,Negeri Sembilan,0,0,0
1/11/2021,Switzerland,Pahang,0,0,0
1/11/2021,Switzerland,Perak,0,0,0
1/11/2021,Switzerland,Perlis,0,0,0
1/11/2021,Switzerland,Pulau Pinang,3,0,3
1/11/2021,Switzerland,Sabah,0,0,0
1/11/2021,Switzerland,Sarawak,0,0,0
1/11/2021,Switzerland,Selangor,28,17,11
1/11/2021,Switzerland,W.P. Labuan,0,0,0
1/11/2021,Chile,Johor,0,0,0
1/11/2021,Chile,Kedah,0,0,0
1/11/2021,Chile,Kelantan,0,0,0
1/11/2021,Chile,Melaka,0,0,0
1/11/2021,Chile,Pahang,0,0,0
1/11/2021,Chile,Perak,0,0,0
1/11/2021,Chile,Perlis,0,0,0
1/11/2021,Chile,Pulau Pinang,0,0,0
1/11/2021,Chile,Sabah,0,0,0
1/11/2021,Chile,Sarawak,0,0,0
1/11/2021,Chile,Selangor,2,0,2
1/11/2021,China,Johor,61,59,2
1/11/2021,China,Kedah,0,0,0
1/11/2021,China,Kelantan,0,0,0
1/11/2021,China,Melaka,0,0,0
1/11/2021,China,Pahang,0,0,0
1/11/2021,China,Perak,0,0,0
1/11/2021,China,Perlis,0,0,0
1/11/2021,China,Pulau Pinang,1,0,1
1/11/2021,China,Sabah,2,1,1
1/11/2021,China,Sarawak,64,60,4
1/11/2021,China,Selangor,1249,961,288
1/11/2021,China,Terengganu,0,0,0
1/11/2021,China,W.P. Labuan,0,0,0
1/11/2021,Côte d'Ivoire,Johor,0,0,0
1/11/2021,Côte d'Ivoire,Kedah,0,0,0
1/11/2021,Côte d'Ivoire,Pulau Pinang,0,0,0
1/11/2021,Côte d'Ivoire,Sabah,0,0,0
1/11/2021,Côte d'Ivoire,Sarawak,0,0,0
1/11/2021,Côte d'Ivoire,Selangor,0,0,0
1/11/2021,Cameroon,Johor,0,0,0
1/11/2021,Cameroon,Kedah,0,0,0
1/11/2021,Cameroon,Pulau Pinang,0,0,0
1/11/2021,Cameroon,Sabah,0,0,0
1/11/2021,Cameroon,Sarawak,0,0,0
1/11/2021,Cameroon,Selangor,1,1,0
1/11/2021,Congo,Johor,0,0,0
1/11/2021,Congo,Pulau Pinang,0,0,0
1/11/2021,Congo,Sarawak,0,0,0
1/11/2021,Congo,Selangor,0,0,0
1/11/2021,Congo,Johor,0,0,0
1/11/2021,Congo,Kedah,0,0,0
1/11/2021,Congo,Selangor,0,0,0
1/11/2021,Cook Islands,Selangor,0,0,0
1/11/2021,Colombia,Johor,0,0,0
1/11/2021,Colombia,Kedah,0,0,0
1/11/2021,Colombia,Perak,0,0,0
1/11/2021,Colombia,Pulau Pinang,0,0,0
1/11/2021,Colombia,Sabah,0,0,0
1/11/2021,Colombia,Sarawak,0,0,0
1/11/2021,Colombia,Selangor,5,3,2
1/11/2021,Colombia,W.P. Labuan,0,0,0
1/11/2021,Comoros,Johor,0,0,0
1/11/2021,Comoros,Kedah,0,0,0
1/11/2021,Comoros,Selangor,1,0,1
1/11/2021,Cabo Verde,Johor,0,0,0
1/11/2021,Cabo Verde,Kedah,0,0,0
1/11/2021,Cabo Verde,Pulau Pinang,0,0,0
1/11/2021,Cabo Verde,Sabah,0,0,0
1/11/2021,Cabo Verde,Selangor,0,0,0
1/11/2021,Costa Rica,Johor,0,0,0
1/11/2021,Costa Rica,Kedah,0,0,0
1/11/2021,Costa Rica,Perak,0,0,0
1/11/2021,Costa Rica,Perlis,0,0,0
1/11/2021,Costa Rica,Pulau Pinang,0,0,0
1/11/2021,Costa Rica,Sabah,0,0,0
1/11/2021,Costa Rica,Sarawak,0,0,0
1/11/2021,Costa Rica,Selangor,3,1,2
1/11/2021,Cuba,Johor,0,0,0
1/11/2021,Cuba,Kedah,0,0,0
1/11/2021,Cuba,Perlis,0,0,0
1/11/2021,Cuba,Pulau Pinang,0,0,0
1/11/2021,Cuba,Sabah,0,0,0
1/11/2021,Cuba,Sarawak,0,0,0
1/11/2021,Cuba,Selangor,0,0,0
1/11/2021,Cyprus,Johor,0,0,0
1/11/2021,Cyprus,Kedah,0,0,0
1/11/2021,Cyprus,Perak,0,0,0
1/11/2021,Cyprus,Perlis,0,0,0
1/11/2021,Cyprus,Pulau Pinang,0,0,0
1/11/2021,Cyprus,Sabah,0,0,0
1/11/2021,Cyprus,Sarawak,0,0,0
1/11/2021,Cyprus,Selangor,0,0,0
1/11/2021,Czechia,Johor,0,0,0
1/11/2021,Czechia,Kedah,0,0,0
1/11/2021,Czechia,Kelantan,0,0,0
1/11/2021,Czechia,Melaka,0,0,0
1/11/2021,Czechia,Negeri Sembilan,0,0,0
1/11/2021,Czechia,Perak,0,0,0
1/11/2021,Czechia,Perlis,0,0,0
1/11/2021,Czechia,Pulau Pinang,0,0,0
1/11/2021,Czechia,Sabah,0,0,0
1/11/2021,Czechia,Sarawak,0,0,0
1/11/2021,Czechia,Selangor,13,10,3
1/11/2021,Czechia,W.P. Labuan,0,0,0
1/11/2021,Germany,Johor,0,0,0
1/11/2021,Germany,Kedah,0,0,0
1/11/2021,Germany,Kelantan,0,0,0
1/11/2021,Germany,Melaka,0,0,0
1/11/2021,Germany,Negeri Sembilan,0,0,0
1/11/2021,Germany,Pahang,0,0,0
1/11/2021,Germany,Perak,0,0,0
1/11/2021,Germany,Perlis,0,0,0
1/11/2021,Germany,Pulau Pinang,7,7,0
1/11/2021,Germany,Sabah,0,0,0
1/11/2021,Germany,Sarawak,1,1,0
1/11/2021,Germany,Selangor,163,138,25
1/11/2021,Germany,Terengganu,0,0,0
1/11/2021,Germany,W.P. Labuan,0,0,0
1/11/2021,Djibouti,Johor,0,0,0
1/11/2021,Djibouti,Selangor,3,2,1
1/11/2021,Dominica,Johor,0,0,0
1/11/2021,Dominica,Kedah,0,0,0
1/11/2021,Dominica,Pulau Pinang,0,0,0
1/11/2021,Dominica,Sabah,0,0,0
1/11/2021,Dominica,Sarawak,0,0,0
1/11/2021,Dominica,Selangor,8,3,5
1/11/2021,Dominica,W.P. Labuan,0,0,0
1/11/2021,Denmark,Johor,0,0,0
1/11/2021,Denmark,Kedah,0,0,0
1/11/2021,Denmark,Kelantan,0,0,0
1/11/2021,Denmark,Melaka,0,0,0
1/11/2021,Denmark,Negeri Sembilan,0,0,0
1/11/2021,Denmark,Pahang,0,0,0
1/11/2021,Denmark,Perak,0,0,0
1/11/2021,Denmark,Perlis,0,0,0
1/11/2021,Denmark,Pulau Pinang,2,2,0
1/11/2021,Denmark,Sabah,0,0,0
1/11/2021,Denmark,Sarawak,0,0,0
1/11/2021,Denmark,Selangor,34,30,4
1/11/2021,Denmark,W.P. Labuan,0,0,0
1/11/2021,Dominican Republic,Johor,0,0,0
1/11/2021,Dominican Republic,Kedah,0,0,0
1/11/2021,Dominican Republic,Perak,0,0,0
1/11/2021,Dominican Republic,Perlis,0,0,0
1/11/2021,Dominican Republic,Pulau Pinang,0,0,0
1/11/2021,Dominican Republic,Sabah,0,0,0
1/11/2021,Dominican Republic,Sarawak,0,0,0
1/11/2021,Dominican Republic,Selangor,0,0,0
1/11/2021,Algeria,Johor,0,0,0
1/11/2021,Algeria,Kedah,0,0,0
1/11/2021,Algeria,Kelantan,0,0,0
1/11/2021,Algeria,Melaka,0,0,0
1/11/2021,Algeria,Perak,0,0,0
1/11/2021,Algeria,Perlis,0,0,0
1/11/2021,Algeria,Pulau Pinang,0,0,0
1/11/2021,Algeria,Sabah,0,0,0
1/11/2021,Algeria,Sarawak,0,0,0
1/11/2021,Algeria,Selangor,26,18,8
1/11/2021,Algeria,W.P. Labuan,0,0,0
1/11/2021,Ecuador,Johor,0,0,0
1/11/2021,Ecuador,Kedah,0,0,0
1/11/2021,Ecuador,Perak,0,0,0
1/11/2021,Ecuador,Perlis,0,0,0
1/11/2021,Ecuador,Pulau Pinang,0,0,0
1/11/2021,Ecuador,Sabah,0,0,0
1/11/2021,Ecuador,Sarawak,0,0,0
1/11/2021,Ecuador,Selangor,0,0,0
1/11/2021,Egypt,Johor,0,0,0
1/11/2021,Egypt,Kedah,0,0,0
1/11/2021,Egypt,Kelantan,0,0,0
1/11/2021,Egypt,Melaka,0,0,0
1/11/2021,Egypt,Pahang,0,0,0
1/11/2021,Egypt,Perak,0,0,0
1/11/2021,Egypt,Perlis,0,0,0
1/11/2021,Egypt,Pulau Pinang,0,0,0
1/11/2021,Egypt,Sabah,0,0,0
1/11/2021,Egypt,Sarawak,0,0,0
1/11/2021,Egypt,Selangor,213,160,53
1/11/2021,Egypt,Terengganu,0,0,0
1/11/2021,Egypt,W.P. Labuan,0,0,0
1/11/2021,Eritrea,Johor,0,0,0
1/11/2021,Eritrea,Pulau Pinang,0,0,0
1/11/2021,Eritrea,Sabah,0,0,0
1/11/2021,Eritrea,Selangor,1,0,1
1/11/2021,Spain,Johor,0,0,0
1/11/2021,Spain,Kedah,0,0,0
1/11/2021,Spain,Kelantan,0,0,0
1/11/2021,Spain,Melaka,0,0,0
1/11/2021,Spain,Negeri Sembilan,0,0,0
1/11/2021,Spain,Pahang,0,0,0
1/11/2021,Spain,Perak,0,0,0
1/11/2021,Spain,Perlis,0,0,0
1/11/2021,Spain,Pulau Pinang,0,0,0
1/11/2021,Spain,Sabah,0,0,0
1/11/2021,Spain,Sarawak,0,0,0
1/11/2021,Spain,Selangor,44,31,13
1/11/2021,Spain,W.P. Labuan,0,0,0
1/11/2021,Estonia,Johor,0,0,0
1/11/2021,Estonia,Kedah,1,1,0
1/11/2021,Estonia,Kelantan,0,0,0
1/11/2021,Estonia,Pahang,0,0,0
1/11/2021,Estonia,Perak,0,0,0
1/11/2021,Estonia,Perlis,0,0,0
1/11/2021,Estonia,Pulau Pinang,0,0,0
1/11/2021,Estonia,Sabah,0,0,0
1/11/2021,Estonia,Sarawak,0,0,0
1/11/2021,Estonia,Selangor,6,6,0
1/11/2021,Estonia,W.P. Labuan,0,0,0
1/11/2021,Ethiopia,Johor,0,0,0
1/11/2021,Ethiopia,Kedah,0,0,0
1/11/2021,Ethiopia,Pulau Pinang,0,0,0
1/11/2021,Ethiopia,Sarawak,0,0,0
1/11/2021,Ethiopia,Selangor,10,2,8
1/11/2021,Finland,Johor,0,0,0
1/11/2021,Finland,Kedah,0,0,0
1/11/2021,Finland,Kelantan,0,0,0
1/11/2021,Finland,Melaka,0,0,0
1/11/2021,Finland,Negeri Sembilan,0,0,0
1/11/2021,Finland,Pahang,0,0,0
1/11/2021,Finland,Perak,0,0,0
1/11/2021,Finland,Perlis,0,0,0
1/11/2021,Finland,Pulau Pinang,0,0,0
1/11/2021,Finland,Sabah,0,0,0
1/11/2021,Finland,Sarawak,0,0,0
1/11/2021,Finland,Selangor,19,18,1
1/11/2021,Finland,W.P. Labuan,0,0,0
1/11/2021,Fiji,Johor,0,0,0
1/11/2021,Fiji,Kedah,0,0,0
1/11/2021,Fiji,Kelantan,0,0,0
1/11/2021,Fiji,Perak,0,0,0
1/11/2021,Fiji,Perlis,0,0,0
1/11/2021,Fiji,Pulau Pinang,0,0,0
1/11/2021,Fiji,Sabah,0,0,0
1/11/2021,Fiji,Sarawak,0,0,0
1/11/2021,Fiji,Selangor,2,0,2
1/11/2021,France,Johor,0,0,0
1/11/2021,France,Kedah,0,0,0
1/11/2021,France,Kelantan,0,0,0
1/11/2021,France,Melaka,0,0,0
1/11/2021,France,Negeri Sembilan,0,0,0
1/11/2021,France,Pahang,0,0,0
1/11/2021,France,Perak,0,0,0
1/11/2021,France,Perlis,0,0,0
1/11/2021,France,Pulau Pinang,3,3,0
1/11/2021,France,Sabah,0,0,0
1/11/2021,France,Sarawak,2,2,0
1/11/2021,France,Selangor,166,120,46
1/11/2021,France,Terengganu,0,0,0
1/11/2021,France,W.P. Labuan,0,0,0
1/11/2021,"Micronesia, Federated States of",Johor,0,0,0
1/11/2021,"Micronesia, Federated States of",Pulau Pinang,0,0,0
1/11/2021,"Micronesia, Federated States of",Selangor,0,0,0
1/11/2021,Gabon,Johor,0,0,0
1/11/2021,Gabon,Pulau Pinang,0,0,0
1/11/2021,Gabon,Sarawak,0,0,0
1/11/2021,Gabon,Selangor,1,1,0
1/11/2021,United Kingdom of Great Britain and Northern Ireland,Johor,0,0,0
1/11/2021,United Kingdom of Great Britain and Northern Ireland,Kedah,0,0,0
1/11/2021,United Kingdom of Great Britain and Northern Ireland,Kelantan,0,0,0
1/11/2021,United Kingdom of Great Britain and Northern Ireland,Melaka,0,0,0
1/11/2021,United Kingdom of Great Britain and Northern Ireland,Negeri Sembilan,0,0,0
1/11/2021,United Kingdom of Great Britain and Northern Ireland,Pahang,0,0,0
1/11/2021,United Kingdom of Great Britain and Northern Ireland,Perak,0,0,0
1/11/2021,United Kingdom of Great Britain and Northern Ireland,Perlis,0,0,0
1/11/2021,United Kingdom of Great Britain and Northern Ireland,Pulau Pinang,18,11,7
1/11/2021,United Kingdom of Great Britain and Northern Ireland,Sabah,0,0,0
1/11/2021,United Kingdom of Great Britain and Northern Ireland,Sarawak,4,3,1
1/11/2021,United Kingdom of Great Britain and Northern Ireland,Selangor,433,333,100
1/11/2021,United Kingdom of Great Britain and Northern Ireland,Terengganu,0,0,0
1/11/2021,United Kingdom of Great Britain and Northern Ireland,W.P. Labuan,0,0,0
1/11/2021,Georgia,Johor,1,1,0
1/11/2021,Georgia,Kedah,0,0,0
1/11/2021,Georgia,Melaka,0,0,0
1/11/2021,Georgia,Perak,0,0,0
1/11/2021,Georgia,Perlis,0,0,0
1/11/2021,Georgia,Pulau Pinang,0,0,0
1/11/2021,Georgia,Sabah,0,0,0
1/11/2021,Georgia,Sarawak,0,0,0
1/11/2021,Georgia,Selangor,1,1,0
1/11/2021,Ghana,Johor,0,0,0
1/11/2021,Ghana,Kedah,0,0,0
1/11/2021,Ghana,Kelantan,0,0,0
1/11/2021,Ghana,Pulau Pinang,0,0,0
1/11/2021,Ghana,Sabah,0,0,0
1/11/2021,Ghana,Sarawak,0,0,0
1/11/2021,Ghana,Selangor,2,1,1
1/11/2021,Gibraltar,Johor,0,0,0
1/11/2021,Gibraltar,Sarawak,0,0,0
1/11/2021,Guinea,Johor,0,0,0
1/11/2021,Guinea,Kedah,0,0,0
1/11/2021,Guinea,Kelantan,0,0,0
1/11/2021,Guinea,Perlis,0,0,0
1/11/2021,Guinea,Pulau Pinang,0,0,0
1/11/2021,Guinea,Sabah,0,0,0
1/11/2021,Guinea,Sarawak,0,0,0
1/11/2021,Guinea,Selangor,4,4,0
1/11/2021,Guadeloupe,Selangor,0,0,0
1/11/2021,Gambia,Johor,0,0,0
1/11/2021,Gambia,Kedah,0,0,0
1/11/2021,Gambia,Kelantan,0,0,0
1/11/2021,Gambia,Pulau Pinang,0,0,0
1/11/2021,Gambia,Sabah,0,0,0
1/11/2021,Gambia,Sarawak,0,0,0
1/11/2021,Gambia,Selangor,3,1,2
1/11/2021,Guinea-Bissau,Johor,0,0,0
1/11/2021,Guinea-Bissau,Selangor,0,0,0
1/11/2021,Equatorial Guinea,Johor,0,0,0
1/11/2021,Equatorial Guinea,Selangor,0,0,0
1/11/2021,Greece,Johor,0,0,0
1/11/2021,Greece,Kedah,0,0,0
1/11/2021,Greece,Kelantan,0,0,0
1/11/2021,Greece,Melaka,0,0,0
1/11/2021,Greece,Negeri Sembilan,0,0,0
1/11/2021,Greece,Pahang,0,0,0
1/11/2021,Greece,Perak,0,0,0
1/11/2021,Greece,Perlis,0,0,0
1/11/2021,Greece,Pulau Pinang,0,0,0
1/11/2021,Greece,Sabah,0,0,0
1/11/2021,Greece,Sarawak,0,0,0
1/11/2021,Greece,Selangor,15,14,1
1/11/2021,Grenada,Johor,0,0,0
1/11/2021,Grenada,Kedah,0,0,0
1/11/2021,Grenada,Pulau Pinang,0,0,0
1/11/2021,Grenada,Sabah,0,0,0
1/11/2021,Grenada,Sarawak,0,0,0
1/11/2021,Grenada,Selangor,0,0,0
1/11/2021,Greenland,Johor,0,0,0
1/11/2021,Greenland,Selangor,0,0,0
1/11/2021,Guatemala,Johor,0,0,0
1/11/2021,Guatemala,Kedah,0,0,0
1/11/2021,Guatemala,Pahang,0,0,0
1/11/2021,Guatemala,Perak,0,0,0
1/11/2021,Guatemala,Pulau Pinang,0,0,0
1/11/2021,Guatemala,Sabah,0,0,0
1/11/2021,Guatemala,Sarawak,0,0,0
1/11/2021,Guatemala,Selangor,0,0,0
1/11/2021,Guatemala,W.P. Labuan,0,0,0
1/11/2021,Guyana,Johor,0,0,0
1/11/2021,Guyana,Kedah,0,0,0
1/11/2021,Guyana,Pulau Pinang,0,0,0
1/11/2021,Guyana,Sarawak,0,0,0
1/11/2021,Guyana,Selangor,0,0,0
1/11/2021,Hong Kong,Johor,0,0,0
1/11/2021,Hong Kong,Kedah,0,0,0
1/11/2021,Hong Kong,Kelantan,0,0,0
1/11/2021,Hong Kong,Pahang,0,0,0
1/11/2021,Hong Kong,Perak,0,0,0
1/11/2021,Hong Kong,Perlis,0,0,0
1/11/2021,Hong Kong,Pulau Pinang,4,2,2
1/11/2021,Hong Kong,Sabah,0,0,0
1/11/2021,Hong Kong,Sarawak,30,28,2
1/11/2021,Hong Kong,Selangor,10,9,1
1/11/2021,Hong Kong,Terengganu,0,0,0
1/11/2021,Heard Island and McDonald Islands,Johor,0,0,0
1/11/2021,Honduras,Johor,0,0,0
1/11/2021,Honduras,Kedah,0,0,0
1/11/2021,Honduras,Perak,0,0,0
1/11/2021,Honduras,Pulau Pinang,0,0,0
1/11/2021,Honduras,Sabah,0,0,0
1/11/2021,Honduras,Sarawak,0,0,0
1/11/2021,Honduras,Selangor,0,0,0
1/11/2021,Croatia,Johor,0,0,0
1/11/2021,Croatia,Kedah,0,0,0
1/11/2021,Croatia,Kelantan,0,0,0
1/11/2021,Croatia,Melaka,0,0,0
1/11/2021,Croatia,Pahang,0,0,0
1/11/2021,Croatia,Perak,0,0,0
1/11/2021,Croatia,Perlis,0,0,0
1/11/2021,Croatia,Pulau Pinang,0,0,0
1/11/2021,Croatia,Sabah,0,0,0
1/11/2021,Croatia,Sarawak,0,0,0
1/11/2021,Croatia,Selangor,19,18,1
1/11/2021,Haiti,Johor,0,0,0
1/11/2021,Haiti,Kedah,0,0,0
1/11/2021,Haiti,Kelantan,0,0,0
1/11/2021,Haiti,Perak,0,0,0
1/11/2021,Haiti,Pulau Pinang,0,0,0
1/11/2021,Haiti,Sabah,0,0,0
1/11/2021,Haiti,Selangor,0,0,0
1/11/2021,Hungary,Johor,0,0,0
1/11/2021,Hungary,Kedah,0,0,0
1/11/2021,Hungary,Kelantan,0,0,0
1/11/2021,Hungary,Pahang,0,0,0
1/11/2021,Hungary,Perak,0,0,0
1/11/2021,Hungary,Perlis,0,0,0
1/11/2021,Hungary,Pulau Pinang,0,0,0
1/11/2021,Hungary,Sabah,0,0,0
1/11/2021,Hungary,Sarawak,0,0,0
1/11/2021,Hungary,Selangor,5,3,2
1/11/2021,Hungary,W.P. Labuan,0,0,0
1/11/2021,Indonesia,Johor,204,130,74
1/11/2021,Indonesia,Kedah,4,4,0
1/11/2021,Indonesia,Kelantan,0,0,0
1/11/2021,Indonesia,Melaka,0,0,0
1/11/2021,Indonesia,Negeri Sembilan,0,0,0
1/11/2021,Indonesia,Pahang,0,0,0
1/11/2021,Indonesia,Perak,0,0,0
1/11/2021,Indonesia,Perlis,4,4,0
1/11/2021,Indonesia,Pulau Pinang,45,18,27
1/11/2021,Indonesia,Sabah,10,4,6
1/11/2021,Indonesia,Sarawak,265,250,15
1/11/2021,Indonesia,Selangor,1970,915,1055
1/11/2021,Indonesia,Terengganu,0,0,0
1/11/2021,Indonesia,W.P. Labuan,0,0,0
1/11/2021,India,Johor,12,12,0
1/11/2021,India,Kedah,0,0,0
1/11/2021,India,Kelantan,0,0,0
1/11/2021,India,Melaka,0,0,0
1/11/2021,India,Negeri Sembilan,0,0,0
1/11/2021,India,Pahang,0,0,0
1/11/2021,India,Perak,0,0,0
1/11/2021,India,Perlis,0,0,0
1/11/2021,India,Pulau Pinang,5,4,1
1/11/2021,India,Sabah,1,1,0
1/11/2021,India,Sarawak,0,0,0
1/11/2021,India,Selangor,2054,1623,431
1/11/2021,India,Terengganu,0,0,0
1/11/2021,India,W.P. Labuan,0,0,0
1/11/2021, British Indian Ocean Territory,Pulau Pinang,0,0,0
1/11/2021, British Indian Ocean Territory,Selangor,0,0,0
1/11/2021,Ireland,Johor,0,0,0
1/11/2021,Ireland,Kedah,0,0,0
1/11/2021,Ireland,Kelantan,0,0,0
1/11/2021,Ireland,Negeri Sembilan,0,0,0
1/11/2021,Ireland,Pahang,0,0,0
1/11/2021,Ireland,Perak,0,0,0
1/11/2021,Ireland,Perlis,0,0,0
1/11/2021,Ireland,Pulau Pinang,0,0,0
1/11/2021,Ireland,Sabah,0,0,0
1/11/2021,Ireland,Sarawak,1,1,0
1/11/2021,Ireland,Selangor,24,15,9
1/11/2021,Ireland,Terengganu,0,0,0
1/11/2021,Ireland,W.P. Labuan,0,0,0
1/11/2021,"Iran, Islamic Republic of",Johor,0,0,0
1/11/2021,"Iran, Islamic Republic of",Kedah,0,0,0
1/11/2021,"Iran, Islamic Republic of",Kelantan,0,0,0
1/11/2021,"Iran, Islamic Republic of",Perak,0,0,0
1/11/2021,"Iran, Islamic Republic of",Perlis,0,0,0
1/11/2021,"Iran, Islamic Republic of",Pulau Pinang,0,0,0
1/11/2021,"Iran, Islamic Republic of",Sabah,0,0,0
1/11/2021,"Iran, Islamic Republic of",Sarawak,0,0,0
1/11/2021,"Iran, Islamic Republic of",Selangor,99,58,41
1/11/2021,"Iran, Islamic Republic of",W.P. Labuan,0,0,0
1/11/2021,Iraq,Johor,0,0,0
1/11/2021,Iraq,Kedah,0,0,0
1/11/2021,Iraq,Kelantan,0,0,0
1/11/2021,Iraq,Melaka,0,0,0
1/11/2021,Iraq,Pahang,0,0,0
1/11/2021,Iraq,Perak,0,0,0
1/11/2021,Iraq,Perlis,0,0,0
1/11/2021,Iraq,Pulau Pinang,0,0,0
1/11/2021,Iraq,Sabah,0,0,0
1/11/2021,Iraq,Sarawak,0,0,0
1/11/2021,Iraq,Selangor,104,73,31
1/11/2021,Iceland,Johor,0,0,0
1/11/2021,Iceland,Kedah,0,0,0
1/11/2021,Iceland,Kelantan,0,0,0
1/11/2021,Iceland,Perak,0,0,0
1/11/2021,Iceland,Perlis,0,0,0
1/11/2021,Iceland,Pulau Pinang,0,0,0
1/11/2021,Iceland,Sabah,0,0,0
1/11/2021,Iceland,Sarawak,0,0,0
1/11/2021,Iceland,Selangor,0,0,0
1/11/2021,Iceland,W.P. Labuan,0,0,0
1/11/2021,Israel,Pulau Pinang,0,0,0
1/11/2021,Italy,Johor,0,0,0
1/11/2021,Italy,Kedah,0,0,0
1/11/2021,Italy,Kelantan,0,0,0
1/11/2021,Italy,Melaka,0,0,0
1/11/2021,Italy,Negeri Sembilan,0,0,0
1/11/2021,Italy,Pahang,0,0,0
1/11/2021,Italy,Perak,0,0,0
1/11/2021,Italy,Perlis,0,0,0
1/11/2021,Italy,Pulau Pinang,1,1,0
1/11/2021,Italy,Sabah,0,0,0
1/11/2021,Italy,Sarawak,0,0,0
1/11/2021,Italy,Selangor,73,61,12
1/11/2021,Italy,W.P. Labuan,0,0,0
1/11/2021,Jamaica,Johor,0,0,0
1/11/2021,Jamaica,Kedah,0,0,0
1/11/2021,Jamaica,Perak,0,0,0
1/11/2021,Jamaica,Pulau Pinang,0,0,0
1/11/2021,Jamaica,Sabah,0,0,0
1/11/2021,Jamaica,Sarawak,0,0,0
1/11/2021,Jamaica,Selangor,0,0,0
1/11/2021,Jamaica,W.P. Labuan,0,0,0
1/11/2021,Jordan,Johor,0,0,0
1/11/2021,Jordan,Kedah,0,0,0
1/11/2021,Jordan,Kelantan,0,0,0
1/11/2021,Jordan,Melaka,0,0,0
1/11/2021,Jordan,Perlis,0,0,0
1/11/2021,Jordan,Pulau Pinang,0,0,0
1/11/2021,Jordan,Sabah,0,0,0
1/11/2021,Jordan,Sarawak,1,1,0
1/11/2021,Jordan,Selangor,50,45,5
1/11/2021,Jordan,W.P. Labuan,0,0,0
1/11/2021,Japan,Johor,0,0,0
1/11/2021,Japan,Kedah,0,0,0
1/11/2021,Japan,Kelantan,0,0,0
1/11/2021,Japan,Melaka,0,0,0
1/11/2021,Japan,Negeri Sembilan,0,0,0
1/11/2021,Japan,Pahang,0,0,0
1/11/2021,Japan,Perak,0,0,0
1/11/2021,Japan,Perlis,0,0,0
1/11/2021,Japan,Pulau Pinang,54,38,16
1/11/2021,Japan,Sabah,1,1,0
1/11/2021,Japan,Sarawak,5,3,2
1/11/2021,Japan,Selangor,732,505,227
1/11/2021,Japan,W.P. Labuan,0,0,0
1/11/2021,Kazakhstan,Johor,0,0,0
1/11/2021,Kazakhstan,Kedah,0,0,0
1/11/2021,Kazakhstan,Kelantan,0,0,0
1/11/2021,Kazakhstan,Melaka,0,0,0
1/11/2021,Kazakhstan,Perak,0,0,0
1/11/2021,Kazakhstan,Perlis,0,0,0
1/11/2021,Kazakhstan,Pulau Pinang,0,0,0
1/11/2021,Kazakhstan,Sabah,0,0,0
1/11/2021,Kazakhstan,Sarawak,0,0,0
1/11/2021,Kazakhstan,Selangor,25,13,12
1/11/2021,Kazakhstan,W.P. Labuan,0,0,0
1/11/2021,Kenya,Johor,0,0,0
1/11/2021,Kenya,Kedah,0,0,0
1/11/2021,Kenya,Kelantan,0,0,0
1/11/2021,Kenya,Perak,0,0,0
1/11/2021,Kenya,Perlis,0,0,0
1/11/2021,Kenya,Pulau Pinang,0,0,0
1/11/2021,Kenya,Sabah,0,0,0
1/11/2021,Kenya,Sarawak,0,0,0
1/11/2021,Kenya,Selangor,42,32,10
1/11/2021,Kyrgyzstan,Johor,0,0,0
1/11/2021,Kyrgyzstan,Kedah,0,0,0
1/11/2021,Kyrgyzstan,Kelantan,0,0,0
1/11/2021,Kyrgyzstan,Perak,0,0,0
1/11/2021,Kyrgyzstan,Perlis,0,0,0
1/11/2021,Kyrgyzstan,Pulau Pinang,0,0,0
1/11/2021,Kyrgyzstan,Sabah,0,0,0
1/11/2021,Kyrgyzstan,Sarawak,0,0,0
1/11/2021,Kyrgyzstan,Selangor,6,2,4
1/11/2021,Cambodia,Johor,0,0,0
1/11/2021,Cambodia,Kedah,0,0,0
1/11/2021,Cambodia,Kelantan,0,0,0
1/11/2021,Cambodia,Melaka,0,0,0
1/11/2021,Cambodia,Negeri Sembilan,0,0,0
1/11/2021,Cambodia,Pahang,0,0,0
1/11/2021,Cambodia,Perak,0,0,0
1/11/2021,Cambodia,Perlis,0,0,0
1/11/2021,Cambodia,Pulau Pinang,18,17,1
1/11/2021,Cambodia,Sabah,0,0,0
1/11/2021,Cambodia,Sarawak,1,1,0
1/11/2021,Cambodia,Selangor,28,15,13
1/11/2021,Cambodia,W.P. Labuan,0,0,0
1/11/2021,Kiribati,Johor,0,0,0
1/11/2021,Kiribati,Sabah,0,0,0
1/11/2021,Kiribati,Selangor,0,0,0
1/11/2021,Saint Kitts and Nevis,Johor,0,0,0
1/11/2021,Saint Kitts and Nevis,Kedah,0,0,0
1/11/2021,Saint Kitts and Nevis,Perlis,0,0,0
1/11/2021,Saint Kitts and Nevis,Pulau Pinang,0,0,0
1/11/2021,Saint Kitts and Nevis,Sabah,0,0,0
1/11/2021,Saint Kitts and Nevis,Selangor,0,0,0
1/11/2021,Saint Kitts and Nevis,W.P. Labuan,0,0,0
1/11/2021,"Korea, Republic of",Johor,2,1,1
1/11/2021,"Korea, Republic of",Kedah,0,0,0
1/11/2021,"Korea, Republic of",Kelantan,0,0,0
1/11/2021,"Korea, Republic of",Melaka,0,0,0
1/11/2021,"Korea, Republic of",Negeri Sembilan,0,0,0
1/11/2021,"Korea, Republic of",Pahang,0,0,0
1/11/2021,"Korea, Republic of",Perak,1,1,0
1/11/2021,"Korea, Republic of",Perlis,0,0,0
1/11/2021,"Korea, Republic of",Pulau Pinang,34,13,21
1/11/2021,"Korea, Republic of",Sabah,6,3,3
1/11/2021,"Korea, Republic of",Sarawak,34,31,3
1/11/2021,"Korea, Republic of",Selangor,546,337,209
1/11/2021,"Korea, Republic of",Terengganu,0,0,0
1/11/2021,"Korea, Republic of",W.P. Labuan,0,0,0
1/11/2021,Kuwait,Johor,0,0,0
1/11/2021,Kuwait,Kedah,0,0,0
1/11/2021,Kuwait,Kelantan,0,0,0
1/11/2021,Kuwait,Perak,0,0,0
1/11/2021,Kuwait,Perlis,0,0,0
1/11/2021,Kuwait,Pulau Pinang,0,0,0
1/11/2021,Kuwait,Sabah,0,0,0
1/11/2021,Kuwait,Sarawak,0,0,0
1/11/2021,Kuwait,Selangor,2,2,0
1/11/2021,Kuwait,W.P. Labuan,0,0,0
1/11/2021, Lao People's Democratic Republic,Johor,0,0,0
1/11/2021, Lao People's Democratic Republic,Kedah,0,0,0
1/11/2021, Lao People's Democratic Republic,Kelantan,0,0,0
1/11/2021, Lao People's Democratic Republic,Melaka,0,0,0
1/11/2021, Lao People's Democratic Republic,Perak,0,0,0
1/11/2021, Lao People's Democratic Republic,Perlis,0,0,0
1/11/2021, Lao People's Democratic Republic,Pulau Pinang,0,0,0
1/11/2021, Lao People's Democratic Republic,Sabah,0,0,0
1/11/2021, Lao People's Democratic Republic,Sarawak,0,0,0
1/11/2021, Lao People's Democratic Republic,Selangor,1,0,1
1/11/2021, Lao People's Democratic Republic,W.P. Labuan,0,0,0
1/11/2021,Lebanon,Johor,0,0,0
1/11/2021,Lebanon,Kedah,0,0,0
1/11/2021,Lebanon,Kelantan,0,0,0
1/11/2021,Lebanon,Pahang,0,0,0
1/11/2021,Lebanon,Perak,0,0,0
1/11/2021,Lebanon,Perlis,0,0,0
1/11/2021,Lebanon,Pulau Pinang,0,0,0
1/11/2021,Lebanon,Sabah,0,0,0
1/11/2021,Lebanon,Sarawak,0,0,0
1/11/2021,Lebanon,Selangor,14,9,5
1/11/2021,Lebanon,W.P. Labuan,0,0,0
1/11/2021,Liberia,Johor,0,0,0
1/11/2021,Liberia,Kedah,0,0,0
1/11/2021,Liberia,Sabah,0,0,0
1/11/2021,Liberia,Sarawak,0,0,0
1/11/2021,Liberia,Selangor,0,0,0
1/11/2021,Libya,Johor,0,0,0
1/11/2021,Libya,Kedah,0,0,0
1/11/2021,Libya,Perlis,0,0,0
1/11/2021,Libya,Pulau Pinang,0,0,0
1/11/2021,Libya,Sabah,0,0,0
1/11/2021,Libya,Sarawak,0,0,0
1/11/2021,Libya,Selangor,58,49,9
1/11/2021,Saint Lucia,Johor,0,0,0
1/11/2021,Saint Lucia,Kedah,0,0,0
1/11/2021,Saint Lucia,Pulau Pinang,0,0,0
1/11/2021,Saint Lucia,Sarawak,0,0,0
1/11/2021,Saint Lucia,Selangor,1,1,0
1/11/2021,Liechtenstein,Johor,0,0,0
1/11/2021,Liechtenstein,Kedah,0,0,0
1/11/2021,Liechtenstein,Perlis,0,0,0
1/11/2021,Liechtenstein,Pulau Pinang,0,0,0
1/11/2021,Liechtenstein,Sabah,0,0,0
1/11/2021,Liechtenstein,Sarawak,0,0,0
1/11/2021,Liechtenstein,Selangor,0,0,0
1/11/2021,LKA,Johor,0,0,0
1/11/2021,LKA,Kedah,0,0,0
1/11/2021,LKA,Kelantan,0,0,0
1/11/2021,LKA,Melaka,0,0,0
1/11/2021,LKA,Pahang,0,0,0
1/11/2021,LKA,Perak,0,0,0
1/11/2021,LKA,Perlis,0,0,0
1/11/2021,LKA,Pulau Pinang,0,0,0
1/11/2021,LKA,Sabah,0,0,0
1/11/2021,LKA,Sarawak,1,1,0
1/11/2021,LKA,Selangor,126,76,50
1/11/2021,LKA,W.P. Labuan,0,0,0
1/11/2021,Lesotho,Johor,0,0,0
1/11/2021,Lesotho,Kedah,0,0,0
1/11/2021,Lesotho,Pulau Pinang,0,0,0
1/11/2021,Lesotho,Sarawak,0,0,0
1/11/2021,Lesotho,Selangor,0,0,0
1/11/2021,Lithuania,Johor,0,0,0
1/11/2021,Lithuania,Kedah,0,0,0
1/11/2021,Lithuania,Kelantan,0,0,0
1/11/2021,Lithuania,Pahang,0,0,0
1/11/2021,Lithuania,Perak,0,0,0
1/11/2021,Lithuania,Perlis,0,0,0
1/11/2021,Lithuania,Pulau Pinang,0,0,0
1/11/2021,Lithuania,Sabah,0,0,0
1/11/2021,Lithuania,Sarawak,0,0,0
1/11/2021,Lithuania,Selangor,3,2,1
1/11/2021,Lithuania,W.P. Labuan,0,0,0
1/11/2021,Luxembourg,Johor,0,0,0
1/11/2021,Luxembourg,Kedah,0,0,0
1/11/2021,Luxembourg,Kelantan,0,0,0
1/11/2021,Luxembourg,Perak,0,0,0
1/11/2021,Luxembourg,Perlis,0,0,0
1/11/2021,Luxembourg,Pulau Pinang,0,0,0
1/11/2021,Luxembourg,Sabah,0,0,0
1/11/2021,Luxembourg,Sarawak,0,0,0
1/11/2021,Luxembourg,Selangor,0,0,0
1/11/2021,Latvia,Johor,0,0,0
1/11/2021,Latvia,Kedah,0,0,0
1/11/2021,Latvia,Kelantan,0,0,0
1/11/2021,Latvia,Pahang,0,0,0
1/11/2021,Latvia,Perak,0,0,0
1/11/2021,Latvia,Perlis,0,0,0
1/11/2021,Latvia,Pulau Pinang,0,0,0
1/11/2021,Latvia,Sabah,0,0,0
1/11/2021,Latvia,Sarawak,0,0,0
1/11/2021,Latvia,Selangor,2,2,0
1/11/2021,Latvia,W.P. Labuan,0,0,0
1/11/2021,Macao,Johor,0,0,0
1/11/2021,Macao,Pahang,0,0,0
1/11/2021,Macao,Perak,0,0,0
1/11/2021,Macao,Selangor,0,0,0
1/11/2021,Macao,W.P. Labuan,0,0,0
1/11/2021,Morocco,Johor,0,0,0
1/11/2021,Morocco,Kedah,0,0,0
1/11/2021,Morocco,Kelantan,0,0,0
1/11/2021,Morocco,Melaka,0,0,0
1/11/2021,Morocco,Pahang,0,0,0
1/11/2021,Morocco,Perak,0,0,0
1/11/2021,Morocco,Perlis,0,0,0
1/11/2021,Morocco,Pulau Pinang,0,0,0
1/11/2021,Morocco,Sabah,0,0,0
1/11/2021,Morocco,Sarawak,0,0,0
1/11/2021,Morocco,Selangor,18,9,9
1/11/2021,Morocco,W.P. Labuan,0,0,0
1/11/2021,Monaco,Johor,0,0,0
1/11/2021,Monaco,Kedah,0,0,0
1/11/2021,Monaco,Sabah,0,0,0
1/11/2021,Monaco,Selangor,0,0,0
1/11/2021,"Moldova, Republic of",Johor,0,0,0
1/11/2021,"Moldova, Republic of",Kedah,0,0,0
1/11/2021,"Moldova, Republic of",Kelantan,0,0,0
1/11/2021,"Moldova, Republic of",Negeri Sembilan,0,0,0
1/11/2021,"Moldova, Republic of",Perlis,0,0,0
1/11/2021,"Moldova, Republic of",Pulau Pinang,0,0,0
1/11/2021,"Moldova, Republic of",Sabah,0,0,0
1/11/2021,"Moldova, Republic of",Sarawak,0,0,0
1/11/2021,"Moldova, Republic of",Selangor,0,0,0
1/11/2021,Madagascar,Johor,0,0,0
1/11/2021,Madagascar,Kedah,0,0,0
1/11/2021,Madagascar,Perak,0,0,0
1/11/2021,Madagascar,Perlis,0,0,0
1/11/2021,Madagascar,Pulau Pinang,0,0,0
1/11/2021,Madagascar,Sabah,0,0,0
1/11/2021,Madagascar,Sarawak,0,0,0
1/11/2021,Madagascar,Selangor,1,0,1
1/11/2021,Maldives,Johor,0,0,0
1/11/2021,Maldives,Kedah,0,0,0
1/11/2021,Maldives,Kelantan,0,0,0
1/11/2021,Maldives,Perak,0,0,0
1/11/2021,Maldives,Perlis,0,0,0
1/11/2021,Maldives,Pulau Pinang,1,1,0
1/11/2021,Maldives,Sabah,0,0,0
1/11/2021,Maldives,Sarawak,0,0,0
1/11/2021,Maldives,Selangor,99,44,55
1/11/2021,Mexico,Johor,0,0,0
1/11/2021,Mexico,Kedah,0,0,0
1/11/2021,Mexico,Kelantan,0,0,0
1/11/2021,Mexico,Pahang,0,0,0
1/11/2021,Mexico,Perak,0,0,0
1/11/2021,Mexico,Perlis,0,0,0
1/11/2021,Mexico,Pulau Pinang,0,0,0
1/11/2021,Mexico,Sabah,0,0,0
1/11/2021,Mexico,Sarawak,0,0,0
1/11/2021,Mexico,Selangor,7,5,2
1/11/2021,Mexico,W.P. Labuan,0,0,0
1/11/2021,Marshall Islands,Johor,0,0,0
1/11/2021,Marshall Islands,Kedah,0,0,0
1/11/2021,Marshall Islands,Perak,0,0,0
1/11/2021,Marshall Islands,Pulau Pinang,0,0,0
1/11/2021,Marshall Islands,Sabah,0,0,0
1/11/2021,Marshall Islands,Selangor,0,0,0
1/11/2021,North Macedonia,Johor,0,0,0
1/11/2021,North Macedonia,Kedah,0,0,0
1/11/2021,North Macedonia,Perak,0,0,0
1/11/2021,North Macedonia,Pulau Pinang,0,0,0
1/11/2021,North Macedonia,Sabah,0,0,0
1/11/2021,North Macedonia,Sarawak,0,0,0
1/11/2021,North Macedonia,Selangor,1,0,1
1/11/2021,Mali,Johor,0,0,0
1/11/2021,Mali,Sabah,0,0,0
1/11/2021,Mali,Selangor,4,4,0
1/11/2021,Malta,Johor,0,0,0
1/11/2021,Malta,Kedah,0,0,0
1/11/2021,Malta,Kelantan,0,0,0
1/11/2021,Malta,Perak,0,0,0
1/11/2021,Malta,Perlis,0,0,0
1/11/2021,Malta,Pulau Pinang,0,0,0
1/11/2021,Malta,Sabah,0,0,0
1/11/2021,Malta,Sarawak,0,0,0
1/11/2021,Malta,Selangor,1,0,1
1/11/2021,Malta,W.P. Labuan,0,0,0
1/11/2021,Myanmar,Johor,2,2,0
1/11/2021,Myanmar,Kedah,0,0,0
1/11/2021,Myanmar,Kelantan,0,0,0
1/11/2021,Myanmar,Negeri Sembilan,0,0,0
1/11/2021,Myanmar,Pahang,0,0,0
1/11/2021,Myanmar,Perak,0,0,0
1/11/2021,Myanmar,Perlis,0,0,0
1/11/2021,Myanmar,Pulau Pinang,0,0,0
1/11/2021,Myanmar,Sabah,0,0,0
1/11/2021,Myanmar,Sarawak,0,0,0
1/11/2021,Myanmar,Selangor,208,193,15
1/11/2021,Myanmar,Terengganu,0,0,0
1/11/2021,Myanmar,W.P. Labuan,0,0,0
1/11/2021,Montenegro,Johor,0,0,0
1/11/2021,Montenegro,Kedah,0,0,0
1/11/2021,Montenegro,Pulau Pinang,0,0,0
1/11/2021,Montenegro,Sabah,0,0,0
1/11/2021,Montenegro,Sarawak,0,0,0
1/11/2021,Montenegro,Selangor,6,6,0
1/11/2021,Mongolia,Johor,0,0,0
1/11/2021,Mongolia,Kedah,0,0,0
1/11/2021,Mongolia,Kelantan,0,0,0
1/11/2021,Mongolia,Perak,0,0,0
1/11/2021,Mongolia,Perlis,0,0,0
1/11/2021,Mongolia,Pulau Pinang,0,0,0
1/11/2021,Mongolia,Sabah,0,0,0
1/11/2021,Mongolia,Sarawak,0,0,0
1/11/2021,Mongolia,Selangor,2,1,1
1/11/2021,Northern Mariana Islands,Selangor,0,0,0
1/11/2021,Mozambique,Johor,0,0,0
1/11/2021,Mozambique,Kedah,0,0,0
1/11/2021,Mozambique,Perak,0,0,0
1/11/2021,Mozambique,Pulau Pinang,0,0,0
1/11/2021,Mozambique,Sabah,0,0,0
1/11/2021,Mozambique,Sarawak,0,0,0
1/11/2021,Mozambique,Selangor,0,0,0
1/11/2021,Mauritania,Johor,0,0,0
1/11/2021,Mauritania,Kedah,0,0,0
1/11/2021,Mauritania,Pulau Pinang,0,0,0
1/11/2021,Mauritania,Sabah,0,0,0
1/11/2021,Mauritania,Sarawak,0,0,0
1/11/2021,Mauritania,Selangor,9,8,1
1/11/2021,Mauritius,Johor,0,0,0
1/11/2021,Mauritius,Kedah,0,0,0
1/11/2021,Mauritius,Kelantan,0,0,0
1/11/2021,Mauritius,Pahang,0,0,0
1/11/2021,Mauritius,Perak,0,0,0
1/11/2021,Mauritius,Perlis,0,0,0
1/11/2021,Mauritius,Pulau Pinang,0,0,0
1/11/2021,Mauritius,Sabah,0,0,0
1/11/2021,Mauritius,Sarawak,0,0,0
1/11/2021,Mauritius,Selangor,16,9,7
1/11/2021,Malawi,Johor,0,0,0
1/11/2021,Malawi,Pulau Pinang,0,0,0
1/11/2021,Malawi,Sabah,0,0,0
1/11/2021,Malawi,Sarawak,0,0,0
1/11/2021,Malawi,Selangor,4,2,2
1/11/2021,Mayotte,Selangor,0,0,0
1/11/2021,Namibia,Johor,0,0,0
1/11/2021,Namibia,Kedah,0,0,0
1/11/2021,Namibia,Perak,0,0,0
1/11/2021,Namibia,Perlis,0,0,0
1/11/2021,Namibia,Pulau Pinang,0,0,0
1/11/2021,Namibia,Sabah,0,0,0
1/11/2021,Namibia,Sarawak,0,0,0
1/11/2021,Namibia,Selangor,0,0,0
1/11/2021,New Caledonia,Selangor,0,0,0
1/11/2021,Niger,Johor,0,0,0
1/11/2021,Niger,Sabah,0,0,0
1/11/2021,Niger,Selangor,1,1,0
1/11/2021,Nigeria,Johor,0,0,0
1/11/2021,Nigeria,Kedah,0,0,0
1/11/2021,Nigeria,Perlis,0,0,0
1/11/2021,Nigeria,Pulau Pinang,0,0,0
1/11/2021,Nigeria,Sabah,1,1,0
1/11/2021,Nigeria,Sarawak,1,1,0
1/11/2021,Nigeria,Selangor,95,88,7
1/11/2021,Nicaragua,Johor,0,0,0
1/11/2021,Nicaragua,Kedah,0,0,0
1/11/2021,Nicaragua,Pulau Pinang,0,0,0
1/11/2021,Nicaragua,Sabah,0,0,0
1/11/2021,Nicaragua,Selangor,0,0,0
1/11/2021,Netherlands,Johor,0,0,0
1/11/2021,Netherlands,Kedah,0,0,0
1/11/2021,Netherlands,Kelantan,0,0,0
1/11/2021,Netherlands,Melaka,0,0,0
1/11/2021,Netherlands,Negeri Sembilan,0,0,0
1/11/2021,Netherlands,Pahang,0,0,0
1/11/2021,Netherlands,Perak,0,0,0
1/11/2021,Netherlands,Perlis,0,0,0
1/11/2021,Netherlands,Pulau Pinang,5,3,2
1/11/2021,Netherlands,Sabah,0,0,0
1/11/2021,Netherlands,Sarawak,0,0,0
1/11/2021,Netherlands,Selangor,90,67,23
1/11/2021,Netherlands,Terengganu,0,0,0
1/11/2021,Netherlands,W.P. Labuan,0,0,0
1/11/2021,Norway,Johor,0,0,0
1/11/2021,Norway,Kedah,0,0,0
1/11/2021,Norway,Kelantan,0,0,0
1/11/2021,Norway,Melaka,0,0,0
1/11/2021,Norway,Pahang,0,0,0
1/11/2021,Norway,Perak,0,0,0
1/11/2021,Norway,Perlis,0,0,0
1/11/2021,Norway,Pulau Pinang,0,0,0
1/11/2021,Norway,Sabah,0,0,0
1/11/2021,Norway,Sarawak,0,0,0
1/11/2021,Norway,Selangor,28,24,4
1/11/2021,Norway,W.P. Labuan,0,0,0
1/11/2021,Nepal,Johor,0,0,0
1/11/2021,Nepal,Kedah,0,0,0
1/11/2021,Nepal,Pahang,0,0,0
1/11/2021,Nepal,Perak,0,0,0
1/11/2021,Nepal,Perlis,0,0,0
1/11/2021,Nepal,Pulau Pinang,0,0,0
1/11/2021,Nepal,Sabah,0,0,0
1/11/2021,Nepal,Sarawak,0,0,0
1/11/2021,Nepal,Selangor,98,87,11
1/11/2021,Nepal,W.P. Labuan,0,0,0
1/11/2021,Nauru,Johor,0,0,0
1/11/2021,Nauru,Pulau Pinang,0,0,0
1/11/2021,Nauru,Selangor,0,0,0
1/11/2021,New Zealand,Johor,0,0,0
1/11/2021,New Zealand,Kedah,0,0,0
1/11/2021,New Zealand,Kelantan,0,0,0
1/11/2021,New Zealand,Melaka,0,0,0
1/11/2021,New Zealand,Negeri Sembilan,0,0,0
1/11/2021,New Zealand,Pahang,0,0,0
1/11/2021,New Zealand,Perak,0,0,0
1/11/2021,New Zealand,Perlis,0,0,0
1/11/2021,New Zealand,Pulau Pinang,0,0,0
1/11/2021,New Zealand,Sabah,1,1,0
1/11/2021,New Zealand,Sarawak,0,0,0
1/11/2021,New Zealand,Selangor,21,14,7
1/11/2021,New Zealand,Terengganu,0,0,0
1/11/2021,New Zealand,W.P. Labuan,0,0,0
1/11/2021,Oman,Johor,0,0,0
1/11/2021,Oman,Kedah,0,0,0
1/11/2021,Oman,Kelantan,0,0,0
1/11/2021,Oman,Melaka,0,0,0
1/11/2021,Oman,Perak,0,0,0
1/11/2021,Oman,Perlis,0,0,0
1/11/2021,Oman,Pulau Pinang,0,0,0
1/11/2021,Oman,Sabah,0,0,0
1/11/2021,Oman,Sarawak,0,0,0
1/11/2021,Oman,Selangor,16,11,5
1/11/2021,Pakistan,Johor,1,1,0
1/11/2021,Pakistan,Kedah,0,0,0
1/11/2021,Pakistan,Kelantan,0,0,0
1/11/2021,Pakistan,Melaka,0,0,0
1/11/2021,Pakistan,Negeri Sembilan,0,0,0
1/11/2021,Pakistan,Pahang,0,0,0
1/11/2021,Pakistan,Perak,0,0,0
1/11/2021,Pakistan,Perlis,0,0,0
1/11/2021,Pakistan,Pulau Pinang,1,1,0
1/11/2021,Pakistan,Sabah,1,1,0
1/11/2021,Pakistan,Sarawak,1,1,0
1/11/2021,Pakistan,Selangor,939,869,70
1/11/2021,Pakistan,W.P. Labuan,0,0,0
1/11/2021,Panama,Johor,0,0,0
1/11/2021,Panama,Kedah,0,0,0
1/11/2021,Panama,Perak,0,0,0
1/11/2021,Panama,Perlis,0,0,0
1/11/2021,Panama,Pulau Pinang,0,0,0
1/11/2021,Panama,Sabah,0,0,0
1/11/2021,Panama,Sarawak,0,0,0
1/11/2021,Panama,Selangor,1,1,0
1/11/2021,Peru,Johor,0,0,0
1/11/2021,Peru,Kedah,0,0,0
1/11/2021,Peru,Kelantan,0,0,0
1/11/2021,Peru,Pahang,0,0,0
1/11/2021,Peru,Perak,0,0,0
1/11/2021,Peru,Perlis,0,0,0
1/11/2021,Peru,Pulau Pinang,0,0,0
1/11/2021,Peru,Sabah,0,0,0
1/11/2021,Peru,Sarawak,0,0,0
1/11/2021,Peru,Selangor,3,3,0
1/11/2021,Peru,W.P. Labuan,0,0,0
1/11/2021,Philippines,Johor,23,21,2
1/11/2021,Philippines,Kedah,0,0,0
1/11/2021,Philippines,Kelantan,0,0,0
1/11/2021,Philippines,Melaka,0,0,0
1/11/2021,Philippines,Negeri Sembilan,0,0,0
1/11/2021,Philippines,Pahang,0,0,0
1/11/2021,Philippines,Perak,0,0,0
1/11/2021,Philippines,Perlis,0,0,0
1/11/2021,Philippines,Pulau Pinang,5,4,1
1/11/2021,Philippines,Sabah,3,1,2
1/11/2021,Philippines,Sarawak,45,42,3
1/11/2021,Philippines,Selangor,626,502,124
1/11/2021,Philippines,Terengganu,0,0,0
1/11/2021,Philippines,W.P. Labuan,2,2,0
1/11/2021,Palau,Johor,0,0,0
1/11/2021,Palau,Pulau Pinang,0,0,0
1/11/2021,Palau,Selangor,0,0,0
1/11/2021,Papua New Guinea,Johor,0,0,0
1/11/2021,Papua New Guinea,Kedah,0,0,0
1/11/2021,Papua New Guinea,Kelantan,0,0,0
1/11/2021,Papua New Guinea,Perak,0,0,0
1/11/2021,Papua New Guinea,Pulau Pinang,0,0,0
1/11/2021,Papua New Guinea,Sabah,0,0,0
1/11/2021,Papua New Guinea,Sarawak,1,0,1
1/11/2021,Papua New Guinea,Selangor,1,0,1
1/11/2021,Poland,Johor,2,2,0
1/11/2021,Poland,Kedah,0,0,0
1/11/2021,Poland,Kelantan,0,0,0
1/11/2021,Poland,Melaka,0,0,0
1/11/2021,Poland,Negeri Sembilan,0,0,0
1/11/2021,Poland,Pahang,0,0,0
1/11/2021,Poland,Perak,0,0,0
1/11/2021,Poland,Perlis,0,0,0
1/11/2021,Poland,Pulau Pinang,0,0,0
1/11/2021,Poland,Sabah,0,0,0
1/11/2021,Poland,Sarawak,1,1,0
1/11/2021,Poland,Selangor,33,32,1
1/11/2021,Poland,Terengganu,0,0,0
1/11/2021,Poland,W.P. Labuan,0,0,0
1/11/2021,"North Korea, Democratic People's Republic of",Selangor,0,0,0
1/11/2021,Portugal,Johor,0,0,0
1/11/2021,Portugal,Kedah,0,0,0
1/11/2021,Portugal,Kelantan,0,0,0
1/11/2021,Portugal,Melaka,0,0,0
1/11/2021,Portugal,Pahang,0,0,0
1/11/2021,Portugal,Perak,0,0,0
1/11/2021,Portugal,Perlis,0,0,0
1/11/2021,Portugal,Pulau Pinang,1,0,1
1/11/2021,Portugal,Sabah,0,0,0
1/11/2021,Portugal,Sarawak,0,0,0
1/11/2021,Portugal,Selangor,15,12,3
1/11/2021,Portugal,W.P. Labuan,0,0,0
1/11/2021,Paraguay,Johor,0,0,0
1/11/2021,Paraguay,Kedah,0,0,0
1/11/2021,Paraguay,Perak,0,0,0
1/11/2021,Paraguay,Perlis,0,0,0
1/11/2021,Paraguay,Pulau Pinang,0,0,0
1/11/2021,Paraguay,Sabah,0,0,0
1/11/2021,Paraguay,Sarawak,0,0,0
1/11/2021,Paraguay,Selangor,0,0,0
1/11/2021,"Palestine, State of",Johor,0,0,0
1/11/2021,"Palestine, State of",Kedah,0,0,0
1/11/2021,"Palestine, State of",Kelantan,0,0,0
1/11/2021,"Palestine, State of",Melaka,0,0,0
1/11/2021,"Palestine, State of",Perak,0,0,0
1/11/2021,"Palestine, State of",Perlis,0,0,0
1/11/2021,"Palestine, State of",Pulau Pinang,0,0,0
1/11/2021,"Palestine, State of",Sabah,0,0,0
1/11/2021,"Palestine, State of",Sarawak,0,0,0
1/11/2021,"Palestine, State of",Selangor,34,24,10
1/11/2021,Qatar,Johor,0,0,0
1/11/2021,Qatar,Kedah,0,0,0
1/11/2021,Qatar,Perlis,0,0,0
1/11/2021,Qatar,Pulau Pinang,0,0,0
1/11/2021,Qatar,Sabah,0,0,0
1/11/2021,Qatar,Sarawak,0,0,0
1/11/2021,Qatar,Selangor,1,1,0
1/11/2021,Réunion,Johor,0,0,0
1/11/2021,Réunion,Sarawak,0,0,0
1/11/2021,Romania,Johor,1,1,0
1/11/2021,Romania,Kedah,0,0,0
1/11/2021,Romania,Kelantan,0,0,0
1/11/2021,Romania,Negeri Sembilan,0,0,0
1/11/2021,Romania,Pahang,0,0,0
1/11/2021,Romania,Perak,0,0,0
1/11/2021,Romania,Perlis,0,0,0
1/11/2021,Romania,Pulau Pinang,0,0,0
1/11/2021,Romania,Sabah,0,0,0
1/11/2021,Romania,Sarawak,1,1,0
1/11/2021,Romania,Selangor,21,18,3
1/11/2021,Romania,W.P. Labuan,0,0,0
1/11/2021,Russian Federation (Russia),Johor,1,1,0
1/11/2021,Russian Federation (Russia),Kedah,0,0,0
1/11/2021,Russian Federation (Russia),Kelantan,0,0,0
1/11/2021,Russian Federation (Russia),Melaka,0,0,0
1/11/2021,Russian Federation (Russia),Negeri Sembilan,0,0,0
1/11/2021,Russian Federation (Russia),Pahang,0,0,0
1/11/2021,Russian Federation (Russia),Perak,0,0,0
1/11/2021,Russian Federation (Russia),Perlis,0,0,0
1/11/2021,Russian Federation (Russia),Pulau Pinang,0,0,0
1/11/2021,Russian Federation (Russia),Sabah,0,0,0
1/11/2021,Russian Federation (Russia),Sarawak,0,0,0
1/11/2021,Russian Federation (Russia),Selangor,72,47,25
1/11/2021,Russian Federation (Russia),W.P. Labuan,0,0,0
1/11/2021,Rwanda,Johor,0,0,0
1/11/2021,Rwanda,Kedah,0,0,0
1/11/2021,Rwanda,Pulau Pinang,0,0,0
1/11/2021,Rwanda,Selangor,2,0,2
1/11/2021,Saudi Arabia,Johor,0,0,0
1/11/2021,Saudi Arabia,Kedah,0,0,0
1/11/2021,Saudi Arabia,Kelantan,0,0,0
1/11/2021,Saudi Arabia,Melaka,0,0,0
1/11/2021,Saudi Arabia,Perak,0,0,0
1/11/2021,Saudi Arabia,Perlis,0,0,0
1/11/2021,Saudi Arabia,Pulau Pinang,0,0,0
1/11/2021,Saudi Arabia,Sabah,0,0,0
1/11/2021,Saudi Arabia,Sarawak,0,0,0
1/11/2021,Saudi Arabia,Selangor,137,82,55
1/11/2021,Saudi Arabia,W.P. Labuan,0,0,0
1/11/2021,Sudan,Johor,0,0,0
1/11/2021,Sudan,Kedah,0,0,0
1/11/2021,Sudan,Kelantan,0,0,0
1/11/2021,Sudan,Perlis,0,0,0
1/11/2021,Sudan,Pulau Pinang,0,0,0
1/11/2021,Sudan,Sabah,0,0,0
1/11/2021,Sudan,Sarawak,0,0,0
1/11/2021,Sudan,Selangor,103,77,26
1/11/2021,Sudan,W.P. Labuan,0,0,0
1/11/2021,Senegal,Johor,0,0,0
1/11/2021,Senegal,Kedah,0,0,0
1/11/2021,Senegal,Kelantan,0,0,0
1/11/2021,Senegal,Perak,0,0,0
1/11/2021,Senegal,Perlis,0,0,0
1/11/2021,Senegal,Pulau Pinang,0,0,0
1/11/2021,Senegal,Sabah,0,0,0
1/11/2021,Senegal,Sarawak,0,0,0
1/11/2021,Senegal,Selangor,3,0,3
1/11/2021,Singapore,Johor,257,174,83
1/11/2021,Singapore,Kedah,2,2,0
1/11/2021,Singapore,Kelantan,0,0,0
1/11/2021,Singapore,Melaka,0,0,0
1/11/2021,Singapore,Negeri Sembilan,0,0,0
1/11/2021,Singapore,Pahang,0,0,0
1/11/2021,Singapore,Perak,3,1,2
1/11/2021,Singapore,Perlis,0,0,0
1/11/2021,Singapore,Pulau Pinang,28,18,10
1/11/2021,Singapore,Sabah,3,1,2
1/11/2021,Singapore,Sarawak,17,7,10
1/11/2021,Singapore,Selangor,726,437,289
1/11/2021,Singapore,Terengganu,0,0,0
1/11/2021,Singapore,W.P. Labuan,0,0,0
1/11/2021,South Georgia and the South Sandwich Islands,Johor,0,0,0
1/11/2021,South Georgia and the South Sandwich Islands,Sabah,0,0,0
1/11/2021,South Georgia and the South Sandwich Islands,Selangor,0,0,0
1/11/2021,Saint Helena,Sarawak,0,0,0
1/11/2021,Solomon Islands,Johor,0,0,0
1/11/2021,Solomon Islands,Perlis,0,0,0
1/11/2021,Solomon Islands,Pulau Pinang,0,0,0
1/11/2021,Solomon Islands,Sabah,0,0,0
1/11/2021,Solomon Islands,Sarawak,0,0,0
1/11/2021,Solomon Islands,Selangor,0,0,0
1/11/2021,Solomon Islands,W.P. Labuan,0,0,0
1/11/2021,Sierra Leone,Johor,0,0,0
1/11/2021,Sierra Leone,Kedah,0,0,0
1/11/2021,Sierra Leone,Perak,0,0,0
1/11/2021,Sierra Leone,Pulau Pinang,0,0,0
1/11/2021,Sierra Leone,Sabah,0,0,0
1/11/2021,Sierra Leone,Selangor,3,2,1
1/11/2021,El Salvador,Johor,0,0,0
1/11/2021,El Salvador,Kedah,0,0,0
1/11/2021,El Salvador,Perak,0,0,0
1/11/2021,El Salvador,Perlis,0,0,0
1/11/2021,El Salvador,Pulau Pinang,0,0,0
1/11/2021,El Salvador,Sabah,0,0,0
1/11/2021,El Salvador,Selangor,0,0,0
1/11/2021,El Salvador,W.P. Labuan,0,0,0
1/11/2021,San Marino,Johor,0,0,0
1/11/2021,San Marino,Selangor,0,0,0
1/11/2021,Somalia,Johor,0,0,0
1/11/2021,Somalia,Kedah,0,0,0
1/11/2021,Somalia,Kelantan,0,0,0
1/11/2021,Somalia,Perlis,0,0,0
1/11/2021,Somalia,Sabah,0,0,0
1/11/2021,Somalia,Sarawak,0,0,0
1/11/2021,Somalia,Selangor,43,33,10
1/11/2021,Serbia,Johor,0,0,0
1/11/2021,Serbia,Kedah,0,0,0
1/11/2021,Serbia,Kelantan,0,0,0
1/11/2021,Serbia,Pahang,0,0,0
1/11/2021,Serbia,Perak,0,0,0
1/11/2021,Serbia,Perlis,0,0,0
1/11/2021,Serbia,Pulau Pinang,0,0,0
1/11/2021,Serbia,Sabah,0,0,0
1/11/2021,Serbia,Sarawak,0,0,0
1/11/2021,Serbia,Selangor,6,4,2
1/11/2021,South Sudan,Johor,0,0,0
1/11/2021,South Sudan,Kedah,0,0,0
1/11/2021,South Sudan,Sarawak,0,0,0
1/11/2021,South Sudan,Selangor,1,1,0
1/11/2021,South Sudan,W.P. Labuan,0,0,0
1/11/2021,Sao Tome and Principe,Selangor,0,0,0
1/11/2021,Suriname,Johor,0,0,0
1/11/2021,Suriname,Kedah,0,0,0
1/11/2021,Suriname,Kelantan,0,0,0
1/11/2021,Suriname,Perak,0,0,0
1/11/2021,Suriname,Perlis,0,0,0
1/11/2021,Suriname,Pulau Pinang,0,0,0
1/11/2021,Suriname,Sabah,0,0,0
1/11/2021,Suriname,Sarawak,0,0,0
1/11/2021,Suriname,Selangor,0,0,0
1/11/2021,Slovakia,Johor,0,0,0
1/11/2021,Slovakia,Kedah,0,0,0
1/11/2021,Slovakia,Kelantan,0,0,0
1/11/2021,Slovakia,Negeri Sembilan,0,0,0
1/11/2021,Slovakia,Pahang,0,0,0
1/11/2021,Slovakia,Perak,0,0,0
1/11/2021,Slovakia,Perlis,0,0,0
1/11/2021,Slovakia,Pulau Pinang,0,0,0
1/11/2021,Slovakia,Sabah,0,0,0
1/11/2021,Slovakia,Sarawak,0,0,0
1/11/2021,Slovakia,Selangor,20,18,2
1/11/2021,Slovakia,W.P. Labuan,0,0,0
1/11/2021,Slovenia,Johor,0,0,0
1/11/2021,Slovenia,Kedah,0,0,0
1/11/2021,Slovenia,Kelantan,0,0,0
1/11/2021,Slovenia,Perak,0,0,0
1/11/2021,Slovenia,Perlis,0,0,0
1/11/2021,Slovenia,Pulau Pinang,0,0,0
1/11/2021,Slovenia,Sabah,0,0,0
1/11/2021,Slovenia,Sarawak,0,0,0
1/11/2021,Slovenia,Selangor,2,1,1
1/11/2021,Slovenia,W.P. Labuan,0,0,0
1/11/2021,Sweden,Johor,0,0,0
1/11/2021,Sweden,Kedah,0,0,0
1/11/2021,Sweden,Kelantan,0,0,0
1/11/2021,Sweden,Melaka,0,0,0
1/11/2021,Sweden,Negeri Sembilan,0,0,0
1/11/2021,Sweden,Pahang,0,0,0
1/11/2021,Sweden,Perak,0,0,0
1/11/2021,Sweden,Perlis,0,0,0
1/11/2021,Sweden,Pulau Pinang,2,2,0
1/11/2021,Sweden,Sabah,0,0,0
1/11/2021,Sweden,Sarawak,0,0,0
1/11/2021,Sweden,Selangor,27,26,1
1/11/2021,Sweden,W.P. Labuan,0,0,0
1/11/2021,Eswatini,Johor,0,0,0
1/11/2021,Eswatini,Kedah,0,0,0
1/11/2021,Eswatini,Pulau Pinang,0,0,0
1/11/2021,Eswatini,Sabah,0,0,0
1/11/2021,Eswatini,Selangor,0,0,0
1/11/2021,Seychelles,Johor,0,0,0
1/11/2021,Seychelles,Kedah,0,0,0
1/11/2021,Seychelles,Pulau Pinang,0,0,0
1/11/2021,Seychelles,Sabah,0,0,0
1/11/2021,Seychelles,Sarawak,0,0,0
1/11/2021,Seychelles,Selangor,15,8,7
1/11/2021,Syrian Arab Republic,Johor,0,0,0
1/11/2021,Syrian Arab Republic,Kedah,0,0,0
1/11/2021,Syrian Arab Republic,Kelantan,0,0,0
1/11/2021,Syrian Arab Republic,Pahang,0,0,0
1/11/2021,Syrian Arab Republic,Perlis,0,0,0
1/11/2021,Syrian Arab Republic,Pulau Pinang,0,0,0
1/11/2021,Syrian Arab Republic,Sabah,0,0,0
1/11/2021,Syrian Arab Republic,Sarawak,1,1,0
1/11/2021,Syrian Arab Republic,Selangor,46,34,12
1/11/2021,Syrian Arab Republic,W.P. Labuan,0,0,0
1/11/2021,Turks and Caicos Islands,Perlis,0,0,0
1/11/2021,TCD,Johor,0,0,0
1/11/2021,TCD,Kedah,0,0,0
1/11/2021,TCD,Perlis,0,0,0
1/11/2021,TCD,Selangor,2,2,0
1/11/2021,Togo,Johor,0,0,0
1/11/2021,Togo,Perak,0,0,0
1/11/2021,Togo,Pulau Pinang,0,0,0
1/11/2021,Togo,Selangor,3,3,0
1/11/2021,Thailand,Johor,34,33,1
1/11/2021,Thailand,Kedah,18311,18250,61
1/11/2021,Thailand,Kelantan,4,0,4
1/11/2021,Thailand,Melaka,0,0,0
1/11/2021,Thailand,Negeri Sembilan,0,0,0
1/11/2021,Thailand,Pahang,0,0,0
1/11/2021,Thailand,Perak,0,0,0
1/11/2021,Thailand,Perlis,7400,7287,113
1/11/2021,Thailand,Pulau Pinang,20,13,7
1/11/2021,Thailand,Sabah,0,0,0
1/11/2021,Thailand,Sarawak,9,8,1
1/11/2021,Thailand,Selangor,173,80,93
1/11/2021,Thailand,Terengganu,0,0,0
1/11/2021,Thailand,W.P. Labuan,0,0,0
1/11/2021,Tajikistan,Johor,0,0,0
1/11/2021,Tajikistan,Kedah,0,0,0
1/11/2021,Tajikistan,Perlis,0,0,0
1/11/2021,Tajikistan,Pulau Pinang,0,0,0
1/11/2021,Tajikistan,Sabah,0,0,0
1/11/2021,Tajikistan,Selangor,5,3,2
1/11/2021,Tokelau,Selangor,0,0,0
1/11/2021,Turkmenistan,Johor,0,0,0
1/11/2021,Turkmenistan,Kedah,0,0,0
1/11/2021,Turkmenistan,Kelantan,0,0,0
1/11/2021,Turkmenistan,Perlis,0,0,0
1/11/2021,Turkmenistan,Pulau Pinang,0,0,0
1/11/2021,Turkmenistan,Sabah,0,0,0
1/11/2021,Turkmenistan,Sarawak,0,0,0
1/11/2021,Turkmenistan,Selangor,7,3,4
1/11/2021,Timor-Leste,Johor,0,0,0
1/11/2021,Timor-Leste,Kedah,0,0,0
1/11/2021,Timor-Leste,Perlis,0,0,0
1/11/2021,Timor-Leste,Pulau Pinang,0,0,0
1/11/2021,Timor-Leste,Sabah,0,0,0
1/11/2021,Timor-Leste,Sarawak,0,0,0
1/11/2021,Timor-Leste,Selangor,3,1,2
1/11/2021,Tonga,Johor,0,0,0
1/11/2021,Tonga,Pulau Pinang,0,0,0
1/11/2021,Tonga,Sarawak,0,0,0
1/11/2021,Tonga,Selangor,0,0,0
1/11/2021,Trinidad and Tobago,Johor,0,0,0
1/11/2021,Trinidad and Tobago,Kedah,0,0,0
1/11/2021,Trinidad and Tobago,Pahang,0,0,0
1/11/2021,Trinidad and Tobago,Pulau Pinang,0,0,0
1/11/2021,Trinidad and Tobago,Sabah,0,0,0
1/11/2021,Trinidad and Tobago,Sarawak,0,0,0
1/11/2021,Trinidad and Tobago,Selangor,3,2,1
1/11/2021,Tunisia,Johor,0,0,0
1/11/2021,Tunisia,Kedah,0,0,0
1/11/2021,Tunisia,Kelantan,0,0,0
1/11/2021,Tunisia,Melaka,0,0,0
1/11/2021,Tunisia,Perak,0,0,0
1/11/2021,Tunisia,Perlis,0,0,0
1/11/2021,Tunisia,Pulau Pinang,0,0,0
1/11/2021,Tunisia,Sabah,0,0,0
1/11/2021,Tunisia,Sarawak,0,0,0
1/11/2021,Tunisia,Selangor,12,6,6
1/11/2021,Tunisia,W.P. Labuan,0,0,0
1/11/2021,Türkiye,Johor,0,0,0
1/11/2021,Türkiye,Kedah,0,0,0
1/11/2021,Türkiye,Kelantan,0,0,0
1/11/2021,Türkiye,Melaka,0,0,0
1/11/2021,Türkiye,Negeri Sembilan,0,0,0
1/11/2021,Türkiye,Pahang,0,0,0
1/11/2021,Türkiye,Perak,0,0,0
1/11/2021,Türkiye,Perlis,0,0,0
1/11/2021,Türkiye,Pulau Pinang,0,0,0
1/11/2021,Türkiye,Sabah,0,0,0
1/11/2021,Türkiye,Sarawak,1,1,0
1/11/2021,Türkiye,Selangor,53,41,12
1/11/2021,Türkiye,W.P. Labuan,0,0,0
1/11/2021,Tuvalu,Selangor,0,0,0
1/11/2021,"Taiwan, Province of China",Johor,2,0,2
1/11/2021,"Taiwan, Province of China",Kedah,0,0,0
1/11/2021,"Taiwan, Province of China",Kelantan,0,0,0
1/11/2021,"Taiwan, Province of China",Melaka,0,0,0
1/11/2021,"Taiwan, Province of China",Negeri Sembilan,0,0,0
1/11/2021,"Taiwan, Province of China",Pahang,0,0,0
1/11/2021,"Taiwan, Province of China",Perak,0,0,0
1/11/2021,"Taiwan, Province of China",Perlis,0,0,0
1/11/2021,"Taiwan, Province of China",Pulau Pinang,25,17,8
1/11/2021,"Taiwan, Province of China",Sabah,0,0,0
1/11/2021,"Taiwan, Province of China",Sarawak,2,1,1
1/11/2021,"Taiwan, Province of China",Selangor,94,56,38
1/11/2021,"Taiwan, Province of China",W.P. Labuan,0,0,0
1/11/2021,"Tanzania, United Republic of",Johor,0,0,0
1/11/2021,"Tanzania, United Republic of",Kedah,0,0,0
1/11/2021,"Tanzania, United Republic of",Perak,0,0,0
1/11/2021,"Tanzania, United Republic of",Perlis,0,0,0
1/11/2021,"Tanzania, United Republic of",Pulau Pinang,0,0,0
1/11/2021,"Tanzania, United Republic of",Sabah,0,0,0
1/11/2021,"Tanzania, United Republic of",Sarawak,0,0,0
1/11/2021,"Tanzania, United Republic of",Selangor,26,20,6
1/11/2021,Uganda,Johor,0,0,0
1/11/2021,Uganda,Kedah,0,0,0
1/11/2021,Uganda,Perak,0,0,0
1/11/2021,Uganda,Perlis,0,0,0
1/11/2021,Uganda,Pulau Pinang,0,0,0
1/11/2021,Uganda,Sabah,0,0,0
1/11/2021,Uganda,Sarawak,0,0,0
1/11/2021,Uganda,Selangor,3,3,0
1/11/2021,Ukraine,Johor,4,3,1
1/11/2021,Ukraine,Kedah,0,0,0
1/11/2021,Ukraine,Kelantan,0,0,0
1/11/2021,Ukraine,Melaka,3,3,0
1/11/2021,Ukraine,Negeri Sembilan,0,0,0
1/11/2021,Ukraine,Pahang,0,0,0
1/11/2021,Ukraine,Perak,0,0,0
1/11/2021,Ukraine,Perlis,0,0,0
1/11/2021,Ukraine,Pulau Pinang,0,0,0
1/11/2021,Ukraine,Sabah,0,0,0
1/11/2021,Ukraine,Sarawak,0,0,0
1/11/2021,Ukraine,Selangor,40,33,7
1/11/2021,Ukraine,W.P. Labuan,0,0,0
1/11/2021,Uruguay,Johor,0,0,0
1/11/2021,Uruguay,Kedah,0,0,0
1/11/2021,Uruguay,Kelantan,0,0,0
1/11/2021,Uruguay,Perak,0,0,0
1/11/2021,Uruguay,Perlis,0,0,0
1/11/2021,Uruguay,Pulau Pinang,0,0,0
1/11/2021,Uruguay,Sabah,0,0,0
1/11/2021,Uruguay,Sarawak,0,0,0
1/11/2021,Uruguay,Selangor,0,0,0
1/11/2021,Uruguay,W.P. Labuan,0,0,0
1/11/2021,United States of America,Johor,3,1,2
1/11/2021,United States of America,Kedah,0,0,0
1/11/2021,United States of America,Kelantan,0,0,0
1/11/2021,United States of America,Melaka,0,0,0
1/11/2021,United States of America,Negeri Sembilan,0,0,0
1/11/2021,United States of America,Pahang,0,0,0
1/11/2021,United States of America,Perak,1,1,0
1/11/2021,United States of America,Perlis,0,0,0
1/11/2021,United States of America,Pulau Pinang,55,46,9
1/11/2021,United States of America,Sabah,0,0,0
1/11/2021,United States of America,Sarawak,2,1,1
1/11/2021,United States of America,Selangor,274,180,94
1/11/2021,United States of America,Terengganu,0,0,0
1/11/2021,United States of America,W.P. Labuan,0,0,0
1/11/2021,Uzbekistan,Johor,0,0,0
1/11/2021,Uzbekistan,Kedah,0,0,0
1/11/2021,Uzbekistan,Kelantan,0,0,0
1/11/2021,Uzbekistan,Perak,0,0,0
1/11/2021,Uzbekistan,Perlis,0,0,0
1/11/2021,Uzbekistan,Pulau Pinang,0,0,0
1/11/2021,Uzbekistan,Sabah,0,0,0
1/11/2021,Uzbekistan,Sarawak,0,0,0
1/11/2021,Uzbekistan,Selangor,17,11,6
1/11/2021,Holy See,Johor,0,0,0
1/11/2021,Holy See,Sarawak,0,0,0
1/11/2021,Holy See,Selangor,0,0,0
1/11/2021,Saint Vincent and the Grenadines,Johor,0,0,0
1/11/2021,Saint Vincent and the Grenadines,Kedah,0,0,0
1/11/2021,Saint Vincent and the Grenadines,Pulau Pinang,0,0,0
1/11/2021,Saint Vincent and the Grenadines,Sarawak,0,0,0
1/11/2021,Saint Vincent and the Grenadines,Selangor,0,0,0
1/11/2021,"Venezuela, Bolivarian Republic of",Johor,0,0,0
1/11/2021,"Venezuela, Bolivarian Republic of",Kedah,0,0,0
1/11/2021,"Venezuela, Bolivarian Republic of",Kelantan,0,0,0
1/11/2021,"Venezuela, Bolivarian Republic of",Melaka,0,0,0
1/11/2021,"Venezuela, Bolivarian Republic of",Perak,0,0,0
1/11/2021,"Venezuela, Bolivarian Republic of",Perlis,0,0,0
1/11/2021,"Venezuela, Bolivarian Republic of",Pulau Pinang,0,0,0
1/11/2021,"Venezuela, Bolivarian Republic of",Sabah,0,0,0
1/11/2021,"Venezuela, Bolivarian Republic of",Sarawak,0,0,0
1/11/2021,"Venezuela, Bolivarian Republic of",Selangor,3,2,1
1/11/2021,"Venezuela, Bolivarian Republic of",W.P. Labuan,0,0,0
1/11/2021,Viet Nam,Johor,5,4,1
1/11/2021,Viet Nam,Kedah,0,0,0
1/11/2021,Viet Nam,Kelantan,0,0,0
1/11/2021,Viet Nam,Melaka,0,0,0
1/11/2021,Viet Nam,Negeri Sembilan,0,0,0
1/11/2021,Viet Nam,Pahang,0,0,0
1/11/2021,Viet Nam,Perak,0,0,0
1/11/2021,Viet Nam,Perlis,0,0,0
1/11/2021,Viet Nam,Pulau Pinang,3,1,2
1/11/2021,Viet Nam,Sabah,0,0,0
1/11/2021,Viet Nam,Sarawak,0,0,0
1/11/2021,Viet Nam,Selangor,126,46,80
1/11/2021,Viet Nam,Terengganu,0,0,0
1/11/2021,Viet Nam,W.P. Labuan,0,0,0
1/11/2021,Vanuatu,Johor,0,0,0
1/11/2021,Vanuatu,Kedah,0,0,0
1/11/2021,Vanuatu,Pulau Pinang,0,0,0
1/11/2021,Vanuatu,Sabah,0,0,0
1/11/2021,Vanuatu,Sarawak,0,0,0
1/11/2021,Vanuatu,Selangor,0,0,0
1/11/2021, Samoa,Johor,0,0,0
1/11/2021, Samoa,Sarawak,0,0,0
1/11/2021, Samoa,Selangor,0,0,0
1/11/2021,Yemen,Johor,0,0,0
1/11/2021,Yemen,Kedah,0,0,0
1/11/2021,Yemen,Kelantan,0,0,0
1/11/2021,Yemen,Melaka,0,0,0
1/11/2021,Yemen,Pahang,0,0,0
1/11/2021,Yemen,Perak,0,0,0
1/11/2021,Yemen,Perlis,0,0,0
1/11/2021,Yemen,Pulau Pinang,0,0,0
1/11/2021,Yemen,Sabah,0,0,0
1/11/2021,Yemen,Sarawak,0,0,0
1/11/2021,Yemen,Selangor,190,150,40
1/11/2021,Yemen,W.P. Labuan,0,0,0
1/11/2021,South Africa,Johor,0,0,0
1/11/2021,South Africa,Kedah,0,0,0
1/11/2021,South Africa,Kelantan,0,0,0
1/11/2021,South Africa,Melaka,0,0,0
1/11/2021,South Africa,Pahang,0,0,0
1/11/2021,South Africa,Perak,0,0,0
1/11/2021,South Africa,Perlis,0,0,0
1/11/2021,South Africa,Pulau Pinang,3,1,2
1/11/2021,South Africa,Sabah,1,1,0
1/11/2021,South Africa,Sarawak,0,0,0
1/11/2021,South Africa,Selangor,40,30,10
1/11/2021,South Africa,Terengganu,0,0,0
1/11/2021,South Africa,W.P. Labuan,0,0,0
1/11/2021,ZAR,Selangor,0,0,0
1/11/2021,Zambia,Johor,0,0,0
1/11/2021,Zambia,Kedah,0,0,0
1/11/2021,Zambia,Perak,0,0,0
1/11/2021,Zambia,Perlis,0,0,0
1/11/2021,Zambia,Pulau Pinang,0,0,0
1/11/2021,Zambia,Sabah,0,0,0
1/11/2021,Zambia,Sarawak,0,0,0
1/11/2021,Zambia,Selangor,6,3,3
1/11/2021,Zimbabwe,Johor,0,0,0
1/11/2021,Zimbabwe,Kedah,0,0,0
1/11/2021,Zimbabwe,Kelantan,0,0,0
1/11/2021,Zimbabwe,Perak,0,0,0
1/11/2021,Zimbabwe,Perlis,0,0,0
1/11/2021,Zimbabwe,Pulau Pinang,0,0,0
1/11/2021,Zimbabwe,Sabah,0,0,0
1/11/2021,Zimbabwe,Sarawak,0,0,0
1/11/2021,Zimbabwe,Selangor,13,6,7
1/12/2021,Aruba,Kedah,0,0,0
1/12/2021,Aruba,Pulau Pinang,0,0,0
1/12/2021,Afghanistan,Johor,0,0,0
1/12/2021,Afghanistan,Kedah,0,0,0
1/12/2021,Afghanistan,Perlis,0,0,0
1/12/2021,Afghanistan,Pulau Pinang,0,0,0
1/12/2021,Afghanistan,Sarawak,0,0,0
1/12/2021,Afghanistan,Selangor,68,44,24
1/12/2021,Angola,Johor,0,0,0
1/12/2021,Angola,Kedah,0,0,0
1/12/2021,Angola,Sabah,0,0,0
1/12/2021,Angola,Selangor,0,0,0
1/12/2021,Anguilla,Selangor,0,0,0
1/12/2021,Albania,Johor,0,0,0
1/12/2021,Albania,Kedah,0,0,0
1/12/2021,Albania,Perak,0,0,0
1/12/2021,Albania,Perlis,0,0,0
1/12/2021,Albania,Pulau Pinang,0,0,0
1/12/2021,Albania,Sabah,0,0,0
1/12/2021,Albania,Sarawak,0,0,0
1/12/2021,Albania,Selangor,5,4,1
1/12/2021,Andorra,Johor,0,0,0
1/12/2021,Andorra,Kedah,0,0,0
1/12/2021,Andorra,Perlis,0,0,0
1/12/2021,Andorra,Pulau Pinang,0,0,0
1/12/2021,Andorra,Selangor,0,0,0
1/12/2021,Antigua and Barbuda,Selangor,0,0,0
1/12/2021,United Arab Emirates,Johor,0,0,0
1/12/2021,United Arab Emirates,Kedah,0,0,0
1/12/2021,United Arab Emirates,Kelantan,0,0,0
1/12/2021,United Arab Emirates,Perak,0,0,0
1/12/2021,United Arab Emirates,Perlis,0,0,0
1/12/2021,United Arab Emirates,Pulau Pinang,0,0,0
1/12/2021,United Arab Emirates,Sabah,0,0,0
1/12/2021,United Arab Emirates,Sarawak,0,0,0
1/12/2021,United Arab Emirates,Selangor,21,15,6
1/12/2021,Argentina,Johor,0,0,0
1/12/2021,Argentina,Kedah,0,0,0
1/12/2021,Argentina,Kelantan,0,0,0
1/12/2021,Argentina,Melaka,0,0,0
1/12/2021,Argentina,Perak,0,0,0
1/12/2021,Argentina,Perlis,0,0,0
1/12/2021,Argentina,Pulau Pinang,0,0,0
1/12/2021,Argentina,Sabah,0,0,0
1/12/2021,Argentina,Sarawak,0,0,0
1/12/2021,Argentina,Selangor,11,5,6
1/12/2021,Argentina,W.P. Labuan,0,0,0
1/12/2021,Armenia,Johor,0,0,0
1/12/2021,Armenia,Kedah,0,0,0
1/12/2021,Armenia,Kelantan,0,0,0
1/12/2021,Armenia,Perak,0,0,0
1/12/2021,Armenia,Perlis,0,0,0
1/12/2021,Armenia,Pulau Pinang,0,0,0
1/12/2021,Armenia,Sabah,0,0,0
1/12/2021,Armenia,Sarawak,0,0,0
1/12/2021,Armenia,Selangor,1,0,1
1/12/2021,Antarctica,Selangor,0,0,0
1/12/2021,Antigua and Barbuda,Johor,0,0,0
1/12/2021,Antigua and Barbuda,Kedah,0,0,0
1/12/2021,Antigua and Barbuda,Pulau Pinang,0,0,0
1/12/2021,Antigua and Barbuda,Sarawak,0,0,0
1/12/2021,Antigua and Barbuda,Selangor,1,1,0
1/12/2021,Australia,Johor,2,1,1
1/12/2021,Australia,Kedah,20,12,8
1/12/2021,Australia,Kelantan,0,0,0
1/12/2021,Australia,Melaka,0,0,0
1/12/2021,Australia,Negeri Sembilan,0,0,0
1/12/2021,Australia,Pahang,0,0,0
1/12/2021,Australia,Perak,1,1,0
1/12/2021,Australia,Perlis,0,0,0
1/12/2021,Australia,Pulau Pinang,23,12,11
1/12/2021,Australia,Sabah,0,0,0
1/12/2021,Australia,Sarawak,2,2,0
1/12/2021,Australia,Selangor,580,378,202
1/12/2021,Australia,Terengganu,0,0,0
1/12/2021,Australia,W.P. Labuan,0,0,0
1/12/2021,Austria,Johor,0,0,0
1/12/2021,Austria,Kedah,0,0,0
1/12/2021,Austria,Kelantan,0,0,0
1/12/2021,Austria,Melaka,0,0,0
1/12/2021,Austria,Negeri Sembilan,0,0,0
1/12/2021,Austria,Pahang,0,0,0
1/12/2021,Austria,Perak,0,0,0
1/12/2021,Austria,Perlis,0,0,0
1/12/2021,Austria,Pulau Pinang,0,0,0
1/12/2021,Austria,Sabah,0,0,0
1/12/2021,Austria,Sarawak,0,0,0
1/12/2021,Austria,Selangor,21,15,6
1/12/2021,Austria,Terengganu,0,0,0
1/12/2021,Austria,W.P. Labuan,0,0,0
1/12/2021,Azerbaijan,Johor,0,0,0
1/12/2021,Azerbaijan,Kedah,0,0,0
1/12/2021,Azerbaijan,Kelantan,0,0,0
1/12/2021,Azerbaijan,Melaka,0,0,0
1/12/2021,Azerbaijan,Perlis,0,0,0
1/12/2021,Azerbaijan,Pulau Pinang,0,0,0
1/12/2021,Azerbaijan,Sabah,0,0,0
1/12/2021,Azerbaijan,Sarawak,0,0,0
1/12/2021,Azerbaijan,Selangor,1,1,0
1/12/2021,Azerbaijan,W.P. Labuan,0,0,0
1/12/2021,Burundi,Pulau Pinang,0,0,0
1/12/2021,Burundi,Sarawak,0,0,0
1/12/2021,Burundi,Selangor,0,0,0
1/12/2021,Belgium,Johor,0,0,0
1/12/2021,Belgium,Kedah,1,1,0
1/12/2021,Belgium,Kelantan,0,0,0
1/12/2021,Belgium,Melaka,0,0,0
1/12/2021,Belgium,Negeri Sembilan,0,0,0
1/12/2021,Belgium,Pahang,0,0,0
1/12/2021,Belgium,Perak,0,0,0
1/12/2021,Belgium,Perlis,0,0,0
1/12/2021,Belgium,Pulau Pinang,2,1,1
1/12/2021,Belgium,Sabah,0,0,0
1/12/2021,Belgium,Sarawak,1,1,0
1/12/2021,Belgium,Selangor,56,47,9
1/12/2021,Belgium,W.P. Labuan,0,0,0
1/12/2021,Benin,Johor,0,0,0
1/12/2021,Benin,Kedah,0,0,0
1/12/2021,Benin,Perak,0,0,0
1/12/2021,Benin,Pulau Pinang,0,0,0
1/12/2021,Benin,Sabah,0,0,0
1/12/2021,Benin,Sarawak,0,0,0
1/12/2021,Benin,Selangor,1,1,0
1/12/2021,Burkina Faso,Perak,0,0,0
1/12/2021,Burkina Faso,Pulau Pinang,0,0,0
1/12/2021,Burkina Faso,Selangor,0,0,0
1/12/2021,Bangladesh,Johor,3,3,0
1/12/2021,Bangladesh,Kedah,0,0,0
1/12/2021,Bangladesh,Kelantan,0,0,0
1/12/2021,Bangladesh,Melaka,0,0,0
1/12/2021,Bangladesh,Negeri Sembilan,0,0,0
1/12/2021,Bangladesh,Pahang,0,0,0
1/12/2021,Bangladesh,Perak,0,0,0
1/12/2021,Bangladesh,Perlis,0,0,0
1/12/2021,Bangladesh,Pulau Pinang,0,0,0
1/12/2021,Bangladesh,Sabah,0,0,0
1/12/2021,Bangladesh,Sarawak,0,0,0
1/12/2021,Bangladesh,Selangor,5749,5372,377
1/12/2021,Bangladesh,W.P. Labuan,0,0,0
1/12/2021,Bulgaria,Johor,0,0,0
1/12/2021,Bulgaria,Kedah,0,0,0
1/12/2021,Bulgaria,Kelantan,0,0,0
1/12/2021,Bulgaria,Pahang,0,0,0
1/12/2021,Bulgaria,Perak,0,0,0
1/12/2021,Bulgaria,Perlis,0,0,0
1/12/2021,Bulgaria,Pulau Pinang,0,0,0
1/12/2021,Bulgaria,Sabah,0,0,0
1/12/2021,Bulgaria,Sarawak,0,0,0
1/12/2021,Bulgaria,Selangor,6,5,1
1/12/2021,Bulgaria,W.P. Labuan,0,0,0
1/12/2021,Bahrain,Johor,0,0,0
1/12/2021,Bahrain,Kedah,0,0,0
1/12/2021,Bahrain,Kelantan,0,0,0
1/12/2021,Bahrain,Perlis,0,0,0
1/12/2021,Bahrain,Pulau Pinang,0,0,0
1/12/2021,Bahrain,Sabah,0,0,0
1/12/2021,Bahrain,Sarawak,0,0,0
1/12/2021,Bahrain,Selangor,5,4,1
1/12/2021,Bahamas,Johor,0,0,0
1/12/2021,Bahamas,Kedah,0,0,0
1/12/2021,Bahamas,Perak,0,0,0
1/12/2021,Bahamas,Sabah,0,0,0
1/12/2021,Bahamas,Sarawak,0,0,0
1/12/2021,Bahamas,Selangor,0,0,0
1/12/2021,Bosnia and Herzegovina,Johor,0,0,0
1/12/2021,Bosnia and Herzegovina,Kedah,0,0,0
1/12/2021,Bosnia and Herzegovina,Perlis,0,0,0
1/12/2021,Bosnia and Herzegovina,Pulau Pinang,0,0,0
1/12/2021,Bosnia and Herzegovina,Sabah,0,0,0
1/12/2021,Bosnia and Herzegovina,Sarawak,0,0,0
1/12/2021,Bosnia and Herzegovina,Selangor,10,5,5
1/12/2021,Belarus,Johor,0,0,0
1/12/2021,Belarus,Kedah,0,0,0
1/12/2021,Belarus,Kelantan,0,0,0
1/12/2021,Belarus,Pahang,0,0,0
1/12/2021,Belarus,Perak,0,0,0
1/12/2021,Belarus,Perlis,0,0,0
1/12/2021,Belarus,Pulau Pinang,0,0,0
1/12/2021,Belarus,Sabah,0,0,0
1/12/2021,Belarus,Sarawak,0,0,0
1/12/2021,Belarus,Selangor,2,2,0
1/12/2021,Belarus,W.P. Labuan,0,0,0
1/12/2021,Belize,Johor,0,0,0
1/12/2021,Belize,Pulau Pinang,0,0,0
1/12/2021,Belize,Sarawak,0,0,0
1/12/2021,Belize,Selangor,0,0,0
1/12/2021,Bermuda,Selangor,0,0,0
1/12/2021,Bolivia,Johor,0,0,0
1/12/2021,Bolivia,Kedah,0,0,0
1/12/2021,Bolivia,Melaka,0,0,0
1/12/2021,Bolivia,Perak,0,0,0
1/12/2021,Bolivia,Perlis,0,0,0
1/12/2021,Bolivia,Pulau Pinang,0,0,0
1/12/2021,Bolivia,Sabah,0,0,0
1/12/2021,Bolivia,Sarawak,0,0,0
1/12/2021,Bolivia,Selangor,0,0,0
1/12/2021,Brazil,Johor,0,0,0
1/12/2021,Brazil,Kedah,0,0,0
1/12/2021,Brazil,Kelantan,0,0,0
1/12/2021,Brazil,Melaka,0,0,0
1/12/2021,Brazil,Pahang,0,0,0
1/12/2021,Brazil,Perak,0,0,0
1/12/2021,Brazil,Perlis,0,0,0
1/12/2021,Brazil,Pulau Pinang,0,0,0
1/12/2021,Brazil,Sabah,0,0,0
1/12/2021,Brazil,Sarawak,3,2,1
1/12/2021,Brazil,Selangor,31,16,15
1/12/2021,Brazil,W.P. Labuan,0,0,0
1/12/2021,Barbados,Johor,0,0,0
1/12/2021,Barbados,Kedah,0,0,0
1/12/2021,Barbados,Perlis,0,0,0
1/12/2021,Barbados,Pulau Pinang,0,0,0
1/12/2021,Barbados,Selangor,1,1,0
1/12/2021,Brunei Darussalam,Johor,0,0,0
1/12/2021,Brunei Darussalam,Kedah,2,2,0
1/12/2021,Brunei Darussalam,Kelantan,0,0,0
1/12/2021,Brunei Darussalam,Melaka,0,0,0
1/12/2021,Brunei Darussalam,Pahang,0,0,0
1/12/2021,Brunei Darussalam,Perak,0,0,0
1/12/2021,Brunei Darussalam,Perlis,0,0,0
1/12/2021,Brunei Darussalam,Pulau Pinang,0,0,0
1/12/2021,Brunei Darussalam,Sabah,0,0,0
1/12/2021,Brunei Darussalam,Sarawak,303,291,12
1/12/2021,Brunei Darussalam,Selangor,97,55,42
1/12/2021,Brunei Darussalam,W.P. Labuan,1,1,0
1/12/2021,Bhutan,Johor,0,0,0
1/12/2021,Bhutan,Kedah,0,0,0
1/12/2021,Bhutan,Perak,0,0,0
1/12/2021,Bhutan,Perlis,0,0,0
1/12/2021,Bhutan,Pulau Pinang,0,0,0
1/12/2021,Bhutan,Sabah,0,0,0
1/12/2021,Bhutan,Sarawak,0,0,0
1/12/2021,Bhutan,Selangor,8,7,1
1/12/2021,Botswana,Johor,0,0,0
1/12/2021,Botswana,Kedah,0,0,0
1/12/2021,Botswana,Perlis,0,0,0
1/12/2021,Botswana,Pulau Pinang,0,0,0
1/12/2021,Botswana,Sabah,0,0,0
1/12/2021,Botswana,Sarawak,0,0,0
1/12/2021,Botswana,Selangor,0,0,0
1/12/2021,Central African Republic,Kedah,0,0,0
1/12/2021,Central African Republic,Selangor,0,0,0
1/12/2021,Canada,Johor,0,0,0
1/12/2021,Canada,Kedah,2,2,0
1/12/2021,Canada,Kelantan,0,0,0
1/12/2021,Canada,Melaka,0,0,0
1/12/2021,Canada,Negeri Sembilan,0,0,0
1/12/2021,Canada,Pahang,0,0,0
1/12/2021,Canada,Perak,0,0,0
1/12/2021,Canada,Perlis,0,0,0
1/12/2021,Canada,Pulau Pinang,1,0,1
1/12/2021,Canada,Sabah,0,0,0
1/12/2021,Canada,Sarawak,2,2,0
1/12/2021,Canada,Selangor,181,115,66
1/12/2021,Canada,Terengganu,0,0,0
1/12/2021,Canada,W.P. Labuan,0,0,0
1/12/2021,Cocos (Keeling) Islands,Selangor,0,0,0
1/12/2021,Switzerland,Johor,0,0,0
1/12/2021,Switzerland,Kedah,1,1,0
1/12/2021,Switzerland,Kelantan,0,0,0
1/12/2021,Switzerland,Melaka,0,0,0
1/12/2021,Switzerland,Negeri Sembilan,0,0,0
1/12/2021,Switzerland,Pahang,0,0,0
1/12/2021,Switzerland,Perak,0,0,0
1/12/2021,Switzerland,Perlis,0,0,0
1/12/2021,Switzerland,Pulau Pinang,6,3,3
1/12/2021,Switzerland,Sabah,0,0,0
1/12/2021,Switzerland,Sarawak,0,0,0
1/12/2021,Switzerland,Selangor,67,47,20
1/12/2021,Switzerland,W.P. Labuan,0,0,0
1/12/2021,Chile,Johor,0,0,0
1/12/2021,Chile,Kedah,0,0,0
1/12/2021,Chile,Kelantan,0,0,0
1/12/2021,Chile,Melaka,0,0,0
1/12/2021,Chile,Pahang,0,0,0
1/12/2021,Chile,Perak,0,0,0
1/12/2021,Chile,Perlis,0,0,0
1/12/2021,Chile,Pulau Pinang,0,0,0
1/12/2021,Chile,Sabah,1,1,0
1/12/2021,Chile,Sarawak,0,0,0
1/12/2021,Chile,Selangor,8,5,3
1/12/2021,China,Johor,83,77,6
1/12/2021,China,Kedah,3,3,0
1/12/2021,China,Kelantan,0,0,0
1/12/2021,China,Melaka,0,0,0
1/12/2021,China,Pahang,0,0,0
1/12/2021,China,Perak,0,0,0
1/12/2021,China,Perlis,0,0,0
1/12/2021,China,Pulau Pinang,15,8,7
1/12/2021,China,Sabah,2,1,1
1/12/2021,China,Sarawak,31,28,3
1/12/2021,China,Selangor,2250,1486,764
1/12/2021,China,Terengganu,0,0,0
1/12/2021,China,W.P. Labuan,0,0,0
1/12/2021,Côte d'Ivoire,Johor,0,0,0
1/12/2021,Côte d'Ivoire,Kedah,0,0,0
1/12/2021,Côte d'Ivoire,Pulau Pinang,0,0,0
1/12/2021,Côte d'Ivoire,Sabah,0,0,0
1/12/2021,Côte d'Ivoire,Sarawak,0,0,0
1/12/2021,Côte d'Ivoire,Selangor,2,2,0
1/12/2021,Cameroon,Johor,0,0,0
1/12/2021,Cameroon,Kedah,0,0,0
1/12/2021,Cameroon,Pulau Pinang,0,0,0
1/12/2021,Cameroon,Sabah,0,0,0
1/12/2021,Cameroon,Sarawak,0,0,0
1/12/2021,Cameroon,Selangor,0,0,0
1/12/2021,Congo,Johor,0,0,0
1/12/2021,Congo,Pulau Pinang,0,0,0
1/12/2021,Congo,Sarawak,0,0,0
1/12/2021,Congo,Selangor,1,0,1
1/12/2021,Congo,Johor,0,0,0
1/12/2021,Congo,Kedah,0,0,0
1/12/2021,Congo,Selangor,0,0,0
1/12/2021,Cook Islands,Selangor,0,0,0
1/12/2021,Colombia,Johor,0,0,0
1/12/2021,Colombia,Kedah,0,0,0
1/12/2021,Colombia,Perak,0,0,0
1/12/2021,Colombia,Pulau Pinang,0,0,0
1/12/2021,Colombia,Sabah,0,0,0
1/12/2021,Colombia,Sarawak,0,0,0
1/12/2021,Colombia,Selangor,10,6,4
1/12/2021,Colombia,W.P. Labuan,0,0,0
1/12/2021,Comoros,Johor,0,0,0
1/12/2021,Comoros,Kedah,0,0,0
1/12/2021,Comoros,Selangor,2,1,1
1/12/2021,Cabo Verde,Johor,0,0,0
1/12/2021,Cabo Verde,Kedah,0,0,0
1/12/2021,Cabo Verde,Pulau Pinang,0,0,0
1/12/2021,Cabo Verde,Sabah,0,0,0
1/12/2021,Cabo Verde,Selangor,0,0,0
1/12/2021,Costa Rica,Johor,0,0,0
1/12/2021,Costa Rica,Kedah,0,0,0
1/12/2021,Costa Rica,Perak,0,0,0
1/12/2021,Costa Rica,Perlis,0,0,0
1/12/2021,Costa Rica,Pulau Pinang,0,0,0
1/12/2021,Costa Rica,Sabah,0,0,0
1/12/2021,Costa Rica,Sarawak,0,0,0
1/12/2021,Costa Rica,Selangor,1,0,1
1/12/2021,Cuba,Johor,0,0,0
1/12/2021,Cuba,Kedah,0,0,0
1/12/2021,Cuba,Perlis,0,0,0
1/12/2021,Cuba,Pulau Pinang,0,0,0
1/12/2021,Cuba,Sabah,0,0,0
1/12/2021,Cuba,Sarawak,0,0,0
1/12/2021,Cuba,Selangor,2,1,1
1/12/2021,Cyprus,Johor,0,0,0
1/12/2021,Cyprus,Kedah,0,0,0
1/12/2021,Cyprus,Perak,0,0,0
1/12/2021,Cyprus,Perlis,0,0,0
1/12/2021,Cyprus,Pulau Pinang,0,0,0
1/12/2021,Cyprus,Sabah,0,0,0
1/12/2021,Cyprus,Sarawak,0,0,0
1/12/2021,Cyprus,Selangor,0,0,0
1/12/2021,Czechia,Johor,0,0,0
1/12/2021,Czechia,Kedah,0,0,0
1/12/2021,Czechia,Kelantan,0,0,0
1/12/2021,Czechia,Melaka,0,0,0
1/12/2021,Czechia,Negeri Sembilan,0,0,0
1/12/2021,Czechia,Perak,0,0,0
1/12/2021,Czechia,Perlis,0,0,0
1/12/2021,Czechia,Pulau Pinang,0,0,0
1/12/2021,Czechia,Sabah,0,0,0
1/12/2021,Czechia,Sarawak,0,0,0
1/12/2021,Czechia,Selangor,15,8,7
1/12/2021,Czechia,W.P. Labuan,0,0,0
1/12/2021,Germany,Johor,3,3,0
1/12/2021,Germany,Kedah,8,5,3
1/12/2021,Germany,Kelantan,0,0,0
1/12/2021,Germany,Melaka,0,0,0
1/12/2021,Germany,Negeri Sembilan,0,0,0
1/12/2021,Germany,Pahang,0,0,0
1/12/2021,Germany,Perak,1,1,0
1/12/2021,Germany,Perlis,0,0,0
1/12/2021,Germany,Pulau Pinang,6,5,1
1/12/2021,Germany,Sabah,0,0,0
1/12/2021,Germany,Sarawak,5,3,2
1/12/2021,Germany,Selangor,348,247,101
1/12/2021,Germany,Terengganu,0,0,0
1/12/2021,Germany,W.P. Labuan,0,0,0
1/12/2021,Djibouti,Johor,0,0,0
1/12/2021,Djibouti,Selangor,6,1,5
1/12/2021,Dominica,Johor,0,0,0
1/12/2021,Dominica,Kedah,0,0,0
1/12/2021,Dominica,Pulau Pinang,0,0,0
1/12/2021,Dominica,Sabah,0,0,0
1/12/2021,Dominica,Sarawak,0,0,0
1/12/2021,Dominica,Selangor,5,5,0
1/12/2021,Dominica,W.P. Labuan,0,0,0
1/12/2021,Denmark,Johor,1,1,0
1/12/2021,Denmark,Kedah,1,1,0
1/12/2021,Denmark,Kelantan,0,0,0
1/12/2021,Denmark,Melaka,0,0,0
1/12/2021,Denmark,Negeri Sembilan,0,0,0
1/12/2021,Denmark,Pahang,0,0,0
1/12/2021,Denmark,Perak,0,0,0
1/12/2021,Denmark,Perlis,0,0,0
1/12/2021,Denmark,Pulau Pinang,5,5,0
1/12/2021,Denmark,Sabah,0,0,0
1/12/2021,Denmark,Sarawak,1,1,0
1/12/2021,Denmark,Selangor,50,39,11
1/12/2021,Denmark,W.P. Labuan,0,0,0
1/12/2021,Dominican Republic,Johor,0,0,0
1/12/2021,Dominican Republic,Kedah,0,0,0
1/12/2021,Dominican Republic,Perak,0,0,0
1/12/2021,Dominican Republic,Perlis,0,0,0
1/12/2021,Dominican Republic,Pulau Pinang,0,0,0
1/12/2021,Dominican Republic,Sabah,0,0,0
1/12/2021,Dominican Republic,Sarawak,0,0,0
1/12/2021,Dominican Republic,Selangor,1,1,0
1/12/2021,Algeria,Johor,0,0,0
1/12/2021,Algeria,Kedah,0,0,0
1/12/2021,Algeria,Kelantan,0,0,0
1/12/2021,Algeria,Melaka,0,0,0
1/12/2021,Algeria,Perak,0,0,0
1/12/2021,Algeria,Perlis,0,0,0
1/12/2021,Algeria,Pulau Pinang,0,0,0
1/12/2021,Algeria,Sabah,0,0,0
1/12/2021,Algeria,Sarawak,0,0,0
1/12/2021,Algeria,Selangor,45,35,10
1/12/2021,Algeria,W.P. Labuan,0,0,0
1/12/2021,Ecuador,Johor,0,0,0
1/12/2021,Ecuador,Kedah,0,0,0
1/12/2021,Ecuador,Perak,0,0,0
1/12/2021,Ecuador,Perlis,0,0,0
1/12/2021,Ecuador,Pulau Pinang,0,0,0
1/12/2021,Ecuador,Sabah,0,0,0
1/12/2021,Ecuador,Sarawak,0,0,0
1/12/2021,Ecuador,Selangor,3,3,0
1/12/2021,Egypt,Johor,0,0,0
1/12/2021,Egypt,Kedah,0,0,0
1/12/2021,Egypt,Kelantan,0,0,0
1/12/2021,Egypt,Melaka,0,0,0
1/12/2021,Egypt,Pahang,0,0,0
1/12/2021,Egypt,Perak,0,0,0
1/12/2021,Egypt,Perlis,0,0,0
1/12/2021,Egypt,Pulau Pinang,0,0,0
1/12/2021,Egypt,Sabah,0,0,0
1/12/2021,Egypt,Sarawak,0,0,0
1/12/2021,Egypt,Selangor,271,206,65
1/12/2021,Egypt,Terengganu,0,0,0
1/12/2021,Egypt,W.P. Labuan,0,0,0
1/12/2021,Eritrea,Johor,0,0,0
1/12/2021,Eritrea,Pulau Pinang,0,0,0
1/12/2021,Eritrea,Sabah,0,0,0
1/12/2021,Eritrea,Selangor,4,2,2
1/12/2021,Spain,Johor,0,0,0
1/12/2021,Spain,Kedah,0,0,0
1/12/2021,Spain,Kelantan,0,0,0
1/12/2021,Spain,Melaka,0,0,0
1/12/2021,Spain,Negeri Sembilan,0,0,0
1/12/2021,Spain,Pahang,0,0,0
1/12/2021,Spain,Perak,0,0,0
1/12/2021,Spain,Perlis,0,0,0
1/12/2021,Spain,Pulau Pinang,0,0,0
1/12/2021,Spain,Sabah,0,0,0
1/12/2021,Spain,Sarawak,0,0,0
1/12/2021,Spain,Selangor,44,30,14
1/12/2021,Spain,W.P. Labuan,0,0,0
1/12/2021,Estonia,Johor,0,0,0
1/12/2021,Estonia,Kedah,0,0,0
1/12/2021,Estonia,Kelantan,0,0,0
1/12/2021,Estonia,Pahang,0,0,0
1/12/2021,Estonia,Perak,0,0,0
1/12/2021,Estonia,Perlis,0,0,0
1/12/2021,Estonia,Pulau Pinang,0,0,0
1/12/2021,Estonia,Sabah,0,0,0
1/12/2021,Estonia,Sarawak,0,0,0
1/12/2021,Estonia,Selangor,4,3,1
1/12/2021,Estonia,W.P. Labuan,0,0,0
1/12/2021,Ethiopia,Johor,0,0,0
1/12/2021,Ethiopia,Kedah,0,0,0
1/12/2021,Ethiopia,Pulau Pinang,0,0,0
1/12/2021,Ethiopia,Sarawak,0,0,0
1/12/2021,Ethiopia,Selangor,3,2,1
1/12/2021,Finland,Johor,0,0,0
1/12/2021,Finland,Kedah,0,0,0
1/12/2021,Finland,Kelantan,0,0,0
1/12/2021,Finland,Melaka,0,0,0
1/12/2021,Finland,Negeri Sembilan,0,0,0
1/12/2021,Finland,Pahang,0,0,0
1/12/2021,Finland,Perak,0,0,0
1/12/2021,Finland,Perlis,0,0,0
1/12/2021,Finland,Pulau Pinang,0,0,0
1/12/2021,Finland,Sabah,0,0,0
1/12/2021,Finland,Sarawak,0,0,0
1/12/2021,Finland,Selangor,36,25,11
1/12/2021,Finland,W.P. Labuan,0,0,0
1/12/2021,Fiji,Johor,0,0,0
1/12/2021,Fiji,Kedah,0,0,0
1/12/2021,Fiji,Kelantan,0,0,0
1/12/2021,Fiji,Perak,0,0,0
1/12/2021,Fiji,Perlis,0,0,0
1/12/2021,Fiji,Pulau Pinang,0,0,0
1/12/2021,Fiji,Sabah,0,0,0
1/12/2021,Fiji,Sarawak,0,0,0
1/12/2021,Fiji,Selangor,6,4,2
1/12/2021,France,Johor,0,0,0
1/12/2021,France,Kedah,3,2,1
1/12/2021,France,Kelantan,0,0,0
1/12/2021,France,Melaka,0,0,0
1/12/2021,France,Negeri Sembilan,0,0,0
1/12/2021,France,Pahang,0,0,0
1/12/2021,France,Perak,0,0,0
1/12/2021,France,Perlis,0,0,0
1/12/2021,France,Pulau Pinang,4,4,0
1/12/2021,France,Sabah,0,0,0
1/12/2021,France,Sarawak,1,1,0
1/12/2021,France,Selangor,390,265,125
1/12/2021,France,Terengganu,0,0,0
1/12/2021,France,W.P. Labuan,0,0,0
1/12/2021,"Micronesia, Federated States of",Johor,0,0,0
1/12/2021,"Micronesia, Federated States of",Pulau Pinang,0,0,0
1/12/2021,"Micronesia, Federated States of",Selangor,0,0,0
1/12/2021,Gabon,Johor,0,0,0
1/12/2021,Gabon,Pulau Pinang,0,0,0
1/12/2021,Gabon,Sarawak,0,0,0
1/12/2021,Gabon,Selangor,1,1,0
1/12/2021,United Kingdom of Great Britain and Northern Ireland,Johor,0,0,0
1/12/2021,United Kingdom of Great Britain and Northern Ireland,Kedah,17,11,6
1/12/2021,United Kingdom of Great Britain and Northern Ireland,Kelantan,0,0,0
1/12/2021,United Kingdom of Great Britain and Northern Ireland,Melaka,0,0,0
1/12/2021,United Kingdom of Great Britain and Northern Ireland,Negeri Sembilan,0,0,0
1/12/2021,United Kingdom of Great Britain and Northern Ireland,Pahang,0,0,0
1/12/2021,United Kingdom of Great Britain and Northern Ireland,Perak,1,0,1
1/12/2021,United Kingdom of Great Britain and Northern Ireland,Perlis,0,0,0
1/12/2021,United Kingdom of Great Britain and Northern Ireland,Pulau Pinang,20,14,6
1/12/2021,United Kingdom of Great Britain and Northern Ireland,Sabah,2,1,1
1/12/2021,United Kingdom of Great Britain and Northern Ireland,Sarawak,4,4,0
1/12/2021,United Kingdom of Great Britain and Northern Ireland,Selangor,1347,874,473
1/12/2021,United Kingdom of Great Britain and Northern Ireland,Terengganu,0,0,0
1/12/2021,United Kingdom of Great Britain and Northern Ireland,W.P. Labuan,0,0,0
1/12/2021,Georgia,Johor,0,0,0
1/12/2021,Georgia,Kedah,0,0,0
1/12/2021,Georgia,Melaka,0,0,0
1/12/2021,Georgia,Perak,0,0,0
1/12/2021,Georgia,Perlis,0,0,0
1/12/2021,Georgia,Pulau Pinang,0,0,0
1/12/2021,Georgia,Sabah,0,0,0
1/12/2021,Georgia,Sarawak,0,0,0
1/12/2021,Georgia,Selangor,12,10,2
1/12/2021,Ghana,Johor,0,0,0
1/12/2021,Ghana,Kedah,0,0,0
1/12/2021,Ghana,Kelantan,0,0,0
1/12/2021,Ghana,Pulau Pinang,0,0,0
1/12/2021,Ghana,Sabah,0,0,0
1/12/2021,Ghana,Sarawak,0,0,0
1/12/2021,Ghana,Selangor,9,8,1
1/12/2021,Gibraltar,Johor,0,0,0
1/12/2021,Gibraltar,Sarawak,0,0,0
1/12/2021,Guinea,Johor,0,0,0
1/12/2021,Guinea,Kedah,0,0,0
1/12/2021,Guinea,Kelantan,0,0,0
1/12/2021,Guinea,Perlis,0,0,0
1/12/2021,Guinea,Pulau Pinang,0,0,0
1/12/2021,Guinea,Sabah,0,0,0
1/12/2021,Guinea,Sarawak,0,0,0
1/12/2021,Guinea,Selangor,8,5,3
1/12/2021,Guadeloupe,Selangor,0,0,0
1/12/2021,Gambia,Johor,0,0,0
1/12/2021,Gambia,Kedah,0,0,0
1/12/2021,Gambia,Kelantan,0,0,0
1/12/2021,Gambia,Pulau Pinang,0,0,0
1/12/2021,Gambia,Sabah,0,0,0
1/12/2021,Gambia,Sarawak,0,0,0
1/12/2021,Gambia,Selangor,3,3,0
1/12/2021,Guinea-Bissau,Johor,0,0,0
1/12/2021,Guinea-Bissau,Selangor,0,0,0
1/12/2021,Equatorial Guinea,Johor,0,0,0
1/12/2021,Equatorial Guinea,Selangor,8,6,2
1/12/2021,Greece,Johor,0,0,0
1/12/2021,Greece,Kedah,0,0,0
1/12/2021,Greece,Kelantan,0,0,0
1/12/2021,Greece,Melaka,0,0,0
1/12/2021,Greece,Negeri Sembilan,0,0,0
1/12/2021,Greece,Pahang,0,0,0
1/12/2021,Greece,Perak,0,0,0
1/12/2021,Greece,Perlis,0,0,0
1/12/2021,Greece,Pulau Pinang,0,0,0
1/12/2021,Greece,Sabah,0,0,0
1/12/2021,Greece,Sarawak,0,0,0
1/12/2021,Greece,Selangor,8,8,0
1/12/2021,Grenada,Johor,0,0,0
1/12/2021,Grenada,Kedah,0,0,0
1/12/2021,Grenada,Pulau Pinang,0,0,0
1/12/2021,Grenada,Sabah,0,0,0
1/12/2021,Grenada,Sarawak,0,0,0
1/12/2021,Grenada,Selangor,0,0,0
1/12/2021,Greenland,Johor,0,0,0
1/12/2021,Greenland,Selangor,0,0,0
1/12/2021,Guatemala,Johor,0,0,0
1/12/2021,Guatemala,Kedah,0,0,0
1/12/2021,Guatemala,Pahang,0,0,0
1/12/2021,Guatemala,Perak,0,0,0
1/12/2021,Guatemala,Pulau Pinang,0,0,0
1/12/2021,Guatemala,Sabah,0,0,0
1/12/2021,Guatemala,Sarawak,0,0,0
1/12/2021,Guatemala,Selangor,0,0,0
1/12/2021,Guatemala,W.P. Labuan,0,0,0
1/12/2021,Guyana,Johor,0,0,0
1/12/2021,Guyana,Kedah,0,0,0
1/12/2021,Guyana,Pulau Pinang,0,0,0
1/12/2021,Guyana,Sarawak,0,0,0
1/12/2021,Guyana,Selangor,0,0,0
1/12/2021,Hong Kong,Johor,0,0,0
1/12/2021,Hong Kong,Kedah,0,0,0
1/12/2021,Hong Kong,Kelantan,0,0,0
1/12/2021,Hong Kong,Pahang,0,0,0
1/12/2021,Hong Kong,Perak,0,0,0
1/12/2021,Hong Kong,Perlis,0,0,0
1/12/2021,Hong Kong,Pulau Pinang,2,1,1
1/12/2021,Hong Kong,Sabah,0,0,0
1/12/2021,Hong Kong,Sarawak,44,38,6
1/12/2021,Hong Kong,Selangor,1,1,0
1/12/2021,Hong Kong,Terengganu,0,0,0
1/12/2021,Heard Island and McDonald Islands,Johor,0,0,0
1/12/2021,Honduras,Johor,0,0,0
1/12/2021,Honduras,Kedah,0,0,0
1/12/2021,Honduras,Perak,0,0,0
1/12/2021,Honduras,Pulau Pinang,0,0,0
1/12/2021,Honduras,Sabah,0,0,0
1/12/2021,Honduras,Sarawak,0,0,0
1/12/2021,Honduras,Selangor,0,0,0
1/12/2021,Croatia,Johor,0,0,0
1/12/2021,Croatia,Kedah,0,0,0
1/12/2021,Croatia,Kelantan,0,0,0
1/12/2021,Croatia,Melaka,0,0,0
1/12/2021,Croatia,Pahang,0,0,0
1/12/2021,Croatia,Perak,0,0,0
1/12/2021,Croatia,Perlis,0,0,0
1/12/2021,Croatia,Pulau Pinang,0,0,0
1/12/2021,Croatia,Sabah,0,0,0
1/12/2021,Croatia,Sarawak,0,0,0
1/12/2021,Croatia,Selangor,12,11,1
1/12/2021,Haiti,Johor,0,0,0
1/12/2021,Haiti,Kedah,0,0,0
1/12/2021,Haiti,Kelantan,0,0,0
1/12/2021,Haiti,Perak,0,0,0
1/12/2021,Haiti,Pulau Pinang,0,0,0
1/12/2021,Haiti,Sabah,0,0,0
1/12/2021,Haiti,Selangor,0,0,0
1/12/2021,Hungary,Johor,0,0,0
1/12/2021,Hungary,Kedah,0,0,0
1/12/2021,Hungary,Kelantan,0,0,0
1/12/2021,Hungary,Pahang,0,0,0
1/12/2021,Hungary,Perak,0,0,0
1/12/2021,Hungary,Perlis,0,0,0
1/12/2021,Hungary,Pulau Pinang,0,0,0
1/12/2021,Hungary,Sabah,0,0,0
1/12/2021,Hungary,Sarawak,0,0,0
1/12/2021,Hungary,Selangor,15,10,5
1/12/2021,Hungary,W.P. Labuan,0,0,0
1/12/2021,Indonesia,Johor,332,174,158
1/12/2021,Indonesia,Kedah,19,10,9
1/12/2021,Indonesia,Kelantan,0,0,0
1/12/2021,Indonesia,Melaka,0,0,0
1/12/2021,Indonesia,Negeri Sembilan,0,0,0
1/12/2021,Indonesia,Pahang,0,0,0
1/12/2021,Indonesia,Perak,0,0,0
1/12/2021,Indonesia,Perlis,1,1,0
1/12/2021,Indonesia,Pulau Pinang,22,11,11
1/12/2021,Indonesia,Sabah,3,2,1
1/12/2021,Indonesia,Sarawak,154,144,10
1/12/2021,Indonesia,Selangor,3834,1643,2191
1/12/2021,Indonesia,Terengganu,0,0,0
1/12/2021,Indonesia,W.P. Labuan,0,0,0
1/12/2021,India,Johor,35,32,3
1/12/2021,India,Kedah,0,0,0
1/12/2021,India,Kelantan,0,0,0
1/12/2021,India,Melaka,0,0,0
1/12/2021,India,Negeri Sembilan,0,0,0
1/12/2021,India,Pahang,0,0,0
1/12/2021,India,Perak,0,0,0
1/12/2021,India,Perlis,0,0,0
1/12/2021,India,Pulau Pinang,9,7,2
1/12/2021,India,Sabah,4,3,1
1/12/2021,India,Sarawak,3,3,0
1/12/2021,India,Selangor,6305,4601,1704
1/12/2021,India,Terengganu,0,0,0
1/12/2021,India,W.P. Labuan,0,0,0
1/12/2021, British Indian Ocean Territory,Pulau Pinang,0,0,0
1/12/2021, British Indian Ocean Territory,Selangor,0,0,0
1/12/2021,Ireland,Johor,0,0,0
1/12/2021,Ireland,Kedah,0,0,0
1/12/2021,Ireland,Kelantan,0,0,0
1/12/2021,Ireland,Negeri Sembilan,0,0,0
1/12/2021,Ireland,Pahang,0,0,0
1/12/2021,Ireland,Perak,0,0,0
1/12/2021,Ireland,Perlis,0,0,0
1/12/2021,Ireland,Pulau Pinang,0,0,0
1/12/2021,Ireland,Sabah,0,0,0
1/12/2021,Ireland,Sarawak,0,0,0
1/12/2021,Ireland,Selangor,74,46,28
1/12/2021,Ireland,Terengganu,0,0,0
1/12/2021,Ireland,W.P. Labuan,0,0,0
1/12/2021,"Iran, Islamic Republic of",Johor,0,0,0
1/12/2021,"Iran, Islamic Republic of",Kedah,0,0,0
1/12/2021,"Iran, Islamic Republic of",Kelantan,0,0,0
1/12/2021,"Iran, Islamic Republic of",Perak,0,0,0
1/12/2021,"Iran, Islamic Republic of",Perlis,0,0,0
1/12/2021,"Iran, Islamic Republic of",Pulau Pinang,0,0,0
1/12/2021,"Iran, Islamic Republic of",Sabah,0,0,0
1/12/2021,"Iran, Islamic Republic of",Sarawak,0,0,0
1/12/2021,"Iran, Islamic Republic of",Selangor,175,101,74
1/12/2021,"Iran, Islamic Republic of",W.P. Labuan,0,0,0
1/12/2021,Iraq,Johor,0,0,0
1/12/2021,Iraq,Kedah,0,0,0
1/12/2021,Iraq,Kelantan,0,0,0
1/12/2021,Iraq,Melaka,0,0,0
1/12/2021,Iraq,Pahang,0,0,0
1/12/2021,Iraq,Perak,0,0,0
1/12/2021,Iraq,Perlis,0,0,0
1/12/2021,Iraq,Pulau Pinang,0,0,0
1/12/2021,Iraq,Sabah,0,0,0
1/12/2021,Iraq,Sarawak,0,0,0
1/12/2021,Iraq,Selangor,256,164,92
1/12/2021,Iceland,Johor,0,0,0
1/12/2021,Iceland,Kedah,0,0,0
1/12/2021,Iceland,Kelantan,0,0,0
1/12/2021,Iceland,Perak,0,0,0
1/12/2021,Iceland,Perlis,0,0,0
1/12/2021,Iceland,Pulau Pinang,0,0,0
1/12/2021,Iceland,Sabah,0,0,0
1/12/2021,Iceland,Sarawak,0,0,0
1/12/2021,Iceland,Selangor,1,1,0
1/12/2021,Iceland,W.P. Labuan,0,0,0
1/12/2021,Israel,Pulau Pinang,0,0,0
1/12/2021,Italy,Johor,0,0,0
1/12/2021,Italy,Kedah,4,3,1
1/12/2021,Italy,Kelantan,0,0,0
1/12/2021,Italy,Melaka,0,0,0
1/12/2021,Italy,Negeri Sembilan,0,0,0
1/12/2021,Italy,Pahang,0,0,0
1/12/2021,Italy,Perak,0,0,0
1/12/2021,Italy,Perlis,0,0,0
1/12/2021,Italy,Pulau Pinang,1,1,0
1/12/2021,Italy,Sabah,1,1,0
1/12/2021,Italy,Sarawak,0,0,0
1/12/2021,Italy,Selangor,85,70,15
1/12/2021,Italy,W.P. Labuan,0,0,0
1/12/2021,Jamaica,Johor,0,0,0
1/12/2021,Jamaica,Kedah,0,0,0
1/12/2021,Jamaica,Perak,0,0,0
1/12/2021,Jamaica,Pulau Pinang,0,0,0
1/12/2021,Jamaica,Sabah,0,0,0
1/12/2021,Jamaica,Sarawak,0,0,0
1/12/2021,Jamaica,Selangor,2,2,0
1/12/2021,Jamaica,W.P. Labuan,0,0,0
1/12/2021,Jordan,Johor,0,0,0
1/12/2021,Jordan,Kedah,0,0,0
1/12/2021,Jordan,Kelantan,0,0,0
1/12/2021,Jordan,Melaka,0,0,0
1/12/2021,Jordan,Perlis,0,0,0
1/12/2021,Jordan,Pulau Pinang,0,0,0
1/12/2021,Jordan,Sabah,0,0,0
1/12/2021,Jordan,Sarawak,0,0,0
1/12/2021,Jordan,Selangor,78,62,16
1/12/2021,Jordan,W.P. Labuan,0,0,0
1/12/2021,Japan,Johor,5,4,1
1/12/2021,Japan,Kedah,7,1,6
1/12/2021,Japan,Kelantan,0,0,0
1/12/2021,Japan,Melaka,0,0,0
1/12/2021,Japan,Negeri Sembilan,0,0,0
1/12/2021,Japan,Pahang,0,0,0
1/12/2021,Japan,Perak,3,2,1
1/12/2021,Japan,Perlis,0,0,0
1/12/2021,Japan,Pulau Pinang,58,32,26
1/12/2021,Japan,Sabah,3,1,2
1/12/2021,Japan,Sarawak,9,8,1
1/12/2021,Japan,Selangor,1066,624,442
1/12/2021,Japan,W.P. Labuan,0,0,0
1/12/2021,Kazakhstan,Johor,0,0,0
1/12/2021,Kazakhstan,Kedah,0,0,0
1/12/2021,Kazakhstan,Kelantan,0,0,0
1/12/2021,Kazakhstan,Melaka,0,0,0
1/12/2021,Kazakhstan,Perak,0,0,0
1/12/2021,Kazakhstan,Perlis,0,0,0
1/12/2021,Kazakhstan,Pulau Pinang,0,0,0
1/12/2021,Kazakhstan,Sabah,0,0,0
1/12/2021,Kazakhstan,Sarawak,0,0,0
1/12/2021,Kazakhstan,Selangor,21,10,11
1/12/2021,Kazakhstan,W.P. Labuan,0,0,0
1/12/2021,Kenya,Johor,0,0,0
1/12/2021,Kenya,Kedah,0,0,0
1/12/2021,Kenya,Kelantan,0,0,0
1/12/2021,Kenya,Perak,0,0,0
1/12/2021,Kenya,Perlis,0,0,0
1/12/2021,Kenya,Pulau Pinang,0,0,0
1/12/2021,Kenya,Sabah,0,0,0
1/12/2021,Kenya,Sarawak,0,0,0
1/12/2021,Kenya,Selangor,37,22,15
1/12/2021,Kyrgyzstan,Johor,0,0,0
1/12/2021,Kyrgyzstan,Kedah,0,0,0
1/12/2021,Kyrgyzstan,Kelantan,0,0,0
1/12/2021,Kyrgyzstan,Perak,0,0,0
1/12/2021,Kyrgyzstan,Perlis,0,0,0
1/12/2021,Kyrgyzstan,Pulau Pinang,0,0,0
1/12/2021,Kyrgyzstan,Sabah,0,0,0
1/12/2021,Kyrgyzstan,Sarawak,0,0,0
1/12/2021,Kyrgyzstan,Selangor,13,6,7
1/12/2021,Cambodia,Johor,0,0,0
1/12/2021,Cambodia,Kedah,0,0,0
1/12/2021,Cambodia,Kelantan,0,0,0
1/12/2021,Cambodia,Melaka,0,0,0
1/12/2021,Cambodia,Negeri Sembilan,0,0,0
1/12/2021,Cambodia,Pahang,0,0,0
1/12/2021,Cambodia,Perak,0,0,0
1/12/2021,Cambodia,Perlis,0,0,0
1/12/2021,Cambodia,Pulau Pinang,16,16,0
1/12/2021,Cambodia,Sabah,0,0,0
1/12/2021,Cambodia,Sarawak,0,0,0
1/12/2021,Cambodia,Selangor,67,42,25
1/12/2021,Cambodia,W.P. Labuan,0,0,0
1/12/2021,Kiribati,Johor,0,0,0
1/12/2021,Kiribati,Sabah,0,0,0
1/12/2021,Kiribati,Selangor,0,0,0
1/12/2021,Saint Kitts and Nevis,Johor,0,0,0
1/12/2021,Saint Kitts and Nevis,Kedah,0,0,0
1/12/2021,Saint Kitts and Nevis,Perlis,0,0,0
1/12/2021,Saint Kitts and Nevis,Pulau Pinang,0,0,0
1/12/2021,Saint Kitts and Nevis,Sabah,0,0,0
1/12/2021,Saint Kitts and Nevis,Selangor,1,1,0
1/12/2021,Saint Kitts and Nevis,W.P. Labuan,0,0,0
1/12/2021,"Korea, Republic of",Johor,2,2,0
1/12/2021,"Korea, Republic of",Kedah,0,0,0
1/12/2021,"Korea, Republic of",Kelantan,0,0,0
1/12/2021,"Korea, Republic of",Melaka,0,0,0
1/12/2021,"Korea, Republic of",Negeri Sembilan,0,0,0
1/12/2021,"Korea, Republic of",Pahang,0,0,0
1/12/2021,"Korea, Republic of",Perak,0,0,0
1/12/2021,"Korea, Republic of",Perlis,0,0,0
1/12/2021,"Korea, Republic of",Pulau Pinang,22,6,16
1/12/2021,"Korea, Republic of",Sabah,2,0,2
1/12/2021,"Korea, Republic of",Sarawak,40,34,6
1/12/2021,"Korea, Republic of",Selangor,1288,809,479
1/12/2021,"Korea, Republic of",Terengganu,0,0,0
1/12/2021,"Korea, Republic of",W.P. Labuan,0,0,0
1/12/2021,Kuwait,Johor,0,0,0
1/12/2021,Kuwait,Kedah,0,0,0
1/12/2021,Kuwait,Kelantan,0,0,0
1/12/2021,Kuwait,Perak,0,0,0
1/12/2021,Kuwait,Perlis,0,0,0
1/12/2021,Kuwait,Pulau Pinang,0,0,0
1/12/2021,Kuwait,Sabah,0,0,0
1/12/2021,Kuwait,Sarawak,0,0,0
1/12/2021,Kuwait,Selangor,6,5,1
1/12/2021,Kuwait,W.P. Labuan,0,0,0
1/12/2021, Lao People's Democratic Republic,Johor,0,0,0
1/12/2021, Lao People's Democratic Republic,Kedah,0,0,0
1/12/2021, Lao People's Democratic Republic,Kelantan,0,0,0
1/12/2021, Lao People's Democratic Republic,Melaka,0,0,0
1/12/2021, Lao People's Democratic Republic,Perak,0,0,0
1/12/2021, Lao People's Democratic Republic,Perlis,0,0,0
1/12/2021, Lao People's Democratic Republic,Pulau Pinang,0,0,0
1/12/2021, Lao People's Democratic Republic,Sabah,0,0,0
1/12/2021, Lao People's Democratic Republic,Sarawak,0,0,0
1/12/2021, Lao People's Democratic Republic,Selangor,19,15,4
1/12/2021, Lao People's Democratic Republic,W.P. Labuan,0,0,0
1/12/2021,Lebanon,Johor,0,0,0
1/12/2021,Lebanon,Kedah,0,0,0
1/12/2021,Lebanon,Kelantan,0,0,0
1/12/2021,Lebanon,Pahang,0,0,0
1/12/2021,Lebanon,Perak,0,0,0
1/12/2021,Lebanon,Perlis,0,0,0
1/12/2021,Lebanon,Pulau Pinang,0,0,0
1/12/2021,Lebanon,Sabah,0,0,0
1/12/2021,Lebanon,Sarawak,0,0,0
1/12/2021,Lebanon,Selangor,14,8,6
1/12/2021,Lebanon,W.P. Labuan,0,0,0
1/12/2021,Liberia,Johor,0,0,0
1/12/2021,Liberia,Kedah,0,0,0
1/12/2021,Liberia,Sabah,0,0,0
1/12/2021,Liberia,Sarawak,0,0,0
1/12/2021,Liberia,Selangor,5,5,0
1/12/2021,Libya,Johor,0,0,0
1/12/2021,Libya,Kedah,0,0,0
1/12/2021,Libya,Perlis,0,0,0
1/12/2021,Libya,Pulau Pinang,0,0,0
1/12/2021,Libya,Sabah,0,0,0
1/12/2021,Libya,Sarawak,0,0,0
1/12/2021,Libya,Selangor,194,124,70
1/12/2021,Saint Lucia,Johor,0,0,0
1/12/2021,Saint Lucia,Kedah,0,0,0
1/12/2021,Saint Lucia,Pulau Pinang,0,0,0
1/12/2021,Saint Lucia,Sarawak,0,0,0
1/12/2021,Saint Lucia,Selangor,1,1,0
1/12/2021,Liechtenstein,Johor,0,0,0
1/12/2021,Liechtenstein,Kedah,0,0,0
1/12/2021,Liechtenstein,Perlis,0,0,0
1/12/2021,Liechtenstein,Pulau Pinang,0,0,0
1/12/2021,Liechtenstein,Sabah,0,0,0
1/12/2021,Liechtenstein,Sarawak,0,0,0
1/12/2021,Liechtenstein,Selangor,1,1,0
1/12/2021,LKA,Johor,0,0,0
1/12/2021,LKA,Kedah,0,0,0
1/12/2021,LKA,Kelantan,0,0,0
1/12/2021,LKA,Melaka,0,0,0
1/12/2021,LKA,Pahang,0,0,0
1/12/2021,LKA,Perak,0,0,0
1/12/2021,LKA,Perlis,0,0,0
1/12/2021,LKA,Pulau Pinang,0,0,0
1/12/2021,LKA,Sabah,0,0,0
1/12/2021,LKA,Sarawak,0,0,0
1/12/2021,LKA,Selangor,204,119,85
1/12/2021,LKA,W.P. Labuan,0,0,0
1/12/2021,Lesotho,Johor,0,0,0
1/12/2021,Lesotho,Kedah,0,0,0
1/12/2021,Lesotho,Pulau Pinang,0,0,0
1/12/2021,Lesotho,Sarawak,0,0,0
1/12/2021,Lesotho,Selangor,0,0,0
1/12/2021,Lithuania,Johor,1,0,1
1/12/2021,Lithuania,Kedah,0,0,0
1/12/2021,Lithuania,Kelantan,0,0,0
1/12/2021,Lithuania,Pahang,0,0,0
1/12/2021,Lithuania,Perak,0,0,0
1/12/2021,Lithuania,Perlis,0,0,0
1/12/2021,Lithuania,Pulau Pinang,0,0,0
1/12/2021,Lithuania,Sabah,0,0,0
1/12/2021,Lithuania,Sarawak,0,0,0
1/12/2021,Lithuania,Selangor,15,13,2
1/12/2021,Lithuania,W.P. Labuan,0,0,0
1/12/2021,Luxembourg,Johor,0,0,0
1/12/2021,Luxembourg,Kedah,0,0,0
1/12/2021,Luxembourg,Kelantan,0,0,0
1/12/2021,Luxembourg,Perak,0,0,0
1/12/2021,Luxembourg,Perlis,0,0,0
1/12/2021,Luxembourg,Pulau Pinang,0,0,0
1/12/2021,Luxembourg,Sabah,0,0,0
1/12/2021,Luxembourg,Sarawak,0,0,0
1/12/2021,Luxembourg,Selangor,1,0,1
1/12/2021,Latvia,Johor,0,0,0
1/12/2021,Latvia,Kedah,0,0,0
1/12/2021,Latvia,Kelantan,0,0,0
1/12/2021,Latvia,Pahang,0,0,0
1/12/2021,Latvia,Perak,0,0,0
1/12/2021,Latvia,Perlis,0,0,0
1/12/2021,Latvia,Pulau Pinang,0,0,0
1/12/2021,Latvia,Sabah,0,0,0
1/12/2021,Latvia,Sarawak,0,0,0
1/12/2021,Latvia,Selangor,7,5,2
1/12/2021,Latvia,W.P. Labuan,0,0,0
1/12/2021,Macao,Johor,0,0,0
1/12/2021,Macao,Pahang,0,0,0
1/12/2021,Macao,Perak,0,0,0
1/12/2021,Macao,Selangor,0,0,0
1/12/2021,Macao,W.P. Labuan,0,0,0
1/12/2021,Morocco,Johor,0,0,0
1/12/2021,Morocco,Kedah,1,1,0
1/12/2021,Morocco,Kelantan,0,0,0
1/12/2021,Morocco,Melaka,0,0,0
1/12/2021,Morocco,Pahang,0,0,0
1/12/2021,Morocco,Perak,0,0,0
1/12/2021,Morocco,Perlis,0,0,0
1/12/2021,Morocco,Pulau Pinang,0,0,0
1/12/2021,Morocco,Sabah,0,0,0
1/12/2021,Morocco,Sarawak,0,0,0
1/12/2021,Morocco,Selangor,21,5,16
1/12/2021,Morocco,W.P. Labuan,0,0,0
1/12/2021,Monaco,Johor,0,0,0
1/12/2021,Monaco,Kedah,0,0,0
1/12/2021,Monaco,Sabah,0,0,0
1/12/2021,Monaco,Selangor,0,0,0
1/12/2021,"Moldova, Republic of",Johor,0,0,0
1/12/2021,"Moldova, Republic of",Kedah,0,0,0
1/12/2021,"Moldova, Republic of",Kelantan,0,0,0
1/12/2021,"Moldova, Republic of",Negeri Sembilan,0,0,0
1/12/2021,"Moldova, Republic of",Perlis,0,0,0
1/12/2021,"Moldova, Republic of",Pulau Pinang,0,0,0
1/12/2021,"Moldova, Republic of",Sabah,0,0,0
1/12/2021,"Moldova, Republic of",Sarawak,0,0,0
1/12/2021,"Moldova, Republic of",Selangor,0,0,0
1/12/2021,Madagascar,Johor,0,0,0
1/12/2021,Madagascar,Kedah,0,0,0
1/12/2021,Madagascar,Perak,0,0,0
1/12/2021,Madagascar,Perlis,0,0,0
1/12/2021,Madagascar,Pulau Pinang,0,0,0
1/12/2021,Madagascar,Sabah,0,0,0
1/12/2021,Madagascar,Sarawak,0,0,0
1/12/2021,Madagascar,Selangor,0,0,0
1/12/2021,Maldives,Johor,0,0,0
1/12/2021,Maldives,Kedah,4,3,1
1/12/2021,Maldives,Kelantan,0,0,0
1/12/2021,Maldives,Perak,0,0,0
1/12/2021,Maldives,Perlis,0,0,0
1/12/2021,Maldives,Pulau Pinang,0,0,0
1/12/2021,Maldives,Sabah,0,0,0
1/12/2021,Maldives,Sarawak,0,0,0
1/12/2021,Maldives,Selangor,223,99,124
1/12/2021,Mexico,Johor,0,0,0
1/12/2021,Mexico,Kedah,0,0,0
1/12/2021,Mexico,Kelantan,0,0,0
1/12/2021,Mexico,Pahang,0,0,0
1/12/2021,Mexico,Perak,0,0,0
1/12/2021,Mexico,Perlis,0,0,0
1/12/2021,Mexico,Pulau Pinang,0,0,0
1/12/2021,Mexico,Sabah,0,0,0
1/12/2021,Mexico,Sarawak,0,0,0
1/12/2021,Mexico,Selangor,22,12,10
1/12/2021,Mexico,W.P. Labuan,0,0,0
1/12/2021,Marshall Islands,Johor,0,0,0
1/12/2021,Marshall Islands,Kedah,0,0,0
1/12/2021,Marshall Islands,Perak,0,0,0
1/12/2021,Marshall Islands,Pulau Pinang,0,0,0
1/12/2021,Marshall Islands,Sabah,0,0,0
1/12/2021,Marshall Islands,Selangor,0,0,0
1/12/2021,North Macedonia,Johor,0,0,0
1/12/2021,North Macedonia,Kedah,0,0,0
1/12/2021,North Macedonia,Perak,0,0,0
1/12/2021,North Macedonia,Pulau Pinang,0,0,0
1/12/2021,North Macedonia,Sabah,0,0,0
1/12/2021,North Macedonia,Sarawak,0,0,0
1/12/2021,North Macedonia,Selangor,0,0,0
1/12/2021,Mali,Johor,0,0,0
1/12/2021,Mali,Sabah,0,0,0
1/12/2021,Mali,Selangor,1,0,1
1/12/2021,Malta,Johor,0,0,0
1/12/2021,Malta,Kedah,0,0,0
1/12/2021,Malta,Kelantan,0,0,0
1/12/2021,Malta,Perak,0,0,0
1/12/2021,Malta,Perlis,0,0,0
1/12/2021,Malta,Pulau Pinang,0,0,0
1/12/2021,Malta,Sabah,0,0,0
1/12/2021,Malta,Sarawak,0,0,0
1/12/2021,Malta,Selangor,2,2,0
1/12/2021,Malta,W.P. Labuan,0,0,0
1/12/2021,Myanmar,Johor,0,0,0
1/12/2021,Myanmar,Kedah,0,0,0
1/12/2021,Myanmar,Kelantan,0,0,0
1/12/2021,Myanmar,Negeri Sembilan,0,0,0
1/12/2021,Myanmar,Pahang,0,0,0
1/12/2021,Myanmar,Perak,0,0,0
1/12/2021,Myanmar,Perlis,0,0,0
1/12/2021,Myanmar,Pulau Pinang,0,0,0
1/12/2021,Myanmar,Sabah,0,0,0
1/12/2021,Myanmar,Sarawak,0,0,0
1/12/2021,Myanmar,Selangor,341,295,46
1/12/2021,Myanmar,Terengganu,0,0,0
1/12/2021,Myanmar,W.P. Labuan,0,0,0
1/12/2021,Montenegro,Johor,0,0,0
1/12/2021,Montenegro,Kedah,0,0,0
1/12/2021,Montenegro,Pulau Pinang,0,0,0
1/12/2021,Montenegro,Sabah,0,0,0
1/12/2021,Montenegro,Sarawak,0,0,0
1/12/2021,Montenegro,Selangor,8,8,0
1/12/2021,Mongolia,Johor,0,0,0
1/12/2021,Mongolia,Kedah,0,0,0
1/12/2021,Mongolia,Kelantan,0,0,0
1/12/2021,Mongolia,Perak,0,0,0
1/12/2021,Mongolia,Perlis,0,0,0
1/12/2021,Mongolia,Pulau Pinang,0,0,0
1/12/2021,Mongolia,Sabah,0,0,0
1/12/2021,Mongolia,Sarawak,0,0,0
1/12/2021,Mongolia,Selangor,7,2,5
1/12/2021,Northern Mariana Islands,Selangor,0,0,0
1/12/2021,Mozambique,Johor,0,0,0
1/12/2021,Mozambique,Kedah,0,0,0
1/12/2021,Mozambique,Perak,0,0,0
1/12/2021,Mozambique,Pulau Pinang,0,0,0
1/12/2021,Mozambique,Sabah,0,0,0
1/12/2021,Mozambique,Sarawak,0,0,0
1/12/2021,Mozambique,Selangor,0,0,0
1/12/2021,Mauritania,Johor,0,0,0
1/12/2021,Mauritania,Kedah,0,0,0
1/12/2021,Mauritania,Pulau Pinang,0,0,0
1/12/2021,Mauritania,Sabah,0,0,0
1/12/2021,Mauritania,Sarawak,0,0,0
1/12/2021,Mauritania,Selangor,8,7,1
1/12/2021,Mauritius,Johor,0,0,0
1/12/2021,Mauritius,Kedah,0,0,0
1/12/2021,Mauritius,Kelantan,0,0,0
1/12/2021,Mauritius,Pahang,0,0,0
1/12/2021,Mauritius,Perak,0,0,0
1/12/2021,Mauritius,Perlis,0,0,0
1/12/2021,Mauritius,Pulau Pinang,0,0,0
1/12/2021,Mauritius,Sabah,0,0,0
1/12/2021,Mauritius,Sarawak,0,0,0
1/12/2021,Mauritius,Selangor,31,15,16
1/12/2021,Malawi,Johor,0,0,0
1/12/2021,Malawi,Pulau Pinang,0,0,0
1/12/2021,Malawi,Sabah,0,0,0
1/12/2021,Malawi,Sarawak,0,0,0
1/12/2021,Malawi,Selangor,0,0,0
1/12/2021,Mayotte,Selangor,0,0,0
1/12/2021,Namibia,Johor,0,0,0
1/12/2021,Namibia,Kedah,0,0,0
1/12/2021,Namibia,Perak,0,0,0
1/12/2021,Namibia,Perlis,0,0,0
1/12/2021,Namibia,Pulau Pinang,0,0,0
1/12/2021,Namibia,Sabah,0,0,0
1/12/2021,Namibia,Sarawak,0,0,0
1/12/2021,Namibia,Selangor,1,1,0
1/12/2021,New Caledonia,Selangor,0,0,0
1/12/2021,Niger,Johor,0,0,0
1/12/2021,Niger,Sabah,0,0,0
1/12/2021,Niger,Selangor,0,0,0
1/12/2021,Nigeria,Johor,0,0,0
1/12/2021,Nigeria,Kedah,0,0,0
1/12/2021,Nigeria,Perlis,0,0,0
1/12/2021,Nigeria,Pulau Pinang,0,0,0
1/12/2021,Nigeria,Sabah,0,0,0
1/12/2021,Nigeria,Sarawak,4,2,2
1/12/2021,Nigeria,Selangor,169,145,24
1/12/2021,Nicaragua,Johor,0,0,0
1/12/2021,Nicaragua,Kedah,0,0,0
1/12/2021,Nicaragua,Pulau Pinang,0,0,0
1/12/2021,Nicaragua,Sabah,0,0,0
1/12/2021,Nicaragua,Selangor,0,0,0
1/12/2021,Netherlands,Johor,0,0,0
1/12/2021,Netherlands,Kedah,1,0,1
1/12/2021,Netherlands,Kelantan,0,0,0
1/12/2021,Netherlands,Melaka,0,0,0
1/12/2021,Netherlands,Negeri Sembilan,0,0,0
1/12/2021,Netherlands,Pahang,0,0,0
1/12/2021,Netherlands,Perak,0,0,0
1/12/2021,Netherlands,Perlis,0,0,0
1/12/2021,Netherlands,Pulau Pinang,3,1,2
1/12/2021,Netherlands,Sabah,1,1,0
1/12/2021,Netherlands,Sarawak,2,2,0
1/12/2021,Netherlands,Selangor,163,128,35
1/12/2021,Netherlands,Terengganu,0,0,0
1/12/2021,Netherlands,W.P. Labuan,0,0,0
1/12/2021,Norway,Johor,0,0,0
1/12/2021,Norway,Kedah,0,0,0
1/12/2021,Norway,Kelantan,0,0,0
1/12/2021,Norway,Melaka,0,0,0
1/12/2021,Norway,Pahang,0,0,0
1/12/2021,Norway,Perak,0,0,0
1/12/2021,Norway,Perlis,0,0,0
1/12/2021,Norway,Pulau Pinang,1,1,0
1/12/2021,Norway,Sabah,0,0,0
1/12/2021,Norway,Sarawak,1,1,0
1/12/2021,Norway,Selangor,54,39,15
1/12/2021,Norway,W.P. Labuan,0,0,0
1/12/2021,Nepal,Johor,0,0,0
1/12/2021,Nepal,Kedah,0,0,0
1/12/2021,Nepal,Pahang,0,0,0
1/12/2021,Nepal,Perak,0,0,0
1/12/2021,Nepal,Perlis,0,0,0
1/12/2021,Nepal,Pulau Pinang,1,1,0
1/12/2021,Nepal,Sabah,0,0,0
1/12/2021,Nepal,Sarawak,0,0,0
1/12/2021,Nepal,Selangor,599,570,29
1/12/2021,Nepal,W.P. Labuan,0,0,0
1/12/2021,Nauru,Johor,0,0,0
1/12/2021,Nauru,Pulau Pinang,0,0,0
1/12/2021,Nauru,Selangor,0,0,0
1/12/2021,New Zealand,Johor,0,0,0
1/12/2021,New Zealand,Kedah,1,0,1
1/12/2021,New Zealand,Kelantan,0,0,0
1/12/2021,New Zealand,Melaka,0,0,0
1/12/2021,New Zealand,Negeri Sembilan,0,0,0
1/12/2021,New Zealand,Pahang,0,0,0
1/12/2021,New Zealand,Perak,0,0,0
1/12/2021,New Zealand,Perlis,0,0,0
1/12/2021,New Zealand,Pulau Pinang,0,0,0
1/12/2021,New Zealand,Sabah,1,1,0
1/12/2021,New Zealand,Sarawak,0,0,0
1/12/2021,New Zealand,Selangor,95,66,29
1/12/2021,New Zealand,Terengganu,0,0,0
1/12/2021,New Zealand,W.P. Labuan,0,0,0
1/12/2021,Oman,Johor,0,0,0
1/12/2021,Oman,Kedah,0,0,0
1/12/2021,Oman,Kelantan,0,0,0
1/12/2021,Oman,Melaka,0,0,0
1/12/2021,Oman,Perak,0,0,0
1/12/2021,Oman,Perlis,0,0,0
1/12/2021,Oman,Pulau Pinang,0,0,0
1/12/2021,Oman,Sabah,0,0,0
1/12/2021,Oman,Sarawak,0,0,0
1/12/2021,Oman,Selangor,38,28,10
1/12/2021,Pakistan,Johor,0,0,0
1/12/2021,Pakistan,Kedah,0,0,0
1/12/2021,Pakistan,Kelantan,0,0,0
1/12/2021,Pakistan,Melaka,0,0,0
1/12/2021,Pakistan,Negeri Sembilan,0,0,0
1/12/2021,Pakistan,Pahang,0,0,0
1/12/2021,Pakistan,Perak,0,0,0
1/12/2021,Pakistan,Perlis,0,0,0
1/12/2021,Pakistan,Pulau Pinang,0,0,0
1/12/2021,Pakistan,Sabah,0,0,0
1/12/2021,Pakistan,Sarawak,2,2,0
1/12/2021,Pakistan,Selangor,2812,2519,293
1/12/2021,Pakistan,W.P. Labuan,0,0,0
1/12/2021,Panama,Johor,0,0,0
1/12/2021,Panama,Kedah,0,0,0
1/12/2021,Panama,Perak,0,0,0
1/12/2021,Panama,Perlis,0,0,0
1/12/2021,Panama,Pulau Pinang,0,0,0
1/12/2021,Panama,Sabah,0,0,0
1/12/2021,Panama,Sarawak,0,0,0
1/12/2021,Panama,Selangor,1,0,1
1/12/2021,Peru,Johor,0,0,0
1/12/2021,Peru,Kedah,0,0,0
1/12/2021,Peru,Kelantan,0,0,0
1/12/2021,Peru,Pahang,0,0,0
1/12/2021,Peru,Perak,0,0,0
1/12/2021,Peru,Perlis,0,0,0
1/12/2021,Peru,Pulau Pinang,0,0,0
1/12/2021,Peru,Sabah,0,0,0
1/12/2021,Peru,Sarawak,0,0,0
1/12/2021,Peru,Selangor,7,2,5
1/12/2021,Peru,W.P. Labuan,0,0,0
1/12/2021,Philippines,Johor,24,18,6
1/12/2021,Philippines,Kedah,0,0,0
1/12/2021,Philippines,Kelantan,0,0,0
1/12/2021,Philippines,Melaka,0,0,0
1/12/2021,Philippines,Negeri Sembilan,0,0,0
1/12/2021,Philippines,Pahang,0,0,0
1/12/2021,Philippines,Perak,0,0,0
1/12/2021,Philippines,Perlis,0,0,0
1/12/2021,Philippines,Pulau Pinang,5,4,1
1/12/2021,Philippines,Sabah,4,0,4
1/12/2021,Philippines,Sarawak,23,18,5
1/12/2021,Philippines,Selangor,1108,649,459
1/12/2021,Philippines,Terengganu,0,0,0
1/12/2021,Philippines,W.P. Labuan,9,9,0
1/12/2021,Palau,Johor,0,0,0
1/12/2021,Palau,Pulau Pinang,0,0,0
1/12/2021,Palau,Selangor,0,0,0
1/12/2021,Papua New Guinea,Johor,0,0,0
1/12/2021,Papua New Guinea,Kedah,1,0,1
1/12/2021,Papua New Guinea,Kelantan,0,0,0
1/12/2021,Papua New Guinea,Perak,0,0,0
1/12/2021,Papua New Guinea,Pulau Pinang,0,0,0
1/12/2021,Papua New Guinea,Sabah,0,0,0
1/12/2021,Papua New Guinea,Sarawak,0,0,0
1/12/2021,Papua New Guinea,Selangor,2,1,1
1/12/2021,Poland,Johor,0,0,0
1/12/2021,Poland,Kedah,1,0,1
1/12/2021,Poland,Kelantan,0,0,0
1/12/2021,Poland,Melaka,0,0,0
1/12/2021,Poland,Negeri Sembilan,0,0,0
1/12/2021,Poland,Pahang,0,0,0
1/12/2021,Poland,Perak,0,0,0
1/12/2021,Poland,Perlis,0,0,0
1/12/2021,Poland,Pulau Pinang,0,0,0
1/12/2021,Poland,Sabah,0,0,0
1/12/2021,Poland,Sarawak,0,0,0
1/12/2021,Poland,Selangor,29,21,8
1/12/2021,Poland,Terengganu,0,0,0
1/12/2021,Poland,W.P. Labuan,0,0,0
1/12/2021,"North Korea, Democratic People's Republic of",Selangor,0,0,0
1/12/2021,Portugal,Johor,0,0,0
1/12/2021,Portugal,Kedah,0,0,0
1/12/2021,Portugal,Kelantan,0,0,0
1/12/2021,Portugal,Melaka,0,0,0
1/12/2021,Portugal,Pahang,0,0,0
1/12/2021,Portugal,Perak,0,0,0
1/12/2021,Portugal,Perlis,0,0,0
1/12/2021,Portugal,Pulau Pinang,1,1,0
1/12/2021,Portugal,Sabah,0,0,0
1/12/2021,Portugal,Sarawak,0,0,0
1/12/2021,Portugal,Selangor,31,20,11
1/12/2021,Portugal,W.P. Labuan,0,0,0
1/12/2021,Paraguay,Johor,0,0,0
1/12/2021,Paraguay,Kedah,0,0,0
1/12/2021,Paraguay,Perak,0,0,0
1/12/2021,Paraguay,Perlis,0,0,0
1/12/2021,Paraguay,Pulau Pinang,0,0,0
1/12/2021,Paraguay,Sabah,0,0,0
1/12/2021,Paraguay,Sarawak,0,0,0
1/12/2021,Paraguay,Selangor,0,0,0
1/12/2021,"Palestine, State of",Johor,0,0,0
1/12/2021,"Palestine, State of",Kedah,0,0,0
1/12/2021,"Palestine, State of",Kelantan,0,0,0
1/12/2021,"Palestine, State of",Melaka,0,0,0
1/12/2021,"Palestine, State of",Perak,0,0,0
1/12/2021,"Palestine, State of",Perlis,0,0,0
1/12/2021,"Palestine, State of",Pulau Pinang,0,0,0
1/12/2021,"Palestine, State of",Sabah,0,0,0
1/12/2021,"Palestine, State of",Sarawak,0,0,0
1/12/2021,"Palestine, State of",Selangor,61,49,12
1/12/2021,Qatar,Johor,0,0,0
1/12/2021,Qatar,Kedah,0,0,0
1/12/2021,Qatar,Perlis,0,0,0
1/12/2021,Qatar,Pulau Pinang,0,0,0
1/12/2021,Qatar,Sabah,0,0,0
1/12/2021,Qatar,Sarawak,0,0,0
1/12/2021,Qatar,Selangor,1,1,0
1/12/2021,Réunion,Johor,0,0,0
1/12/2021,Réunion,Sarawak,0,0,0
1/12/2021,Romania,Johor,2,2,0
1/12/2021,Romania,Kedah,0,0,0
1/12/2021,Romania,Kelantan,0,0,0
1/12/2021,Romania,Negeri Sembilan,0,0,0
1/12/2021,Romania,Pahang,0,0,0
1/12/2021,Romania,Perak,0,0,0
1/12/2021,Romania,Perlis,0,0,0
1/12/2021,Romania,Pulau Pinang,0,0,0
1/12/2021,Romania,Sabah,0,0,0
1/12/2021,Romania,Sarawak,0,0,0
1/12/2021,Romania,Selangor,29,23,6
1/12/2021,Romania,W.P. Labuan,0,0,0
1/12/2021,Russian Federation (Russia),Johor,0,0,0
1/12/2021,Russian Federation (Russia),Kedah,0,0,0
1/12/2021,Russian Federation (Russia),Kelantan,0,0,0
1/12/2021,Russian Federation (Russia),Melaka,0,0,0
1/12/2021,Russian Federation (Russia),Negeri Sembilan,0,0,0
1/12/2021,Russian Federation (Russia),Pahang,0,0,0
1/12/2021,Russian Federation (Russia),Perak,0,0,0
1/12/2021,Russian Federation (Russia),Perlis,0,0,0
1/12/2021,Russian Federation (Russia),Pulau Pinang,0,0,0
1/12/2021,Russian Federation (Russia),Sabah,0,0,0
1/12/2021,Russian Federation (Russia),Sarawak,8,7,1
1/12/2021,Russian Federation (Russia),Selangor,113,77,36
1/12/2021,Russian Federation (Russia),W.P. Labuan,0,0,0
1/12/2021,Rwanda,Johor,0,0,0
1/12/2021,Rwanda,Kedah,0,0,0
1/12/2021,Rwanda,Pulau Pinang,0,0,0
1/12/2021,Rwanda,Selangor,2,1,1
1/12/2021,Saudi Arabia,Johor,0,0,0
1/12/2021,Saudi Arabia,Kedah,0,0,0
1/12/2021,Saudi Arabia,Kelantan,0,0,0
1/12/2021,Saudi Arabia,Melaka,0,0,0
1/12/2021,Saudi Arabia,Perak,0,0,0
1/12/2021,Saudi Arabia,Perlis,0,0,0
1/12/2021,Saudi Arabia,Pulau Pinang,0,0,0
1/12/2021,Saudi Arabia,Sabah,0,0,0
1/12/2021,Saudi Arabia,Sarawak,1,1,0
1/12/2021,Saudi Arabia,Selangor,211,132,79
1/12/2021,Saudi Arabia,W.P. Labuan,0,0,0
1/12/2021,Sudan,Johor,0,0,0
1/12/2021,Sudan,Kedah,0,0,0
1/12/2021,Sudan,Kelantan,0,0,0
1/12/2021,Sudan,Perlis,0,0,0
1/12/2021,Sudan,Pulau Pinang,0,0,0
1/12/2021,Sudan,Sabah,0,0,0
1/12/2021,Sudan,Sarawak,0,0,0
1/12/2021,Sudan,Selangor,146,95,51
1/12/2021,Sudan,W.P. Labuan,0,0,0
1/12/2021,Senegal,Johor,0,0,0
1/12/2021,Senegal,Kedah,0,0,0
1/12/2021,Senegal,Kelantan,0,0,0
1/12/2021,Senegal,Perak,0,0,0
1/12/2021,Senegal,Perlis,0,0,0
1/12/2021,Senegal,Pulau Pinang,0,0,0
1/12/2021,Senegal,Sabah,0,0,0
1/12/2021,Senegal,Sarawak,0,0,0
1/12/2021,Senegal,Selangor,4,2,2
1/12/2021,Singapore,Johor,2642,1423,1219
1/12/2021,Singapore,Kedah,16,7,9
1/12/2021,Singapore,Kelantan,0,0,0
1/12/2021,Singapore,Melaka,0,0,0
1/12/2021,Singapore,Negeri Sembilan,0,0,0
1/12/2021,Singapore,Pahang,0,0,0
1/12/2021,Singapore,Perak,4,2,2
1/12/2021,Singapore,Perlis,0,0,0
1/12/2021,Singapore,Pulau Pinang,18,6,12
1/12/2021,Singapore,Sabah,0,0,0
1/12/2021,Singapore,Sarawak,28,17,11
1/12/2021,Singapore,Selangor,10716,6000,4716
1/12/2021,Singapore,Terengganu,0,0,0
1/12/2021,Singapore,W.P. Labuan,0,0,0
1/12/2021,South Georgia and the South Sandwich Islands,Johor,0,0,0
1/12/2021,South Georgia and the South Sandwich Islands,Sabah,0,0,0
1/12/2021,South Georgia and the South Sandwich Islands,Selangor,0,0,0
1/12/2021,Saint Helena,Sarawak,0,0,0
1/12/2021,Solomon Islands,Johor,0,0,0
1/12/2021,Solomon Islands,Perlis,0,0,0
1/12/2021,Solomon Islands,Pulau Pinang,0,0,0
1/12/2021,Solomon Islands,Sabah,0,0,0
1/12/2021,Solomon Islands,Sarawak,1,1,0
1/12/2021,Solomon Islands,Selangor,1,1,0
1/12/2021,Solomon Islands,W.P. Labuan,0,0,0
1/12/2021,Sierra Leone,Johor,0,0,0
1/12/2021,Sierra Leone,Kedah,0,0,0
1/12/2021,Sierra Leone,Perak,0,0,0
1/12/2021,Sierra Leone,Pulau Pinang,0,0,0
1/12/2021,Sierra Leone,Sabah,0,0,0
1/12/2021,Sierra Leone,Selangor,0,0,0
1/12/2021,El Salvador,Johor,0,0,0
1/12/2021,El Salvador,Kedah,0,0,0
1/12/2021,El Salvador,Perak,0,0,0
1/12/2021,El Salvador,Perlis,0,0,0
1/12/2021,El Salvador,Pulau Pinang,0,0,0
1/12/2021,El Salvador,Sabah,0,0,0
1/12/2021,El Salvador,Selangor,0,0,0
1/12/2021,El Salvador,W.P. Labuan,0,0,0
1/12/2021,San Marino,Johor,0,0,0
1/12/2021,San Marino,Selangor,0,0,0
1/12/2021,Somalia,Johor,0,0,0
1/12/2021,Somalia,Kedah,0,0,0
1/12/2021,Somalia,Kelantan,0,0,0
1/12/2021,Somalia,Perlis,0,0,0
1/12/2021,Somalia,Sabah,0,0,0
1/12/2021,Somalia,Sarawak,0,0,0
1/12/2021,Somalia,Selangor,80,51,29
1/12/2021,Serbia,Johor,0,0,0
1/12/2021,Serbia,Kedah,0,0,0
1/12/2021,Serbia,Kelantan,0,0,0
1/12/2021,Serbia,Pahang,0,0,0
1/12/2021,Serbia,Perak,0,0,0
1/12/2021,Serbia,Perlis,0,0,0
1/12/2021,Serbia,Pulau Pinang,0,0,0
1/12/2021,Serbia,Sabah,0,0,0
1/12/2021,Serbia,Sarawak,0,0,0
1/12/2021,Serbia,Selangor,5,5,0
1/12/2021,South Sudan,Johor,0,0,0
1/12/2021,South Sudan,Kedah,0,0,0
1/12/2021,South Sudan,Sarawak,0,0,0
1/12/2021,South Sudan,Selangor,2,1,1
1/12/2021,South Sudan,W.P. Labuan,0,0,0
1/12/2021,Sao Tome and Principe,Selangor,0,0,0
1/12/2021,Suriname,Johor,0,0,0
1/12/2021,Suriname,Kedah,0,0,0
1/12/2021,Suriname,Kelantan,0,0,0
1/12/2021,Suriname,Perak,0,0,0
1/12/2021,Suriname,Perlis,0,0,0
1/12/2021,Suriname,Pulau Pinang,0,0,0
1/12/2021,Suriname,Sabah,0,0,0
1/12/2021,Suriname,Sarawak,0,0,0
1/12/2021,Suriname,Selangor,0,0,0
1/12/2021,Slovakia,Johor,0,0,0
1/12/2021,Slovakia,Kedah,0,0,0
1/12/2021,Slovakia,Kelantan,0,0,0
1/12/2021,Slovakia,Negeri Sembilan,0,0,0
1/12/2021,Slovakia,Pahang,0,0,0
1/12/2021,Slovakia,Perak,0,0,0
1/12/2021,Slovakia,Perlis,0,0,0
1/12/2021,Slovakia,Pulau Pinang,0,0,0
1/12/2021,Slovakia,Sabah,0,0,0
1/12/2021,Slovakia,Sarawak,0,0,0
1/12/2021,Slovakia,Selangor,10,4,6
1/12/2021,Slovakia,W.P. Labuan,0,0,0
1/12/2021,Slovenia,Johor,0,0,0
1/12/2021,Slovenia,Kedah,0,0,0
1/12/2021,Slovenia,Kelantan,0,0,0
1/12/2021,Slovenia,Perak,0,0,0
1/12/2021,Slovenia,Perlis,0,0,0
1/12/2021,Slovenia,Pulau Pinang,0,0,0
1/12/2021,Slovenia,Sabah,0,0,0
1/12/2021,Slovenia,Sarawak,0,0,0
1/12/2021,Slovenia,Selangor,3,2,1
1/12/2021,Slovenia,W.P. Labuan,0,0,0
1/12/2021,Sweden,Johor,0,0,0
1/12/2021,Sweden,Kedah,0,0,0
1/12/2021,Sweden,Kelantan,0,0,0
1/12/2021,Sweden,Melaka,0,0,0
1/12/2021,Sweden,Negeri Sembilan,0,0,0
1/12/2021,Sweden,Pahang,0,0,0
1/12/2021,Sweden,Perak,0,0,0
1/12/2021,Sweden,Perlis,0,0,0
1/12/2021,Sweden,Pulau Pinang,3,1,2
1/12/2021,Sweden,Sabah,0,0,0
1/12/2021,Sweden,Sarawak,0,0,0
1/12/2021,Sweden,Selangor,79,54,25
1/12/2021,Sweden,W.P. Labuan,0,0,0
1/12/2021,Eswatini,Johor,0,0,0
1/12/2021,Eswatini,Kedah,0,0,0
1/12/2021,Eswatini,Pulau Pinang,0,0,0
1/12/2021,Eswatini,Sabah,0,0,0
1/12/2021,Eswatini,Selangor,1,1,0
1/12/2021,Seychelles,Johor,0,0,0
1/12/2021,Seychelles,Kedah,0,0,0
1/12/2021,Seychelles,Pulau Pinang,0,0,0
1/12/2021,Seychelles,Sabah,0,0,0
1/12/2021,Seychelles,Sarawak,1,1,0
1/12/2021,Seychelles,Selangor,12,3,9
1/12/2021,Syrian Arab Republic,Johor,0,0,0
1/12/2021,Syrian Arab Republic,Kedah,0,0,0
1/12/2021,Syrian Arab Republic,Kelantan,0,0,0
1/12/2021,Syrian Arab Republic,Pahang,0,0,0
1/12/2021,Syrian Arab Republic,Perlis,0,0,0
1/12/2021,Syrian Arab Republic,Pulau Pinang,0,0,0
1/12/2021,Syrian Arab Republic,Sabah,0,0,0
1/12/2021,Syrian Arab Republic,Sarawak,0,0,0
1/12/2021,Syrian Arab Republic,Selangor,90,55,35
1/12/2021,Syrian Arab Republic,W.P. Labuan,0,0,0
1/12/2021,Turks and Caicos Islands,Perlis,0,0,0
1/12/2021,TCD,Johor,0,0,0
1/12/2021,TCD,Kedah,0,0,0
1/12/2021,TCD,Perlis,0,0,0
1/12/2021,TCD,Selangor,4,3,1
1/12/2021,Togo,Johor,0,0,0
1/12/2021,Togo,Perak,0,0,0
1/12/2021,Togo,Pulau Pinang,0,0,0
1/12/2021,Togo,Selangor,0,0,0
1/12/2021,Thailand,Johor,44,43,1
1/12/2021,Thailand,Kedah,18122,18065,57
1/12/2021,Thailand,Kelantan,0,0,0
1/12/2021,Thailand,Melaka,0,0,0
1/12/2021,Thailand,Negeri Sembilan,0,0,0
1/12/2021,Thailand,Pahang,0,0,0
1/12/2021,Thailand,Perak,0,0,0
1/12/2021,Thailand,Perlis,9207,9060,147
1/12/2021,Thailand,Pulau Pinang,77,73,4
1/12/2021,Thailand,Sabah,0,0,0
1/12/2021,Thailand,Sarawak,9,8,1
1/12/2021,Thailand,Selangor,583,183,400
1/12/2021,Thailand,Terengganu,0,0,0
1/12/2021,Thailand,W.P. Labuan,0,0,0
1/12/2021,Tajikistan,Johor,0,0,0
1/12/2021,Tajikistan,Kedah,0,0,0
1/12/2021,Tajikistan,Perlis,0,0,0
1/12/2021,Tajikistan,Pulau Pinang,0,0,0
1/12/2021,Tajikistan,Sabah,0,0,0
1/12/2021,Tajikistan,Selangor,8,4,4
1/12/2021,Tokelau,Selangor,0,0,0
1/12/2021,Turkmenistan,Johor,0,0,0
1/12/2021,Turkmenistan,Kedah,0,0,0
1/12/2021,Turkmenistan,Kelantan,0,0,0
1/12/2021,Turkmenistan,Perlis,0,0,0
1/12/2021,Turkmenistan,Pulau Pinang,0,0,0
1/12/2021,Turkmenistan,Sabah,0,0,0
1/12/2021,Turkmenistan,Sarawak,0,0,0
1/12/2021,Turkmenistan,Selangor,9,6,3
1/12/2021,Timor-Leste,Johor,0,0,0
1/12/2021,Timor-Leste,Kedah,0,0,0
1/12/2021,Timor-Leste,Perlis,0,0,0
1/12/2021,Timor-Leste,Pulau Pinang,0,0,0
1/12/2021,Timor-Leste,Sabah,0,0,0
1/12/2021,Timor-Leste,Sarawak,0,0,0
1/12/2021,Timor-Leste,Selangor,7,2,5
1/12/2021,Tonga,Johor,0,0,0
1/12/2021,Tonga,Pulau Pinang,0,0,0
1/12/2021,Tonga,Sarawak,0,0,0
1/12/2021,Tonga,Selangor,0,0,0
1/12/2021,Trinidad and Tobago,Johor,0,0,0
1/12/2021,Trinidad and Tobago,Kedah,0,0,0
1/12/2021,Trinidad and Tobago,Pahang,0,0,0
1/12/2021,Trinidad and Tobago,Pulau Pinang,0,0,0
1/12/2021,Trinidad and Tobago,Sabah,0,0,0
1/12/2021,Trinidad and Tobago,Sarawak,0,0,0
1/12/2021,Trinidad and Tobago,Selangor,0,0,0
1/12/2021,Tunisia,Johor,0,0,0
1/12/2021,Tunisia,Kedah,0,0,0
1/12/2021,Tunisia,Kelantan,0,0,0
1/12/2021,Tunisia,Melaka,0,0,0
1/12/2021,Tunisia,Perak,0,0,0
1/12/2021,Tunisia,Perlis,0,0,0
1/12/2021,Tunisia,Pulau Pinang,0,0,0
1/12/2021,Tunisia,Sabah,0,0,0
1/12/2021,Tunisia,Sarawak,0,0,0
1/12/2021,Tunisia,Selangor,11,5,6
1/12/2021,Tunisia,W.P. Labuan,0,0,0
1/12/2021,Türkiye,Johor,0,0,0
1/12/2021,Türkiye,Kedah,0,0,0
1/12/2021,Türkiye,Kelantan,0,0,0
1/12/2021,Türkiye,Melaka,0,0,0
1/12/2021,Türkiye,Negeri Sembilan,0,0,0
1/12/2021,Türkiye,Pahang,0,0,0
1/12/2021,Türkiye,Perak,1,1,0
1/12/2021,Türkiye,Perlis,0,0,0
1/12/2021,Türkiye,Pulau Pinang,0,0,0
1/12/2021,Türkiye,Sabah,0,0,0
1/12/2021,Türkiye,Sarawak,0,0,0
1/12/2021,Türkiye,Selangor,92,73,19
1/12/2021,Türkiye,W.P. Labuan,0,0,0
1/12/2021,Tuvalu,Selangor,0,0,0
1/12/2021,"Taiwan, Province of China",Johor,4,2,2
1/12/2021,"Taiwan, Province of China",Kedah,3,1,2
1/12/2021,"Taiwan, Province of China",Kelantan,0,0,0
1/12/2021,"Taiwan, Province of China",Melaka,0,0,0
1/12/2021,"Taiwan, Province of China",Negeri Sembilan,0,0,0
1/12/2021,"Taiwan, Province of China",Pahang,0,0,0
1/12/2021,"Taiwan, Province of China",Perak,0,0,0
1/12/2021,"Taiwan, Province of China",Perlis,0,0,0
1/12/2021,"Taiwan, Province of China",Pulau Pinang,13,8,5
1/12/2021,"Taiwan, Province of China",Sabah,1,0,1
1/12/2021,"Taiwan, Province of China",Sarawak,2,0,2
1/12/2021,"Taiwan, Province of China",Selangor,205,128,77
1/12/2021,"Taiwan, Province of China",W.P. Labuan,0,0,0
1/12/2021,"Tanzania, United Republic of",Johor,0,0,0
1/12/2021,"Tanzania, United Republic of",Kedah,0,0,0
1/12/2021,"Tanzania, United Republic of",Perak,0,0,0
1/12/2021,"Tanzania, United Republic of",Perlis,0,0,0
1/12/2021,"Tanzania, United Republic of",Pulau Pinang,0,0,0
1/12/2021,"Tanzania, United Republic of",Sabah,0,0,0
1/12/2021,"Tanzania, United Republic of",Sarawak,0,0,0
1/12/2021,"Tanzania, United Republic of",Selangor,36,14,22
1/12/2021,Uganda,Johor,0,0,0
1/12/2021,Uganda,Kedah,0,0,0
1/12/2021,Uganda,Perak,0,0,0
1/12/2021,Uganda,Perlis,0,0,0
1/12/2021,Uganda,Pulau Pinang,0,0,0
1/12/2021,Uganda,Sabah,0,0,0
1/12/2021,Uganda,Sarawak,0,0,0
1/12/2021,Uganda,Selangor,15,10,5
1/12/2021,Ukraine,Johor,0,0,0
1/12/2021,Ukraine,Kedah,0,0,0
1/12/2021,Ukraine,Kelantan,0,0,0
1/12/2021,Ukraine,Melaka,0,0,0
1/12/2021,Ukraine,Negeri Sembilan,0,0,0
1/12/2021,Ukraine,Pahang,0,0,0
1/12/2021,Ukraine,Perak,0,0,0
1/12/2021,Ukraine,Perlis,0,0,0
1/12/2021,Ukraine,Pulau Pinang,8,8,0
1/12/2021,Ukraine,Sabah,0,0,0
1/12/2021,Ukraine,Sarawak,0,0,0
1/12/2021,Ukraine,Selangor,85,81,4
1/12/2021,Ukraine,W.P. Labuan,0,0,0
1/12/2021,Uruguay,Johor,0,0,0
1/12/2021,Uruguay,Kedah,0,0,0
1/12/2021,Uruguay,Kelantan,0,0,0
1/12/2021,Uruguay,Perak,0,0,0
1/12/2021,Uruguay,Perlis,0,0,0
1/12/2021,Uruguay,Pulau Pinang,0,0,0
1/12/2021,Uruguay,Sabah,0,0,0
1/12/2021,Uruguay,Sarawak,0,0,0
1/12/2021,Uruguay,Selangor,6,3,3
1/12/2021,Uruguay,W.P. Labuan,0,0,0
1/12/2021,United States of America,Johor,0,0,0
1/12/2021,United States of America,Kedah,7,7,0
1/12/2021,United States of America,Kelantan,0,0,0
1/12/2021,United States of America,Melaka,0,0,0
1/12/2021,United States of America,Negeri Sembilan,0,0,0
1/12/2021,United States of America,Pahang,0,0,0
1/12/2021,United States of America,Perak,0,0,0
1/12/2021,United States of America,Perlis,0,0,0
1/12/2021,United States of America,Pulau Pinang,21,8,13
1/12/2021,United States of America,Sabah,2,1,1
1/12/2021,United States of America,Sarawak,7,5,2
1/12/2021,United States of America,Selangor,704,453,251
1/12/2021,United States of America,Terengganu,0,0,0
1/12/2021,United States of America,W.P. Labuan,0,0,0
1/12/2021,Uzbekistan,Johor,0,0,0
1/12/2021,Uzbekistan,Kedah,0,0,0
1/12/2021,Uzbekistan,Kelantan,0,0,0
1/12/2021,Uzbekistan,Perak,0,0,0
1/12/2021,Uzbekistan,Perlis,0,0,0
1/12/2021,Uzbekistan,Pulau Pinang,0,0,0
1/12/2021,Uzbekistan,Sabah,0,0,0
1/12/2021,Uzbekistan,Sarawak,0,0,0
1/12/2021,Uzbekistan,Selangor,45,30,15
1/12/2021,Holy See,Johor,0,0,0
1/12/2021,Holy See,Sarawak,0,0,0
1/12/2021,Holy See,Selangor,1,1,0
1/12/2021,Saint Vincent and the Grenadines,Johor,0,0,0
1/12/2021,Saint Vincent and the Grenadines,Kedah,0,0,0
1/12/2021,Saint Vincent and the Grenadines,Pulau Pinang,0,0,0
1/12/2021,Saint Vincent and the Grenadines,Sarawak,0,0,0
1/12/2021,Saint Vincent and the Grenadines,Selangor,0,0,0
1/12/2021,"Venezuela, Bolivarian Republic of",Johor,0,0,0
1/12/2021,"Venezuela, Bolivarian Republic of",Kedah,0,0,0
1/12/2021,"Venezuela, Bolivarian Republic of",Kelantan,0,0,0
1/12/2021,"Venezuela, Bolivarian Republic of",Melaka,0,0,0
1/12/2021,"Venezuela, Bolivarian Republic of",Perak,0,0,0
1/12/2021,"Venezuela, Bolivarian Republic of",Perlis,0,0,0
1/12/2021,"Venezuela, Bolivarian Republic of",Pulau Pinang,0,0,0
1/12/2021,"Venezuela, Bolivarian Republic of",Sabah,0,0,0
1/12/2021,"Venezuela, Bolivarian Republic of",Sarawak,0,0,0
1/12/2021,"Venezuela, Bolivarian Republic of",Selangor,4,4,0
1/12/2021,"Venezuela, Bolivarian Republic of",W.P. Labuan,0,0,0
1/12/2021,Viet Nam,Johor,2,0,2
1/12/2021,Viet Nam,Kedah,9,2,7
1/12/2021,Viet Nam,Kelantan,0,0,0
1/12/2021,Viet Nam,Melaka,0,0,0
1/12/2021,Viet Nam,Negeri Sembilan,0,0,0
1/12/2021,Viet Nam,Pahang,0,0,0
1/12/2021,Viet Nam,Perak,1,0,1
1/12/2021,Viet Nam,Perlis,0,0,0
1/12/2021,Viet Nam,Pulau Pinang,3,1,2
1/12/2021,Viet Nam,Sabah,1,0,1
1/12/2021,Viet Nam,Sarawak,2,0,2
1/12/2021,Viet Nam,Selangor,240,63,177
1/12/2021,Viet Nam,Terengganu,0,0,0
1/12/2021,Viet Nam,W.P. Labuan,0,0,0
1/12/2021,Vanuatu,Johor,0,0,0
1/12/2021,Vanuatu,Kedah,0,0,0
1/12/2021,Vanuatu,Pulau Pinang,0,0,0
1/12/2021,Vanuatu,Sabah,0,0,0
1/12/2021,Vanuatu,Sarawak,0,0,0
1/12/2021,Vanuatu,Selangor,6,4,2
1/12/2021, Samoa,Johor,0,0,0
1/12/2021, Samoa,Sarawak,0,0,0
1/12/2021, Samoa,Selangor,0,0,0
1/12/2021,Yemen,Johor,0,0,0
1/12/2021,Yemen,Kedah,2,2,0
1/12/2021,Yemen,Kelantan,0,0,0
1/12/2021,Yemen,Melaka,0,0,0
1/12/2021,Yemen,Pahang,0,0,0
1/12/2021,Yemen,Perak,0,0,0
1/12/2021,Yemen,Perlis,0,0,0
1/12/2021,Yemen,Pulau Pinang,0,0,0
1/12/2021,Yemen,Sabah,0,0,0
1/12/2021,Yemen,Sarawak,0,0,0
1/12/2021,Yemen,Selangor,283,202,81
1/12/2021,Yemen,W.P. Labuan,0,0,0
1/12/2021,South Africa,Johor,0,0,0
1/12/2021,South Africa,Kedah,1,1,0
1/12/2021,South Africa,Kelantan,0,0,0
1/12/2021,South Africa,Melaka,0,0,0
1/12/2021,South Africa,Pahang,0,0,0
1/12/2021,South Africa,Perak,0,0,0
1/12/2021,South Africa,Perlis,0,0,0
1/12/2021,South Africa,Pulau Pinang,0,0,0
1/12/2021,South Africa,Sabah,0,0,0
1/12/2021,South Africa,Sarawak,0,0,0
1/12/2021,South Africa,Selangor,37,24,13
1/12/2021,South Africa,Terengganu,0,0,0
1/12/2021,South Africa,W.P. Labuan,0,0,0
1/12/2021,ZAR,Selangor,0,0,0
1/12/2021,Zambia,Johor,0,0,0
1/12/2021,Zambia,Kedah,0,0,0
1/12/2021,Zambia,Perak,0,0,0
1/12/2021,Zambia,Perlis,0,0,0
1/12/2021,Zambia,Pulau Pinang,0,0,0
1/12/2021,Zambia,Sabah,0,0,0
1/12/2021,Zambia,Sarawak,0,0,0
1/12/2021,Zambia,Selangor,6,3,3
1/12/2021,Zimbabwe,Johor,0,0,0
1/12/2021,Zimbabwe,Kedah,0,0,0
1/12/2021,Zimbabwe,Kelantan,0,0,0
1/12/2021,Zimbabwe,Perak,0,0,0
1/12/2021,Zimbabwe,Perlis,0,0,0
1/12/2021,Zimbabwe,Pulau Pinang,0,0,0
1/12/2021,Zimbabwe,Sabah,0,0,0
1/12/2021,Zimbabwe,Sarawak,0,0,0
1/12/2021,Zimbabwe,Selangor,1,0,1
1/01/2022,Aruba,Kedah,0,0,0
1/01/2022,Aruba,Pulau Pinang,0,0,0
1/01/2022,Afghanistan,Johor,0,0,0
1/01/2022,Afghanistan,Kedah,0,0,0
1/01/2022,Afghanistan,Perlis,0,0,0
1/01/2022,Afghanistan,Pulau Pinang,0,0,0
1/01/2022,Afghanistan,Sarawak,0,0,0
1/01/2022,Afghanistan,Selangor,65,52,13
1/01/2022,Angola,Johor,0,0,0
1/01/2022,Angola,Kedah,0,0,0
1/01/2022,Angola,Sabah,0,0,0
1/01/2022,Angola,Selangor,4,3,1
1/01/2022,Anguilla,Selangor,0,0,0
1/01/2022,Albania,Johor,0,0,0
1/01/2022,Albania,Kedah,0,0,0
1/01/2022,Albania,Perak,0,0,0
1/01/2022,Albania,Perlis,0,0,0
1/01/2022,Albania,Pulau Pinang,0,0,0
1/01/2022,Albania,Sabah,0,0,0
1/01/2022,Albania,Sarawak,0,0,0
1/01/2022,Albania,Selangor,5,4,1
1/01/2022,Andorra,Johor,0,0,0
1/01/2022,Andorra,Kedah,0,0,0
1/01/2022,Andorra,Perlis,0,0,0
1/01/2022,Andorra,Pulau Pinang,0,0,0
1/01/2022,Andorra,Selangor,0,0,0
1/01/2022,Antigua and Barbuda,Selangor,0,0,0
1/01/2022,United Arab Emirates,Johor,0,0,0
1/01/2022,United Arab Emirates,Kedah,0,0,0
1/01/2022,United Arab Emirates,Kelantan,0,0,0
1/01/2022,United Arab Emirates,Perak,0,0,0
1/01/2022,United Arab Emirates,Perlis,0,0,0
1/01/2022,United Arab Emirates,Pulau Pinang,0,0,0
1/01/2022,United Arab Emirates,Sabah,0,0,0
1/01/2022,United Arab Emirates,Sarawak,0,0,0
1/01/2022,United Arab Emirates,Selangor,10,7,3
1/01/2022,Argentina,Johor,0,0,0
1/01/2022,Argentina,Kedah,0,0,0
1/01/2022,Argentina,Kelantan,0,0,0
1/01/2022,Argentina,Melaka,0,0,0
1/01/2022,Argentina,Perak,0,0,0
1/01/2022,Argentina,Perlis,0,0,0
1/01/2022,Argentina,Pulau Pinang,0,0,0
1/01/2022,Argentina,Sabah,0,0,0
1/01/2022,Argentina,Sarawak,0,0,0
1/01/2022,Argentina,Selangor,42,24,18
1/01/2022,Argentina,W.P. Labuan,0,0,0
1/01/2022,Armenia,Johor,0,0,0
1/01/2022,Armenia,Kedah,0,0,0
1/01/2022,Armenia,Kelantan,0,0,0
1/01/2022,Armenia,Perak,0,0,0
1/01/2022,Armenia,Perlis,0,0,0
1/01/2022,Armenia,Pulau Pinang,0,0,0
1/01/2022,Armenia,Sabah,0,0,0
1/01/2022,Armenia,Sarawak,0,0,0
1/01/2022,Armenia,Selangor,6,2,4
1/01/2022,Antarctica,Selangor,0,0,0
1/01/2022,Antigua and Barbuda,Johor,0,0,0
1/01/2022,Antigua and Barbuda,Kedah,0,0,0
1/01/2022,Antigua and Barbuda,Pulau Pinang,0,0,0
1/01/2022,Antigua and Barbuda,Sarawak,0,0,0
1/01/2022,Antigua and Barbuda,Selangor,0,0,0
1/01/2022,Australia,Johor,0,0,0
1/01/2022,Australia,Kedah,45,29,16
1/01/2022,Australia,Kelantan,0,0,0
1/01/2022,Australia,Melaka,0,0,0
1/01/2022,Australia,Negeri Sembilan,0,0,0
1/01/2022,Australia,Pahang,0,0,0
1/01/2022,Australia,Perak,0,0,0
1/01/2022,Australia,Perlis,0,0,0
1/01/2022,Australia,Pulau Pinang,20,11,9
1/01/2022,Australia,Sabah,0,0,0
1/01/2022,Australia,Sarawak,7,3,4
1/01/2022,Australia,Selangor,901,569,332
1/01/2022,Australia,Terengganu,0,0,0
1/01/2022,Australia,W.P. Labuan,0,0,0
1/01/2022,Austria,Johor,1,0,1
1/01/2022,Austria,Kedah,1,1,0
1/01/2022,Austria,Kelantan,0,0,0
1/01/2022,Austria,Melaka,0,0,0
1/01/2022,Austria,Negeri Sembilan,0,0,0
1/01/2022,Austria,Pahang,0,0,0
1/01/2022,Austria,Perak,0,0,0
1/01/2022,Austria,Perlis,0,0,0
1/01/2022,Austria,Pulau Pinang,0,0,0
1/01/2022,Austria,Sabah,1,1,0
1/01/2022,Austria,Sarawak,0,0,0
1/01/2022,Austria,Selangor,63,52,11
1/01/2022,Austria,Terengganu,0,0,0
1/01/2022,Austria,W.P. Labuan,0,0,0
1/01/2022,Azerbaijan,Johor,0,0,0
1/01/2022,Azerbaijan,Kedah,0,0,0
1/01/2022,Azerbaijan,Kelantan,0,0,0
1/01/2022,Azerbaijan,Melaka,0,0,0
1/01/2022,Azerbaijan,Perlis,0,0,0
1/01/2022,Azerbaijan,Pulau Pinang,0,0,0
1/01/2022,Azerbaijan,Sabah,0,0,0
1/01/2022,Azerbaijan,Sarawak,0,0,0
1/01/2022,Azerbaijan,Selangor,14,9,5
1/01/2022,Azerbaijan,W.P. Labuan,0,0,0
1/01/2022,Burundi,Pulau Pinang,0,0,0
1/01/2022,Burundi,Sarawak,0,0,0
1/01/2022,Burundi,Selangor,2,2,0
1/01/2022,Belgium,Johor,0,0,0
1/01/2022,Belgium,Kedah,0,0,0
1/01/2022,Belgium,Kelantan,0,0,0
1/01/2022,Belgium,Melaka,0,0,0
1/01/2022,Belgium,Negeri Sembilan,0,0,0
1/01/2022,Belgium,Pahang,0,0,0
1/01/2022,Belgium,Perak,0,0,0
1/01/2022,Belgium,Perlis,0,0,0
1/01/2022,Belgium,Pulau Pinang,0,0,0
1/01/2022,Belgium,Sabah,0,0,0
1/01/2022,Belgium,Sarawak,0,0,0
1/01/2022,Belgium,Selangor,65,43,22
1/01/2022,Belgium,W.P. Labuan,0,0,0
1/01/2022,Benin,Johor,0,0,0
1/01/2022,Benin,Kedah,0,0,0
1/01/2022,Benin,Perak,0,0,0
1/01/2022,Benin,Pulau Pinang,0,0,0
1/01/2022,Benin,Sabah,0,0,0
1/01/2022,Benin,Sarawak,0,0,0
1/01/2022,Benin,Selangor,1,1,0
1/01/2022,Burkina Faso,Perak,0,0,0
1/01/2022,Burkina Faso,Pulau Pinang,0,0,0
1/01/2022,Burkina Faso,Selangor,2,2,0
1/01/2022,Bangladesh,Johor,11,9,2
1/01/2022,Bangladesh,Kedah,0,0,0
1/01/2022,Bangladesh,Kelantan,0,0,0
1/01/2022,Bangladesh,Melaka,0,0,0
1/01/2022,Bangladesh,Negeri Sembilan,0,0,0
1/01/2022,Bangladesh,Pahang,0,0,0
1/01/2022,Bangladesh,Perak,0,0,0
1/01/2022,Bangladesh,Perlis,0,0,0
1/01/2022,Bangladesh,Pulau Pinang,1,1,0
1/01/2022,Bangladesh,Sabah,1,1,0
1/01/2022,Bangladesh,Sarawak,0,0,0
1/01/2022,Bangladesh,Selangor,5380,4995,385
1/01/2022,Bangladesh,W.P. Labuan,0,0,0
1/01/2022,Bulgaria,Johor,1,1,0
1/01/2022,Bulgaria,Kedah,0,0,0
1/01/2022,Bulgaria,Kelantan,0,0,0
1/01/2022,Bulgaria,Pahang,0,0,0
1/01/2022,Bulgaria,Perak,0,0,0
1/01/2022,Bulgaria,Perlis,0,0,0
1/01/2022,Bulgaria,Pulau Pinang,0,0,0
1/01/2022,Bulgaria,Sabah,0,0,0
1/01/2022,Bulgaria,Sarawak,0,0,0
1/01/2022,Bulgaria,Selangor,17,15,2
1/01/2022,Bulgaria,W.P. Labuan,0,0,0
1/01/2022,Bahrain,Johor,0,0,0
1/01/2022,Bahrain,Kedah,0,0,0
1/01/2022,Bahrain,Kelantan,0,0,0
1/01/2022,Bahrain,Perlis,0,0,0
1/01/2022,Bahrain,Pulau Pinang,0,0,0
1/01/2022,Bahrain,Sabah,0,0,0
1/01/2022,Bahrain,Sarawak,0,0,0
1/01/2022,Bahrain,Selangor,8,7,1
1/01/2022,Bahamas,Johor,0,0,0
1/01/2022,Bahamas,Kedah,0,0,0
1/01/2022,Bahamas,Perak,0,0,0
1/01/2022,Bahamas,Sabah,0,0,0
1/01/2022,Bahamas,Sarawak,0,0,0
1/01/2022,Bahamas,Selangor,0,0,0
1/01/2022,Bosnia and Herzegovina,Johor,0,0,0
1/01/2022,Bosnia and Herzegovina,Kedah,0,0,0
1/01/2022,Bosnia and Herzegovina,Perlis,0,0,0
1/01/2022,Bosnia and Herzegovina,Pulau Pinang,0,0,0
1/01/2022,Bosnia and Herzegovina,Sabah,0,0,0
1/01/2022,Bosnia and Herzegovina,Sarawak,0,0,0
1/01/2022,Bosnia and Herzegovina,Selangor,6,5,1
1/01/2022,Belarus,Johor,0,0,0
1/01/2022,Belarus,Kedah,0,0,0
1/01/2022,Belarus,Kelantan,0,0,0
1/01/2022,Belarus,Pahang,0,0,0
1/01/2022,Belarus,Perak,0,0,0
1/01/2022,Belarus,Perlis,0,0,0
1/01/2022,Belarus,Pulau Pinang,0,0,0
1/01/2022,Belarus,Sabah,0,0,0
1/01/2022,Belarus,Sarawak,0,0,0
1/01/2022,Belarus,Selangor,3,3,0
1/01/2022,Belarus,W.P. Labuan,0,0,0
1/01/2022,Belize,Johor,0,0,0
1/01/2022,Belize,Pulau Pinang,0,0,0
1/01/2022,Belize,Sarawak,0,0,0
1/01/2022,Belize,Selangor,0,0,0
1/01/2022,Bermuda,Selangor,0,0,0
1/01/2022,Bolivia,Johor,0,0,0
1/01/2022,Bolivia,Kedah,0,0,0
1/01/2022,Bolivia,Melaka,0,0,0
1/01/2022,Bolivia,Perak,0,0,0
1/01/2022,Bolivia,Perlis,0,0,0
1/01/2022,Bolivia,Pulau Pinang,0,0,0
1/01/2022,Bolivia,Sabah,0,0,0
1/01/2022,Bolivia,Sarawak,0,0,0
1/01/2022,Bolivia,Selangor,0,0,0
1/01/2022,Brazil,Johor,0,0,0
1/01/2022,Brazil,Kedah,3,2,1
1/01/2022,Brazil,Kelantan,0,0,0
1/01/2022,Brazil,Melaka,0,0,0
1/01/2022,Brazil,Pahang,0,0,0
1/01/2022,Brazil,Perak,0,0,0
1/01/2022,Brazil,Perlis,0,0,0
1/01/2022,Brazil,Pulau Pinang,0,0,0
1/01/2022,Brazil,Sabah,0,0,0
1/01/2022,Brazil,Sarawak,0,0,0
1/01/2022,Brazil,Selangor,128,75,53
1/01/2022,Brazil,W.P. Labuan,0,0,0
1/01/2022,Barbados,Johor,0,0,0
1/01/2022,Barbados,Kedah,0,0,0
1/01/2022,Barbados,Perlis,0,0,0
1/01/2022,Barbados,Pulau Pinang,0,0,0
1/01/2022,Barbados,Selangor,1,1,0
1/01/2022,Brunei Darussalam,Johor,0,0,0
1/01/2022,Brunei Darussalam,Kedah,0,0,0
1/01/2022,Brunei Darussalam,Kelantan,0,0,0
1/01/2022,Brunei Darussalam,Melaka,0,0,0
1/01/2022,Brunei Darussalam,Pahang,0,0,0
1/01/2022,Brunei Darussalam,Perak,0,0,0
1/01/2022,Brunei Darussalam,Perlis,0,0,0
1/01/2022,Brunei Darussalam,Pulau Pinang,0,0,0
1/01/2022,Brunei Darussalam,Sabah,0,0,0
1/01/2022,Brunei Darussalam,Sarawak,422,408,14
1/01/2022,Brunei Darussalam,Selangor,81,51,30
1/01/2022,Brunei Darussalam,W.P. Labuan,2,2,0
1/01/2022,Bhutan,Johor,0,0,0
1/01/2022,Bhutan,Kedah,0,0,0
1/01/2022,Bhutan,Perak,0,0,0
1/01/2022,Bhutan,Perlis,0,0,0
1/01/2022,Bhutan,Pulau Pinang,0,0,0
1/01/2022,Bhutan,Sabah,0,0,0
1/01/2022,Bhutan,Sarawak,0,0,0
1/01/2022,Bhutan,Selangor,2,0,2
1/01/2022,Botswana,Johor,0,0,0
1/01/2022,Botswana,Kedah,0,0,0
1/01/2022,Botswana,Perlis,0,0,0
1/01/2022,Botswana,Pulau Pinang,0,0,0
1/01/2022,Botswana,Sabah,0,0,0
1/01/2022,Botswana,Sarawak,0,0,0
1/01/2022,Botswana,Selangor,3,1,2
1/01/2022,Central African Republic,Kedah,0,0,0
1/01/2022,Central African Republic,Selangor,0,0,0
1/01/2022,Canada,Johor,1,1,0
1/01/2022,Canada,Kedah,3,2,1
1/01/2022,Canada,Kelantan,0,0,0
1/01/2022,Canada,Melaka,0,0,0
1/01/2022,Canada,Negeri Sembilan,0,0,0
1/01/2022,Canada,Pahang,0,0,0
1/01/2022,Canada,Perak,0,0,0
1/01/2022,Canada,Perlis,0,0,0
1/01/2022,Canada,Pulau Pinang,0,0,0
1/01/2022,Canada,Sabah,1,1,0
1/01/2022,Canada,Sarawak,1,0,1
1/01/2022,Canada,Selangor,254,153,101
1/01/2022,Canada,Terengganu,0,0,0
1/01/2022,Canada,W.P. Labuan,0,0,0
1/01/2022,Cocos (Keeling) Islands,Selangor,0,0,0
1/01/2022,Switzerland,Johor,0,0,0
1/01/2022,Switzerland,Kedah,3,2,1
1/01/2022,Switzerland,Kelantan,0,0,0
1/01/2022,Switzerland,Melaka,0,0,0
1/01/2022,Switzerland,Negeri Sembilan,0,0,0
1/01/2022,Switzerland,Pahang,0,0,0
1/01/2022,Switzerland,Perak,0,0,0
1/01/2022,Switzerland,Perlis,0,0,0
1/01/2022,Switzerland,Pulau Pinang,3,3,0
1/01/2022,Switzerland,Sabah,1,0,1
1/01/2022,Switzerland,Sarawak,0,0,0
1/01/2022,Switzerland,Selangor,111,67,44
1/01/2022,Switzerland,W.P. Labuan,0,0,0
1/01/2022,Chile,Johor,0,0,0
1/01/2022,Chile,Kedah,0,0,0
1/01/2022,Chile,Kelantan,0,0,0
1/01/2022,Chile,Melaka,0,0,0
1/01/2022,Chile,Pahang,0,0,0
1/01/2022,Chile,Perak,0,0,0
1/01/2022,Chile,Perlis,0,0,0
1/01/2022,Chile,Pulau Pinang,0,0,0
1/01/2022,Chile,Sabah,0,0,0
1/01/2022,Chile,Sarawak,0,0,0
1/01/2022,Chile,Selangor,18,6,12
1/01/2022,China,Johor,154,145,9
1/01/2022,China,Kedah,6,1,5
1/01/2022,China,Kelantan,0,0,0
1/01/2022,China,Melaka,0,0,0
1/01/2022,China,Pahang,0,0,0
1/01/2022,China,Perak,0,0,0
1/01/2022,China,Perlis,0,0,0
1/01/2022,China,Pulau Pinang,7,4,3
1/01/2022,China,Sabah,4,3,1
1/01/2022,China,Sarawak,37,33,4
1/01/2022,China,Selangor,1844,1117,727
1/01/2022,China,Terengganu,0,0,0
1/01/2022,China,W.P. Labuan,0,0,0
1/01/2022,Côte d'Ivoire,Johor,0,0,0
1/01/2022,Côte d'Ivoire,Kedah,0,0,0
1/01/2022,Côte d'Ivoire,Pulau Pinang,0,0,0
1/01/2022,Côte d'Ivoire,Sabah,0,0,0
1/01/2022,Côte d'Ivoire,Sarawak,0,0,0
1/01/2022,Côte d'Ivoire,Selangor,2,1,1
1/01/2022,Cameroon,Johor,0,0,0
1/01/2022,Cameroon,Kedah,0,0,0
1/01/2022,Cameroon,Pulau Pinang,0,0,0
1/01/2022,Cameroon,Sabah,0,0,0
1/01/2022,Cameroon,Sarawak,0,0,0
1/01/2022,Cameroon,Selangor,4,2,2
1/01/2022,Congo,Johor,0,0,0
1/01/2022,Congo,Pulau Pinang,0,0,0
1/01/2022,Congo,Sarawak,0,0,0
1/01/2022,Congo,Selangor,2,2,0
1/01/2022,Congo,Johor,0,0,0
1/01/2022,Congo,Kedah,0,0,0
1/01/2022,Congo,Selangor,0,0,0
1/01/2022,Cook Islands,Selangor,0,0,0
1/01/2022,Colombia,Johor,0,0,0
1/01/2022,Colombia,Kedah,0,0,0
1/01/2022,Colombia,Perak,0,0,0
1/01/2022,Colombia,Pulau Pinang,0,0,0
1/01/2022,Colombia,Sabah,0,0,0
1/01/2022,Colombia,Sarawak,0,0,0
1/01/2022,Colombia,Selangor,37,20,17
1/01/2022,Colombia,W.P. Labuan,0,0,0
1/01/2022,Comoros,Johor,0,0,0
1/01/2022,Comoros,Kedah,0,0,0
1/01/2022,Comoros,Selangor,1,1,0
1/01/2022,Cabo Verde,Johor,0,0,0
1/01/2022,Cabo Verde,Kedah,0,0,0
1/01/2022,Cabo Verde,Pulau Pinang,0,0,0
1/01/2022,Cabo Verde,Sabah,0,0,0
1/01/2022,Cabo Verde,Selangor,0,0,0
1/01/2022,Costa Rica,Johor,0,0,0
1/01/2022,Costa Rica,Kedah,0,0,0
1/01/2022,Costa Rica,Perak,0,0,0
1/01/2022,Costa Rica,Perlis,0,0,0
1/01/2022,Costa Rica,Pulau Pinang,0,0,0
1/01/2022,Costa Rica,Sabah,0,0,0
1/01/2022,Costa Rica,Sarawak,0,0,0
1/01/2022,Costa Rica,Selangor,17,6,11
1/01/2022,Cuba,Johor,0,0,0
1/01/2022,Cuba,Kedah,0,0,0
1/01/2022,Cuba,Perlis,0,0,0
1/01/2022,Cuba,Pulau Pinang,0,0,0
1/01/2022,Cuba,Sabah,0,0,0
1/01/2022,Cuba,Sarawak,0,0,0
1/01/2022,Cuba,Selangor,5,2,3
1/01/2022,Cyprus,Johor,0,0,0
1/01/2022,Cyprus,Kedah,6,6,0
1/01/2022,Cyprus,Perak,0,0,0
1/01/2022,Cyprus,Perlis,0,0,0
1/01/2022,Cyprus,Pulau Pinang,0,0,0
1/01/2022,Cyprus,Sabah,0,0,0
1/01/2022,Cyprus,Sarawak,0,0,0
1/01/2022,Cyprus,Selangor,4,2,2
1/01/2022,Czechia,Johor,0,0,0
1/01/2022,Czechia,Kedah,0,0,0
1/01/2022,Czechia,Kelantan,0,0,0
1/01/2022,Czechia,Melaka,0,0,0
1/01/2022,Czechia,Negeri Sembilan,0,0,0
1/01/2022,Czechia,Perak,0,0,0
1/01/2022,Czechia,Perlis,0,0,0
1/01/2022,Czechia,Pulau Pinang,0,0,0
1/01/2022,Czechia,Sabah,0,0,0
1/01/2022,Czechia,Sarawak,2,2,0
1/01/2022,Czechia,Selangor,18,13,5
1/01/2022,Czechia,W.P. Labuan,0,0,0
1/01/2022,Germany,Johor,1,1,0
1/01/2022,Germany,Kedah,8,7,1
1/01/2022,Germany,Kelantan,0,0,0
1/01/2022,Germany,Melaka,0,0,0
1/01/2022,Germany,Negeri Sembilan,0,0,0
1/01/2022,Germany,Pahang,0,0,0
1/01/2022,Germany,Perak,0,0,0
1/01/2022,Germany,Perlis,0,0,0
1/01/2022,Germany,Pulau Pinang,7,5,2
1/01/2022,Germany,Sabah,0,0,0
1/01/2022,Germany,Sarawak,0,0,0
1/01/2022,Germany,Selangor,433,332,101
1/01/2022,Germany,Terengganu,0,0,0
1/01/2022,Germany,W.P. Labuan,0,0,0
1/01/2022,Djibouti,Johor,0,0,0
1/01/2022,Djibouti,Selangor,6,3,3
1/01/2022,Dominica,Johor,0,0,0
1/01/2022,Dominica,Kedah,0,0,0
1/01/2022,Dominica,Pulau Pinang,0,0,0
1/01/2022,Dominica,Sabah,0,0,0
1/01/2022,Dominica,Sarawak,0,0,0
1/01/2022,Dominica,Selangor,0,0,0
1/01/2022,Dominica,W.P. Labuan,0,0,0
1/01/2022,Denmark,Johor,2,2,0
1/01/2022,Denmark,Kedah,2,1,1
1/01/2022,Denmark,Kelantan,0,0,0
1/01/2022,Denmark,Melaka,0,0,0
1/01/2022,Denmark,Negeri Sembilan,0,0,0
1/01/2022,Denmark,Pahang,0,0,0
1/01/2022,Denmark,Perak,0,0,0
1/01/2022,Denmark,Perlis,0,0,0
1/01/2022,Denmark,Pulau Pinang,2,1,1
1/01/2022,Denmark,Sabah,0,0,0
1/01/2022,Denmark,Sarawak,0,0,0
1/01/2022,Denmark,Selangor,121,89,32
1/01/2022,Denmark,W.P. Labuan,0,0,0
1/01/2022,Dominican Republic,Johor,0,0,0
1/01/2022,Dominican Republic,Kedah,0,0,0
1/01/2022,Dominican Republic,Perak,0,0,0
1/01/2022,Dominican Republic,Perlis,0,0,0
1/01/2022,Dominican Republic,Pulau Pinang,0,0,0
1/01/2022,Dominican Republic,Sabah,0,0,0
1/01/2022,Dominican Republic,Sarawak,0,0,0
1/01/2022,Dominican Republic,Selangor,1,1,0
1/01/2022,Algeria,Johor,0,0,0
1/01/2022,Algeria,Kedah,0,0,0
1/01/2022,Algeria,Kelantan,0,0,0
1/01/2022,Algeria,Melaka,0,0,0
1/01/2022,Algeria,Perak,0,0,0
1/01/2022,Algeria,Perlis,0,0,0
1/01/2022,Algeria,Pulau Pinang,0,0,0
1/01/2022,Algeria,Sabah,0,0,0
1/01/2022,Algeria,Sarawak,0,0,0
1/01/2022,Algeria,Selangor,50,37,13
1/01/2022,Algeria,W.P. Labuan,0,0,0
1/01/2022,Ecuador,Johor,0,0,0
1/01/2022,Ecuador,Kedah,0,0,0
1/01/2022,Ecuador,Perak,0,0,0
1/01/2022,Ecuador,Perlis,0,0,0
1/01/2022,Ecuador,Pulau Pinang,0,0,0
1/01/2022,Ecuador,Sabah,0,0,0
1/01/2022,Ecuador,Sarawak,0,0,0
1/01/2022,Ecuador,Selangor,2,2,0
1/01/2022,Egypt,Johor,1,1,0
1/01/2022,Egypt,Kedah,0,0,0
1/01/2022,Egypt,Kelantan,0,0,0
1/01/2022,Egypt,Melaka,0,0,0
1/01/2022,Egypt,Pahang,0,0,0
1/01/2022,Egypt,Perak,0,0,0
1/01/2022,Egypt,Perlis,0,0,0
1/01/2022,Egypt,Pulau Pinang,0,0,0
1/01/2022,Egypt,Sabah,0,0,0
1/01/2022,Egypt,Sarawak,1,1,0
1/01/2022,Egypt,Selangor,340,246,94
1/01/2022,Egypt,Terengganu,0,0,0
1/01/2022,Egypt,W.P. Labuan,0,0,0
1/01/2022,Eritrea,Johor,0,0,0
1/01/2022,Eritrea,Pulau Pinang,0,0,0
1/01/2022,Eritrea,Sabah,0,0,0
1/01/2022,Eritrea,Selangor,1,0,1
1/01/2022,Spain,Johor,0,0,0
1/01/2022,Spain,Kedah,3,2,1
1/01/2022,Spain,Kelantan,0,0,0
1/01/2022,Spain,Melaka,0,0,0
1/01/2022,Spain,Negeri Sembilan,0,0,0
1/01/2022,Spain,Pahang,0,0,0
1/01/2022,Spain,Perak,0,0,0
1/01/2022,Spain,Perlis,0,0,0
1/01/2022,Spain,Pulau Pinang,0,0,0
1/01/2022,Spain,Sabah,0,0,0
1/01/2022,Spain,Sarawak,0,0,0
1/01/2022,Spain,Selangor,271,198,73
1/01/2022,Spain,W.P. Labuan,0,0,0
1/01/2022,Estonia,Johor,0,0,0
1/01/2022,Estonia,Kedah,0,0,0
1/01/2022,Estonia,Kelantan,0,0,0
1/01/2022,Estonia,Pahang,0,0,0
1/01/2022,Estonia,Perak,0,0,0
1/01/2022,Estonia,Perlis,0,0,0
1/01/2022,Estonia,Pulau Pinang,0,0,0
1/01/2022,Estonia,Sabah,0,0,0
1/01/2022,Estonia,Sarawak,0,0,0
1/01/2022,Estonia,Selangor,7,4,3
1/01/2022,Estonia,W.P. Labuan,0,0,0
1/01/2022,Ethiopia,Johor,1,1,0
1/01/2022,Ethiopia,Kedah,0,0,0
1/01/2022,Ethiopia,Pulau Pinang,0,0,0
1/01/2022,Ethiopia,Sarawak,0,0,0
1/01/2022,Ethiopia,Selangor,14,8,6
1/01/2022,Finland,Johor,0,0,0
1/01/2022,Finland,Kedah,1,1,0
1/01/2022,Finland,Kelantan,0,0,0
1/01/2022,Finland,Melaka,0,0,0
1/01/2022,Finland,Negeri Sembilan,0,0,0
1/01/2022,Finland,Pahang,0,0,0
1/01/2022,Finland,Perak,0,0,0
1/01/2022,Finland,Perlis,0,0,0
1/01/2022,Finland,Pulau Pinang,0,0,0
1/01/2022,Finland,Sabah,0,0,0
1/01/2022,Finland,Sarawak,0,0,0
1/01/2022,Finland,Selangor,47,30,17
1/01/2022,Finland,W.P. Labuan,0,0,0
1/01/2022,Fiji,Johor,0,0,0
1/01/2022,Fiji,Kedah,0,0,0
1/01/2022,Fiji,Kelantan,0,0,0
1/01/2022,Fiji,Perak,0,0,0
1/01/2022,Fiji,Perlis,0,0,0
1/01/2022,Fiji,Pulau Pinang,0,0,0
1/01/2022,Fiji,Sabah,0,0,0
1/01/2022,Fiji,Sarawak,0,0,0
1/01/2022,Fiji,Selangor,2,0,2
1/01/2022,France,Johor,5,5,0
1/01/2022,France,Kedah,3,3,0
1/01/2022,France,Kelantan,0,0,0
1/01/2022,France,Melaka,0,0,0
1/01/2022,France,Negeri Sembilan,0,0,0
1/01/2022,France,Pahang,0,0,0
1/01/2022,France,Perak,0,0,0
1/01/2022,France,Perlis,0,0,0
1/01/2022,France,Pulau Pinang,0,0,0
1/01/2022,France,Sabah,0,0,0
1/01/2022,France,Sarawak,1,1,0
1/01/2022,France,Selangor,668,482,186
1/01/2022,France,Terengganu,0,0,0
1/01/2022,France,W.P. Labuan,0,0,0
1/01/2022,"Micronesia, Federated States of",Johor,0,0,0
1/01/2022,"Micronesia, Federated States of",Pulau Pinang,0,0,0
1/01/2022,"Micronesia, Federated States of",Selangor,0,0,0
1/01/2022,Gabon,Johor,0,0,0
1/01/2022,Gabon,Pulau Pinang,0,0,0
1/01/2022,Gabon,Sarawak,0,0,0
1/01/2022,Gabon,Selangor,2,1,1
1/01/2022,United Kingdom of Great Britain and Northern Ireland,Johor,8,4,4
1/01/2022,United Kingdom of Great Britain and Northern Ireland,Kedah,34,23,11
1/01/2022,United Kingdom of Great Britain and Northern Ireland,Kelantan,0,0,0
1/01/2022,United Kingdom of Great Britain and Northern Ireland,Melaka,0,0,0
1/01/2022,United Kingdom of Great Britain and Northern Ireland,Negeri Sembilan,0,0,0
1/01/2022,United Kingdom of Great Britain and Northern Ireland,Pahang,0,0,0
1/01/2022,United Kingdom of Great Britain and Northern Ireland,Perak,0,0,0
1/01/2022,United Kingdom of Great Britain and Northern Ireland,Perlis,0,0,0
1/01/2022,United Kingdom of Great Britain and Northern Ireland,Pulau Pinang,13,10,3
1/01/2022,United Kingdom of Great Britain and Northern Ireland,Sabah,4,1,3
1/01/2022,United Kingdom of Great Britain and Northern Ireland,Sarawak,4,3,1
1/01/2022,United Kingdom of Great Britain and Northern Ireland,Selangor,1735,1116,619
1/01/2022,United Kingdom of Great Britain and Northern Ireland,Terengganu,0,0,0
1/01/2022,United Kingdom of Great Britain and Northern Ireland,W.P. Labuan,0,0,0
1/01/2022,Georgia,Johor,0,0,0
1/01/2022,Georgia,Kedah,0,0,0
1/01/2022,Georgia,Melaka,0,0,0
1/01/2022,Georgia,Perak,0,0,0
1/01/2022,Georgia,Perlis,0,0,0
1/01/2022,Georgia,Pulau Pinang,0,0,0
1/01/2022,Georgia,Sabah,0,0,0
1/01/2022,Georgia,Sarawak,0,0,0
1/01/2022,Georgia,Selangor,10,10,0
1/01/2022,Ghana,Johor,0,0,0
1/01/2022,Ghana,Kedah,0,0,0
1/01/2022,Ghana,Kelantan,0,0,0
1/01/2022,Ghana,Pulau Pinang,0,0,0
1/01/2022,Ghana,Sabah,0,0,0
1/01/2022,Ghana,Sarawak,0,0,0
1/01/2022,Ghana,Selangor,15,12,3
1/01/2022,Gibraltar,Johor,0,0,0
1/01/2022,Gibraltar,Sarawak,0,0,0
1/01/2022,Guinea,Johor,0,0,0
1/01/2022,Guinea,Kedah,0,0,0
1/01/2022,Guinea,Kelantan,0,0,0
1/01/2022,Guinea,Perlis,0,0,0
1/01/2022,Guinea,Pulau Pinang,0,0,0
1/01/2022,Guinea,Sabah,0,0,0
1/01/2022,Guinea,Sarawak,0,0,0
1/01/2022,Guinea,Selangor,16,11,5
1/01/2022,Guadeloupe,Selangor,0,0,0
1/01/2022,Gambia,Johor,0,0,0
1/01/2022,Gambia,Kedah,0,0,0
1/01/2022,Gambia,Kelantan,0,0,0
1/01/2022,Gambia,Pulau Pinang,0,0,0
1/01/2022,Gambia,Sabah,0,0,0
1/01/2022,Gambia,Sarawak,0,0,0
1/01/2022,Gambia,Selangor,5,4,1
1/01/2022,Guinea-Bissau,Johor,0,0,0
1/01/2022,Guinea-Bissau,Selangor,0,0,0
1/01/2022,Equatorial Guinea,Johor,0,0,0
1/01/2022,Equatorial Guinea,Selangor,4,4,0
1/01/2022,Greece,Johor,0,0,0
1/01/2022,Greece,Kedah,0,0,0
1/01/2022,Greece,Kelantan,0,0,0
1/01/2022,Greece,Melaka,0,0,0
1/01/2022,Greece,Negeri Sembilan,0,0,0
1/01/2022,Greece,Pahang,0,0,0
1/01/2022,Greece,Perak,0,0,0
1/01/2022,Greece,Perlis,0,0,0
1/01/2022,Greece,Pulau Pinang,0,0,0
1/01/2022,Greece,Sabah,0,0,0
1/01/2022,Greece,Sarawak,0,0,0
1/01/2022,Greece,Selangor,9,6,3
1/01/2022,Grenada,Johor,0,0,0
1/01/2022,Grenada,Kedah,0,0,0
1/01/2022,Grenada,Pulau Pinang,0,0,0
1/01/2022,Grenada,Sabah,0,0,0
1/01/2022,Grenada,Sarawak,0,0,0
1/01/2022,Grenada,Selangor,1,0,1
1/01/2022,Greenland,Johor,0,0,0
1/01/2022,Greenland,Selangor,0,0,0
1/01/2022,Guatemala,Johor,0,0,0
1/01/2022,Guatemala,Kedah,0,0,0
1/01/2022,Guatemala,Pahang,0,0,0
1/01/2022,Guatemala,Perak,0,0,0
1/01/2022,Guatemala,Pulau Pinang,0,0,0
1/01/2022,Guatemala,Sabah,0,0,0
1/01/2022,Guatemala,Sarawak,0,0,0
1/01/2022,Guatemala,Selangor,1,1,0
1/01/2022,Guatemala,W.P. Labuan,0,0,0
1/01/2022,Guyana,Johor,0,0,0
1/01/2022,Guyana,Kedah,0,0,0
1/01/2022,Guyana,Pulau Pinang,0,0,0
1/01/2022,Guyana,Sarawak,0,0,0
1/01/2022,Guyana,Selangor,0,0,0
1/01/2022,Hong Kong,Johor,0,0,0
1/01/2022,Hong Kong,Kedah,7,2,5
1/01/2022,Hong Kong,Kelantan,0,0,0
1/01/2022,Hong Kong,Pahang,0,0,0
1/01/2022,Hong Kong,Perak,0,0,0
1/01/2022,Hong Kong,Perlis,0,0,0
1/01/2022,Hong Kong,Pulau Pinang,1,1,0
1/01/2022,Hong Kong,Sabah,0,0,0
1/01/2022,Hong Kong,Sarawak,19,15,4
1/01/2022,Hong Kong,Selangor,4,4,0
1/01/2022,Hong Kong,Terengganu,0,0,0
1/01/2022,Heard Island and McDonald Islands,Johor,0,0,0
1/01/2022,Honduras,Johor,0,0,0
1/01/2022,Honduras,Kedah,0,0,0
1/01/2022,Honduras,Perak,0,0,0
1/01/2022,Honduras,Pulau Pinang,0,0,0
1/01/2022,Honduras,Sabah,0,0,0
1/01/2022,Honduras,Sarawak,0,0,0
1/01/2022,Honduras,Selangor,1,0,1
1/01/2022,Croatia,Johor,0,0,0
1/01/2022,Croatia,Kedah,0,0,0
1/01/2022,Croatia,Kelantan,0,0,0
1/01/2022,Croatia,Melaka,0,0,0
1/01/2022,Croatia,Pahang,0,0,0
1/01/2022,Croatia,Perak,0,0,0
1/01/2022,Croatia,Perlis,0,0,0
1/01/2022,Croatia,Pulau Pinang,0,0,0
1/01/2022,Croatia,Sabah,0,0,0
1/01/2022,Croatia,Sarawak,0,0,0
1/01/2022,Croatia,Selangor,34,32,2
1/01/2022,Haiti,Johor,0,0,0
1/01/2022,Haiti,Kedah,0,0,0
1/01/2022,Haiti,Kelantan,0,0,0
1/01/2022,Haiti,Perak,0,0,0
1/01/2022,Haiti,Pulau Pinang,0,0,0
1/01/2022,Haiti,Sabah,0,0,0
1/01/2022,Haiti,Selangor,1,1,0
1/01/2022,Hungary,Johor,0,0,0
1/01/2022,Hungary,Kedah,0,0,0
1/01/2022,Hungary,Kelantan,0,0,0
1/01/2022,Hungary,Pahang,0,0,0
1/01/2022,Hungary,Perak,0,0,0
1/01/2022,Hungary,Perlis,0,0,0
1/01/2022,Hungary,Pulau Pinang,0,0,0
1/01/2022,Hungary,Sabah,0,0,0
1/01/2022,Hungary,Sarawak,0,0,0
1/01/2022,Hungary,Selangor,19,13,6
1/01/2022,Hungary,W.P. Labuan,0,0,0
1/01/2022,Indonesia,Johor,1078,341,737
1/01/2022,Indonesia,Kedah,58,23,35
1/01/2022,Indonesia,Kelantan,0,0,0
1/01/2022,Indonesia,Melaka,0,0,0
1/01/2022,Indonesia,Negeri Sembilan,0,0,0
1/01/2022,Indonesia,Pahang,0,0,0
1/01/2022,Indonesia,Perak,0,0,0
1/01/2022,Indonesia,Perlis,0,0,0
1/01/2022,Indonesia,Pulau Pinang,24,9,15
1/01/2022,Indonesia,Sabah,8,3,5
1/01/2022,Indonesia,Sarawak,395,364,31
1/01/2022,Indonesia,Selangor,2943,1651,1292
1/01/2022,Indonesia,Terengganu,0,0,0
1/01/2022,Indonesia,W.P. Labuan,4,4,0
1/01/2022,India,Johor,48,46,2
1/01/2022,India,Kedah,2,1,1
1/01/2022,India,Kelantan,0,0,0
1/01/2022,India,Melaka,0,0,0
1/01/2022,India,Negeri Sembilan,0,0,0
1/01/2022,India,Pahang,0,0,0
1/01/2022,India,Perak,0,0,0
1/01/2022,India,Perlis,0,0,0
1/01/2022,India,Pulau Pinang,0,0,0
1/01/2022,India,Sabah,0,0,0
1/01/2022,India,Sarawak,5,5,0
1/01/2022,India,Selangor,6829,4696,2133
1/01/2022,India,Terengganu,0,0,0
1/01/2022,India,W.P. Labuan,0,0,0
1/01/2022, British Indian Ocean Territory,Pulau Pinang,0,0,0
1/01/2022, British Indian Ocean Territory,Selangor,0,0,0
1/01/2022,Ireland,Johor,0,0,0
1/01/2022,Ireland,Kedah,1,1,0
1/01/2022,Ireland,Kelantan,0,0,0
1/01/2022,Ireland,Negeri Sembilan,0,0,0
1/01/2022,Ireland,Pahang,0,0,0
1/01/2022,Ireland,Perak,0,0,0
1/01/2022,Ireland,Perlis,0,0,0
1/01/2022,Ireland,Pulau Pinang,0,0,0
1/01/2022,Ireland,Sabah,0,0,0
1/01/2022,Ireland,Sarawak,0,0,0
1/01/2022,Ireland,Selangor,118,83,35
1/01/2022,Ireland,Terengganu,0,0,0
1/01/2022,Ireland,W.P. Labuan,0,0,0
1/01/2022,"Iran, Islamic Republic of",Johor,0,0,0
1/01/2022,"Iran, Islamic Republic of",Kedah,0,0,0
1/01/2022,"Iran, Islamic Republic of",Kelantan,0,0,0
1/01/2022,"Iran, Islamic Republic of",Perak,0,0,0
1/01/2022,"Iran, Islamic Republic of",Perlis,0,0,0
1/01/2022,"Iran, Islamic Republic of",Pulau Pinang,0,0,0
1/01/2022,"Iran, Islamic Republic of",Sabah,1,1,0
1/01/2022,"Iran, Islamic Republic of",Sarawak,0,0,0
1/01/2022,"Iran, Islamic Republic of",Selangor,189,110,79
1/01/2022,"Iran, Islamic Republic of",W.P. Labuan,0,0,0
1/01/2022,Iraq,Johor,0,0,0
1/01/2022,Iraq,Kedah,0,0,0
1/01/2022,Iraq,Kelantan,0,0,0
1/01/2022,Iraq,Melaka,0,0,0
1/01/2022,Iraq,Pahang,0,0,0
1/01/2022,Iraq,Perak,0,0,0
1/01/2022,Iraq,Perlis,0,0,0
1/01/2022,Iraq,Pulau Pinang,0,0,0
1/01/2022,Iraq,Sabah,0,0,0
1/01/2022,Iraq,Sarawak,0,0,0
1/01/2022,Iraq,Selangor,194,127,67
1/01/2022,Iceland,Johor,0,0,0
1/01/2022,Iceland,Kedah,0,0,0
1/01/2022,Iceland,Kelantan,0,0,0
1/01/2022,Iceland,Perak,0,0,0
1/01/2022,Iceland,Perlis,0,0,0
1/01/2022,Iceland,Pulau Pinang,0,0,0
1/01/2022,Iceland,Sabah,0,0,0
1/01/2022,Iceland,Sarawak,0,0,0
1/01/2022,Iceland,Selangor,4,2,2
1/01/2022,Iceland,W.P. Labuan,0,0,0
1/01/2022,Israel,Pulau Pinang,0,0,0
1/01/2022,Italy,Johor,2,1,1
1/01/2022,Italy,Kedah,1,1,0
1/01/2022,Italy,Kelantan,0,0,0
1/01/2022,Italy,Melaka,0,0,0
1/01/2022,Italy,Negeri Sembilan,0,0,0
1/01/2022,Italy,Pahang,0,0,0
1/01/2022,Italy,Perak,0,0,0
1/01/2022,Italy,Perlis,0,0,0
1/01/2022,Italy,Pulau Pinang,1,1,0
1/01/2022,Italy,Sabah,0,0,0
1/01/2022,Italy,Sarawak,1,0,1
1/01/2022,Italy,Selangor,343,277,66
1/01/2022,Italy,W.P. Labuan,0,0,0
1/01/2022,Jamaica,Johor,0,0,0
1/01/2022,Jamaica,Kedah,0,0,0
1/01/2022,Jamaica,Perak,0,0,0
1/01/2022,Jamaica,Pulau Pinang,0,0,0
1/01/2022,Jamaica,Sabah,0,0,0
1/01/2022,Jamaica,Sarawak,0,0,0
1/01/2022,Jamaica,Selangor,2,1,1
1/01/2022,Jamaica,W.P. Labuan,0,0,0
1/01/2022,Jordan,Johor,0,0,0
1/01/2022,Jordan,Kedah,0,0,0
1/01/2022,Jordan,Kelantan,0,0,0
1/01/2022,Jordan,Melaka,0,0,0
1/01/2022,Jordan,Perlis,0,0,0
1/01/2022,Jordan,Pulau Pinang,0,0,0
1/01/2022,Jordan,Sabah,0,0,0
1/01/2022,Jordan,Sarawak,0,0,0
1/01/2022,Jordan,Selangor,65,49,16
1/01/2022,Jordan,W.P. Labuan,0,0,0
1/01/2022,Japan,Johor,1,1,0
1/01/2022,Japan,Kedah,4,3,1
1/01/2022,Japan,Kelantan,0,0,0
1/01/2022,Japan,Melaka,0,0,0
1/01/2022,Japan,Negeri Sembilan,0,0,0
1/01/2022,Japan,Pahang,0,0,0
1/01/2022,Japan,Perak,0,0,0
1/01/2022,Japan,Perlis,0,0,0
1/01/2022,Japan,Pulau Pinang,75,52,23
1/01/2022,Japan,Sabah,4,3,1
1/01/2022,Japan,Sarawak,18,16,2
1/01/2022,Japan,Selangor,1256,845,411
1/01/2022,Japan,W.P. Labuan,0,0,0
1/01/2022,Kazakhstan,Johor,0,0,0
1/01/2022,Kazakhstan,Kedah,0,0,0
1/01/2022,Kazakhstan,Kelantan,0,0,0
1/01/2022,Kazakhstan,Melaka,0,0,0
1/01/2022,Kazakhstan,Perak,0,0,0
1/01/2022,Kazakhstan,Perlis,0,0,0
1/01/2022,Kazakhstan,Pulau Pinang,0,0,0
1/01/2022,Kazakhstan,Sabah,0,0,0
1/01/2022,Kazakhstan,Sarawak,0,0,0
1/01/2022,Kazakhstan,Selangor,62,22,40
1/01/2022,Kazakhstan,W.P. Labuan,0,0,0
1/01/2022,Kenya,Johor,0,0,0
1/01/2022,Kenya,Kedah,0,0,0
1/01/2022,Kenya,Kelantan,0,0,0
1/01/2022,Kenya,Perak,0,0,0
1/01/2022,Kenya,Perlis,0,0,0
1/01/2022,Kenya,Pulau Pinang,0,0,0
1/01/2022,Kenya,Sabah,0,0,0
1/01/2022,Kenya,Sarawak,0,0,0
1/01/2022,Kenya,Selangor,115,50,65
1/01/2022,Kyrgyzstan,Johor,0,0,0
1/01/2022,Kyrgyzstan,Kedah,0,0,0
1/01/2022,Kyrgyzstan,Kelantan,0,0,0
1/01/2022,Kyrgyzstan,Perak,0,0,0
1/01/2022,Kyrgyzstan,Perlis,0,0,0
1/01/2022,Kyrgyzstan,Pulau Pinang,0,0,0
1/01/2022,Kyrgyzstan,Sabah,0,0,0
1/01/2022,Kyrgyzstan,Sarawak,0,0,0
1/01/2022,Kyrgyzstan,Selangor,31,18,13
1/01/2022,Cambodia,Johor,0,0,0
1/01/2022,Cambodia,Kedah,0,0,0
1/01/2022,Cambodia,Kelantan,0,0,0
1/01/2022,Cambodia,Melaka,0,0,0
1/01/2022,Cambodia,Negeri Sembilan,0,0,0
1/01/2022,Cambodia,Pahang,0,0,0
1/01/2022,Cambodia,Perak,0,0,0
1/01/2022,Cambodia,Perlis,0,0,0
1/01/2022,Cambodia,Pulau Pinang,1,1,0
1/01/2022,Cambodia,Sabah,0,0,0
1/01/2022,Cambodia,Sarawak,1,0,1
1/01/2022,Cambodia,Selangor,85,49,36
1/01/2022,Cambodia,W.P. Labuan,0,0,0
1/01/2022,Kiribati,Johor,0,0,0
1/01/2022,Kiribati,Sabah,0,0,0
1/01/2022,Kiribati,Selangor,0,0,0
1/01/2022,Saint Kitts and Nevis,Johor,0,0,0
1/01/2022,Saint Kitts and Nevis,Kedah,0,0,0
1/01/2022,Saint Kitts and Nevis,Perlis,0,0,0
1/01/2022,Saint Kitts and Nevis,Pulau Pinang,0,0,0
1/01/2022,Saint Kitts and Nevis,Sabah,0,0,0
1/01/2022,Saint Kitts and Nevis,Selangor,2,2,0
1/01/2022,Saint Kitts and Nevis,W.P. Labuan,0,0,0
1/01/2022,"Korea, Republic of",Johor,0,0,0
1/01/2022,"Korea, Republic of",Kedah,2,2,0
1/01/2022,"Korea, Republic of",Kelantan,0,0,0
1/01/2022,"Korea, Republic of",Melaka,0,0,0
1/01/2022,"Korea, Republic of",Negeri Sembilan,0,0,0
1/01/2022,"Korea, Republic of",Pahang,0,0,0
1/01/2022,"Korea, Republic of",Perak,0,0,0
1/01/2022,"Korea, Republic of",Perlis,0,0,0
1/01/2022,"Korea, Republic of",Pulau Pinang,16,6,10
1/01/2022,"Korea, Republic of",Sabah,1,0,1
1/01/2022,"Korea, Republic of",Sarawak,25,16,9
1/01/2022,"Korea, Republic of",Selangor,1179,685,494
1/01/2022,"Korea, Republic of",Terengganu,0,0,0
1/01/2022,"Korea, Republic of",W.P. Labuan,0,0,0
1/01/2022,Kuwait,Johor,0,0,0
1/01/2022,Kuwait,Kedah,0,0,0
1/01/2022,Kuwait,Kelantan,0,0,0
1/01/2022,Kuwait,Perak,0,0,0
1/01/2022,Kuwait,Perlis,0,0,0
1/01/2022,Kuwait,Pulau Pinang,0,0,0
1/01/2022,Kuwait,Sabah,0,0,0
1/01/2022,Kuwait,Sarawak,0,0,0
1/01/2022,Kuwait,Selangor,27,19,8
1/01/2022,Kuwait,W.P. Labuan,0,0,0
1/01/2022, Lao People's Democratic Republic,Johor,0,0,0
1/01/2022, Lao People's Democratic Republic,Kedah,0,0,0
1/01/2022, Lao People's Democratic Republic,Kelantan,0,0,0
1/01/2022, Lao People's Democratic Republic,Melaka,0,0,0
1/01/2022, Lao People's Democratic Republic,Perak,0,0,0
1/01/2022, Lao People's Democratic Republic,Perlis,0,0,0
1/01/2022, Lao People's Democratic Republic,Pulau Pinang,0,0,0
1/01/2022, Lao People's Democratic Republic,Sabah,0,0,0
1/01/2022, Lao People's Democratic Republic,Sarawak,0,0,0
1/01/2022, Lao People's Democratic Republic,Selangor,19,13,6
1/01/2022, Lao People's Democratic Republic,W.P. Labuan,0,0,0
1/01/2022,Lebanon,Johor,0,0,0
1/01/2022,Lebanon,Kedah,1,1,0
1/01/2022,Lebanon,Kelantan,0,0,0
1/01/2022,Lebanon,Pahang,0,0,0
1/01/2022,Lebanon,Perak,0,0,0
1/01/2022,Lebanon,Perlis,0,0,0
1/01/2022,Lebanon,Pulau Pinang,0,0,0
1/01/2022,Lebanon,Sabah,0,0,0
1/01/2022,Lebanon,Sarawak,0,0,0
1/01/2022,Lebanon,Selangor,27,16,11
1/01/2022,Lebanon,W.P. Labuan,0,0,0
1/01/2022,Liberia,Johor,0,0,0
1/01/2022,Liberia,Kedah,0,0,0
1/01/2022,Liberia,Sabah,0,0,0
1/01/2022,Liberia,Sarawak,0,0,0
1/01/2022,Liberia,Selangor,3,2,1
1/01/2022,Libya,Johor,0,0,0
1/01/2022,Libya,Kedah,0,0,0
1/01/2022,Libya,Perlis,0,0,0
1/01/2022,Libya,Pulau Pinang,0,0,0
1/01/2022,Libya,Sabah,0,0,0
1/01/2022,Libya,Sarawak,0,0,0
1/01/2022,Libya,Selangor,135,92,43
1/01/2022,Saint Lucia,Johor,0,0,0
1/01/2022,Saint Lucia,Kedah,0,0,0
1/01/2022,Saint Lucia,Pulau Pinang,0,0,0
1/01/2022,Saint Lucia,Sarawak,0,0,0
1/01/2022,Saint Lucia,Selangor,2,2,0
1/01/2022,Liechtenstein,Johor,0,0,0
1/01/2022,Liechtenstein,Kedah,0,0,0
1/01/2022,Liechtenstein,Perlis,0,0,0
1/01/2022,Liechtenstein,Pulau Pinang,0,0,0
1/01/2022,Liechtenstein,Sabah,0,0,0
1/01/2022,Liechtenstein,Sarawak,0,0,0
1/01/2022,Liechtenstein,Selangor,0,0,0
1/01/2022,LKA,Johor,6,6,0
1/01/2022,LKA,Kedah,3,3,0
1/01/2022,LKA,Kelantan,0,0,0
1/01/2022,LKA,Melaka,0,0,0
1/01/2022,LKA,Pahang,0,0,0
1/01/2022,LKA,Perak,0,0,0
1/01/2022,LKA,Perlis,0,0,0
1/01/2022,LKA,Pulau Pinang,0,0,0
1/01/2022,LKA,Sabah,0,0,0
1/01/2022,LKA,Sarawak,0,0,0
1/01/2022,LKA,Selangor,431,234,197
1/01/2022,LKA,W.P. Labuan,0,0,0
1/01/2022,Lesotho,Johor,0,0,0
1/01/2022,Lesotho,Kedah,0,0,0
1/01/2022,Lesotho,Pulau Pinang,0,0,0
1/01/2022,Lesotho,Sarawak,0,0,0
1/01/2022,Lesotho,Selangor,0,0,0
1/01/2022,Lithuania,Johor,0,0,0
1/01/2022,Lithuania,Kedah,0,0,0
1/01/2022,Lithuania,Kelantan,0,0,0
1/01/2022,Lithuania,Pahang,0,0,0
1/01/2022,Lithuania,Perak,0,0,0
1/01/2022,Lithuania,Perlis,0,0,0
1/01/2022,Lithuania,Pulau Pinang,0,0,0
1/01/2022,Lithuania,Sabah,0,0,0
1/01/2022,Lithuania,Sarawak,0,0,0
1/01/2022,Lithuania,Selangor,14,8,6
1/01/2022,Lithuania,W.P. Labuan,0,0,0
1/01/2022,Luxembourg,Johor,0,0,0
1/01/2022,Luxembourg,Kedah,0,0,0
1/01/2022,Luxembourg,Kelantan,0,0,0
1/01/2022,Luxembourg,Perak,0,0,0
1/01/2022,Luxembourg,Perlis,0,0,0
1/01/2022,Luxembourg,Pulau Pinang,0,0,0
1/01/2022,Luxembourg,Sabah,0,0,0
1/01/2022,Luxembourg,Sarawak,0,0,0
1/01/2022,Luxembourg,Selangor,0,0,0
1/01/2022,Latvia,Johor,0,0,0
1/01/2022,Latvia,Kedah,0,0,0
1/01/2022,Latvia,Kelantan,0,0,0
1/01/2022,Latvia,Pahang,0,0,0
1/01/2022,Latvia,Perak,0,0,0
1/01/2022,Latvia,Perlis,0,0,0
1/01/2022,Latvia,Pulau Pinang,0,0,0
1/01/2022,Latvia,Sabah,0,0,0
1/01/2022,Latvia,Sarawak,0,0,0
1/01/2022,Latvia,Selangor,4,4,0
1/01/2022,Latvia,W.P. Labuan,0,0,0
1/01/2022,Macao,Johor,0,0,0
1/01/2022,Macao,Pahang,0,0,0
1/01/2022,Macao,Perak,0,0,0
1/01/2022,Macao,Selangor,0,0,0
1/01/2022,Macao,W.P. Labuan,0,0,0
1/01/2022,Morocco,Johor,0,0,0
1/01/2022,Morocco,Kedah,0,0,0
1/01/2022,Morocco,Kelantan,0,0,0
1/01/2022,Morocco,Melaka,0,0,0
1/01/2022,Morocco,Pahang,0,0,0
1/01/2022,Morocco,Perak,0,0,0
1/01/2022,Morocco,Perlis,0,0,0
1/01/2022,Morocco,Pulau Pinang,0,0,0
1/01/2022,Morocco,Sabah,0,0,0
1/01/2022,Morocco,Sarawak,0,0,0
1/01/2022,Morocco,Selangor,30,13,17
1/01/2022,Morocco,W.P. Labuan,0,0,0
1/01/2022,Monaco,Johor,0,0,0
1/01/2022,Monaco,Kedah,0,0,0
1/01/2022,Monaco,Sabah,0,0,0
1/01/2022,Monaco,Selangor,0,0,0
1/01/2022,"Moldova, Republic of",Johor,0,0,0
1/01/2022,"Moldova, Republic of",Kedah,0,0,0
1/01/2022,"Moldova, Republic of",Kelantan,0,0,0
1/01/2022,"Moldova, Republic of",Negeri Sembilan,0,0,0
1/01/2022,"Moldova, Republic of",Perlis,0,0,0
1/01/2022,"Moldova, Republic of",Pulau Pinang,0,0,0
1/01/2022,"Moldova, Republic of",Sabah,0,0,0
1/01/2022,"Moldova, Republic of",Sarawak,0,0,0
1/01/2022,"Moldova, Republic of",Selangor,0,0,0
1/01/2022,Madagascar,Johor,0,0,0
1/01/2022,Madagascar,Kedah,0,0,0
1/01/2022,Madagascar,Perak,0,0,0
1/01/2022,Madagascar,Perlis,0,0,0
1/01/2022,Madagascar,Pulau Pinang,0,0,0
1/01/2022,Madagascar,Sabah,0,0,0
1/01/2022,Madagascar,Sarawak,0,0,0
1/01/2022,Madagascar,Selangor,2,0,2
1/01/2022,Maldives,Johor,0,0,0
1/01/2022,Maldives,Kedah,17,10,7
1/01/2022,Maldives,Kelantan,0,0,0
1/01/2022,Maldives,Perak,0,0,0
1/01/2022,Maldives,Perlis,0,0,0
1/01/2022,Maldives,Pulau Pinang,1,1,0
1/01/2022,Maldives,Sabah,0,0,0
1/01/2022,Maldives,Sarawak,0,0,0
1/01/2022,Maldives,Selangor,329,147,182
1/01/2022,Mexico,Johor,2,0,2
1/01/2022,Mexico,Kedah,0,0,0
1/01/2022,Mexico,Kelantan,0,0,0
1/01/2022,Mexico,Pahang,0,0,0
1/01/2022,Mexico,Perak,0,0,0
1/01/2022,Mexico,Perlis,0,0,0
1/01/2022,Mexico,Pulau Pinang,0,0,0
1/01/2022,Mexico,Sabah,0,0,0
1/01/2022,Mexico,Sarawak,0,0,0
1/01/2022,Mexico,Selangor,84,49,35
1/01/2022,Mexico,W.P. Labuan,0,0,0
1/01/2022,Marshall Islands,Johor,0,0,0
1/01/2022,Marshall Islands,Kedah,0,0,0
1/01/2022,Marshall Islands,Perak,0,0,0
1/01/2022,Marshall Islands,Pulau Pinang,0,0,0
1/01/2022,Marshall Islands,Sabah,0,0,0
1/01/2022,Marshall Islands,Selangor,0,0,0
1/01/2022,North Macedonia,Johor,0,0,0
1/01/2022,North Macedonia,Kedah,0,0,0
1/01/2022,North Macedonia,Perak,0,0,0
1/01/2022,North Macedonia,Pulau Pinang,0,0,0
1/01/2022,North Macedonia,Sabah,0,0,0
1/01/2022,North Macedonia,Sarawak,0,0,0
1/01/2022,North Macedonia,Selangor,0,0,0
1/01/2022,Mali,Johor,0,0,0
1/01/2022,Mali,Sabah,0,0,0
1/01/2022,Mali,Selangor,1,1,0
1/01/2022,Malta,Johor,0,0,0
1/01/2022,Malta,Kedah,0,0,0
1/01/2022,Malta,Kelantan,0,0,0
1/01/2022,Malta,Perak,0,0,0
1/01/2022,Malta,Perlis,0,0,0
1/01/2022,Malta,Pulau Pinang,0,0,0
1/01/2022,Malta,Sabah,0,0,0
1/01/2022,Malta,Sarawak,0,0,0
1/01/2022,Malta,Selangor,3,3,0
1/01/2022,Malta,W.P. Labuan,0,0,0
1/01/2022,Myanmar,Johor,16,15,1
1/01/2022,Myanmar,Kedah,0,0,0
1/01/2022,Myanmar,Kelantan,0,0,0
1/01/2022,Myanmar,Negeri Sembilan,0,0,0
1/01/2022,Myanmar,Pahang,0,0,0
1/01/2022,Myanmar,Perak,0,0,0
1/01/2022,Myanmar,Perlis,0,0,0
1/01/2022,Myanmar,Pulau Pinang,0,0,0
1/01/2022,Myanmar,Sabah,0,0,0
1/01/2022,Myanmar,Sarawak,1,0,1
1/01/2022,Myanmar,Selangor,357,305,52
1/01/2022,Myanmar,Terengganu,0,0,0
1/01/2022,Myanmar,W.P. Labuan,0,0,0
1/01/2022,Montenegro,Johor,1,1,0
1/01/2022,Montenegro,Kedah,0,0,0
1/01/2022,Montenegro,Pulau Pinang,0,0,0
1/01/2022,Montenegro,Sabah,0,0,0
1/01/2022,Montenegro,Sarawak,0,0,0
1/01/2022,Montenegro,Selangor,4,4,0
1/01/2022,Mongolia,Johor,0,0,0
1/01/2022,Mongolia,Kedah,0,0,0
1/01/2022,Mongolia,Kelantan,0,0,0
1/01/2022,Mongolia,Perak,0,0,0
1/01/2022,Mongolia,Perlis,0,0,0
1/01/2022,Mongolia,Pulau Pinang,0,0,0
1/01/2022,Mongolia,Sabah,0,0,0
1/01/2022,Mongolia,Sarawak,0,0,0
1/01/2022,Mongolia,Selangor,9,3,6
1/01/2022,Northern Mariana Islands,Selangor,0,0,0
1/01/2022,Mozambique,Johor,0,0,0
1/01/2022,Mozambique,Kedah,0,0,0
1/01/2022,Mozambique,Perak,0,0,0
1/01/2022,Mozambique,Pulau Pinang,0,0,0
1/01/2022,Mozambique,Sabah,0,0,0
1/01/2022,Mozambique,Sarawak,0,0,0
1/01/2022,Mozambique,Selangor,14,7,7
1/01/2022,Mauritania,Johor,0,0,0
1/01/2022,Mauritania,Kedah,0,0,0
1/01/2022,Mauritania,Pulau Pinang,0,0,0
1/01/2022,Mauritania,Sabah,0,0,0
1/01/2022,Mauritania,Sarawak,0,0,0
1/01/2022,Mauritania,Selangor,18,15,3
1/01/2022,Mauritius,Johor,0,0,0
1/01/2022,Mauritius,Kedah,0,0,0
1/01/2022,Mauritius,Kelantan,0,0,0
1/01/2022,Mauritius,Pahang,0,0,0
1/01/2022,Mauritius,Perak,0,0,0
1/01/2022,Mauritius,Perlis,0,0,0
1/01/2022,Mauritius,Pulau Pinang,0,0,0
1/01/2022,Mauritius,Sabah,0,0,0
1/01/2022,Mauritius,Sarawak,0,0,0
1/01/2022,Mauritius,Selangor,47,16,31
1/01/2022,Malawi,Johor,0,0,0
1/01/2022,Malawi,Pulau Pinang,0,0,0
1/01/2022,Malawi,Sabah,0,0,0
1/01/2022,Malawi,Sarawak,0,0,0
1/01/2022,Malawi,Selangor,7,3,4
1/01/2022,Mayotte,Selangor,0,0,0
1/01/2022,Namibia,Johor,0,0,0
1/01/2022,Namibia,Kedah,0,0,0
1/01/2022,Namibia,Perak,0,0,0
1/01/2022,Namibia,Perlis,0,0,0
1/01/2022,Namibia,Pulau Pinang,0,0,0
1/01/2022,Namibia,Sabah,0,0,0
1/01/2022,Namibia,Sarawak,0,0,0
1/01/2022,Namibia,Selangor,1,1,0
1/01/2022,New Caledonia,Selangor,0,0,0
1/01/2022,Niger,Johor,0,0,0
1/01/2022,Niger,Sabah,0,0,0
1/01/2022,Niger,Selangor,0,0,0
1/01/2022,Nigeria,Johor,0,0,0
1/01/2022,Nigeria,Kedah,0,0,0
1/01/2022,Nigeria,Perlis,0,0,0
1/01/2022,Nigeria,Pulau Pinang,0,0,0
1/01/2022,Nigeria,Sabah,0,0,0
1/01/2022,Nigeria,Sarawak,0,0,0
1/01/2022,Nigeria,Selangor,202,157,45
1/01/2022,Nicaragua,Johor,0,0,0
1/01/2022,Nicaragua,Kedah,0,0,0
1/01/2022,Nicaragua,Pulau Pinang,0,0,0
1/01/2022,Nicaragua,Sabah,0,0,0
1/01/2022,Nicaragua,Selangor,1,1,0
1/01/2022,Netherlands,Johor,1,1,0
1/01/2022,Netherlands,Kedah,10,8,2
1/01/2022,Netherlands,Kelantan,0,0,0
1/01/2022,Netherlands,Melaka,0,0,0
1/01/2022,Netherlands,Negeri Sembilan,0,0,0
1/01/2022,Netherlands,Pahang,0,0,0
1/01/2022,Netherlands,Perak,0,0,0
1/01/2022,Netherlands,Perlis,0,0,0
1/01/2022,Netherlands,Pulau Pinang,3,2,1
1/01/2022,Netherlands,Sabah,0,0,0
1/01/2022,Netherlands,Sarawak,0,0,0
1/01/2022,Netherlands,Selangor,262,183,79
1/01/2022,Netherlands,Terengganu,0,0,0
1/01/2022,Netherlands,W.P. Labuan,0,0,0
1/01/2022,Norway,Johor,0,0,0
1/01/2022,Norway,Kedah,0,0,0
1/01/2022,Norway,Kelantan,0,0,0
1/01/2022,Norway,Melaka,0,0,0
1/01/2022,Norway,Pahang,0,0,0
1/01/2022,Norway,Perak,0,0,0
1/01/2022,Norway,Perlis,0,0,0
1/01/2022,Norway,Pulau Pinang,0,0,0
1/01/2022,Norway,Sabah,0,0,0
1/01/2022,Norway,Sarawak,1,1,0
1/01/2022,Norway,Selangor,66,45,21
1/01/2022,Norway,W.P. Labuan,0,0,0
1/01/2022,Nepal,Johor,0,0,0
1/01/2022,Nepal,Kedah,0,0,0
1/01/2022,Nepal,Pahang,0,0,0
1/01/2022,Nepal,Perak,0,0,0
1/01/2022,Nepal,Perlis,0,0,0
1/01/2022,Nepal,Pulau Pinang,7,7,0
1/01/2022,Nepal,Sabah,0,0,0
1/01/2022,Nepal,Sarawak,0,0,0
1/01/2022,Nepal,Selangor,647,615,32
1/01/2022,Nepal,W.P. Labuan,0,0,0
1/01/2022,Nauru,Johor,0,0,0
1/01/2022,Nauru,Pulau Pinang,0,0,0
1/01/2022,Nauru,Selangor,0,0,0
1/01/2022,New Zealand,Johor,3,1,2
1/01/2022,New Zealand,Kedah,3,2,1
1/01/2022,New Zealand,Kelantan,0,0,0
1/01/2022,New Zealand,Melaka,0,0,0
1/01/2022,New Zealand,Negeri Sembilan,0,0,0
1/01/2022,New Zealand,Pahang,0,0,0
1/01/2022,New Zealand,Perak,0,0,0
1/01/2022,New Zealand,Perlis,0,0,0
1/01/2022,New Zealand,Pulau Pinang,9,5,4
1/01/2022,New Zealand,Sabah,1,0,1
1/01/2022,New Zealand,Sarawak,0,0,0
1/01/2022,New Zealand,Selangor,140,89,51
1/01/2022,New Zealand,Terengganu,0,0,0
1/01/2022,New Zealand,W.P. Labuan,0,0,0
1/01/2022,Oman,Johor,0,0,0
1/01/2022,Oman,Kedah,0,0,0
1/01/2022,Oman,Kelantan,0,0,0
1/01/2022,Oman,Melaka,0,0,0
1/01/2022,Oman,Perak,0,0,0
1/01/2022,Oman,Perlis,0,0,0
1/01/2022,Oman,Pulau Pinang,0,0,0
1/01/2022,Oman,Sabah,0,0,0
1/01/2022,Oman,Sarawak,0,0,0
1/01/2022,Oman,Selangor,82,57,25
1/01/2022,Pakistan,Johor,9,9,0
1/01/2022,Pakistan,Kedah,0,0,0
1/01/2022,Pakistan,Kelantan,0,0,0
1/01/2022,Pakistan,Melaka,0,0,0
1/01/2022,Pakistan,Negeri Sembilan,0,0,0
1/01/2022,Pakistan,Pahang,0,0,0
1/01/2022,Pakistan,Perak,0,0,0
1/01/2022,Pakistan,Perlis,0,0,0
1/01/2022,Pakistan,Pulau Pinang,0,0,0
1/01/2022,Pakistan,Sabah,2,2,0
1/01/2022,Pakistan,Sarawak,2,1,1
1/01/2022,Pakistan,Selangor,3086,2663,423
1/01/2022,Pakistan,W.P. Labuan,0,0,0
1/01/2022,Panama,Johor,0,0,0
1/01/2022,Panama,Kedah,0,0,0
1/01/2022,Panama,Perak,0,0,0
1/01/2022,Panama,Perlis,0,0,0
1/01/2022,Panama,Pulau Pinang,0,0,0
1/01/2022,Panama,Sabah,0,0,0
1/01/2022,Panama,Sarawak,0,0,0
1/01/2022,Panama,Selangor,1,1,0
1/01/2022,Peru,Johor,0,0,0
1/01/2022,Peru,Kedah,0,0,0
1/01/2022,Peru,Kelantan,0,0,0
1/01/2022,Peru,Pahang,0,0,0
1/01/2022,Peru,Perak,0,0,0
1/01/2022,Peru,Perlis,0,0,0
1/01/2022,Peru,Pulau Pinang,0,0,0
1/01/2022,Peru,Sabah,0,0,0
1/01/2022,Peru,Sarawak,0,0,0
1/01/2022,Peru,Selangor,8,5,3
1/01/2022,Peru,W.P. Labuan,0,0,0
1/01/2022,Philippines,Johor,121,116,5
1/01/2022,Philippines,Kedah,3,1,2
1/01/2022,Philippines,Kelantan,0,0,0
1/01/2022,Philippines,Melaka,0,0,0
1/01/2022,Philippines,Negeri Sembilan,0,0,0
1/01/2022,Philippines,Pahang,0,0,0
1/01/2022,Philippines,Perak,0,0,0
1/01/2022,Philippines,Perlis,0,0,0
1/01/2022,Philippines,Pulau Pinang,3,2,1
1/01/2022,Philippines,Sabah,4,1,3
1/01/2022,Philippines,Sarawak,13,10,3
1/01/2022,Philippines,Selangor,1336,676,660
1/01/2022,Philippines,Terengganu,0,0,0
1/01/2022,Philippines,W.P. Labuan,4,4,0
1/01/2022,Palau,Johor,0,0,0
1/01/2022,Palau,Pulau Pinang,0,0,0
1/01/2022,Palau,Selangor,0,0,0
1/01/2022,Papua New Guinea,Johor,0,0,0
1/01/2022,Papua New Guinea,Kedah,0,0,0
1/01/2022,Papua New Guinea,Kelantan,0,0,0
1/01/2022,Papua New Guinea,Perak,0,0,0
1/01/2022,Papua New Guinea,Pulau Pinang,0,0,0
1/01/2022,Papua New Guinea,Sabah,0,0,0
1/01/2022,Papua New Guinea,Sarawak,0,0,0
1/01/2022,Papua New Guinea,Selangor,0,0,0
1/01/2022,Poland,Johor,0,0,0
1/01/2022,Poland,Kedah,0,0,0
1/01/2022,Poland,Kelantan,0,0,0
1/01/2022,Poland,Melaka,0,0,0
1/01/2022,Poland,Negeri Sembilan,0,0,0
1/01/2022,Poland,Pahang,0,0,0
1/01/2022,Poland,Perak,0,0,0
1/01/2022,Poland,Perlis,0,0,0
1/01/2022,Poland,Pulau Pinang,0,0,0
1/01/2022,Poland,Sabah,0,0,0
1/01/2022,Poland,Sarawak,0,0,0
1/01/2022,Poland,Selangor,74,51,23
1/01/2022,Poland,Terengganu,0,0,0
1/01/2022,Poland,W.P. Labuan,0,0,0
1/01/2022,"North Korea, Democratic People's Republic of",Selangor,0,0,0
1/01/2022,Portugal,Johor,1,0,1
1/01/2022,Portugal,Kedah,0,0,0
1/01/2022,Portugal,Kelantan,0,0,0
1/01/2022,Portugal,Melaka,0,0,0
1/01/2022,Portugal,Pahang,0,0,0
1/01/2022,Portugal,Perak,0,0,0
1/01/2022,Portugal,Perlis,0,0,0
1/01/2022,Portugal,Pulau Pinang,0,0,0
1/01/2022,Portugal,Sabah,0,0,0
1/01/2022,Portugal,Sarawak,0,0,0
1/01/2022,Portugal,Selangor,40,27,13
1/01/2022,Portugal,W.P. Labuan,0,0,0
1/01/2022,Paraguay,Johor,0,0,0
1/01/2022,Paraguay,Kedah,0,0,0
1/01/2022,Paraguay,Perak,0,0,0
1/01/2022,Paraguay,Perlis,0,0,0
1/01/2022,Paraguay,Pulau Pinang,0,0,0
1/01/2022,Paraguay,Sabah,0,0,0
1/01/2022,Paraguay,Sarawak,0,0,0
1/01/2022,Paraguay,Selangor,0,0,0
1/01/2022,"Palestine, State of",Johor,0,0,0
1/01/2022,"Palestine, State of",Kedah,0,0,0
1/01/2022,"Palestine, State of",Kelantan,0,0,0
1/01/2022,"Palestine, State of",Melaka,0,0,0
1/01/2022,"Palestine, State of",Perak,0,0,0
1/01/2022,"Palestine, State of",Perlis,0,0,0
1/01/2022,"Palestine, State of",Pulau Pinang,0,0,0
1/01/2022,"Palestine, State of",Sabah,0,0,0
1/01/2022,"Palestine, State of",Sarawak,0,0,0
1/01/2022,"Palestine, State of",Selangor,56,40,16
1/01/2022,Qatar,Johor,0,0,0
1/01/2022,Qatar,Kedah,0,0,0
1/01/2022,Qatar,Perlis,0,0,0
1/01/2022,Qatar,Pulau Pinang,0,0,0
1/01/2022,Qatar,Sabah,0,0,0
1/01/2022,Qatar,Sarawak,0,0,0
1/01/2022,Qatar,Selangor,6,5,1
1/01/2022,Réunion,Johor,0,0,0
1/01/2022,Réunion,Sarawak,0,0,0
1/01/2022,Romania,Johor,3,3,0
1/01/2022,Romania,Kedah,3,1,2
1/01/2022,Romania,Kelantan,0,0,0
1/01/2022,Romania,Negeri Sembilan,0,0,0
1/01/2022,Romania,Pahang,0,0,0
1/01/2022,Romania,Perak,0,0,0
1/01/2022,Romania,Perlis,0,0,0
1/01/2022,Romania,Pulau Pinang,0,0,0
1/01/2022,Romania,Sabah,0,0,0
1/01/2022,Romania,Sarawak,2,1,1
1/01/2022,Romania,Selangor,46,31,15
1/01/2022,Romania,W.P. Labuan,0,0,0
1/01/2022,Russian Federation (Russia),Johor,14,14,0
1/01/2022,Russian Federation (Russia),Kedah,1,1,0
1/01/2022,Russian Federation (Russia),Kelantan,0,0,0
1/01/2022,Russian Federation (Russia),Melaka,0,0,0
1/01/2022,Russian Federation (Russia),Negeri Sembilan,0,0,0
1/01/2022,Russian Federation (Russia),Pahang,0,0,0
1/01/2022,Russian Federation (Russia),Perak,0,0,0
1/01/2022,Russian Federation (Russia),Perlis,0,0,0
1/01/2022,Russian Federation (Russia),Pulau Pinang,1,1,0
1/01/2022,Russian Federation (Russia),Sabah,0,0,0
1/01/2022,Russian Federation (Russia),Sarawak,0,0,0
1/01/2022,Russian Federation (Russia),Selangor,111,48,63
1/01/2022,Russian Federation (Russia),W.P. Labuan,0,0,0
1/01/2022,Rwanda,Johor,0,0,0
1/01/2022,Rwanda,Kedah,0,0,0
1/01/2022,Rwanda,Pulau Pinang,0,0,0
1/01/2022,Rwanda,Selangor,4,1,3
1/01/2022,Saudi Arabia,Johor,0,0,0
1/01/2022,Saudi Arabia,Kedah,4,3,1
1/01/2022,Saudi Arabia,Kelantan,0,0,0
1/01/2022,Saudi Arabia,Melaka,0,0,0
1/01/2022,Saudi Arabia,Perak,0,0,0
1/01/2022,Saudi Arabia,Perlis,0,0,0
1/01/2022,Saudi Arabia,Pulau Pinang,0,0,0
1/01/2022,Saudi Arabia,Sabah,0,0,0
1/01/2022,Saudi Arabia,Sarawak,0,0,0
1/01/2022,Saudi Arabia,Selangor,240,157,83
1/01/2022,Saudi Arabia,W.P. Labuan,0,0,0
1/01/2022,Sudan,Johor,0,0,0
1/01/2022,Sudan,Kedah,0,0,0
1/01/2022,Sudan,Kelantan,0,0,0
1/01/2022,Sudan,Perlis,0,0,0
1/01/2022,Sudan,Pulau Pinang,0,0,0
1/01/2022,Sudan,Sabah,0,0,0
1/01/2022,Sudan,Sarawak,0,0,0
1/01/2022,Sudan,Selangor,143,104,39
1/01/2022,Sudan,W.P. Labuan,0,0,0
1/01/2022,Senegal,Johor,0,0,0
1/01/2022,Senegal,Kedah,0,0,0
1/01/2022,Senegal,Kelantan,0,0,0
1/01/2022,Senegal,Perak,0,0,0
1/01/2022,Senegal,Perlis,0,0,0
1/01/2022,Senegal,Pulau Pinang,0,0,0
1/01/2022,Senegal,Sabah,0,0,0
1/01/2022,Senegal,Sarawak,0,0,0
1/01/2022,Senegal,Selangor,2,2,0
1/01/2022,Singapore,Johor,3211,1801,1410
1/01/2022,Singapore,Kedah,12,8,4
1/01/2022,Singapore,Kelantan,0,0,0
1/01/2022,Singapore,Melaka,0,0,0
1/01/2022,Singapore,Negeri Sembilan,0,0,0
1/01/2022,Singapore,Pahang,0,0,0
1/01/2022,Singapore,Perak,12,5,7
1/01/2022,Singapore,Perlis,0,0,0
1/01/2022,Singapore,Pulau Pinang,14,9,5
1/01/2022,Singapore,Sabah,1,0,1
1/01/2022,Singapore,Sarawak,22,13,9
1/01/2022,Singapore,Selangor,4312,2308,2004
1/01/2022,Singapore,Terengganu,0,0,0
1/01/2022,Singapore,W.P. Labuan,0,0,0
1/01/2022,South Georgia and the South Sandwich Islands,Johor,0,0,0
1/01/2022,South Georgia and the South Sandwich Islands,Sabah,0,0,0
1/01/2022,South Georgia and the South Sandwich Islands,Selangor,0,0,0
1/01/2022,Saint Helena,Sarawak,0,0,0
1/01/2022,Solomon Islands,Johor,0,0,0
1/01/2022,Solomon Islands,Perlis,0,0,0
1/01/2022,Solomon Islands,Pulau Pinang,0,0,0
1/01/2022,Solomon Islands,Sabah,0,0,0
1/01/2022,Solomon Islands,Sarawak,0,0,0
1/01/2022,Solomon Islands,Selangor,0,0,0
1/01/2022,Solomon Islands,W.P. Labuan,0,0,0
1/01/2022,Sierra Leone,Johor,0,0,0
1/01/2022,Sierra Leone,Kedah,0,0,0
1/01/2022,Sierra Leone,Perak,0,0,0
1/01/2022,Sierra Leone,Pulau Pinang,0,0,0
1/01/2022,Sierra Leone,Sabah,0,0,0
1/01/2022,Sierra Leone,Selangor,2,2,0
1/01/2022,El Salvador,Johor,0,0,0
1/01/2022,El Salvador,Kedah,0,0,0
1/01/2022,El Salvador,Perak,0,0,0
1/01/2022,El Salvador,Perlis,0,0,0
1/01/2022,El Salvador,Pulau Pinang,0,0,0
1/01/2022,El Salvador,Sabah,0,0,0
1/01/2022,El Salvador,Selangor,0,0,0
1/01/2022,El Salvador,W.P. Labuan,0,0,0
1/01/2022,San Marino,Johor,0,0,0
1/01/2022,San Marino,Selangor,1,1,0
1/01/2022,Somalia,Johor,0,0,0
1/01/2022,Somalia,Kedah,0,0,0
1/01/2022,Somalia,Kelantan,0,0,0
1/01/2022,Somalia,Perlis,0,0,0
1/01/2022,Somalia,Sabah,0,0,0
1/01/2022,Somalia,Sarawak,0,0,0
1/01/2022,Somalia,Selangor,77,52,25
1/01/2022,Serbia,Johor,0,0,0
1/01/2022,Serbia,Kedah,0,0,0
1/01/2022,Serbia,Kelantan,0,0,0
1/01/2022,Serbia,Pahang,0,0,0
1/01/2022,Serbia,Perak,0,0,0
1/01/2022,Serbia,Perlis,0,0,0
1/01/2022,Serbia,Pulau Pinang,0,0,0
1/01/2022,Serbia,Sabah,0,0,0
1/01/2022,Serbia,Sarawak,0,0,0
1/01/2022,Serbia,Selangor,4,3,1
1/01/2022,South Sudan,Johor,0,0,0
1/01/2022,South Sudan,Kedah,0,0,0
1/01/2022,South Sudan,Sarawak,0,0,0
1/01/2022,South Sudan,Selangor,8,8,0
1/01/2022,South Sudan,W.P. Labuan,0,0,0
1/01/2022,Sao Tome and Principe,Selangor,0,0,0
1/01/2022,Suriname,Johor,0,0,0
1/01/2022,Suriname,Kedah,0,0,0
1/01/2022,Suriname,Kelantan,0,0,0
1/01/2022,Suriname,Perak,0,0,0
1/01/2022,Suriname,Perlis,0,0,0
1/01/2022,Suriname,Pulau Pinang,0,0,0
1/01/2022,Suriname,Sabah,0,0,0
1/01/2022,Suriname,Sarawak,0,0,0
1/01/2022,Suriname,Selangor,0,0,0
1/01/2022,Slovakia,Johor,0,0,0
1/01/2022,Slovakia,Kedah,0,0,0
1/01/2022,Slovakia,Kelantan,0,0,0
1/01/2022,Slovakia,Negeri Sembilan,0,0,0
1/01/2022,Slovakia,Pahang,0,0,0
1/01/2022,Slovakia,Perak,0,0,0
1/01/2022,Slovakia,Perlis,0,0,0
1/01/2022,Slovakia,Pulau Pinang,0,0,0
1/01/2022,Slovakia,Sabah,0,0,0
1/01/2022,Slovakia,Sarawak,1,1,0
1/01/2022,Slovakia,Selangor,33,27,6
1/01/2022,Slovakia,W.P. Labuan,0,0,0
1/01/2022,Slovenia,Johor,0,0,0
1/01/2022,Slovenia,Kedah,0,0,0
1/01/2022,Slovenia,Kelantan,0,0,0
1/01/2022,Slovenia,Perak,0,0,0
1/01/2022,Slovenia,Perlis,0,0,0
1/01/2022,Slovenia,Pulau Pinang,0,0,0
1/01/2022,Slovenia,Sabah,0,0,0
1/01/2022,Slovenia,Sarawak,0,0,0
1/01/2022,Slovenia,Selangor,3,3,0
1/01/2022,Slovenia,W.P. Labuan,0,0,0
1/01/2022,Sweden,Johor,0,0,0
1/01/2022,Sweden,Kedah,1,1,0
1/01/2022,Sweden,Kelantan,0,0,0
1/01/2022,Sweden,Melaka,0,0,0
1/01/2022,Sweden,Negeri Sembilan,0,0,0
1/01/2022,Sweden,Pahang,0,0,0
1/01/2022,Sweden,Perak,0,0,0
1/01/2022,Sweden,Perlis,0,0,0
1/01/2022,Sweden,Pulau Pinang,0,0,0
1/01/2022,Sweden,Sabah,0,0,0
1/01/2022,Sweden,Sarawak,0,0,0
1/01/2022,Sweden,Selangor,86,59,27
1/01/2022,Sweden,W.P. Labuan,0,0,0
1/01/2022,Eswatini,Johor,0,0,0
1/01/2022,Eswatini,Kedah,0,0,0
1/01/2022,Eswatini,Pulau Pinang,0,0,0
1/01/2022,Eswatini,Sabah,0,0,0
1/01/2022,Eswatini,Selangor,3,1,2
1/01/2022,Seychelles,Johor,0,0,0
1/01/2022,Seychelles,Kedah,0,0,0
1/01/2022,Seychelles,Pulau Pinang,0,0,0
1/01/2022,Seychelles,Sabah,0,0,0
1/01/2022,Seychelles,Sarawak,0,0,0
1/01/2022,Seychelles,Selangor,19,6,13
1/01/2022,Syrian Arab Republic,Johor,0,0,0
1/01/2022,Syrian Arab Republic,Kedah,0,0,0
1/01/2022,Syrian Arab Republic,Kelantan,0,0,0
1/01/2022,Syrian Arab Republic,Pahang,0,0,0
1/01/2022,Syrian Arab Republic,Perlis,0,0,0
1/01/2022,Syrian Arab Republic,Pulau Pinang,0,0,0
1/01/2022,Syrian Arab Republic,Sabah,0,0,0
1/01/2022,Syrian Arab Republic,Sarawak,0,0,0
1/01/2022,Syrian Arab Republic,Selangor,98,66,32
1/01/2022,Syrian Arab Republic,W.P. Labuan,0,0,0
1/01/2022,Turks and Caicos Islands,Perlis,0,0,0
1/01/2022,TCD,Johor,0,0,0
1/01/2022,TCD,Kedah,0,0,0
1/01/2022,TCD,Perlis,0,0,0
1/01/2022,TCD,Selangor,8,8,0
1/01/2022,Togo,Johor,0,0,0
1/01/2022,Togo,Perak,0,0,0
1/01/2022,Togo,Pulau Pinang,0,0,0
1/01/2022,Togo,Selangor,0,0,0
1/01/2022,Thailand,Johor,70,68,2
1/01/2022,Thailand,Kedah,18304,18252,52
1/01/2022,Thailand,Kelantan,2,1,1
1/01/2022,Thailand,Melaka,0,0,0
1/01/2022,Thailand,Negeri Sembilan,0,0,0
1/01/2022,Thailand,Pahang,0,0,0
1/01/2022,Thailand,Perak,0,0,0
1/01/2022,Thailand,Perlis,9168,9012,156
1/01/2022,Thailand,Pulau Pinang,16,11,5
1/01/2022,Thailand,Sabah,3,1,2
1/01/2022,Thailand,Sarawak,13,12,1
1/01/2022,Thailand,Selangor,1071,401,670
1/01/2022,Thailand,Terengganu,0,0,0
1/01/2022,Thailand,W.P. Labuan,0,0,0
1/01/2022,Tajikistan,Johor,0,0,0
1/01/2022,Tajikistan,Kedah,0,0,0
1/01/2022,Tajikistan,Perlis,0,0,0
1/01/2022,Tajikistan,Pulau Pinang,0,0,0
1/01/2022,Tajikistan,Sabah,0,0,0
1/01/2022,Tajikistan,Selangor,6,5,1
1/01/2022,Tokelau,Selangor,0,0,0
1/01/2022,Turkmenistan,Johor,0,0,0
1/01/2022,Turkmenistan,Kedah,0,0,0
1/01/2022,Turkmenistan,Kelantan,0,0,0
1/01/2022,Turkmenistan,Perlis,0,0,0
1/01/2022,Turkmenistan,Pulau Pinang,0,0,0
1/01/2022,Turkmenistan,Sabah,0,0,0
1/01/2022,Turkmenistan,Sarawak,0,0,0
1/01/2022,Turkmenistan,Selangor,10,4,6
1/01/2022,Timor-Leste,Johor,0,0,0
1/01/2022,Timor-Leste,Kedah,0,0,0
1/01/2022,Timor-Leste,Perlis,0,0,0
1/01/2022,Timor-Leste,Pulau Pinang,0,0,0
1/01/2022,Timor-Leste,Sabah,0,0,0
1/01/2022,Timor-Leste,Sarawak,0,0,0
1/01/2022,Timor-Leste,Selangor,13,7,6
1/01/2022,Tonga,Johor,0,0,0
1/01/2022,Tonga,Pulau Pinang,0,0,0
1/01/2022,Tonga,Sarawak,0,0,0
1/01/2022,Tonga,Selangor,0,0,0
1/01/2022,Trinidad and Tobago,Johor,0,0,0
1/01/2022,Trinidad and Tobago,Kedah,0,0,0
1/01/2022,Trinidad and Tobago,Pahang,0,0,0
1/01/2022,Trinidad and Tobago,Pulau Pinang,0,0,0
1/01/2022,Trinidad and Tobago,Sabah,0,0,0
1/01/2022,Trinidad and Tobago,Sarawak,0,0,0
1/01/2022,Trinidad and Tobago,Selangor,7,5,2
1/01/2022,Tunisia,Johor,0,0,0
1/01/2022,Tunisia,Kedah,0,0,0
1/01/2022,Tunisia,Kelantan,0,0,0
1/01/2022,Tunisia,Melaka,0,0,0
1/01/2022,Tunisia,Perak,0,0,0
1/01/2022,Tunisia,Perlis,0,0,0
1/01/2022,Tunisia,Pulau Pinang,0,0,0
1/01/2022,Tunisia,Sabah,0,0,0
1/01/2022,Tunisia,Sarawak,0,0,0
1/01/2022,Tunisia,Selangor,24,15,9
1/01/2022,Tunisia,W.P. Labuan,0,0,0
1/01/2022,Türkiye,Johor,9,9,0
1/01/2022,Türkiye,Kedah,0,0,0
1/01/2022,Türkiye,Kelantan,0,0,0
1/01/2022,Türkiye,Melaka,0,0,0
1/01/2022,Türkiye,Negeri Sembilan,0,0,0
1/01/2022,Türkiye,Pahang,0,0,0
1/01/2022,Türkiye,Perak,0,0,0
1/01/2022,Türkiye,Perlis,0,0,0
1/01/2022,Türkiye,Pulau Pinang,0,0,0
1/01/2022,Türkiye,Sabah,0,0,0
1/01/2022,Türkiye,Sarawak,0,0,0
1/01/2022,Türkiye,Selangor,131,92,39
1/01/2022,Türkiye,W.P. Labuan,0,0,0
1/01/2022,Tuvalu,Selangor,0,0,0
1/01/2022,"Taiwan, Province of China",Johor,1,1,0
1/01/2022,"Taiwan, Province of China",Kedah,2,0,2
1/01/2022,"Taiwan, Province of China",Kelantan,0,0,0
1/01/2022,"Taiwan, Province of China",Melaka,0,0,0
1/01/2022,"Taiwan, Province of China",Negeri Sembilan,0,0,0
1/01/2022,"Taiwan, Province of China",Pahang,0,0,0
1/01/2022,"Taiwan, Province of China",Perak,0,0,0
1/01/2022,"Taiwan, Province of China",Perlis,0,0,0
1/01/2022,"Taiwan, Province of China",Pulau Pinang,26,13,13
1/01/2022,"Taiwan, Province of China",Sabah,1,1,0
1/01/2022,"Taiwan, Province of China",Sarawak,3,2,1
1/01/2022,"Taiwan, Province of China",Selangor,205,117,88
1/01/2022,"Taiwan, Province of China",W.P. Labuan,0,0,0
1/01/2022,"Tanzania, United Republic of",Johor,0,0,0
1/01/2022,"Tanzania, United Republic of",Kedah,0,0,0
1/01/2022,"Tanzania, United Republic of",Perak,0,0,0
1/01/2022,"Tanzania, United Republic of",Perlis,0,0,0
1/01/2022,"Tanzania, United Republic of",Pulau Pinang,0,0,0
1/01/2022,"Tanzania, United Republic of",Sabah,0,0,0
1/01/2022,"Tanzania, United Republic of",Sarawak,0,0,0
1/01/2022,"Tanzania, United Republic of",Selangor,41,20,21
1/01/2022,Uganda,Johor,0,0,0
1/01/2022,Uganda,Kedah,0,0,0
1/01/2022,Uganda,Perak,0,0,0
1/01/2022,Uganda,Perlis,0,0,0
1/01/2022,Uganda,Pulau Pinang,0,0,0
1/01/2022,Uganda,Sabah,0,0,0
1/01/2022,Uganda,Sarawak,0,0,0
1/01/2022,Uganda,Selangor,17,7,10
1/01/2022,Ukraine,Johor,17,17,0
1/01/2022,Ukraine,Kedah,2,0,2
1/01/2022,Ukraine,Kelantan,0,0,0
1/01/2022,Ukraine,Melaka,0,0,0
1/01/2022,Ukraine,Negeri Sembilan,0,0,0
1/01/2022,Ukraine,Pahang,0,0,0
1/01/2022,Ukraine,Perak,0,0,0
1/01/2022,Ukraine,Perlis,0,0,0
1/01/2022,Ukraine,Pulau Pinang,2,2,0
1/01/2022,Ukraine,Sabah,0,0,0
1/01/2022,Ukraine,Sarawak,1,1,0
1/01/2022,Ukraine,Selangor,81,62,19
1/01/2022,Ukraine,W.P. Labuan,0,0,0
1/01/2022,Uruguay,Johor,0,0,0
1/01/2022,Uruguay,Kedah,0,0,0
1/01/2022,Uruguay,Kelantan,0,0,0
1/01/2022,Uruguay,Perak,0,0,0
1/01/2022,Uruguay,Perlis,0,0,0
1/01/2022,Uruguay,Pulau Pinang,0,0,0
1/01/2022,Uruguay,Sabah,0,0,0
1/01/2022,Uruguay,Sarawak,0,0,0
1/01/2022,Uruguay,Selangor,0,0,0
1/01/2022,Uruguay,W.P. Labuan,0,0,0
1/01/2022,United States of America,Johor,3,2,1
1/01/2022,United States of America,Kedah,33,20,13
1/01/2022,United States of America,Kelantan,0,0,0
1/01/2022,United States of America,Melaka,0,0,0
1/01/2022,United States of America,Negeri Sembilan,0,0,0
1/01/2022,United States of America,Pahang,0,0,0
1/01/2022,United States of America,Perak,1,0,1
1/01/2022,United States of America,Perlis,0,0,0
1/01/2022,United States of America,Pulau Pinang,10,7,3
1/01/2022,United States of America,Sabah,1,0,1
1/01/2022,United States of America,Sarawak,3,1,2
1/01/2022,United States of America,Selangor,1045,635,410
1/01/2022,United States of America,Terengganu,0,0,0
1/01/2022,United States of America,W.P. Labuan,0,0,0
1/01/2022,Uzbekistan,Johor,0,0,0
1/01/2022,Uzbekistan,Kedah,0,0,0
1/01/2022,Uzbekistan,Kelantan,0,0,0
1/01/2022,Uzbekistan,Perak,0,0,0
1/01/2022,Uzbekistan,Perlis,0,0,0
1/01/2022,Uzbekistan,Pulau Pinang,0,0,0
1/01/2022,Uzbekistan,Sabah,0,0,0
1/01/2022,Uzbekistan,Sarawak,0,0,0
1/01/2022,Uzbekistan,Selangor,45,27,18
1/01/2022,Holy See,Johor,0,0,0
1/01/2022,Holy See,Sarawak,0,0,0
1/01/2022,Holy See,Selangor,0,0,0
1/01/2022,Saint Vincent and the Grenadines,Johor,0,0,0
1/01/2022,Saint Vincent and the Grenadines,Kedah,0,0,0
1/01/2022,Saint Vincent and the Grenadines,Pulau Pinang,0,0,0
1/01/2022,Saint Vincent and the Grenadines,Sarawak,0,0,0
1/01/2022,Saint Vincent and the Grenadines,Selangor,0,0,0
1/01/2022,"Venezuela, Bolivarian Republic of",Johor,0,0,0
1/01/2022,"Venezuela, Bolivarian Republic of",Kedah,0,0,0
1/01/2022,"Venezuela, Bolivarian Republic of",Kelantan,0,0,0
1/01/2022,"Venezuela, Bolivarian Republic of",Melaka,0,0,0
1/01/2022,"Venezuela, Bolivarian Republic of",Perak,0,0,0
1/01/2022,"Venezuela, Bolivarian Republic of",Perlis,0,0,0
1/01/2022,"Venezuela, Bolivarian Republic of",Pulau Pinang,0,0,0
1/01/2022,"Venezuela, Bolivarian Republic of",Sabah,0,0,0
1/01/2022,"Venezuela, Bolivarian Republic of",Sarawak,0,0,0
1/01/2022,"Venezuela, Bolivarian Republic of",Selangor,19,9,10
1/01/2022,"Venezuela, Bolivarian Republic of",W.P. Labuan,0,0,0
1/01/2022,Viet Nam,Johor,12,9,3
1/01/2022,Viet Nam,Kedah,11,2,9
1/01/2022,Viet Nam,Kelantan,2,0,2
1/01/2022,Viet Nam,Melaka,0,0,0
1/01/2022,Viet Nam,Negeri Sembilan,0,0,0
1/01/2022,Viet Nam,Pahang,0,0,0
1/01/2022,Viet Nam,Perak,0,0,0
1/01/2022,Viet Nam,Perlis,0,0,0
1/01/2022,Viet Nam,Pulau Pinang,2,1,1
1/01/2022,Viet Nam,Sabah,1,0,1
1/01/2022,Viet Nam,Sarawak,3,0,3
1/01/2022,Viet Nam,Selangor,255,55,200
1/01/2022,Viet Nam,Terengganu,0,0,0
1/01/2022,Viet Nam,W.P. Labuan,2,2,0
1/01/2022,Vanuatu,Johor,0,0,0
1/01/2022,Vanuatu,Kedah,0,0,0
1/01/2022,Vanuatu,Pulau Pinang,0,0,0
1/01/2022,Vanuatu,Sabah,0,0,0
1/01/2022,Vanuatu,Sarawak,0,0,0
1/01/2022,Vanuatu,Selangor,1,1,0
1/01/2022, Samoa,Johor,0,0,0
1/01/2022, Samoa,Sarawak,0,0,0
1/01/2022, Samoa,Selangor,0,0,0
1/01/2022,Yemen,Johor,0,0,0
1/01/2022,Yemen,Kedah,1,1,0
1/01/2022,Yemen,Kelantan,0,0,0
1/01/2022,Yemen,Melaka,0,0,0
1/01/2022,Yemen,Pahang,0,0,0
1/01/2022,Yemen,Perak,0,0,0
1/01/2022,Yemen,Perlis,0,0,0
1/01/2022,Yemen,Pulau Pinang,0,0,0
1/01/2022,Yemen,Sabah,0,0,0
1/01/2022,Yemen,Sarawak,0,0,0
1/01/2022,Yemen,Selangor,315,215,100
1/01/2022,Yemen,W.P. Labuan,0,0,0
1/01/2022,South Africa,Johor,0,0,0
1/01/2022,South Africa,Kedah,1,1,0
1/01/2022,South Africa,Kelantan,0,0,0
1/01/2022,South Africa,Melaka,0,0,0
1/01/2022,South Africa,Pahang,0,0,0
1/01/2022,South Africa,Perak,0,0,0
1/01/2022,South Africa,Perlis,0,0,0
1/01/2022,South Africa,Pulau Pinang,1,1,0
1/01/2022,South Africa,Sabah,0,0,0
1/01/2022,South Africa,Sarawak,4,3,1
1/01/2022,South Africa,Selangor,102,64,38
1/01/2022,South Africa,Terengganu,0,0,0
1/01/2022,South Africa,W.P. Labuan,0,0,0
1/01/2022,ZAR,Selangor,0,0,0
1/01/2022,Zambia,Johor,0,0,0
1/01/2022,Zambia,Kedah,0,0,0
1/01/2022,Zambia,Perak,0,0,0
1/01/2022,Zambia,Perlis,0,0,0
1/01/2022,Zambia,Pulau Pinang,0,0,0
1/01/2022,Zambia,Sabah,0,0,0
1/01/2022,Zambia,Sarawak,0,0,0
1/01/2022,Zambia,Selangor,8,5,3
1/01/2022,Zimbabwe,Johor,0,0,0
1/01/2022,Zimbabwe,Kedah,0,0,0
1/01/2022,Zimbabwe,Kelantan,0,0,0
1/01/2022,Zimbabwe,Perak,0,0,0
1/01/2022,Zimbabwe,Perlis,0,0,0
1/01/2022,Zimbabwe,Pulau Pinang,0,0,0
1/01/2022,Zimbabwe,Sabah,0,0,0
1/01/2022,Zimbabwe,Sarawak,0,0,0
1/01/2022,Zimbabwe,Selangor,25,9,16
1/02/2022,Aruba,Kedah,0,0,0
1/02/2022,Aruba,Pulau Pinang,0,0,0
1/02/2022,Afghanistan,Johor,0,0,0
1/02/2022,Afghanistan,Kedah,0,0,0
1/02/2022,Afghanistan,Perlis,0,0,0
1/02/2022,Afghanistan,Pulau Pinang,0,0,0
1/02/2022,Afghanistan,Sarawak,0,0,0
1/02/2022,Afghanistan,Selangor,76,53,23
1/02/2022,Angola,Johor,0,0,0
1/02/2022,Angola,Kedah,0,0,0
1/02/2022,Angola,Sabah,0,0,0
1/02/2022,Angola,Selangor,0,0,0
1/02/2022,Anguilla,Selangor,0,0,0
1/02/2022,Albania,Johor,0,0,0
1/02/2022,Albania,Kedah,0,0,0
1/02/2022,Albania,Perak,0,0,0
1/02/2022,Albania,Perlis,0,0,0
1/02/2022,Albania,Pulau Pinang,0,0,0
1/02/2022,Albania,Sabah,0,0,0
1/02/2022,Albania,Sarawak,0,0,0
1/02/2022,Albania,Selangor,3,2,1
1/02/2022,Andorra,Johor,0,0,0
1/02/2022,Andorra,Kedah,0,0,0
1/02/2022,Andorra,Perlis,0,0,0
1/02/2022,Andorra,Pulau Pinang,0,0,0
1/02/2022,Andorra,Selangor,0,0,0
1/02/2022,Antigua and Barbuda,Selangor,0,0,0
1/02/2022,United Arab Emirates,Johor,0,0,0
1/02/2022,United Arab Emirates,Kedah,0,0,0
1/02/2022,United Arab Emirates,Kelantan,1,1,0
1/02/2022,United Arab Emirates,Perak,0,0,0
1/02/2022,United Arab Emirates,Perlis,0,0,0
1/02/2022,United Arab Emirates,Pulau Pinang,0,0,0
1/02/2022,United Arab Emirates,Sabah,0,0,0
1/02/2022,United Arab Emirates,Sarawak,0,0,0
1/02/2022,United Arab Emirates,Selangor,5,4,1
1/02/2022,Argentina,Johor,0,0,0
1/02/2022,Argentina,Kedah,0,0,0
1/02/2022,Argentina,Kelantan,0,0,0
1/02/2022,Argentina,Melaka,0,0,0
1/02/2022,Argentina,Perak,0,0,0
1/02/2022,Argentina,Perlis,0,0,0
1/02/2022,Argentina,Pulau Pinang,0,0,0
1/02/2022,Argentina,Sabah,0,0,0
1/02/2022,Argentina,Sarawak,0,0,0
1/02/2022,Argentina,Selangor,19,13,6
1/02/2022,Argentina,W.P. Labuan,0,0,0
1/02/2022,Armenia,Johor,0,0,0
1/02/2022,Armenia,Kedah,0,0,0
1/02/2022,Armenia,Kelantan,0,0,0
1/02/2022,Armenia,Perak,0,0,0
1/02/2022,Armenia,Perlis,0,0,0
1/02/2022,Armenia,Pulau Pinang,0,0,0
1/02/2022,Armenia,Sabah,0,0,0
1/02/2022,Armenia,Sarawak,0,0,0
1/02/2022,Armenia,Selangor,1,0,1
1/02/2022,Antarctica,Selangor,0,0,0
1/02/2022,Antigua and Barbuda,Johor,0,0,0
1/02/2022,Antigua and Barbuda,Kedah,0,0,0
1/02/2022,Antigua and Barbuda,Pulau Pinang,0,0,0
1/02/2022,Antigua and Barbuda,Sarawak,0,0,0
1/02/2022,Antigua and Barbuda,Selangor,5,2,3
1/02/2022,Australia,Johor,0,0,0
1/02/2022,Australia,Kedah,68,44,24
1/02/2022,Australia,Kelantan,0,0,0
1/02/2022,Australia,Melaka,0,0,0
1/02/2022,Australia,Negeri Sembilan,0,0,0
1/02/2022,Australia,Pahang,0,0,0
1/02/2022,Australia,Perak,3,0,3
1/02/2022,Australia,Perlis,0,0,0
1/02/2022,Australia,Pulau Pinang,18,7,11
1/02/2022,Australia,Sabah,0,0,0
1/02/2022,Australia,Sarawak,7,4,3
1/02/2022,Australia,Selangor,474,319,155
1/02/2022,Australia,Terengganu,0,0,0
1/02/2022,Australia,W.P. Labuan,0,0,0
1/02/2022,Austria,Johor,0,0,0
1/02/2022,Austria,Kedah,1,1,0
1/02/2022,Austria,Kelantan,0,0,0
1/02/2022,Austria,Melaka,0,0,0
1/02/2022,Austria,Negeri Sembilan,0,0,0
1/02/2022,Austria,Pahang,0,0,0
1/02/2022,Austria,Perak,0,0,0
1/02/2022,Austria,Perlis,0,0,0
1/02/2022,Austria,Pulau Pinang,0,0,0
1/02/2022,Austria,Sabah,0,0,0
1/02/2022,Austria,Sarawak,0,0,0
1/02/2022,Austria,Selangor,45,38,7
1/02/2022,Austria,Terengganu,0,0,0
1/02/2022,Austria,W.P. Labuan,0,0,0
1/02/2022,Azerbaijan,Johor,0,0,0
1/02/2022,Azerbaijan,Kedah,0,0,0
1/02/2022,Azerbaijan,Kelantan,0,0,0
1/02/2022,Azerbaijan,Melaka,0,0,0
1/02/2022,Azerbaijan,Perlis,0,0,0
1/02/2022,Azerbaijan,Pulau Pinang,0,0,0
1/02/2022,Azerbaijan,Sabah,0,0,0
1/02/2022,Azerbaijan,Sarawak,0,0,0
1/02/2022,Azerbaijan,Selangor,3,3,0
1/02/2022,Azerbaijan,W.P. Labuan,0,0,0
1/02/2022,Burundi,Pulau Pinang,0,0,0
1/02/2022,Burundi,Sarawak,0,0,0
1/02/2022,Burundi,Selangor,1,1,0
1/02/2022,Belgium,Johor,0,0,0
1/02/2022,Belgium,Kedah,0,0,0
1/02/2022,Belgium,Kelantan,0,0,0
1/02/2022,Belgium,Melaka,0,0,0
1/02/2022,Belgium,Negeri Sembilan,0,0,0
1/02/2022,Belgium,Pahang,0,0,0
1/02/2022,Belgium,Perak,0,0,0
1/02/2022,Belgium,Perlis,0,0,0
1/02/2022,Belgium,Pulau Pinang,1,1,0
1/02/2022,Belgium,Sabah,0,0,0
1/02/2022,Belgium,Sarawak,1,1,0
1/02/2022,Belgium,Selangor,51,36,15
1/02/2022,Belgium,W.P. Labuan,0,0,0
1/02/2022,Benin,Johor,0,0,0
1/02/2022,Benin,Kedah,1,1,0
1/02/2022,Benin,Perak,0,0,0
1/02/2022,Benin,Pulau Pinang,0,0,0
1/02/2022,Benin,Sabah,0,0,0
1/02/2022,Benin,Sarawak,0,0,0
1/02/2022,Benin,Selangor,0,0,0
1/02/2022,Burkina Faso,Perak,0,0,0
1/02/2022,Burkina Faso,Pulau Pinang,0,0,0
1/02/2022,Burkina Faso,Selangor,0,0,0
1/02/2022,Bangladesh,Johor,15,13,2
1/02/2022,Bangladesh,Kedah,0,0,0
1/02/2022,Bangladesh,Kelantan,0,0,0
1/02/2022,Bangladesh,Melaka,0,0,0
1/02/2022,Bangladesh,Negeri Sembilan,0,0,0
1/02/2022,Bangladesh,Pahang,0,0,0
1/02/2022,Bangladesh,Perak,0,0,0
1/02/2022,Bangladesh,Perlis,0,0,0
1/02/2022,Bangladesh,Pulau Pinang,2,2,0
1/02/2022,Bangladesh,Sabah,0,0,0
1/02/2022,Bangladesh,Sarawak,0,0,0
1/02/2022,Bangladesh,Selangor,5698,5346,352
1/02/2022,Bangladesh,W.P. Labuan,0,0,0
1/02/2022,Bulgaria,Johor,0,0,0
1/02/2022,Bulgaria,Kedah,0,0,0
1/02/2022,Bulgaria,Kelantan,0,0,0
1/02/2022,Bulgaria,Pahang,0,0,0
1/02/2022,Bulgaria,Perak,0,0,0
1/02/2022,Bulgaria,Perlis,0,0,0
1/02/2022,Bulgaria,Pulau Pinang,0,0,0
1/02/2022,Bulgaria,Sabah,0,0,0
1/02/2022,Bulgaria,Sarawak,0,0,0
1/02/2022,Bulgaria,Selangor,17,14,3
1/02/2022,Bulgaria,W.P. Labuan,0,0,0
1/02/2022,Bahrain,Johor,0,0,0
1/02/2022,Bahrain,Kedah,0,0,0
1/02/2022,Bahrain,Kelantan,0,0,0
1/02/2022,Bahrain,Perlis,0,0,0
1/02/2022,Bahrain,Pulau Pinang,0,0,0
1/02/2022,Bahrain,Sabah,0,0,0
1/02/2022,Bahrain,Sarawak,0,0,0
1/02/2022,Bahrain,Selangor,4,4,0
1/02/2022,Bahamas,Johor,0,0,0
1/02/2022,Bahamas,Kedah,0,0,0
1/02/2022,Bahamas,Perak,0,0,0
1/02/2022,Bahamas,Sabah,0,0,0
1/02/2022,Bahamas,Sarawak,0,0,0
1/02/2022,Bahamas,Selangor,0,0,0
1/02/2022,Bosnia and Herzegovina,Johor,0,0,0
1/02/2022,Bosnia and Herzegovina,Kedah,0,0,0
1/02/2022,Bosnia and Herzegovina,Perlis,0,0,0
1/02/2022,Bosnia and Herzegovina,Pulau Pinang,0,0,0
1/02/2022,Bosnia and Herzegovina,Sabah,0,0,0
1/02/2022,Bosnia and Herzegovina,Sarawak,0,0,0
1/02/2022,Bosnia and Herzegovina,Selangor,11,10,1
1/02/2022,Belarus,Johor,1,1,0
1/02/2022,Belarus,Kedah,0,0,0
1/02/2022,Belarus,Kelantan,0,0,0
1/02/2022,Belarus,Pahang,0,0,0
1/02/2022,Belarus,Perak,0,0,0
1/02/2022,Belarus,Perlis,0,0,0
1/02/2022,Belarus,Pulau Pinang,0,0,0
1/02/2022,Belarus,Sabah,0,0,0
1/02/2022,Belarus,Sarawak,0,0,0
1/02/2022,Belarus,Selangor,5,3,2
1/02/2022,Belarus,W.P. Labuan,0,0,0
1/02/2022,Belize,Johor,0,0,0
1/02/2022,Belize,Pulau Pinang,0,0,0
1/02/2022,Belize,Sarawak,0,0,0
1/02/2022,Belize,Selangor,0,0,0
1/02/2022,Bermuda,Selangor,0,0,0
1/02/2022,Bolivia,Johor,0,0,0
1/02/2022,Bolivia,Kedah,0,0,0
1/02/2022,Bolivia,Melaka,0,0,0
1/02/2022,Bolivia,Perak,0,0,0
1/02/2022,Bolivia,Perlis,0,0,0
1/02/2022,Bolivia,Pulau Pinang,0,0,0
1/02/2022,Bolivia,Sabah,0,0,0
1/02/2022,Bolivia,Sarawak,0,0,0
1/02/2022,Bolivia,Selangor,1,1,0
1/02/2022,Brazil,Johor,0,0,0
1/02/2022,Brazil,Kedah,1,1,0
1/02/2022,Brazil,Kelantan,0,0,0
1/02/2022,Brazil,Melaka,0,0,0
1/02/2022,Brazil,Pahang,0,0,0
1/02/2022,Brazil,Perak,0,0,0
1/02/2022,Brazil,Perlis,0,0,0
1/02/2022,Brazil,Pulau Pinang,0,0,0
1/02/2022,Brazil,Sabah,0,0,0
1/02/2022,Brazil,Sarawak,0,0,0
1/02/2022,Brazil,Selangor,62,42,20
1/02/2022,Brazil,W.P. Labuan,0,0,0
1/02/2022,Barbados,Johor,0,0,0
1/02/2022,Barbados,Kedah,0,0,0
1/02/2022,Barbados,Perlis,0,0,0
1/02/2022,Barbados,Pulau Pinang,0,0,0
1/02/2022,Barbados,Selangor,1,0,1
1/02/2022,Brunei Darussalam,Johor,1,0,1
1/02/2022,Brunei Darussalam,Kedah,0,0,0
1/02/2022,Brunei Darussalam,Kelantan,0,0,0
1/02/2022,Brunei Darussalam,Melaka,0,0,0
1/02/2022,Brunei Darussalam,Pahang,0,0,0
1/02/2022,Brunei Darussalam,Perak,0,0,0
1/02/2022,Brunei Darussalam,Perlis,0,0,0
1/02/2022,Brunei Darussalam,Pulau Pinang,0,0,0
1/02/2022,Brunei Darussalam,Sabah,0,0,0
1/02/2022,Brunei Darussalam,Sarawak,312,299,13
1/02/2022,Brunei Darussalam,Selangor,57,27,30
1/02/2022,Brunei Darussalam,W.P. Labuan,1,1,0
1/02/2022,Bhutan,Johor,0,0,0
1/02/2022,Bhutan,Kedah,0,0,0
1/02/2022,Bhutan,Perak,0,0,0
1/02/2022,Bhutan,Perlis,0,0,0
1/02/2022,Bhutan,Pulau Pinang,0,0,0
1/02/2022,Bhutan,Sabah,0,0,0
1/02/2022,Bhutan,Sarawak,0,0,0
1/02/2022,Bhutan,Selangor,1,1,0
1/02/2022,Botswana,Johor,0,0,0
1/02/2022,Botswana,Kedah,0,0,0
1/02/2022,Botswana,Perlis,0,0,0
1/02/2022,Botswana,Pulau Pinang,0,0,0
1/02/2022,Botswana,Sabah,0,0,0
1/02/2022,Botswana,Sarawak,0,0,0
1/02/2022,Botswana,Selangor,4,3,1
1/02/2022,Central African Republic,Kedah,0,0,0
1/02/2022,Central African Republic,Selangor,0,0,0
1/02/2022,Canada,Johor,0,0,0
1/02/2022,Canada,Kedah,5,3,2
1/02/2022,Canada,Kelantan,0,0,0
1/02/2022,Canada,Melaka,0,0,0
1/02/2022,Canada,Negeri Sembilan,0,0,0
1/02/2022,Canada,Pahang,0,0,0
1/02/2022,Canada,Perak,0,0,0
1/02/2022,Canada,Perlis,0,0,0
1/02/2022,Canada,Pulau Pinang,0,0,0
1/02/2022,Canada,Sabah,0,0,0
1/02/2022,Canada,Sarawak,3,2,1
1/02/2022,Canada,Selangor,157,114,43
1/02/2022,Canada,Terengganu,0,0,0
1/02/2022,Canada,W.P. Labuan,0,0,0
1/02/2022,Cocos (Keeling) Islands,Selangor,0,0,0
1/02/2022,Switzerland,Johor,0,0,0
1/02/2022,Switzerland,Kedah,2,1,1
1/02/2022,Switzerland,Kelantan,0,0,0
1/02/2022,Switzerland,Melaka,0,0,0
1/02/2022,Switzerland,Negeri Sembilan,0,0,0
1/02/2022,Switzerland,Pahang,0,0,0
1/02/2022,Switzerland,Perak,0,0,0
1/02/2022,Switzerland,Perlis,0,0,0
1/02/2022,Switzerland,Pulau Pinang,4,4,0
1/02/2022,Switzerland,Sabah,0,0,0
1/02/2022,Switzerland,Sarawak,0,0,0
1/02/2022,Switzerland,Selangor,54,39,15
1/02/2022,Switzerland,W.P. Labuan,0,0,0
1/02/2022,Chile,Johor,0,0,0
1/02/2022,Chile,Kedah,0,0,0
1/02/2022,Chile,Kelantan,0,0,0
1/02/2022,Chile,Melaka,0,0,0
1/02/2022,Chile,Pahang,0,0,0
1/02/2022,Chile,Perak,0,0,0
1/02/2022,Chile,Perlis,0,0,0
1/02/2022,Chile,Pulau Pinang,0,0,0
1/02/2022,Chile,Sabah,0,0,0
1/02/2022,Chile,Sarawak,0,0,0
1/02/2022,Chile,Selangor,3,1,2
1/02/2022,China,Johor,107,103,4
1/02/2022,China,Kedah,5,3,2
1/02/2022,China,Kelantan,0,0,0
1/02/2022,China,Melaka,0,0,0
1/02/2022,China,Pahang,0,0,0
1/02/2022,China,Perak,0,0,0
1/02/2022,China,Perlis,0,0,0
1/02/2022,China,Pulau Pinang,4,1,3
1/02/2022,China,Sabah,2,1,1
1/02/2022,China,Sarawak,34,31,3
1/02/2022,China,Selangor,3033,2127,906
1/02/2022,China,Terengganu,0,0,0
1/02/2022,China,W.P. Labuan,0,0,0
1/02/2022,Côte d'Ivoire,Johor,0,0,0
1/02/2022,Côte d'Ivoire,Kedah,0,0,0
1/02/2022,Côte d'Ivoire,Pulau Pinang,0,0,0
1/02/2022,Côte d'Ivoire,Sabah,0,0,0
1/02/2022,Côte d'Ivoire,Sarawak,0,0,0
1/02/2022,Côte d'Ivoire,Selangor,8,7,1
1/02/2022,Cameroon,Johor,0,0,0
1/02/2022,Cameroon,Kedah,0,0,0
1/02/2022,Cameroon,Pulau Pinang,0,0,0
1/02/2022,Cameroon,Sabah,0,0,0
1/02/2022,Cameroon,Sarawak,0,0,0
1/02/2022,Cameroon,Selangor,1,0,1
1/02/2022,Congo,Johor,0,0,0
1/02/2022,Congo,Pulau Pinang,0,0,0
1/02/2022,Congo,Sarawak,0,0,0
1/02/2022,Congo,Selangor,2,1,1
1/02/2022,Congo,Johor,0,0,0
1/02/2022,Congo,Kedah,0,0,0
1/02/2022,Congo,Selangor,0,0,0
1/02/2022,Cook Islands,Selangor,0,0,0
1/02/2022,Colombia,Johor,0,0,0
1/02/2022,Colombia,Kedah,0,0,0
1/02/2022,Colombia,Perak,0,0,0
1/02/2022,Colombia,Pulau Pinang,0,0,0
1/02/2022,Colombia,Sabah,0,0,0
1/02/2022,Colombia,Sarawak,0,0,0
1/02/2022,Colombia,Selangor,10,2,8
1/02/2022,Colombia,W.P. Labuan,0,0,0
1/02/2022,Comoros,Johor,0,0,0
1/02/2022,Comoros,Kedah,0,0,0
1/02/2022,Comoros,Selangor,8,2,6
1/02/2022,Cabo Verde,Johor,0,0,0
1/02/2022,Cabo Verde,Kedah,0,0,0
1/02/2022,Cabo Verde,Pulau Pinang,0,0,0
1/02/2022,Cabo Verde,Sabah,0,0,0
1/02/2022,Cabo Verde,Selangor,0,0,0
1/02/2022,Costa Rica,Johor,0,0,0
1/02/2022,Costa Rica,Kedah,0,0,0
1/02/2022,Costa Rica,Perak,0,0,0
1/02/2022,Costa Rica,Perlis,0,0,0
1/02/2022,Costa Rica,Pulau Pinang,0,0,0
1/02/2022,Costa Rica,Sabah,0,0,0
1/02/2022,Costa Rica,Sarawak,0,0,0
1/02/2022,Costa Rica,Selangor,5,4,1
1/02/2022,Cuba,Johor,0,0,0
1/02/2022,Cuba,Kedah,0,0,0
1/02/2022,Cuba,Perlis,0,0,0
1/02/2022,Cuba,Pulau Pinang,0,0,0
1/02/2022,Cuba,Sabah,0,0,0
1/02/2022,Cuba,Sarawak,0,0,0
1/02/2022,Cuba,Selangor,0,0,0
1/02/2022,Cyprus,Johor,0,0,0
1/02/2022,Cyprus,Kedah,1,1,0
1/02/2022,Cyprus,Perak,0,0,0
1/02/2022,Cyprus,Perlis,0,0,0
1/02/2022,Cyprus,Pulau Pinang,0,0,0
1/02/2022,Cyprus,Sabah,0,0,0
1/02/2022,Cyprus,Sarawak,0,0,0
1/02/2022,Cyprus,Selangor,7,4,3
1/02/2022,Czechia,Johor,0,0,0
1/02/2022,Czechia,Kedah,0,0,0
1/02/2022,Czechia,Kelantan,4,3,1
1/02/2022,Czechia,Melaka,0,0,0
1/02/2022,Czechia,Negeri Sembilan,0,0,0
1/02/2022,Czechia,Perak,0,0,0
1/02/2022,Czechia,Perlis,0,0,0
1/02/2022,Czechia,Pulau Pinang,0,0,0
1/02/2022,Czechia,Sabah,0,0,0
1/02/2022,Czechia,Sarawak,0,0,0
1/02/2022,Czechia,Selangor,20,15,5
1/02/2022,Czechia,W.P. Labuan,0,0,0
1/02/2022,Germany,Johor,3,3,0
1/02/2022,Germany,Kedah,11,8,3
1/02/2022,Germany,Kelantan,0,0,0
1/02/2022,Germany,Melaka,0,0,0
1/02/2022,Germany,Negeri Sembilan,0,0,0
1/02/2022,Germany,Pahang,0,0,0
1/02/2022,Germany,Perak,0,0,0
1/02/2022,Germany,Perlis,0,0,0
1/02/2022,Germany,Pulau Pinang,15,14,1
1/02/2022,Germany,Sabah,0,0,0
1/02/2022,Germany,Sarawak,0,0,0
1/02/2022,Germany,Selangor,322,266,56
1/02/2022,Germany,Terengganu,0,0,0
1/02/2022,Germany,W.P. Labuan,0,0,0
1/02/2022,Djibouti,Johor,0,0,0
1/02/2022,Djibouti,Selangor,3,1,2
1/02/2022,Dominica,Johor,0,0,0
1/02/2022,Dominica,Kedah,0,0,0
1/02/2022,Dominica,Pulau Pinang,0,0,0
1/02/2022,Dominica,Sabah,0,0,0
1/02/2022,Dominica,Sarawak,0,0,0
1/02/2022,Dominica,Selangor,3,3,0
1/02/2022,Dominica,W.P. Labuan,0,0,0
1/02/2022,Denmark,Johor,1,1,0
1/02/2022,Denmark,Kedah,1,0,1
1/02/2022,Denmark,Kelantan,0,0,0
1/02/2022,Denmark,Melaka,0,0,0
1/02/2022,Denmark,Negeri Sembilan,0,0,0
1/02/2022,Denmark,Pahang,0,0,0
1/02/2022,Denmark,Perak,0,0,0
1/02/2022,Denmark,Perlis,0,0,0
1/02/2022,Denmark,Pulau Pinang,4,2,2
1/02/2022,Denmark,Sabah,0,0,0
1/02/2022,Denmark,Sarawak,0,0,0
1/02/2022,Denmark,Selangor,53,45,8
1/02/2022,Denmark,W.P. Labuan,0,0,0
1/02/2022,Dominican Republic,Johor,0,0,0
1/02/2022,Dominican Republic,Kedah,0,0,0
1/02/2022,Dominican Republic,Perak,0,0,0
1/02/2022,Dominican Republic,Perlis,0,0,0
1/02/2022,Dominican Republic,Pulau Pinang,0,0,0
1/02/2022,Dominican Republic,Sabah,0,0,0
1/02/2022,Dominican Republic,Sarawak,0,0,0
1/02/2022,Dominican Republic,Selangor,0,0,0
1/02/2022,Algeria,Johor,0,0,0
1/02/2022,Algeria,Kedah,0,0,0
1/02/2022,Algeria,Kelantan,0,0,0
1/02/2022,Algeria,Melaka,0,0,0
1/02/2022,Algeria,Perak,0,0,0
1/02/2022,Algeria,Perlis,0,0,0
1/02/2022,Algeria,Pulau Pinang,0,0,0
1/02/2022,Algeria,Sabah,0,0,0
1/02/2022,Algeria,Sarawak,0,0,0
1/02/2022,Algeria,Selangor,47,32,15
1/02/2022,Algeria,W.P. Labuan,0,0,0
1/02/2022,Ecuador,Johor,0,0,0
1/02/2022,Ecuador,Kedah,0,0,0
1/02/2022,Ecuador,Perak,0,0,0
1/02/2022,Ecuador,Perlis,0,0,0
1/02/2022,Ecuador,Pulau Pinang,0,0,0
1/02/2022,Ecuador,Sabah,0,0,0
1/02/2022,Ecuador,Sarawak,0,0,0
1/02/2022,Ecuador,Selangor,0,0,0
1/02/2022,Egypt,Johor,0,0,0
1/02/2022,Egypt,Kedah,0,0,0
1/02/2022,Egypt,Kelantan,0,0,0
1/02/2022,Egypt,Melaka,0,0,0
1/02/2022,Egypt,Pahang,0,0,0
1/02/2022,Egypt,Perak,0,0,0
1/02/2022,Egypt,Perlis,0,0,0
1/02/2022,Egypt,Pulau Pinang,0,0,0
1/02/2022,Egypt,Sabah,0,0,0
1/02/2022,Egypt,Sarawak,0,0,0
1/02/2022,Egypt,Selangor,270,210,60
1/02/2022,Egypt,Terengganu,0,0,0
1/02/2022,Egypt,W.P. Labuan,0,0,0
1/02/2022,Eritrea,Johor,0,0,0
1/02/2022,Eritrea,Pulau Pinang,0,0,0
1/02/2022,Eritrea,Sabah,0,0,0
1/02/2022,Eritrea,Selangor,3,0,3
1/02/2022,Spain,Johor,0,0,0
1/02/2022,Spain,Kedah,2,2,0
1/02/2022,Spain,Kelantan,1,0,1
1/02/2022,Spain,Melaka,0,0,0
1/02/2022,Spain,Negeri Sembilan,0,0,0
1/02/2022,Spain,Pahang,0,0,0
1/02/2022,Spain,Perak,0,0,0
1/02/2022,Spain,Perlis,0,0,0
1/02/2022,Spain,Pulau Pinang,0,0,0
1/02/2022,Spain,Sabah,0,0,0
1/02/2022,Spain,Sarawak,0,0,0
1/02/2022,Spain,Selangor,131,108,23
1/02/2022,Spain,W.P. Labuan,0,0,0
1/02/2022,Estonia,Johor,0,0,0
1/02/2022,Estonia,Kedah,0,0,0
1/02/2022,Estonia,Kelantan,0,0,0
1/02/2022,Estonia,Pahang,0,0,0
1/02/2022,Estonia,Perak,0,0,0
1/02/2022,Estonia,Perlis,0,0,0
1/02/2022,Estonia,Pulau Pinang,0,0,0
1/02/2022,Estonia,Sabah,0,0,0
1/02/2022,Estonia,Sarawak,0,0,0
1/02/2022,Estonia,Selangor,4,2,2
1/02/2022,Estonia,W.P. Labuan,0,0,0
1/02/2022,Ethiopia,Johor,0,0,0
1/02/2022,Ethiopia,Kedah,0,0,0
1/02/2022,Ethiopia,Pulau Pinang,0,0,0
1/02/2022,Ethiopia,Sarawak,0,0,0
1/02/2022,Ethiopia,Selangor,5,5,0
1/02/2022,Finland,Johor,0,0,0
1/02/2022,Finland,Kedah,1,1,0
1/02/2022,Finland,Kelantan,0,0,0
1/02/2022,Finland,Melaka,0,0,0
1/02/2022,Finland,Negeri Sembilan,0,0,0
1/02/2022,Finland,Pahang,0,0,0
1/02/2022,Finland,Perak,0,0,0
1/02/2022,Finland,Perlis,0,0,0
1/02/2022,Finland,Pulau Pinang,0,0,0
1/02/2022,Finland,Sabah,0,0,0
1/02/2022,Finland,Sarawak,0,0,0
1/02/2022,Finland,Selangor,23,19,4
1/02/2022,Finland,W.P. Labuan,0,0,0
1/02/2022,Fiji,Johor,0,0,0
1/02/2022,Fiji,Kedah,0,0,0
1/02/2022,Fiji,Kelantan,0,0,0
1/02/2022,Fiji,Perak,0,0,0
1/02/2022,Fiji,Perlis,0,0,0
1/02/2022,Fiji,Pulau Pinang,0,0,0
1/02/2022,Fiji,Sabah,0,0,0
1/02/2022,Fiji,Sarawak,0,0,0
1/02/2022,Fiji,Selangor,4,3,1
1/02/2022,France,Johor,2,2,0
1/02/2022,France,Kedah,10,6,4
1/02/2022,France,Kelantan,1,1,0
1/02/2022,France,Melaka,0,0,0
1/02/2022,France,Negeri Sembilan,0,0,0
1/02/2022,France,Pahang,0,0,0
1/02/2022,France,Perak,0,0,0
1/02/2022,France,Perlis,0,0,0
1/02/2022,France,Pulau Pinang,1,1,0
1/02/2022,France,Sabah,0,0,0
1/02/2022,France,Sarawak,0,0,0
1/02/2022,France,Selangor,399,277,122
1/02/2022,France,Terengganu,0,0,0
1/02/2022,France,W.P. Labuan,0,0,0
1/02/2022,"Micronesia, Federated States of",Johor,0,0,0
1/02/2022,"Micronesia, Federated States of",Pulau Pinang,0,0,0
1/02/2022,"Micronesia, Federated States of",Selangor,0,0,0
1/02/2022,Gabon,Johor,0,0,0
1/02/2022,Gabon,Pulau Pinang,0,0,0
1/02/2022,Gabon,Sarawak,0,0,0
1/02/2022,Gabon,Selangor,1,0,1
1/02/2022,United Kingdom of Great Britain and Northern Ireland,Johor,0,0,0
1/02/2022,United Kingdom of Great Britain and Northern Ireland,Kedah,39,24,15
1/02/2022,United Kingdom of Great Britain and Northern Ireland,Kelantan,1,0,1
1/02/2022,United Kingdom of Great Britain and Northern Ireland,Melaka,0,0,0
1/02/2022,United Kingdom of Great Britain and Northern Ireland,Negeri Sembilan,0,0,0
1/02/2022,United Kingdom of Great Britain and Northern Ireland,Pahang,0,0,0
1/02/2022,United Kingdom of Great Britain and Northern Ireland,Perak,1,0,1
1/02/2022,United Kingdom of Great Britain and Northern Ireland,Perlis,0,0,0
1/02/2022,United Kingdom of Great Britain and Northern Ireland,Pulau Pinang,19,10,9
1/02/2022,United Kingdom of Great Britain and Northern Ireland,Sabah,1,1,0
1/02/2022,United Kingdom of Great Britain and Northern Ireland,Sarawak,3,2,1
1/02/2022,United Kingdom of Great Britain and Northern Ireland,Selangor,925,642,283
1/02/2022,United Kingdom of Great Britain and Northern Ireland,Terengganu,0,0,0
1/02/2022,United Kingdom of Great Britain and Northern Ireland,W.P. Labuan,0,0,0
1/02/2022,Georgia,Johor,0,0,0
1/02/2022,Georgia,Kedah,0,0,0
1/02/2022,Georgia,Melaka,0,0,0
1/02/2022,Georgia,Perak,0,0,0
1/02/2022,Georgia,Perlis,0,0,0
1/02/2022,Georgia,Pulau Pinang,0,0,0
1/02/2022,Georgia,Sabah,0,0,0
1/02/2022,Georgia,Sarawak,0,0,0
1/02/2022,Georgia,Selangor,1,1,0
1/02/2022,Ghana,Johor,0,0,0
1/02/2022,Ghana,Kedah,0,0,0
1/02/2022,Ghana,Kelantan,0,0,0
1/02/2022,Ghana,Pulau Pinang,0,0,0
1/02/2022,Ghana,Sabah,0,0,0
1/02/2022,Ghana,Sarawak,0,0,0
1/02/2022,Ghana,Selangor,11,8,3
1/02/2022,Gibraltar,Johor,0,0,0
1/02/2022,Gibraltar,Sarawak,0,0,0
1/02/2022,Guinea,Johor,0,0,0
1/02/2022,Guinea,Kedah,0,0,0
1/02/2022,Guinea,Kelantan,0,0,0
1/02/2022,Guinea,Perlis,0,0,0
1/02/2022,Guinea,Pulau Pinang,0,0,0
1/02/2022,Guinea,Sabah,0,0,0
1/02/2022,Guinea,Sarawak,0,0,0
1/02/2022,Guinea,Selangor,18,16,2
1/02/2022,Guadeloupe,Selangor,0,0,0
1/02/2022,Gambia,Johor,0,0,0
1/02/2022,Gambia,Kedah,0,0,0
1/02/2022,Gambia,Kelantan,0,0,0
1/02/2022,Gambia,Pulau Pinang,0,0,0
1/02/2022,Gambia,Sabah,0,0,0
1/02/2022,Gambia,Sarawak,0,0,0
1/02/2022,Gambia,Selangor,3,1,2
1/02/2022,Guinea-Bissau,Johor,0,0,0
1/02/2022,Guinea-Bissau,Selangor,0,0,0
1/02/2022,Equatorial Guinea,Johor,0,0,0
1/02/2022,Equatorial Guinea,Selangor,0,0,0
1/02/2022,Greece,Johor,1,1,0
1/02/2022,Greece,Kedah,0,0,0
1/02/2022,Greece,Kelantan,0,0,0
1/02/2022,Greece,Melaka,0,0,0
1/02/2022,Greece,Negeri Sembilan,0,0,0
1/02/2022,Greece,Pahang,0,0,0
1/02/2022,Greece,Perak,0,0,0
1/02/2022,Greece,Perlis,0,0,0
1/02/2022,Greece,Pulau Pinang,0,0,0
1/02/2022,Greece,Sabah,0,0,0
1/02/2022,Greece,Sarawak,0,0,0
1/02/2022,Greece,Selangor,9,9,0
1/02/2022,Grenada,Johor,0,0,0
1/02/2022,Grenada,Kedah,0,0,0
1/02/2022,Grenada,Pulau Pinang,0,0,0
1/02/2022,Grenada,Sabah,0,0,0
1/02/2022,Grenada,Sarawak,0,0,0
1/02/2022,Grenada,Selangor,0,0,0
1/02/2022,Greenland,Johor,0,0,0
1/02/2022,Greenland,Selangor,0,0,0
1/02/2022,Guatemala,Johor,0,0,0
1/02/2022,Guatemala,Kedah,0,0,0
1/02/2022,Guatemala,Pahang,0,0,0
1/02/2022,Guatemala,Perak,0,0,0
1/02/2022,Guatemala,Pulau Pinang,0,0,0
1/02/2022,Guatemala,Sabah,0,0,0
1/02/2022,Guatemala,Sarawak,0,0,0
1/02/2022,Guatemala,Selangor,1,0,1
1/02/2022,Guatemala,W.P. Labuan,0,0,0
1/02/2022,Guyana,Johor,0,0,0
1/02/2022,Guyana,Kedah,0,0,0
1/02/2022,Guyana,Pulau Pinang,0,0,0
1/02/2022,Guyana,Sarawak,0,0,0
1/02/2022,Guyana,Selangor,0,0,0
1/02/2022,Hong Kong,Johor,0,0,0
1/02/2022,Hong Kong,Kedah,3,2,1
1/02/2022,Hong Kong,Kelantan,0,0,0
1/02/2022,Hong Kong,Pahang,0,0,0
1/02/2022,Hong Kong,Perak,0,0,0
1/02/2022,Hong Kong,Perlis,0,0,0
1/02/2022,Hong Kong,Pulau Pinang,2,2,0
1/02/2022,Hong Kong,Sabah,0,0,0
1/02/2022,Hong Kong,Sarawak,35,32,3
1/02/2022,Hong Kong,Selangor,1,0,1
1/02/2022,Hong Kong,Terengganu,0,0,0
1/02/2022,Heard Island and McDonald Islands,Johor,0,0,0
1/02/2022,Honduras,Johor,0,0,0
1/02/2022,Honduras,Kedah,0,0,0
1/02/2022,Honduras,Perak,0,0,0
1/02/2022,Honduras,Pulau Pinang,0,0,0
1/02/2022,Honduras,Sabah,0,0,0
1/02/2022,Honduras,Sarawak,0,0,0
1/02/2022,Honduras,Selangor,0,0,0
1/02/2022,Croatia,Johor,0,0,0
1/02/2022,Croatia,Kedah,0,0,0
1/02/2022,Croatia,Kelantan,0,0,0
1/02/2022,Croatia,Melaka,0,0,0
1/02/2022,Croatia,Pahang,0,0,0
1/02/2022,Croatia,Perak,0,0,0
1/02/2022,Croatia,Perlis,0,0,0
1/02/2022,Croatia,Pulau Pinang,0,0,0
1/02/2022,Croatia,Sabah,0,0,0
1/02/2022,Croatia,Sarawak,0,0,0
1/02/2022,Croatia,Selangor,31,30,1
1/02/2022,Haiti,Johor,0,0,0
1/02/2022,Haiti,Kedah,0,0,0
1/02/2022,Haiti,Kelantan,0,0,0
1/02/2022,Haiti,Perak,0,0,0
1/02/2022,Haiti,Pulau Pinang,0,0,0
1/02/2022,Haiti,Sabah,0,0,0
1/02/2022,Haiti,Selangor,1,1,0
1/02/2022,Hungary,Johor,1,1,0
1/02/2022,Hungary,Kedah,0,0,0
1/02/2022,Hungary,Kelantan,0,0,0
1/02/2022,Hungary,Pahang,0,0,0
1/02/2022,Hungary,Perak,0,0,0
1/02/2022,Hungary,Perlis,0,0,0
1/02/2022,Hungary,Pulau Pinang,0,0,0
1/02/2022,Hungary,Sabah,0,0,0
1/02/2022,Hungary,Sarawak,0,0,0
1/02/2022,Hungary,Selangor,10,6,4
1/02/2022,Hungary,W.P. Labuan,0,0,0
1/02/2022,Indonesia,Johor,607,259,348
1/02/2022,Indonesia,Kedah,37,13,24
1/02/2022,Indonesia,Kelantan,0,0,0
1/02/2022,Indonesia,Melaka,0,0,0
1/02/2022,Indonesia,Negeri Sembilan,0,0,0
1/02/2022,Indonesia,Pahang,0,0,0
1/02/2022,Indonesia,Perak,0,0,0
1/02/2022,Indonesia,Perlis,0,0,0
1/02/2022,Indonesia,Pulau Pinang,13,7,6
1/02/2022,Indonesia,Sabah,3,1,2
1/02/2022,Indonesia,Sarawak,245,221,24
1/02/2022,Indonesia,Selangor,3047,1469,1578
1/02/2022,Indonesia,Terengganu,0,0,0
1/02/2022,Indonesia,W.P. Labuan,2,2,0
1/02/2022,India,Johor,44,42,2
1/02/2022,India,Kedah,2,2,0
1/02/2022,India,Kelantan,0,0,0
1/02/2022,India,Melaka,0,0,0
1/02/2022,India,Negeri Sembilan,0,0,0
1/02/2022,India,Pahang,0,0,0
1/02/2022,India,Perak,0,0,0
1/02/2022,India,Perlis,0,0,0
1/02/2022,India,Pulau Pinang,1,0,1
1/02/2022,India,Sabah,2,2,0
1/02/2022,India,Sarawak,6,6,0
1/02/2022,India,Selangor,5140,3707,1433
1/02/2022,India,Terengganu,0,0,0
1/02/2022,India,W.P. Labuan,0,0,0
1/02/2022, British Indian Ocean Territory,Pulau Pinang,0,0,0
1/02/2022, British Indian Ocean Territory,Selangor,0,0,0
1/02/2022,Ireland,Johor,0,0,0
1/02/2022,Ireland,Kedah,2,1,1
1/02/2022,Ireland,Kelantan,0,0,0
1/02/2022,Ireland,Negeri Sembilan,0,0,0
1/02/2022,Ireland,Pahang,0,0,0
1/02/2022,Ireland,Perak,0,0,0
1/02/2022,Ireland,Perlis,0,0,0
1/02/2022,Ireland,Pulau Pinang,0,0,0
1/02/2022,Ireland,Sabah,0,0,0
1/02/2022,Ireland,Sarawak,0,0,0
1/02/2022,Ireland,Selangor,65,41,24
1/02/2022,Ireland,Terengganu,0,0,0
1/02/2022,Ireland,W.P. Labuan,0,0,0
1/02/2022,"Iran, Islamic Republic of",Johor,0,0,0
1/02/2022,"Iran, Islamic Republic of",Kedah,0,0,0
1/02/2022,"Iran, Islamic Republic of",Kelantan,0,0,0
1/02/2022,"Iran, Islamic Republic of",Perak,0,0,0
1/02/2022,"Iran, Islamic Republic of",Perlis,0,0,0
1/02/2022,"Iran, Islamic Republic of",Pulau Pinang,0,0,0
1/02/2022,"Iran, Islamic Republic of",Sabah,0,0,0
1/02/2022,"Iran, Islamic Republic of",Sarawak,0,0,0
1/02/2022,"Iran, Islamic Republic of",Selangor,185,106,79
1/02/2022,"Iran, Islamic Republic of",W.P. Labuan,0,0,0
1/02/2022,Iraq,Johor,0,0,0
1/02/2022,Iraq,Kedah,0,0,0
1/02/2022,Iraq,Kelantan,0,0,0
1/02/2022,Iraq,Melaka,0,0,0
1/02/2022,Iraq,Pahang,0,0,0
1/02/2022,Iraq,Perak,0,0,0
1/02/2022,Iraq,Perlis,0,0,0
1/02/2022,Iraq,Pulau Pinang,0,0,0
1/02/2022,Iraq,Sabah,0,0,0
1/02/2022,Iraq,Sarawak,1,1,0
1/02/2022,Iraq,Selangor,174,113,61
1/02/2022,Iceland,Johor,0,0,0
1/02/2022,Iceland,Kedah,0,0,0
1/02/2022,Iceland,Kelantan,0,0,0
1/02/2022,Iceland,Perak,0,0,0
1/02/2022,Iceland,Perlis,0,0,0
1/02/2022,Iceland,Pulau Pinang,0,0,0
1/02/2022,Iceland,Sabah,0,0,0
1/02/2022,Iceland,Sarawak,0,0,0
1/02/2022,Iceland,Selangor,2,2,0
1/02/2022,Iceland,W.P. Labuan,0,0,0
1/02/2022,Israel,Pulau Pinang,0,0,0
1/02/2022,Italy,Johor,0,0,0
1/02/2022,Italy,Kedah,1,1,0
1/02/2022,Italy,Kelantan,0,0,0
1/02/2022,Italy,Melaka,0,0,0
1/02/2022,Italy,Negeri Sembilan,0,0,0
1/02/2022,Italy,Pahang,0,0,0
1/02/2022,Italy,Perak,0,0,0
1/02/2022,Italy,Perlis,0,0,0
1/02/2022,Italy,Pulau Pinang,2,2,0
1/02/2022,Italy,Sabah,0,0,0
1/02/2022,Italy,Sarawak,1,1,0
1/02/2022,Italy,Selangor,171,144,27
1/02/2022,Italy,W.P. Labuan,0,0,0
1/02/2022,Jamaica,Johor,0,0,0
1/02/2022,Jamaica,Kedah,0,0,0
1/02/2022,Jamaica,Perak,0,0,0
1/02/2022,Jamaica,Pulau Pinang,0,0,0
1/02/2022,Jamaica,Sabah,0,0,0
1/02/2022,Jamaica,Sarawak,1,1,0
1/02/2022,Jamaica,Selangor,1,0,1
1/02/2022,Jamaica,W.P. Labuan,0,0,0
1/02/2022,Jordan,Johor,0,0,0
1/02/2022,Jordan,Kedah,0,0,0
1/02/2022,Jordan,Kelantan,0,0,0
1/02/2022,Jordan,Melaka,0,0,0
1/02/2022,Jordan,Perlis,0,0,0
1/02/2022,Jordan,Pulau Pinang,0,0,0
1/02/2022,Jordan,Sabah,0,0,0
1/02/2022,Jordan,Sarawak,1,1,0
1/02/2022,Jordan,Selangor,78,49,29
1/02/2022,Jordan,W.P. Labuan,0,0,0
1/02/2022,Japan,Johor,2,2,0
1/02/2022,Japan,Kedah,8,6,2
1/02/2022,Japan,Kelantan,0,0,0
1/02/2022,Japan,Melaka,0,0,0
1/02/2022,Japan,Negeri Sembilan,0,0,0
1/02/2022,Japan,Pahang,0,0,0
1/02/2022,Japan,Perak,0,0,0
1/02/2022,Japan,Perlis,0,0,0
1/02/2022,Japan,Pulau Pinang,43,28,15
1/02/2022,Japan,Sabah,0,0,0
1/02/2022,Japan,Sarawak,9,8,1
1/02/2022,Japan,Selangor,971,663,308
1/02/2022,Japan,W.P. Labuan,0,0,0
1/02/2022,Kazakhstan,Johor,1,1,0
1/02/2022,Kazakhstan,Kedah,0,0,0
1/02/2022,Kazakhstan,Kelantan,0,0,0
1/02/2022,Kazakhstan,Melaka,0,0,0
1/02/2022,Kazakhstan,Perak,0,0,0
1/02/2022,Kazakhstan,Perlis,0,0,0
1/02/2022,Kazakhstan,Pulau Pinang,0,0,0
1/02/2022,Kazakhstan,Sabah,0,0,0
1/02/2022,Kazakhstan,Sarawak,0,0,0
1/02/2022,Kazakhstan,Selangor,60,35,25
1/02/2022,Kazakhstan,W.P. Labuan,0,0,0
1/02/2022,Kenya,Johor,0,0,0
1/02/2022,Kenya,Kedah,0,0,0
1/02/2022,Kenya,Kelantan,0,0,0
1/02/2022,Kenya,Perak,0,0,0
1/02/2022,Kenya,Perlis,0,0,0
1/02/2022,Kenya,Pulau Pinang,0,0,0
1/02/2022,Kenya,Sabah,0,0,0
1/02/2022,Kenya,Sarawak,0,0,0
1/02/2022,Kenya,Selangor,57,33,24
1/02/2022,Kyrgyzstan,Johor,0,0,0
1/02/2022,Kyrgyzstan,Kedah,0,0,0
1/02/2022,Kyrgyzstan,Kelantan,0,0,0
1/02/2022,Kyrgyzstan,Perak,0,0,0
1/02/2022,Kyrgyzstan,Perlis,0,0,0
1/02/2022,Kyrgyzstan,Pulau Pinang,0,0,0
1/02/2022,Kyrgyzstan,Sabah,0,0,0
1/02/2022,Kyrgyzstan,Sarawak,0,0,0
1/02/2022,Kyrgyzstan,Selangor,19,11,8
1/02/2022,Cambodia,Johor,0,0,0
1/02/2022,Cambodia,Kedah,0,0,0
1/02/2022,Cambodia,Kelantan,0,0,0
1/02/2022,Cambodia,Melaka,0,0,0
1/02/2022,Cambodia,Negeri Sembilan,0,0,0
1/02/2022,Cambodia,Pahang,0,0,0
1/02/2022,Cambodia,Perak,0,0,0
1/02/2022,Cambodia,Perlis,0,0,0
1/02/2022,Cambodia,Pulau Pinang,29,28,1
1/02/2022,Cambodia,Sabah,0,0,0
1/02/2022,Cambodia,Sarawak,1,1,0
1/02/2022,Cambodia,Selangor,138,109,29
1/02/2022,Cambodia,W.P. Labuan,0,0,0
1/02/2022,Kiribati,Johor,0,0,0
1/02/2022,Kiribati,Sabah,0,0,0
1/02/2022,Kiribati,Selangor,0,0,0
1/02/2022,Saint Kitts and Nevis,Johor,0,0,0
1/02/2022,Saint Kitts and Nevis,Kedah,0,0,0
1/02/2022,Saint Kitts and Nevis,Perlis,0,0,0
1/02/2022,Saint Kitts and Nevis,Pulau Pinang,0,0,0
1/02/2022,Saint Kitts and Nevis,Sabah,0,0,0
1/02/2022,Saint Kitts and Nevis,Selangor,2,2,0
1/02/2022,Saint Kitts and Nevis,W.P. Labuan,0,0,0
1/02/2022,"Korea, Republic of",Johor,4,2,2
1/02/2022,"Korea, Republic of",Kedah,2,1,1
1/02/2022,"Korea, Republic of",Kelantan,0,0,0
1/02/2022,"Korea, Republic of",Melaka,0,0,0
1/02/2022,"Korea, Republic of",Negeri Sembilan,0,0,0
1/02/2022,"Korea, Republic of",Pahang,0,0,0
1/02/2022,"Korea, Republic of",Perak,0,0,0
1/02/2022,"Korea, Republic of",Perlis,0,0,0
1/02/2022,"Korea, Republic of",Pulau Pinang,9,4,5
1/02/2022,"Korea, Republic of",Sabah,0,0,0
1/02/2022,"Korea, Republic of",Sarawak,39,34,5
1/02/2022,"Korea, Republic of",Selangor,837,576,261
1/02/2022,"Korea, Republic of",Terengganu,0,0,0
1/02/2022,"Korea, Republic of",W.P. Labuan,0,0,0
1/02/2022,Kuwait,Johor,0,0,0
1/02/2022,Kuwait,Kedah,0,0,0
1/02/2022,Kuwait,Kelantan,0,0,0
1/02/2022,Kuwait,Perak,0,0,0
1/02/2022,Kuwait,Perlis,0,0,0
1/02/2022,Kuwait,Pulau Pinang,0,0,0
1/02/2022,Kuwait,Sabah,0,0,0
1/02/2022,Kuwait,Sarawak,0,0,0
1/02/2022,Kuwait,Selangor,19,8,11
1/02/2022,Kuwait,W.P. Labuan,0,0,0
1/02/2022, Lao People's Democratic Republic,Johor,0,0,0
1/02/2022, Lao People's Democratic Republic,Kedah,0,0,0
1/02/2022, Lao People's Democratic Republic,Kelantan,0,0,0
1/02/2022, Lao People's Democratic Republic,Melaka,0,0,0
1/02/2022, Lao People's Democratic Republic,Perak,0,0,0
1/02/2022, Lao People's Democratic Republic,Perlis,0,0,0
1/02/2022, Lao People's Democratic Republic,Pulau Pinang,0,0,0
1/02/2022, Lao People's Democratic Republic,Sabah,0,0,0
1/02/2022, Lao People's Democratic Republic,Sarawak,0,0,0
1/02/2022, Lao People's Democratic Republic,Selangor,42,36,6
1/02/2022, Lao People's Democratic Republic,W.P. Labuan,0,0,0
1/02/2022,Lebanon,Johor,0,0,0
1/02/2022,Lebanon,Kedah,0,0,0
1/02/2022,Lebanon,Kelantan,0,0,0
1/02/2022,Lebanon,Pahang,0,0,0
1/02/2022,Lebanon,Perak,0,0,0
1/02/2022,Lebanon,Perlis,0,0,0
1/02/2022,Lebanon,Pulau Pinang,0,0,0
1/02/2022,Lebanon,Sabah,0,0,0
1/02/2022,Lebanon,Sarawak,0,0,0
1/02/2022,Lebanon,Selangor,22,15,7
1/02/2022,Lebanon,W.P. Labuan,0,0,0
1/02/2022,Liberia,Johor,0,0,0
1/02/2022,Liberia,Kedah,1,1,0
1/02/2022,Liberia,Sabah,0,0,0
1/02/2022,Liberia,Sarawak,0,0,0
1/02/2022,Liberia,Selangor,7,5,2
1/02/2022,Libya,Johor,0,0,0
1/02/2022,Libya,Kedah,0,0,0
1/02/2022,Libya,Perlis,0,0,0
1/02/2022,Libya,Pulau Pinang,0,0,0
1/02/2022,Libya,Sabah,0,0,0
1/02/2022,Libya,Sarawak,0,0,0
1/02/2022,Libya,Selangor,148,108,40
1/02/2022,Saint Lucia,Johor,0,0,0
1/02/2022,Saint Lucia,Kedah,0,0,0
1/02/2022,Saint Lucia,Pulau Pinang,0,0,0
1/02/2022,Saint Lucia,Sarawak,0,0,0
1/02/2022,Saint Lucia,Selangor,0,0,0
1/02/2022,Liechtenstein,Johor,0,0,0
1/02/2022,Liechtenstein,Kedah,0,0,0
1/02/2022,Liechtenstein,Perlis,0,0,0
1/02/2022,Liechtenstein,Pulau Pinang,0,0,0
1/02/2022,Liechtenstein,Sabah,0,0,0
1/02/2022,Liechtenstein,Sarawak,0,0,0
1/02/2022,Liechtenstein,Selangor,1,1,0
1/02/2022,LKA,Johor,1,1,0
1/02/2022,LKA,Kedah,0,0,0
1/02/2022,LKA,Kelantan,0,0,0
1/02/2022,LKA,Melaka,0,0,0
1/02/2022,LKA,Pahang,0,0,0
1/02/2022,LKA,Perak,0,0,0
1/02/2022,LKA,Perlis,0,0,0
1/02/2022,LKA,Pulau Pinang,1,1,0
1/02/2022,LKA,Sabah,0,0,0
1/02/2022,LKA,Sarawak,0,0,0
1/02/2022,LKA,Selangor,369,206,163
1/02/2022,LKA,W.P. Labuan,0,0,0
1/02/2022,Lesotho,Johor,0,0,0
1/02/2022,Lesotho,Kedah,0,0,0
1/02/2022,Lesotho,Pulau Pinang,0,0,0
1/02/2022,Lesotho,Sarawak,0,0,0
1/02/2022,Lesotho,Selangor,7,3,4
1/02/2022,Lithuania,Johor,0,0,0
1/02/2022,Lithuania,Kedah,1,0,1
1/02/2022,Lithuania,Kelantan,0,0,0
1/02/2022,Lithuania,Pahang,0,0,0
1/02/2022,Lithuania,Perak,0,0,0
1/02/2022,Lithuania,Perlis,0,0,0
1/02/2022,Lithuania,Pulau Pinang,0,0,0
1/02/2022,Lithuania,Sabah,0,0,0
1/02/2022,Lithuania,Sarawak,0,0,0
1/02/2022,Lithuania,Selangor,12,12,0
1/02/2022,Lithuania,W.P. Labuan,0,0,0
1/02/2022,Luxembourg,Johor,0,0,0
1/02/2022,Luxembourg,Kedah,0,0,0
1/02/2022,Luxembourg,Kelantan,0,0,0
1/02/2022,Luxembourg,Perak,0,0,0
1/02/2022,Luxembourg,Perlis,0,0,0
1/02/2022,Luxembourg,Pulau Pinang,0,0,0
1/02/2022,Luxembourg,Sabah,0,0,0
1/02/2022,Luxembourg,Sarawak,0,0,0
1/02/2022,Luxembourg,Selangor,3,2,1
1/02/2022,Latvia,Johor,0,0,0
1/02/2022,Latvia,Kedah,0,0,0
1/02/2022,Latvia,Kelantan,0,0,0
1/02/2022,Latvia,Pahang,0,0,0
1/02/2022,Latvia,Perak,0,0,0
1/02/2022,Latvia,Perlis,0,0,0
1/02/2022,Latvia,Pulau Pinang,0,0,0
1/02/2022,Latvia,Sabah,0,0,0
1/02/2022,Latvia,Sarawak,0,0,0
1/02/2022,Latvia,Selangor,6,5,1
1/02/2022,Latvia,W.P. Labuan,0,0,0
1/02/2022,Macao,Johor,0,0,0
1/02/2022,Macao,Pahang,0,0,0
1/02/2022,Macao,Perak,0,0,0
1/02/2022,Macao,Selangor,0,0,0
1/02/2022,Macao,W.P. Labuan,0,0,0
1/02/2022,Morocco,Johor,0,0,0
1/02/2022,Morocco,Kedah,0,0,0
1/02/2022,Morocco,Kelantan,0,0,0
1/02/2022,Morocco,Melaka,0,0,0
1/02/2022,Morocco,Pahang,0,0,0
1/02/2022,Morocco,Perak,0,0,0
1/02/2022,Morocco,Perlis,0,0,0
1/02/2022,Morocco,Pulau Pinang,0,0,0
1/02/2022,Morocco,Sabah,0,0,0
1/02/2022,Morocco,Sarawak,0,0,0
1/02/2022,Morocco,Selangor,32,7,25
1/02/2022,Morocco,W.P. Labuan,0,0,0
1/02/2022,Monaco,Johor,0,0,0
1/02/2022,Monaco,Kedah,0,0,0
1/02/2022,Monaco,Sabah,0,0,0
1/02/2022,Monaco,Selangor,2,1,1
1/02/2022,"Moldova, Republic of",Johor,0,0,0
1/02/2022,"Moldova, Republic of",Kedah,0,0,0
1/02/2022,"Moldova, Republic of",Kelantan,0,0,0
1/02/2022,"Moldova, Republic of",Negeri Sembilan,0,0,0
1/02/2022,"Moldova, Republic of",Perlis,0,0,0
1/02/2022,"Moldova, Republic of",Pulau Pinang,0,0,0
1/02/2022,"Moldova, Republic of",Sabah,0,0,0
1/02/2022,"Moldova, Republic of",Sarawak,0,0,0
1/02/2022,"Moldova, Republic of",Selangor,1,0,1
1/02/2022,Madagascar,Johor,0,0,0
1/02/2022,Madagascar,Kedah,0,0,0
1/02/2022,Madagascar,Perak,0,0,0
1/02/2022,Madagascar,Perlis,0,0,0
1/02/2022,Madagascar,Pulau Pinang,0,0,0
1/02/2022,Madagascar,Sabah,0,0,0
1/02/2022,Madagascar,Sarawak,0,0,0
1/02/2022,Madagascar,Selangor,0,0,0
1/02/2022,Maldives,Johor,0,0,0
1/02/2022,Maldives,Kedah,41,17,24
1/02/2022,Maldives,Kelantan,0,0,0
1/02/2022,Maldives,Perak,0,0,0
1/02/2022,Maldives,Perlis,0,0,0
1/02/2022,Maldives,Pulau Pinang,0,0,0
1/02/2022,Maldives,Sabah,0,0,0
1/02/2022,Maldives,Sarawak,0,0,0
1/02/2022,Maldives,Selangor,212,97,115
1/02/2022,Mexico,Johor,0,0,0
1/02/2022,Mexico,Kedah,0,0,0
1/02/2022,Mexico,Kelantan,0,0,0
1/02/2022,Mexico,Pahang,0,0,0
1/02/2022,Mexico,Perak,0,0,0
1/02/2022,Mexico,Perlis,0,0,0
1/02/2022,Mexico,Pulau Pinang,0,0,0
1/02/2022,Mexico,Sabah,0,0,0
1/02/2022,Mexico,Sarawak,0,0,0
1/02/2022,Mexico,Selangor,32,19,13
1/02/2022,Mexico,W.P. Labuan,0,0,0
1/02/2022,Marshall Islands,Johor,0,0,0
1/02/2022,Marshall Islands,Kedah,0,0,0
1/02/2022,Marshall Islands,Perak,0,0,0
1/02/2022,Marshall Islands,Pulau Pinang,0,0,0
1/02/2022,Marshall Islands,Sabah,0,0,0
1/02/2022,Marshall Islands,Selangor,0,0,0
1/02/2022,North Macedonia,Johor,0,0,0
1/02/2022,North Macedonia,Kedah,0,0,0
1/02/2022,North Macedonia,Perak,0,0,0
1/02/2022,North Macedonia,Pulau Pinang,0,0,0
1/02/2022,North Macedonia,Sabah,0,0,0
1/02/2022,North Macedonia,Sarawak,0,0,0
1/02/2022,North Macedonia,Selangor,1,1,0
1/02/2022,Mali,Johor,0,0,0
1/02/2022,Mali,Sabah,0,0,0
1/02/2022,Mali,Selangor,3,2,1
1/02/2022,Malta,Johor,0,0,0
1/02/2022,Malta,Kedah,0,0,0
1/02/2022,Malta,Kelantan,0,0,0
1/02/2022,Malta,Perak,0,0,0
1/02/2022,Malta,Perlis,0,0,0
1/02/2022,Malta,Pulau Pinang,0,0,0
1/02/2022,Malta,Sabah,0,0,0
1/02/2022,Malta,Sarawak,0,0,0
1/02/2022,Malta,Selangor,2,2,0
1/02/2022,Malta,W.P. Labuan,0,0,0
1/02/2022,Myanmar,Johor,26,26,0
1/02/2022,Myanmar,Kedah,0,0,0
1/02/2022,Myanmar,Kelantan,0,0,0
1/02/2022,Myanmar,Negeri Sembilan,0,0,0
1/02/2022,Myanmar,Pahang,0,0,0
1/02/2022,Myanmar,Perak,0,0,0
1/02/2022,Myanmar,Perlis,0,0,0
1/02/2022,Myanmar,Pulau Pinang,1,0,1
1/02/2022,Myanmar,Sabah,0,0,0
1/02/2022,Myanmar,Sarawak,2,0,2
1/02/2022,Myanmar,Selangor,272,209,63
1/02/2022,Myanmar,Terengganu,0,0,0
1/02/2022,Myanmar,W.P. Labuan,0,0,0
1/02/2022,Montenegro,Johor,0,0,0
1/02/2022,Montenegro,Kedah,0,0,0
1/02/2022,Montenegro,Pulau Pinang,0,0,0
1/02/2022,Montenegro,Sabah,0,0,0
1/02/2022,Montenegro,Sarawak,0,0,0
1/02/2022,Montenegro,Selangor,9,9,0
1/02/2022,Mongolia,Johor,0,0,0
1/02/2022,Mongolia,Kedah,1,0,1
1/02/2022,Mongolia,Kelantan,0,0,0
1/02/2022,Mongolia,Perak,0,0,0
1/02/2022,Mongolia,Perlis,0,0,0
1/02/2022,Mongolia,Pulau Pinang,0,0,0
1/02/2022,Mongolia,Sabah,0,0,0
1/02/2022,Mongolia,Sarawak,0,0,0
1/02/2022,Mongolia,Selangor,12,7,5
1/02/2022,Northern Mariana Islands,Selangor,0,0,0
1/02/2022,Mozambique,Johor,0,0,0
1/02/2022,Mozambique,Kedah,0,0,0
1/02/2022,Mozambique,Perak,0,0,0
1/02/2022,Mozambique,Pulau Pinang,0,0,0
1/02/2022,Mozambique,Sabah,0,0,0
1/02/2022,Mozambique,Sarawak,0,0,0
1/02/2022,Mozambique,Selangor,6,2,4
1/02/2022,Mauritania,Johor,0,0,0
1/02/2022,Mauritania,Kedah,0,0,0
1/02/2022,Mauritania,Pulau Pinang,0,0,0
1/02/2022,Mauritania,Sabah,0,0,0
1/02/2022,Mauritania,Sarawak,0,0,0
1/02/2022,Mauritania,Selangor,7,5,2
1/02/2022,Mauritius,Johor,0,0,0
1/02/2022,Mauritius,Kedah,0,0,0
1/02/2022,Mauritius,Kelantan,0,0,0
1/02/2022,Mauritius,Pahang,0,0,0
1/02/2022,Mauritius,Perak,0,0,0
1/02/2022,Mauritius,Perlis,0,0,0
1/02/2022,Mauritius,Pulau Pinang,0,0,0
1/02/2022,Mauritius,Sabah,0,0,0
1/02/2022,Mauritius,Sarawak,0,0,0
1/02/2022,Mauritius,Selangor,44,20,24
1/02/2022,Malawi,Johor,0,0,0
1/02/2022,Malawi,Pulau Pinang,0,0,0
1/02/2022,Malawi,Sabah,0,0,0
1/02/2022,Malawi,Sarawak,0,0,0
1/02/2022,Malawi,Selangor,3,2,1
1/02/2022,Mayotte,Selangor,0,0,0
1/02/2022,Namibia,Johor,0,0,0
1/02/2022,Namibia,Kedah,0,0,0
1/02/2022,Namibia,Perak,0,0,0
1/02/2022,Namibia,Perlis,0,0,0
1/02/2022,Namibia,Pulau Pinang,0,0,0
1/02/2022,Namibia,Sabah,0,0,0
1/02/2022,Namibia,Sarawak,0,0,0
1/02/2022,Namibia,Selangor,2,1,1
1/02/2022,New Caledonia,Selangor,0,0,0
1/02/2022,Niger,Johor,0,0,0
1/02/2022,Niger,Sabah,0,0,0
1/02/2022,Niger,Selangor,1,0,1
1/02/2022,Nigeria,Johor,0,0,0
1/02/2022,Nigeria,Kedah,0,0,0
1/02/2022,Nigeria,Perlis,0,0,0
1/02/2022,Nigeria,Pulau Pinang,0,0,0
1/02/2022,Nigeria,Sabah,0,0,0
1/02/2022,Nigeria,Sarawak,0,0,0
1/02/2022,Nigeria,Selangor,244,209,35
1/02/2022,Nicaragua,Johor,0,0,0
1/02/2022,Nicaragua,Kedah,0,0,0
1/02/2022,Nicaragua,Pulau Pinang,0,0,0
1/02/2022,Nicaragua,Sabah,0,0,0
1/02/2022,Nicaragua,Selangor,0,0,0
1/02/2022,Netherlands,Johor,2,2,0
1/02/2022,Netherlands,Kedah,19,11,8
1/02/2022,Netherlands,Kelantan,0,0,0
1/02/2022,Netherlands,Melaka,0,0,0
1/02/2022,Netherlands,Negeri Sembilan,0,0,0
1/02/2022,Netherlands,Pahang,0,0,0
1/02/2022,Netherlands,Perak,0,0,0
1/02/2022,Netherlands,Perlis,0,0,0
1/02/2022,Netherlands,Pulau Pinang,3,1,2
1/02/2022,Netherlands,Sabah,0,0,0
1/02/2022,Netherlands,Sarawak,0,0,0
1/02/2022,Netherlands,Selangor,185,148,37
1/02/2022,Netherlands,Terengganu,0,0,0
1/02/2022,Netherlands,W.P. Labuan,0,0,0
1/02/2022,Norway,Johor,0,0,0
1/02/2022,Norway,Kedah,0,0,0
1/02/2022,Norway,Kelantan,0,0,0
1/02/2022,Norway,Melaka,0,0,0
1/02/2022,Norway,Pahang,0,0,0
1/02/2022,Norway,Perak,0,0,0
1/02/2022,Norway,Perlis,0,0,0
1/02/2022,Norway,Pulau Pinang,0,0,0
1/02/2022,Norway,Sabah,0,0,0
1/02/2022,Norway,Sarawak,0,0,0
1/02/2022,Norway,Selangor,28,23,5
1/02/2022,Norway,W.P. Labuan,0,0,0
1/02/2022,Nepal,Johor,0,0,0
1/02/2022,Nepal,Kedah,0,0,0
1/02/2022,Nepal,Pahang,0,0,0
1/02/2022,Nepal,Perak,0,0,0
1/02/2022,Nepal,Perlis,0,0,0
1/02/2022,Nepal,Pulau Pinang,21,20,1
1/02/2022,Nepal,Sabah,0,0,0
1/02/2022,Nepal,Sarawak,1,1,0
1/02/2022,Nepal,Selangor,576,552,24
1/02/2022,Nepal,W.P. Labuan,0,0,0
1/02/2022,Nauru,Johor,0,0,0
1/02/2022,Nauru,Pulau Pinang,0,0,0
1/02/2022,Nauru,Selangor,0,0,0
1/02/2022,New Zealand,Johor,0,0,0
1/02/2022,New Zealand,Kedah,12,10,2
1/02/2022,New Zealand,Kelantan,0,0,0
1/02/2022,New Zealand,Melaka,0,0,0
1/02/2022,New Zealand,Negeri Sembilan,0,0,0
1/02/2022,New Zealand,Pahang,0,0,0
1/02/2022,New Zealand,Perak,0,0,0
1/02/2022,New Zealand,Perlis,0,0,0
1/02/2022,New Zealand,Pulau Pinang,2,1,1
1/02/2022,New Zealand,Sabah,0,0,0
1/02/2022,New Zealand,Sarawak,2,2,0
1/02/2022,New Zealand,Selangor,63,39,24
1/02/2022,New Zealand,Terengganu,0,0,0
1/02/2022,New Zealand,W.P. Labuan,0,0,0
1/02/2022,Oman,Johor,0,0,0
1/02/2022,Oman,Kedah,0,0,0
1/02/2022,Oman,Kelantan,0,0,0
1/02/2022,Oman,Melaka,0,0,0
1/02/2022,Oman,Perak,0,0,0
1/02/2022,Oman,Perlis,0,0,0
1/02/2022,Oman,Pulau Pinang,0,0,0
1/02/2022,Oman,Sabah,0,0,0
1/02/2022,Oman,Sarawak,0,0,0
1/02/2022,Oman,Selangor,62,45,17
1/02/2022,Pakistan,Johor,0,0,0
1/02/2022,Pakistan,Kedah,0,0,0
1/02/2022,Pakistan,Kelantan,0,0,0
1/02/2022,Pakistan,Melaka,0,0,0
1/02/2022,Pakistan,Negeri Sembilan,0,0,0
1/02/2022,Pakistan,Pahang,0,0,0
1/02/2022,Pakistan,Perak,0,0,0
1/02/2022,Pakistan,Perlis,0,0,0
1/02/2022,Pakistan,Pulau Pinang,0,0,0
1/02/2022,Pakistan,Sabah,1,1,0
1/02/2022,Pakistan,Sarawak,3,3,0
1/02/2022,Pakistan,Selangor,3094,2779,315
1/02/2022,Pakistan,W.P. Labuan,0,0,0
1/02/2022,Panama,Johor,0,0,0
1/02/2022,Panama,Kedah,0,0,0
1/02/2022,Panama,Perak,0,0,0
1/02/2022,Panama,Perlis,0,0,0
1/02/2022,Panama,Pulau Pinang,0,0,0
1/02/2022,Panama,Sabah,0,0,0
1/02/2022,Panama,Sarawak,0,0,0
1/02/2022,Panama,Selangor,0,0,0
1/02/2022,Peru,Johor,0,0,0
1/02/2022,Peru,Kedah,1,1,0
1/02/2022,Peru,Kelantan,0,0,0
1/02/2022,Peru,Pahang,0,0,0
1/02/2022,Peru,Perak,0,0,0
1/02/2022,Peru,Perlis,0,0,0
1/02/2022,Peru,Pulau Pinang,0,0,0
1/02/2022,Peru,Sabah,0,0,0
1/02/2022,Peru,Sarawak,0,0,0
1/02/2022,Peru,Selangor,2,0,2
1/02/2022,Peru,W.P. Labuan,0,0,0
1/02/2022,Philippines,Johor,91,87,4
1/02/2022,Philippines,Kedah,1,0,1
1/02/2022,Philippines,Kelantan,1,1,0
1/02/2022,Philippines,Melaka,0,0,0
1/02/2022,Philippines,Negeri Sembilan,0,0,0
1/02/2022,Philippines,Pahang,0,0,0
1/02/2022,Philippines,Perak,0,0,0
1/02/2022,Philippines,Perlis,0,0,0
1/02/2022,Philippines,Pulau Pinang,6,5,1
1/02/2022,Philippines,Sabah,5,2,3
1/02/2022,Philippines,Sarawak,20,19,1
1/02/2022,Philippines,Selangor,1456,852,604
1/02/2022,Philippines,Terengganu,0,0,0
1/02/2022,Philippines,W.P. Labuan,14,14,0
1/02/2022,Palau,Johor,0,0,0
1/02/2022,Palau,Pulau Pinang,0,0,0
1/02/2022,Palau,Selangor,0,0,0
1/02/2022,Papua New Guinea,Johor,0,0,0
1/02/2022,Papua New Guinea,Kedah,0,0,0
1/02/2022,Papua New Guinea,Kelantan,0,0,0
1/02/2022,Papua New Guinea,Perak,0,0,0
1/02/2022,Papua New Guinea,Pulau Pinang,0,0,0
1/02/2022,Papua New Guinea,Sabah,0,0,0
1/02/2022,Papua New Guinea,Sarawak,0,0,0
1/02/2022,Papua New Guinea,Selangor,2,1,1
1/02/2022,Poland,Johor,0,0,0
1/02/2022,Poland,Kedah,0,0,0
1/02/2022,Poland,Kelantan,0,0,0
1/02/2022,Poland,Melaka,0,0,0
1/02/2022,Poland,Negeri Sembilan,0,0,0
1/02/2022,Poland,Pahang,0,0,0
1/02/2022,Poland,Perak,0,0,0
1/02/2022,Poland,Perlis,0,0,0
1/02/2022,Poland,Pulau Pinang,0,0,0
1/02/2022,Poland,Sabah,0,0,0
1/02/2022,Poland,Sarawak,0,0,0
1/02/2022,Poland,Selangor,62,53,9
1/02/2022,Poland,Terengganu,0,0,0
1/02/2022,Poland,W.P. Labuan,0,0,0
1/02/2022,"North Korea, Democratic People's Republic of",Selangor,0,0,0
1/02/2022,Portugal,Johor,0,0,0
1/02/2022,Portugal,Kedah,0,0,0
1/02/2022,Portugal,Kelantan,0,0,0
1/02/2022,Portugal,Melaka,0,0,0
1/02/2022,Portugal,Pahang,0,0,0
1/02/2022,Portugal,Perak,0,0,0
1/02/2022,Portugal,Perlis,0,0,0
1/02/2022,Portugal,Pulau Pinang,0,0,0
1/02/2022,Portugal,Sabah,0,0,0
1/02/2022,Portugal,Sarawak,0,0,0
1/02/2022,Portugal,Selangor,35,25,10
1/02/2022,Portugal,W.P. Labuan,0,0,0
1/02/2022,Paraguay,Johor,0,0,0
1/02/2022,Paraguay,Kedah,0,0,0
1/02/2022,Paraguay,Perak,0,0,0
1/02/2022,Paraguay,Perlis,0,0,0
1/02/2022,Paraguay,Pulau Pinang,0,0,0
1/02/2022,Paraguay,Sabah,0,0,0
1/02/2022,Paraguay,Sarawak,0,0,0
1/02/2022,Paraguay,Selangor,0,0,0
1/02/2022,"Palestine, State of",Johor,0,0,0
1/02/2022,"Palestine, State of",Kedah,0,0,0
1/02/2022,"Palestine, State of",Kelantan,0,0,0
1/02/2022,"Palestine, State of",Melaka,0,0,0
1/02/2022,"Palestine, State of",Perak,0,0,0
1/02/2022,"Palestine, State of",Perlis,0,0,0
1/02/2022,"Palestine, State of",Pulau Pinang,0,0,0
1/02/2022,"Palestine, State of",Sabah,0,0,0
1/02/2022,"Palestine, State of",Sarawak,0,0,0
1/02/2022,"Palestine, State of",Selangor,53,43,10
1/02/2022,Qatar,Johor,0,0,0
1/02/2022,Qatar,Kedah,0,0,0
1/02/2022,Qatar,Perlis,0,0,0
1/02/2022,Qatar,Pulau Pinang,0,0,0
1/02/2022,Qatar,Sabah,0,0,0
1/02/2022,Qatar,Sarawak,0,0,0
1/02/2022,Qatar,Selangor,7,1,6
1/02/2022,Réunion,Johor,0,0,0
1/02/2022,Réunion,Sarawak,0,0,0
1/02/2022,Romania,Johor,6,6,0
1/02/2022,Romania,Kedah,4,0,4
1/02/2022,Romania,Kelantan,1,0,1
1/02/2022,Romania,Negeri Sembilan,0,0,0
1/02/2022,Romania,Pahang,0,0,0
1/02/2022,Romania,Perak,0,0,0
1/02/2022,Romania,Perlis,0,0,0
1/02/2022,Romania,Pulau Pinang,0,0,0
1/02/2022,Romania,Sabah,0,0,0
1/02/2022,Romania,Sarawak,0,0,0
1/02/2022,Romania,Selangor,31,26,5
1/02/2022,Romania,W.P. Labuan,0,0,0
1/02/2022,Russian Federation (Russia),Johor,7,6,1
1/02/2022,Russian Federation (Russia),Kedah,0,0,0
1/02/2022,Russian Federation (Russia),Kelantan,0,0,0
1/02/2022,Russian Federation (Russia),Melaka,0,0,0
1/02/2022,Russian Federation (Russia),Negeri Sembilan,0,0,0
1/02/2022,Russian Federation (Russia),Pahang,0,0,0
1/02/2022,Russian Federation (Russia),Perak,0,0,0
1/02/2022,Russian Federation (Russia),Perlis,0,0,0
1/02/2022,Russian Federation (Russia),Pulau Pinang,0,0,0
1/02/2022,Russian Federation (Russia),Sabah,1,0,1
1/02/2022,Russian Federation (Russia),Sarawak,0,0,0
1/02/2022,Russian Federation (Russia),Selangor,104,68,36
1/02/2022,Russian Federation (Russia),W.P. Labuan,0,0,0
1/02/2022,Rwanda,Johor,0,0,0
1/02/2022,Rwanda,Kedah,0,0,0
1/02/2022,Rwanda,Pulau Pinang,0,0,0
1/02/2022,Rwanda,Selangor,0,0,0
1/02/2022,Saudi Arabia,Johor,0,0,0
1/02/2022,Saudi Arabia,Kedah,0,0,0
1/02/2022,Saudi Arabia,Kelantan,0,0,0
1/02/2022,Saudi Arabia,Melaka,0,0,0
1/02/2022,Saudi Arabia,Perak,0,0,0
1/02/2022,Saudi Arabia,Perlis,0,0,0
1/02/2022,Saudi Arabia,Pulau Pinang,0,0,0
1/02/2022,Saudi Arabia,Sabah,0,0,0
1/02/2022,Saudi Arabia,Sarawak,0,0,0
1/02/2022,Saudi Arabia,Selangor,142,89,53
1/02/2022,Saudi Arabia,W.P. Labuan,0,0,0
1/02/2022,Sudan,Johor,0,0,0
1/02/2022,Sudan,Kedah,0,0,0
1/02/2022,Sudan,Kelantan,0,0,0
1/02/2022,Sudan,Perlis,0,0,0
1/02/2022,Sudan,Pulau Pinang,0,0,0
1/02/2022,Sudan,Sabah,0,0,0
1/02/2022,Sudan,Sarawak,0,0,0
1/02/2022,Sudan,Selangor,184,134,50
1/02/2022,Sudan,W.P. Labuan,0,0,0
1/02/2022,Senegal,Johor,0,0,0
1/02/2022,Senegal,Kedah,0,0,0
1/02/2022,Senegal,Kelantan,0,0,0
1/02/2022,Senegal,Perak,0,0,0
1/02/2022,Senegal,Perlis,0,0,0
1/02/2022,Senegal,Pulau Pinang,0,0,0
1/02/2022,Senegal,Sabah,0,0,0
1/02/2022,Senegal,Sarawak,0,0,0
1/02/2022,Senegal,Selangor,3,3,0
1/02/2022,Singapore,Johor,2230,1240,990
1/02/2022,Singapore,Kedah,16,8,8
1/02/2022,Singapore,Kelantan,0,0,0
1/02/2022,Singapore,Melaka,0,0,0
1/02/2022,Singapore,Negeri Sembilan,0,0,0
1/02/2022,Singapore,Pahang,0,0,0
1/02/2022,Singapore,Perak,7,2,5
1/02/2022,Singapore,Perlis,1,1,0
1/02/2022,Singapore,Pulau Pinang,15,9,6
1/02/2022,Singapore,Sabah,1,1,0
1/02/2022,Singapore,Sarawak,28,18,10
1/02/2022,Singapore,Selangor,4594,2801,1793
1/02/2022,Singapore,Terengganu,0,0,0
1/02/2022,Singapore,W.P. Labuan,0,0,0
1/02/2022,South Georgia and the South Sandwich Islands,Johor,0,0,0
1/02/2022,South Georgia and the South Sandwich Islands,Sabah,0,0,0
1/02/2022,South Georgia and the South Sandwich Islands,Selangor,0,0,0
1/02/2022,Saint Helena,Sarawak,0,0,0
1/02/2022,Solomon Islands,Johor,0,0,0
1/02/2022,Solomon Islands,Perlis,0,0,0
1/02/2022,Solomon Islands,Pulau Pinang,0,0,0
1/02/2022,Solomon Islands,Sabah,0,0,0
1/02/2022,Solomon Islands,Sarawak,0,0,0
1/02/2022,Solomon Islands,Selangor,0,0,0
1/02/2022,Solomon Islands,W.P. Labuan,0,0,0
1/02/2022,Sierra Leone,Johor,0,0,0
1/02/2022,Sierra Leone,Kedah,0,0,0
1/02/2022,Sierra Leone,Perak,0,0,0
1/02/2022,Sierra Leone,Pulau Pinang,0,0,0
1/02/2022,Sierra Leone,Sabah,0,0,0
1/02/2022,Sierra Leone,Selangor,5,3,2
1/02/2022,El Salvador,Johor,0,0,0
1/02/2022,El Salvador,Kedah,0,0,0
1/02/2022,El Salvador,Perak,0,0,0
1/02/2022,El Salvador,Perlis,0,0,0
1/02/2022,El Salvador,Pulau Pinang,0,0,0
1/02/2022,El Salvador,Sabah,0,0,0
1/02/2022,El Salvador,Selangor,1,0,1
1/02/2022,El Salvador,W.P. Labuan,0,0,0
1/02/2022,San Marino,Johor,0,0,0
1/02/2022,San Marino,Selangor,2,2,0
1/02/2022,Somalia,Johor,0,0,0
1/02/2022,Somalia,Kedah,0,0,0
1/02/2022,Somalia,Kelantan,0,0,0
1/02/2022,Somalia,Perlis,0,0,0
1/02/2022,Somalia,Sabah,0,0,0
1/02/2022,Somalia,Sarawak,0,0,0
1/02/2022,Somalia,Selangor,54,31,23
1/02/2022,Serbia,Johor,0,0,0
1/02/2022,Serbia,Kedah,0,0,0
1/02/2022,Serbia,Kelantan,0,0,0
1/02/2022,Serbia,Pahang,0,0,0
1/02/2022,Serbia,Perak,0,0,0
1/02/2022,Serbia,Perlis,0,0,0
1/02/2022,Serbia,Pulau Pinang,0,0,0
1/02/2022,Serbia,Sabah,0,0,0
1/02/2022,Serbia,Sarawak,0,0,0
1/02/2022,Serbia,Selangor,5,3,2
1/02/2022,South Sudan,Johor,0,0,0
1/02/2022,South Sudan,Kedah,0,0,0
1/02/2022,South Sudan,Sarawak,0,0,0
1/02/2022,South Sudan,Selangor,2,1,1
1/02/2022,South Sudan,W.P. Labuan,0,0,0
1/02/2022,Sao Tome and Principe,Selangor,0,0,0
1/02/2022,Suriname,Johor,0,0,0
1/02/2022,Suriname,Kedah,0,0,0
1/02/2022,Suriname,Kelantan,0,0,0
1/02/2022,Suriname,Perak,0,0,0
1/02/2022,Suriname,Perlis,0,0,0
1/02/2022,Suriname,Pulau Pinang,0,0,0
1/02/2022,Suriname,Sabah,0,0,0
1/02/2022,Suriname,Sarawak,0,0,0
1/02/2022,Suriname,Selangor,0,0,0
1/02/2022,Slovakia,Johor,0,0,0
1/02/2022,Slovakia,Kedah,0,0,0
1/02/2022,Slovakia,Kelantan,0,0,0
1/02/2022,Slovakia,Negeri Sembilan,0,0,0
1/02/2022,Slovakia,Pahang,0,0,0
1/02/2022,Slovakia,Perak,0,0,0
1/02/2022,Slovakia,Perlis,0,0,0
1/02/2022,Slovakia,Pulau Pinang,0,0,0
1/02/2022,Slovakia,Sabah,0,0,0
1/02/2022,Slovakia,Sarawak,0,0,0
1/02/2022,Slovakia,Selangor,13,10,3
1/02/2022,Slovakia,W.P. Labuan,0,0,0
1/02/2022,Slovenia,Johor,0,0,0
1/02/2022,Slovenia,Kedah,0,0,0
1/02/2022,Slovenia,Kelantan,0,0,0
1/02/2022,Slovenia,Perak,0,0,0
1/02/2022,Slovenia,Perlis,0,0,0
1/02/2022,Slovenia,Pulau Pinang,0,0,0
1/02/2022,Slovenia,Sabah,0,0,0
1/02/2022,Slovenia,Sarawak,0,0,0
1/02/2022,Slovenia,Selangor,8,5,3
1/02/2022,Slovenia,W.P. Labuan,0,0,0
1/02/2022,Sweden,Johor,0,0,0
1/02/2022,Sweden,Kedah,1,1,0
1/02/2022,Sweden,Kelantan,0,0,0
1/02/2022,Sweden,Melaka,0,0,0
1/02/2022,Sweden,Negeri Sembilan,0,0,0
1/02/2022,Sweden,Pahang,0,0,0
1/02/2022,Sweden,Perak,0,0,0
1/02/2022,Sweden,Perlis,0,0,0
1/02/2022,Sweden,Pulau Pinang,0,0,0
1/02/2022,Sweden,Sabah,0,0,0
1/02/2022,Sweden,Sarawak,0,0,0
1/02/2022,Sweden,Selangor,70,52,18
1/02/2022,Sweden,W.P. Labuan,0,0,0
1/02/2022,Eswatini,Johor,0,0,0
1/02/2022,Eswatini,Kedah,0,0,0
1/02/2022,Eswatini,Pulau Pinang,0,0,0
1/02/2022,Eswatini,Sabah,0,0,0
1/02/2022,Eswatini,Selangor,2,0,2
1/02/2022,Seychelles,Johor,0,0,0
1/02/2022,Seychelles,Kedah,0,0,0
1/02/2022,Seychelles,Pulau Pinang,0,0,0
1/02/2022,Seychelles,Sabah,0,0,0
1/02/2022,Seychelles,Sarawak,0,0,0
1/02/2022,Seychelles,Selangor,6,1,5
1/02/2022,Syrian Arab Republic,Johor,0,0,0
1/02/2022,Syrian Arab Republic,Kedah,0,0,0
1/02/2022,Syrian Arab Republic,Kelantan,0,0,0
1/02/2022,Syrian Arab Republic,Pahang,0,0,0
1/02/2022,Syrian Arab Republic,Perlis,0,0,0
1/02/2022,Syrian Arab Republic,Pulau Pinang,0,0,0
1/02/2022,Syrian Arab Republic,Sabah,0,0,0
1/02/2022,Syrian Arab Republic,Sarawak,1,1,0
1/02/2022,Syrian Arab Republic,Selangor,146,105,41
1/02/2022,Syrian Arab Republic,W.P. Labuan,0,0,0
1/02/2022,Turks and Caicos Islands,Perlis,0,0,0
1/02/2022,TCD,Johor,0,0,0
1/02/2022,TCD,Kedah,0,0,0
1/02/2022,TCD,Perlis,0,0,0
1/02/2022,TCD,Selangor,4,3,1
1/02/2022,Togo,Johor,0,0,0
1/02/2022,Togo,Perak,0,0,0
1/02/2022,Togo,Pulau Pinang,0,0,0
1/02/2022,Togo,Selangor,1,1,0
1/02/2022,Thailand,Johor,55,55,0
1/02/2022,Thailand,Kedah,16556,16500,56
1/02/2022,Thailand,Kelantan,5,0,5
1/02/2022,Thailand,Melaka,0,0,0
1/02/2022,Thailand,Negeri Sembilan,0,0,0
1/02/2022,Thailand,Pahang,0,0,0
1/02/2022,Thailand,Perak,0,0,0
1/02/2022,Thailand,Perlis,8532,8415,117
1/02/2022,Thailand,Pulau Pinang,187,182,5
1/02/2022,Thailand,Sabah,1,0,1
1/02/2022,Thailand,Sarawak,9,9,0
1/02/2022,Thailand,Selangor,931,520,411
1/02/2022,Thailand,Terengganu,0,0,0
1/02/2022,Thailand,W.P. Labuan,0,0,0
1/02/2022,Tajikistan,Johor,0,0,0
1/02/2022,Tajikistan,Kedah,0,0,0
1/02/2022,Tajikistan,Perlis,0,0,0
1/02/2022,Tajikistan,Pulau Pinang,0,0,0
1/02/2022,Tajikistan,Sabah,0,0,0
1/02/2022,Tajikistan,Selangor,4,2,2
1/02/2022,Tokelau,Selangor,0,0,0
1/02/2022,Turkmenistan,Johor,0,0,0
1/02/2022,Turkmenistan,Kedah,0,0,0
1/02/2022,Turkmenistan,Kelantan,0,0,0
1/02/2022,Turkmenistan,Perlis,0,0,0
1/02/2022,Turkmenistan,Pulau Pinang,0,0,0
1/02/2022,Turkmenistan,Sabah,0,0,0
1/02/2022,Turkmenistan,Sarawak,0,0,0
1/02/2022,Turkmenistan,Selangor,6,2,4
1/02/2022,Timor-Leste,Johor,0,0,0
1/02/2022,Timor-Leste,Kedah,0,0,0
1/02/2022,Timor-Leste,Perlis,0,0,0
1/02/2022,Timor-Leste,Pulau Pinang,0,0,0
1/02/2022,Timor-Leste,Sabah,0,0,0
1/02/2022,Timor-Leste,Sarawak,0,0,0
1/02/2022,Timor-Leste,Selangor,8,6,2
1/02/2022,Tonga,Johor,0,0,0
1/02/2022,Tonga,Pulau Pinang,0,0,0
1/02/2022,Tonga,Sarawak,0,0,0
1/02/2022,Tonga,Selangor,0,0,0
1/02/2022,Trinidad and Tobago,Johor,0,0,0
1/02/2022,Trinidad and Tobago,Kedah,0,0,0
1/02/2022,Trinidad and Tobago,Pahang,0,0,0
1/02/2022,Trinidad and Tobago,Pulau Pinang,0,0,0
1/02/2022,Trinidad and Tobago,Sabah,0,0,0
1/02/2022,Trinidad and Tobago,Sarawak,0,0,0
1/02/2022,Trinidad and Tobago,Selangor,1,1,0
1/02/2022,Tunisia,Johor,0,0,0
1/02/2022,Tunisia,Kedah,0,0,0
1/02/2022,Tunisia,Kelantan,0,0,0
1/02/2022,Tunisia,Melaka,0,0,0
1/02/2022,Tunisia,Perak,0,0,0
1/02/2022,Tunisia,Perlis,0,0,0
1/02/2022,Tunisia,Pulau Pinang,0,0,0
1/02/2022,Tunisia,Sabah,0,0,0
1/02/2022,Tunisia,Sarawak,0,0,0
1/02/2022,Tunisia,Selangor,19,13,6
1/02/2022,Tunisia,W.P. Labuan,0,0,0
1/02/2022,Türkiye,Johor,12,12,0
1/02/2022,Türkiye,Kedah,0,0,0
1/02/2022,Türkiye,Kelantan,0,0,0
1/02/2022,Türkiye,Melaka,0,0,0
1/02/2022,Türkiye,Negeri Sembilan,0,0,0
1/02/2022,Türkiye,Pahang,0,0,0
1/02/2022,Türkiye,Perak,0,0,0
1/02/2022,Türkiye,Perlis,0,0,0
1/02/2022,Türkiye,Pulau Pinang,0,0,0
1/02/2022,Türkiye,Sabah,1,1,0
1/02/2022,Türkiye,Sarawak,0,0,0
1/02/2022,Türkiye,Selangor,74,62,12
1/02/2022,Türkiye,W.P. Labuan,0,0,0
1/02/2022,Tuvalu,Selangor,0,0,0
1/02/2022,"Taiwan, Province of China",Johor,4,1,3
1/02/2022,"Taiwan, Province of China",Kedah,4,3,1
1/02/2022,"Taiwan, Province of China",Kelantan,0,0,0
1/02/2022,"Taiwan, Province of China",Melaka,0,0,0
1/02/2022,"Taiwan, Province of China",Negeri Sembilan,0,0,0
1/02/2022,"Taiwan, Province of China",Pahang,0,0,0
1/02/2022,"Taiwan, Province of China",Perak,0,0,0
1/02/2022,"Taiwan, Province of China",Perlis,0,0,0
1/02/2022,"Taiwan, Province of China",Pulau Pinang,50,41,9
1/02/2022,"Taiwan, Province of China",Sabah,0,0,0
1/02/2022,"Taiwan, Province of China",Sarawak,4,4,0
1/02/2022,"Taiwan, Province of China",Selangor,279,169,110
1/02/2022,"Taiwan, Province of China",W.P. Labuan,0,0,0
1/02/2022,"Tanzania, United Republic of",Johor,0,0,0
1/02/2022,"Tanzania, United Republic of",Kedah,0,0,0
1/02/2022,"Tanzania, United Republic of",Perak,0,0,0
1/02/2022,"Tanzania, United Republic of",Perlis,0,0,0
1/02/2022,"Tanzania, United Republic of",Pulau Pinang,0,0,0
1/02/2022,"Tanzania, United Republic of",Sabah,0,0,0
1/02/2022,"Tanzania, United Republic of",Sarawak,0,0,0
1/02/2022,"Tanzania, United Republic of",Selangor,22,13,9
1/02/2022,Uganda,Johor,0,0,0
1/02/2022,Uganda,Kedah,0,0,0
1/02/2022,Uganda,Perak,0,0,0
1/02/2022,Uganda,Perlis,0,0,0
1/02/2022,Uganda,Pulau Pinang,0,0,0
1/02/2022,Uganda,Sabah,0,0,0
1/02/2022,Uganda,Sarawak,0,0,0
1/02/2022,Uganda,Selangor,12,7,5
1/02/2022,Ukraine,Johor,8,8,0
1/02/2022,Ukraine,Kedah,0,0,0
1/02/2022,Ukraine,Kelantan,0,0,0
1/02/2022,Ukraine,Melaka,0,0,0
1/02/2022,Ukraine,Negeri Sembilan,0,0,0
1/02/2022,Ukraine,Pahang,0,0,0
1/02/2022,Ukraine,Perak,0,0,0
1/02/2022,Ukraine,Perlis,0,0,0
1/02/2022,Ukraine,Pulau Pinang,0,0,0
1/02/2022,Ukraine,Sabah,0,0,0
1/02/2022,Ukraine,Sarawak,0,0,0
1/02/2022,Ukraine,Selangor,69,61,8
1/02/2022,Ukraine,W.P. Labuan,0,0,0
1/02/2022,Uruguay,Johor,0,0,0
1/02/2022,Uruguay,Kedah,0,0,0
1/02/2022,Uruguay,Kelantan,0,0,0
1/02/2022,Uruguay,Perak,0,0,0
1/02/2022,Uruguay,Perlis,0,0,0
1/02/2022,Uruguay,Pulau Pinang,0,0,0
1/02/2022,Uruguay,Sabah,0,0,0
1/02/2022,Uruguay,Sarawak,0,0,0
1/02/2022,Uruguay,Selangor,1,0,1
1/02/2022,Uruguay,W.P. Labuan,0,0,0
1/02/2022,United States of America,Johor,1,1,0
1/02/2022,United States of America,Kedah,26,16,10
1/02/2022,United States of America,Kelantan,0,0,0
1/02/2022,United States of America,Melaka,0,0,0
1/02/2022,United States of America,Negeri Sembilan,0,0,0
1/02/2022,United States of America,Pahang,0,0,0
1/02/2022,United States of America,Perak,2,1,1
1/02/2022,United States of America,Perlis,0,0,0
1/02/2022,United States of America,Pulau Pinang,16,12,4
1/02/2022,United States of America,Sabah,0,0,0
1/02/2022,United States of America,Sarawak,5,4,1
1/02/2022,United States of America,Selangor,642,424,218
1/02/2022,United States of America,Terengganu,0,0,0
1/02/2022,United States of America,W.P. Labuan,0,0,0
1/02/2022,Uzbekistan,Johor,0,0,0
1/02/2022,Uzbekistan,Kedah,0,0,0
1/02/2022,Uzbekistan,Kelantan,0,0,0
1/02/2022,Uzbekistan,Perak,0,0,0
1/02/2022,Uzbekistan,Perlis,0,0,0
1/02/2022,Uzbekistan,Pulau Pinang,0,0,0
1/02/2022,Uzbekistan,Sabah,0,0,0
1/02/2022,Uzbekistan,Sarawak,0,0,0
1/02/2022,Uzbekistan,Selangor,39,26,13
1/02/2022,Holy See,Johor,0,0,0
1/02/2022,Holy See,Sarawak,0,0,0
1/02/2022,Holy See,Selangor,1,1,0
1/02/2022,Saint Vincent and the Grenadines,Johor,0,0,0
1/02/2022,Saint Vincent and the Grenadines,Kedah,0,0,0
1/02/2022,Saint Vincent and the Grenadines,Pulau Pinang,0,0,0
1/02/2022,Saint Vincent and the Grenadines,Sarawak,0,0,0
1/02/2022,Saint Vincent and the Grenadines,Selangor,0,0,0
1/02/2022,"Venezuela, Bolivarian Republic of",Johor,0,0,0
1/02/2022,"Venezuela, Bolivarian Republic of",Kedah,0,0,0
1/02/2022,"Venezuela, Bolivarian Republic of",Kelantan,0,0,0
1/02/2022,"Venezuela, Bolivarian Republic of",Melaka,0,0,0
1/02/2022,"Venezuela, Bolivarian Republic of",Perak,0,0,0
1/02/2022,"Venezuela, Bolivarian Republic of",Perlis,0,0,0
1/02/2022,"Venezuela, Bolivarian Republic of",Pulau Pinang,0,0,0
1/02/2022,"Venezuela, Bolivarian Republic of",Sabah,0,0,0
1/02/2022,"Venezuela, Bolivarian Republic of",Sarawak,0,0,0
1/02/2022,"Venezuela, Bolivarian Republic of",Selangor,6,4,2
1/02/2022,"Venezuela, Bolivarian Republic of",W.P. Labuan,0,0,0
1/02/2022,Viet Nam,Johor,3,0,3
1/02/2022,Viet Nam,Kedah,29,12,17
1/02/2022,Viet Nam,Kelantan,0,0,0
1/02/2022,Viet Nam,Melaka,0,0,0
1/02/2022,Viet Nam,Negeri Sembilan,0,0,0
1/02/2022,Viet Nam,Pahang,0,0,0
1/02/2022,Viet Nam,Perak,0,0,0
1/02/2022,Viet Nam,Perlis,0,0,0
1/02/2022,Viet Nam,Pulau Pinang,2,2,0
1/02/2022,Viet Nam,Sabah,0,0,0
1/02/2022,Viet Nam,Sarawak,2,0,2
1/02/2022,Viet Nam,Selangor,495,136,359
1/02/2022,Viet Nam,Terengganu,0,0,0
1/02/2022,Viet Nam,W.P. Labuan,0,0,0
1/02/2022,Vanuatu,Johor,0,0,0
1/02/2022,Vanuatu,Kedah,0,0,0
1/02/2022,Vanuatu,Pulau Pinang,0,0,0
1/02/2022,Vanuatu,Sabah,0,0,0
1/02/2022,Vanuatu,Sarawak,0,0,0
1/02/2022,Vanuatu,Selangor,4,4,0
1/02/2022, Samoa,Johor,0,0,0
1/02/2022, Samoa,Sarawak,0,0,0
1/02/2022, Samoa,Selangor,0,0,0
1/02/2022,Yemen,Johor,0,0,0
1/02/2022,Yemen,Kedah,1,1,0
1/02/2022,Yemen,Kelantan,0,0,0
1/02/2022,Yemen,Melaka,0,0,0
1/02/2022,Yemen,Pahang,0,0,0
1/02/2022,Yemen,Perak,0,0,0
1/02/2022,Yemen,Perlis,0,0,0
1/02/2022,Yemen,Pulau Pinang,0,0,0
1/02/2022,Yemen,Sabah,0,0,0
1/02/2022,Yemen,Sarawak,1,1,0
1/02/2022,Yemen,Selangor,374,258,116
1/02/2022,Yemen,W.P. Labuan,0,0,0
1/02/2022,South Africa,Johor,0,0,0
1/02/2022,South Africa,Kedah,2,1,1
1/02/2022,South Africa,Kelantan,0,0,0
1/02/2022,South Africa,Melaka,0,0,0
1/02/2022,South Africa,Pahang,0,0,0
1/02/2022,South Africa,Perak,0,0,0
1/02/2022,South Africa,Perlis,0,0,0
1/02/2022,South Africa,Pulau Pinang,0,0,0
1/02/2022,South Africa,Sabah,0,0,0
1/02/2022,South Africa,Sarawak,0,0,0
1/02/2022,South Africa,Selangor,69,41,28
1/02/2022,South Africa,Terengganu,0,0,0
1/02/2022,South Africa,W.P. Labuan,0,0,0
1/02/2022,ZAR,Selangor,0,0,0
1/02/2022,Zambia,Johor,0,0,0
1/02/2022,Zambia,Kedah,0,0,0
1/02/2022,Zambia,Perak,0,0,0
1/02/2022,Zambia,Perlis,0,0,0
1/02/2022,Zambia,Pulau Pinang,0,0,0
1/02/2022,Zambia,Sabah,0,0,0
1/02/2022,Zambia,Sarawak,1,0,1
1/02/2022,Zambia,Selangor,23,11,12
1/02/2022,Zimbabwe,Johor,0,0,0
1/02/2022,Zimbabwe,Kedah,0,0,0
1/02/2022,Zimbabwe,Kelantan,0,0,0
1/02/2022,Zimbabwe,Perak,0,0,0
1/02/2022,Zimbabwe,Perlis,0,0,0
1/02/2022,Zimbabwe,Pulau Pinang,0,0,0
1/02/2022,Zimbabwe,Sabah,0,0,0
1/02/2022,Zimbabwe,Sarawak,0,0,0
1/02/2022,Zimbabwe,Selangor,44,19,25
1/03/2022,Aruba,Kedah,0,0,0
1/03/2022,Aruba,Pulau Pinang,0,0,0
1/03/2022,Afghanistan,Johor,0,0,0
1/03/2022,Afghanistan,Kedah,0,0,0
1/03/2022,Afghanistan,Perlis,0,0,0
1/03/2022,Afghanistan,Pulau Pinang,0,0,0
1/03/2022,Afghanistan,Sarawak,0,0,0
1/03/2022,Afghanistan,Selangor,94,64,30
1/03/2022,Angola,Johor,0,0,0
1/03/2022,Angola,Kedah,0,0,0
1/03/2022,Angola,Sabah,0,0,0
1/03/2022,Angola,Selangor,0,0,0
1/03/2022,Anguilla,Selangor,0,0,0
1/03/2022,Albania,Johor,0,0,0
1/03/2022,Albania,Kedah,0,0,0
1/03/2022,Albania,Perak,0,0,0
1/03/2022,Albania,Perlis,0,0,0
1/03/2022,Albania,Pulau Pinang,0,0,0
1/03/2022,Albania,Sabah,0,0,0
1/03/2022,Albania,Sarawak,0,0,0
1/03/2022,Albania,Selangor,3,2,1
1/03/2022,Andorra,Johor,0,0,0
1/03/2022,Andorra,Kedah,0,0,0
1/03/2022,Andorra,Perlis,0,0,0
1/03/2022,Andorra,Pulau Pinang,0,0,0
1/03/2022,Andorra,Selangor,0,0,0
1/03/2022,Antigua and Barbuda,Selangor,0,0,0
1/03/2022,United Arab Emirates,Johor,0,0,0
1/03/2022,United Arab Emirates,Kedah,0,0,0
1/03/2022,United Arab Emirates,Kelantan,0,0,0
1/03/2022,United Arab Emirates,Perak,0,0,0
1/03/2022,United Arab Emirates,Perlis,0,0,0
1/03/2022,United Arab Emirates,Pulau Pinang,0,0,0
1/03/2022,United Arab Emirates,Sabah,0,0,0
1/03/2022,United Arab Emirates,Sarawak,0,0,0
1/03/2022,United Arab Emirates,Selangor,34,19,15
1/03/2022,Argentina,Johor,0,0,0
1/03/2022,Argentina,Kedah,0,0,0
1/03/2022,Argentina,Kelantan,0,0,0
1/03/2022,Argentina,Melaka,0,0,0
1/03/2022,Argentina,Perak,0,0,0
1/03/2022,Argentina,Perlis,0,0,0
1/03/2022,Argentina,Pulau Pinang,0,0,0
1/03/2022,Argentina,Sabah,0,0,0
1/03/2022,Argentina,Sarawak,0,0,0
1/03/2022,Argentina,Selangor,25,15,10
1/03/2022,Argentina,W.P. Labuan,0,0,0
1/03/2022,Armenia,Johor,0,0,0
1/03/2022,Armenia,Kedah,0,0,0
1/03/2022,Armenia,Kelantan,0,0,0
1/03/2022,Armenia,Perak,0,0,0
1/03/2022,Armenia,Perlis,0,0,0
1/03/2022,Armenia,Pulau Pinang,0,0,0
1/03/2022,Armenia,Sabah,0,0,0
1/03/2022,Armenia,Sarawak,0,0,0
1/03/2022,Armenia,Selangor,2,0,2
1/03/2022,Antarctica,Selangor,0,0,0
1/03/2022,Antigua and Barbuda,Johor,0,0,0
1/03/2022,Antigua and Barbuda,Kedah,0,0,0
1/03/2022,Antigua and Barbuda,Pulau Pinang,0,0,0
1/03/2022,Antigua and Barbuda,Sarawak,0,0,0
1/03/2022,Antigua and Barbuda,Selangor,6,4,2
1/03/2022,Australia,Johor,5,5,0
1/03/2022,Australia,Kedah,59,32,27
1/03/2022,Australia,Kelantan,0,0,0
1/03/2022,Australia,Melaka,0,0,0
1/03/2022,Australia,Negeri Sembilan,0,0,0
1/03/2022,Australia,Pahang,0,0,0
1/03/2022,Australia,Perak,2,1,1
1/03/2022,Australia,Perlis,0,0,0
1/03/2022,Australia,Pulau Pinang,26,21,5
1/03/2022,Australia,Sabah,1,0,1
1/03/2022,Australia,Sarawak,3,2,1
1/03/2022,Australia,Selangor,738,492,246
1/03/2022,Australia,Terengganu,0,0,0
1/03/2022,Australia,W.P. Labuan,0,0,0
1/03/2022,Austria,Johor,0,0,0
1/03/2022,Austria,Kedah,2,2,0
1/03/2022,Austria,Kelantan,0,0,0
1/03/2022,Austria,Melaka,0,0,0
1/03/2022,Austria,Negeri Sembilan,0,0,0
1/03/2022,Austria,Pahang,0,0,0
1/03/2022,Austria,Perak,0,0,0
1/03/2022,Austria,Perlis,0,0,0
1/03/2022,Austria,Pulau Pinang,2,1,1
1/03/2022,Austria,Sabah,0,0,0
1/03/2022,Austria,Sarawak,0,0,0
1/03/2022,Austria,Selangor,80,73,7
1/03/2022,Austria,Terengganu,0,0,0
1/03/2022,Austria,W.P. Labuan,0,0,0
1/03/2022,Azerbaijan,Johor,0,0,0
1/03/2022,Azerbaijan,Kedah,0,0,0
1/03/2022,Azerbaijan,Kelantan,0,0,0
1/03/2022,Azerbaijan,Melaka,0,0,0
1/03/2022,Azerbaijan,Perlis,0,0,0
1/03/2022,Azerbaijan,Pulau Pinang,0,0,0
1/03/2022,Azerbaijan,Sabah,0,0,0
1/03/2022,Azerbaijan,Sarawak,0,0,0
1/03/2022,Azerbaijan,Selangor,12,10,2
1/03/2022,Azerbaijan,W.P. Labuan,0,0,0
1/03/2022,Burundi,Pulau Pinang,0,0,0
1/03/2022,Burundi,Sarawak,0,0,0
1/03/2022,Burundi,Selangor,0,0,0
1/03/2022,Belgium,Johor,1,1,0
1/03/2022,Belgium,Kedah,0,0,0
1/03/2022,Belgium,Kelantan,0,0,0
1/03/2022,Belgium,Melaka,0,0,0
1/03/2022,Belgium,Negeri Sembilan,0,0,0
1/03/2022,Belgium,Pahang,0,0,0
1/03/2022,Belgium,Perak,0,0,0
1/03/2022,Belgium,Perlis,0,0,0
1/03/2022,Belgium,Pulau Pinang,1,1,0
1/03/2022,Belgium,Sabah,0,0,0
1/03/2022,Belgium,Sarawak,0,0,0
1/03/2022,Belgium,Selangor,83,58,25
1/03/2022,Belgium,W.P. Labuan,0,0,0
1/03/2022,Benin,Johor,0,0,0
1/03/2022,Benin,Kedah,0,0,0
1/03/2022,Benin,Perak,0,0,0
1/03/2022,Benin,Pulau Pinang,0,0,0
1/03/2022,Benin,Sabah,0,0,0
1/03/2022,Benin,Sarawak,0,0,0
1/03/2022,Benin,Selangor,1,0,1
1/03/2022,Burkina Faso,Perak,0,0,0
1/03/2022,Burkina Faso,Pulau Pinang,0,0,0
1/03/2022,Burkina Faso,Selangor,1,1,0
1/03/2022,Bangladesh,Johor,22,19,3
1/03/2022,Bangladesh,Kedah,0,0,0
1/03/2022,Bangladesh,Kelantan,0,0,0
1/03/2022,Bangladesh,Melaka,0,0,0
1/03/2022,Bangladesh,Negeri Sembilan,0,0,0
1/03/2022,Bangladesh,Pahang,0,0,0
1/03/2022,Bangladesh,Perak,0,0,0
1/03/2022,Bangladesh,Perlis,0,0,0
1/03/2022,Bangladesh,Pulau Pinang,5,5,0
1/03/2022,Bangladesh,Sabah,0,0,0
1/03/2022,Bangladesh,Sarawak,0,0,0
1/03/2022,Bangladesh,Selangor,8928,8566,362
1/03/2022,Bangladesh,W.P. Labuan,0,0,0
1/03/2022,Bulgaria,Johor,0,0,0
1/03/2022,Bulgaria,Kedah,0,0,0
1/03/2022,Bulgaria,Kelantan,0,0,0
1/03/2022,Bulgaria,Pahang,0,0,0
1/03/2022,Bulgaria,Perak,0,0,0
1/03/2022,Bulgaria,Perlis,0,0,0
1/03/2022,Bulgaria,Pulau Pinang,0,0,0
1/03/2022,Bulgaria,Sabah,0,0,0
1/03/2022,Bulgaria,Sarawak,0,0,0
1/03/2022,Bulgaria,Selangor,35,31,4
1/03/2022,Bulgaria,W.P. Labuan,0,0,0
1/03/2022,Bahrain,Johor,0,0,0
1/03/2022,Bahrain,Kedah,0,0,0
1/03/2022,Bahrain,Kelantan,0,0,0
1/03/2022,Bahrain,Perlis,0,0,0
1/03/2022,Bahrain,Pulau Pinang,0,0,0
1/03/2022,Bahrain,Sabah,0,0,0
1/03/2022,Bahrain,Sarawak,0,0,0
1/03/2022,Bahrain,Selangor,6,4,2
1/03/2022,Bahamas,Johor,0,0,0
1/03/2022,Bahamas,Kedah,0,0,0
1/03/2022,Bahamas,Perak,0,0,0
1/03/2022,Bahamas,Sabah,0,0,0
1/03/2022,Bahamas,Sarawak,0,0,0
1/03/2022,Bahamas,Selangor,1,1,0
1/03/2022,Bosnia and Herzegovina,Johor,0,0,0
1/03/2022,Bosnia and Herzegovina,Kedah,0,0,0
1/03/2022,Bosnia and Herzegovina,Perlis,0,0,0
1/03/2022,Bosnia and Herzegovina,Pulau Pinang,0,0,0
1/03/2022,Bosnia and Herzegovina,Sabah,0,0,0
1/03/2022,Bosnia and Herzegovina,Sarawak,0,0,0
1/03/2022,Bosnia and Herzegovina,Selangor,19,9,10
1/03/2022,Belarus,Johor,1,1,0
1/03/2022,Belarus,Kedah,0,0,0
1/03/2022,Belarus,Kelantan,0,0,0
1/03/2022,Belarus,Pahang,0,0,0
1/03/2022,Belarus,Perak,0,0,0
1/03/2022,Belarus,Perlis,0,0,0
1/03/2022,Belarus,Pulau Pinang,1,0,1
1/03/2022,Belarus,Sabah,0,0,0
1/03/2022,Belarus,Sarawak,0,0,0
1/03/2022,Belarus,Selangor,12,7,5
1/03/2022,Belarus,W.P. Labuan,0,0,0
1/03/2022,Belize,Johor,0,0,0
1/03/2022,Belize,Pulau Pinang,0,0,0
1/03/2022,Belize,Sarawak,0,0,0
1/03/2022,Belize,Selangor,0,0,0
1/03/2022,Bermuda,Selangor,0,0,0
1/03/2022,Bolivia,Johor,0,0,0
1/03/2022,Bolivia,Kedah,0,0,0
1/03/2022,Bolivia,Melaka,0,0,0
1/03/2022,Bolivia,Perak,0,0,0
1/03/2022,Bolivia,Perlis,0,0,0
1/03/2022,Bolivia,Pulau Pinang,0,0,0
1/03/2022,Bolivia,Sabah,0,0,0
1/03/2022,Bolivia,Sarawak,0,0,0
1/03/2022,Bolivia,Selangor,1,1,0
1/03/2022,Brazil,Johor,0,0,0
1/03/2022,Brazil,Kedah,0,0,0
1/03/2022,Brazil,Kelantan,0,0,0
1/03/2022,Brazil,Melaka,0,0,0
1/03/2022,Brazil,Pahang,0,0,0
1/03/2022,Brazil,Perak,0,0,0
1/03/2022,Brazil,Perlis,0,0,0
1/03/2022,Brazil,Pulau Pinang,1,1,0
1/03/2022,Brazil,Sabah,0,0,0
1/03/2022,Brazil,Sarawak,1,1,0
1/03/2022,Brazil,Selangor,64,40,24
1/03/2022,Brazil,W.P. Labuan,0,0,0
1/03/2022,Barbados,Johor,0,0,0
1/03/2022,Barbados,Kedah,0,0,0
1/03/2022,Barbados,Perlis,0,0,0
1/03/2022,Barbados,Pulau Pinang,0,0,0
1/03/2022,Barbados,Selangor,2,1,1
1/03/2022,Brunei Darussalam,Johor,0,0,0
1/03/2022,Brunei Darussalam,Kedah,0,0,0
1/03/2022,Brunei Darussalam,Kelantan,0,0,0
1/03/2022,Brunei Darussalam,Melaka,0,0,0
1/03/2022,Brunei Darussalam,Pahang,0,0,0
1/03/2022,Brunei Darussalam,Perak,0,0,0
1/03/2022,Brunei Darussalam,Perlis,0,0,0
1/03/2022,Brunei Darussalam,Pulau Pinang,0,0,0
1/03/2022,Brunei Darussalam,Sabah,0,0,0
1/03/2022,Brunei Darussalam,Sarawak,391,386,5
1/03/2022,Brunei Darussalam,Selangor,129,76,53
1/03/2022,Brunei Darussalam,W.P. Labuan,2,2,0
1/03/2022,Bhutan,Johor,0,0,0
1/03/2022,Bhutan,Kedah,0,0,0
1/03/2022,Bhutan,Perak,0,0,0
1/03/2022,Bhutan,Perlis,0,0,0
1/03/2022,Bhutan,Pulau Pinang,0,0,0
1/03/2022,Bhutan,Sabah,0,0,0
1/03/2022,Bhutan,Sarawak,0,0,0
1/03/2022,Bhutan,Selangor,4,3,1
1/03/2022,Botswana,Johor,0,0,0
1/03/2022,Botswana,Kedah,0,0,0
1/03/2022,Botswana,Perlis,0,0,0
1/03/2022,Botswana,Pulau Pinang,0,0,0
1/03/2022,Botswana,Sabah,0,0,0
1/03/2022,Botswana,Sarawak,0,0,0
1/03/2022,Botswana,Selangor,2,1,1
1/03/2022,Central African Republic,Kedah,0,0,0
1/03/2022,Central African Republic,Selangor,0,0,0
1/03/2022,Canada,Johor,0,0,0
1/03/2022,Canada,Kedah,15,10,5
1/03/2022,Canada,Kelantan,0,0,0
1/03/2022,Canada,Melaka,0,0,0
1/03/2022,Canada,Negeri Sembilan,0,0,0
1/03/2022,Canada,Pahang,0,0,0
1/03/2022,Canada,Perak,0,0,0
1/03/2022,Canada,Perlis,0,0,0
1/03/2022,Canada,Pulau Pinang,9,5,4
1/03/2022,Canada,Sabah,1,1,0
1/03/2022,Canada,Sarawak,1,1,0
1/03/2022,Canada,Selangor,249,161,88
1/03/2022,Canada,Terengganu,0,0,0
1/03/2022,Canada,W.P. Labuan,0,0,0
1/03/2022,Cocos (Keeling) Islands,Selangor,0,0,0
1/03/2022,Switzerland,Johor,0,0,0
1/03/2022,Switzerland,Kedah,3,3,0
1/03/2022,Switzerland,Kelantan,0,0,0
1/03/2022,Switzerland,Melaka,0,0,0
1/03/2022,Switzerland,Negeri Sembilan,0,0,0
1/03/2022,Switzerland,Pahang,0,0,0
1/03/2022,Switzerland,Perak,0,0,0
1/03/2022,Switzerland,Perlis,0,0,0
1/03/2022,Switzerland,Pulau Pinang,5,3,2
1/03/2022,Switzerland,Sabah,1,1,0
1/03/2022,Switzerland,Sarawak,0,0,0
1/03/2022,Switzerland,Selangor,80,63,17
1/03/2022,Switzerland,W.P. Labuan,0,0,0
1/03/2022,Chile,Johor,0,0,0
1/03/2022,Chile,Kedah,0,0,0
1/03/2022,Chile,Kelantan,0,0,0
1/03/2022,Chile,Melaka,0,0,0
1/03/2022,Chile,Pahang,0,0,0
1/03/2022,Chile,Perak,0,0,0
1/03/2022,Chile,Perlis,0,0,0
1/03/2022,Chile,Pulau Pinang,0,0,0
1/03/2022,Chile,Sabah,0,0,0
1/03/2022,Chile,Sarawak,0,0,0
1/03/2022,Chile,Selangor,9,6,3
1/03/2022,China,Johor,254,240,14
1/03/2022,China,Kedah,14,8,6
1/03/2022,China,Kelantan,0,0,0
1/03/2022,China,Melaka,0,0,0
1/03/2022,China,Pahang,0,0,0
1/03/2022,China,Perak,0,0,0
1/03/2022,China,Perlis,0,0,0
1/03/2022,China,Pulau Pinang,16,9,7
1/03/2022,China,Sabah,2,2,0
1/03/2022,China,Sarawak,38,38,0
1/03/2022,China,Selangor,3088,2200,888
1/03/2022,China,Terengganu,0,0,0
1/03/2022,China,W.P. Labuan,0,0,0
1/03/2022,Côte d'Ivoire,Johor,0,0,0
1/03/2022,Côte d'Ivoire,Kedah,0,0,0
1/03/2022,Côte d'Ivoire,Pulau Pinang,0,0,0
1/03/2022,Côte d'Ivoire,Sabah,0,0,0
1/03/2022,Côte d'Ivoire,Sarawak,0,0,0
1/03/2022,Côte d'Ivoire,Selangor,0,0,0
1/03/2022,Cameroon,Johor,0,0,0
1/03/2022,Cameroon,Kedah,0,0,0
1/03/2022,Cameroon,Pulau Pinang,0,0,0
1/03/2022,Cameroon,Sabah,0,0,0
1/03/2022,Cameroon,Sarawak,0,0,0
1/03/2022,Cameroon,Selangor,6,6,0
1/03/2022,Congo,Johor,0,0,0
1/03/2022,Congo,Pulau Pinang,0,0,0
1/03/2022,Congo,Sarawak,0,0,0
1/03/2022,Congo,Selangor,2,1,1
1/03/2022,Congo,Johor,0,0,0
1/03/2022,Congo,Kedah,0,0,0
1/03/2022,Congo,Selangor,0,0,0
1/03/2022,Cook Islands,Selangor,0,0,0
1/03/2022,Colombia,Johor,0,0,0
1/03/2022,Colombia,Kedah,0,0,0
1/03/2022,Colombia,Perak,0,0,0
1/03/2022,Colombia,Pulau Pinang,0,0,0
1/03/2022,Colombia,Sabah,0,0,0
1/03/2022,Colombia,Sarawak,0,0,0
1/03/2022,Colombia,Selangor,14,10,4
1/03/2022,Colombia,W.P. Labuan,0,0,0
1/03/2022,Comoros,Johor,0,0,0
1/03/2022,Comoros,Kedah,0,0,0
1/03/2022,Comoros,Selangor,9,8,1
1/03/2022,Cabo Verde,Johor,0,0,0
1/03/2022,Cabo Verde,Kedah,0,0,0
1/03/2022,Cabo Verde,Pulau Pinang,0,0,0
1/03/2022,Cabo Verde,Sabah,0,0,0
1/03/2022,Cabo Verde,Selangor,0,0,0
1/03/2022,Costa Rica,Johor,0,0,0
1/03/2022,Costa Rica,Kedah,0,0,0
1/03/2022,Costa Rica,Perak,0,0,0
1/03/2022,Costa Rica,Perlis,0,0,0
1/03/2022,Costa Rica,Pulau Pinang,0,0,0
1/03/2022,Costa Rica,Sabah,0,0,0
1/03/2022,Costa Rica,Sarawak,0,0,0
1/03/2022,Costa Rica,Selangor,4,4,0
1/03/2022,Cuba,Johor,0,0,0
1/03/2022,Cuba,Kedah,0,0,0
1/03/2022,Cuba,Perlis,0,0,0
1/03/2022,Cuba,Pulau Pinang,0,0,0
1/03/2022,Cuba,Sabah,0,0,0
1/03/2022,Cuba,Sarawak,0,0,0
1/03/2022,Cuba,Selangor,0,0,0
1/03/2022,Cyprus,Johor,0,0,0
1/03/2022,Cyprus,Kedah,0,0,0
1/03/2022,Cyprus,Perak,0,0,0
1/03/2022,Cyprus,Perlis,0,0,0
1/03/2022,Cyprus,Pulau Pinang,0,0,0
1/03/2022,Cyprus,Sabah,0,0,0
1/03/2022,Cyprus,Sarawak,0,0,0
1/03/2022,Cyprus,Selangor,3,2,1
1/03/2022,Czechia,Johor,0,0,0
1/03/2022,Czechia,Kedah,0,0,0
1/03/2022,Czechia,Kelantan,1,0,1
1/03/2022,Czechia,Melaka,0,0,0
1/03/2022,Czechia,Negeri Sembilan,0,0,0
1/03/2022,Czechia,Perak,0,0,0
1/03/2022,Czechia,Perlis,0,0,0
1/03/2022,Czechia,Pulau Pinang,0,0,0
1/03/2022,Czechia,Sabah,0,0,0
1/03/2022,Czechia,Sarawak,0,0,0
1/03/2022,Czechia,Selangor,38,30,8
1/03/2022,Czechia,W.P. Labuan,0,0,0
1/03/2022,Germany,Johor,3,2,1
1/03/2022,Germany,Kedah,14,11,3
1/03/2022,Germany,Kelantan,0,0,0
1/03/2022,Germany,Melaka,0,0,0
1/03/2022,Germany,Negeri Sembilan,0,0,0
1/03/2022,Germany,Pahang,0,0,0
1/03/2022,Germany,Perak,0,0,0
1/03/2022,Germany,Perlis,0,0,0
1/03/2022,Germany,Pulau Pinang,19,14,5
1/03/2022,Germany,Sabah,0,0,0
1/03/2022,Germany,Sarawak,0,0,0
1/03/2022,Germany,Selangor,476,374,102
1/03/2022,Germany,Terengganu,0,0,0
1/03/2022,Germany,W.P. Labuan,0,0,0
1/03/2022,Djibouti,Johor,0,0,0
1/03/2022,Djibouti,Selangor,10,6,4
1/03/2022,Dominica,Johor,0,0,0
1/03/2022,Dominica,Kedah,0,0,0
1/03/2022,Dominica,Pulau Pinang,0,0,0
1/03/2022,Dominica,Sabah,0,0,0
1/03/2022,Dominica,Sarawak,0,0,0
1/03/2022,Dominica,Selangor,5,4,1
1/03/2022,Dominica,W.P. Labuan,0,0,0
1/03/2022,Denmark,Johor,3,3,0
1/03/2022,Denmark,Kedah,4,3,1
1/03/2022,Denmark,Kelantan,0,0,0
1/03/2022,Denmark,Melaka,0,0,0
1/03/2022,Denmark,Negeri Sembilan,0,0,0
1/03/2022,Denmark,Pahang,0,0,0
1/03/2022,Denmark,Perak,0,0,0
1/03/2022,Denmark,Perlis,0,0,0
1/03/2022,Denmark,Pulau Pinang,5,3,2
1/03/2022,Denmark,Sabah,1,0,1
1/03/2022,Denmark,Sarawak,0,0,0
1/03/2022,Denmark,Selangor,93,71,22
1/03/2022,Denmark,W.P. Labuan,0,0,0
1/03/2022,Dominican Republic,Johor,0,0,0
1/03/2022,Dominican Republic,Kedah,0,0,0
1/03/2022,Dominican Republic,Perak,0,0,0
1/03/2022,Dominican Republic,Perlis,0,0,0
1/03/2022,Dominican Republic,Pulau Pinang,0,0,0
1/03/2022,Dominican Republic,Sabah,0,0,0
1/03/2022,Dominican Republic,Sarawak,0,0,0
1/03/2022,Dominican Republic,Selangor,0,0,0
1/03/2022,Algeria,Johor,0,0,0
1/03/2022,Algeria,Kedah,0,0,0
1/03/2022,Algeria,Kelantan,0,0,0
1/03/2022,Algeria,Melaka,0,0,0
1/03/2022,Algeria,Perak,0,0,0
1/03/2022,Algeria,Perlis,0,0,0
1/03/2022,Algeria,Pulau Pinang,0,0,0
1/03/2022,Algeria,Sabah,0,0,0
1/03/2022,Algeria,Sarawak,0,0,0
1/03/2022,Algeria,Selangor,54,36,18
1/03/2022,Algeria,W.P. Labuan,0,0,0
1/03/2022,Ecuador,Johor,0,0,0
1/03/2022,Ecuador,Kedah,0,0,0
1/03/2022,Ecuador,Perak,0,0,0
1/03/2022,Ecuador,Perlis,0,0,0
1/03/2022,Ecuador,Pulau Pinang,0,0,0
1/03/2022,Ecuador,Sabah,0,0,0
1/03/2022,Ecuador,Sarawak,0,0,0
1/03/2022,Ecuador,Selangor,2,1,1
1/03/2022,Egypt,Johor,1,1,0
1/03/2022,Egypt,Kedah,0,0,0
1/03/2022,Egypt,Kelantan,0,0,0
1/03/2022,Egypt,Melaka,0,0,0
1/03/2022,Egypt,Pahang,0,0,0
1/03/2022,Egypt,Perak,0,0,0
1/03/2022,Egypt,Perlis,0,0,0
1/03/2022,Egypt,Pulau Pinang,0,0,0
1/03/2022,Egypt,Sabah,0,0,0
1/03/2022,Egypt,Sarawak,0,0,0
1/03/2022,Egypt,Selangor,233,176,57
1/03/2022,Egypt,Terengganu,0,0,0
1/03/2022,Egypt,W.P. Labuan,0,0,0
1/03/2022,Eritrea,Johor,0,0,0
1/03/2022,Eritrea,Pulau Pinang,0,0,0
1/03/2022,Eritrea,Sabah,0,0,0
1/03/2022,Eritrea,Selangor,5,4,1
1/03/2022,Spain,Johor,0,0,0
1/03/2022,Spain,Kedah,3,1,2
1/03/2022,Spain,Kelantan,0,0,0
1/03/2022,Spain,Melaka,0,0,0
1/03/2022,Spain,Negeri Sembilan,0,0,0
1/03/2022,Spain,Pahang,0,0,0
1/03/2022,Spain,Perak,0,0,0
1/03/2022,Spain,Perlis,0,0,0
1/03/2022,Spain,Pulau Pinang,1,0,1
1/03/2022,Spain,Sabah,0,0,0
1/03/2022,Spain,Sarawak,0,0,0
1/03/2022,Spain,Selangor,117,87,30
1/03/2022,Spain,W.P. Labuan,0,0,0
1/03/2022,Estonia,Johor,0,0,0
1/03/2022,Estonia,Kedah,0,0,0
1/03/2022,Estonia,Kelantan,0,0,0
1/03/2022,Estonia,Pahang,0,0,0
1/03/2022,Estonia,Perak,0,0,0
1/03/2022,Estonia,Perlis,0,0,0
1/03/2022,Estonia,Pulau Pinang,0,0,0
1/03/2022,Estonia,Sabah,0,0,0
1/03/2022,Estonia,Sarawak,0,0,0
1/03/2022,Estonia,Selangor,9,8,1
1/03/2022,Estonia,W.P. Labuan,0,0,0
1/03/2022,Ethiopia,Johor,1,1,0
1/03/2022,Ethiopia,Kedah,0,0,0
1/03/2022,Ethiopia,Pulau Pinang,0,0,0
1/03/2022,Ethiopia,Sarawak,0,0,0
1/03/2022,Ethiopia,Selangor,12,7,5
1/03/2022,Finland,Johor,0,0,0
1/03/2022,Finland,Kedah,0,0,0
1/03/2022,Finland,Kelantan,0,0,0
1/03/2022,Finland,Melaka,0,0,0
1/03/2022,Finland,Negeri Sembilan,0,0,0
1/03/2022,Finland,Pahang,0,0,0
1/03/2022,Finland,Perak,0,0,0
1/03/2022,Finland,Perlis,0,0,0
1/03/2022,Finland,Pulau Pinang,1,0,1
1/03/2022,Finland,Sabah,0,0,0
1/03/2022,Finland,Sarawak,0,0,0
1/03/2022,Finland,Selangor,58,35,23
1/03/2022,Finland,W.P. Labuan,0,0,0
1/03/2022,Fiji,Johor,0,0,0
1/03/2022,Fiji,Kedah,1,0,1
1/03/2022,Fiji,Kelantan,0,0,0
1/03/2022,Fiji,Perak,0,0,0
1/03/2022,Fiji,Perlis,0,0,0
1/03/2022,Fiji,Pulau Pinang,0,0,0
1/03/2022,Fiji,Sabah,0,0,0
1/03/2022,Fiji,Sarawak,0,0,0
1/03/2022,Fiji,Selangor,2,1,1
1/03/2022,France,Johor,5,5,0
1/03/2022,France,Kedah,6,4,2
1/03/2022,France,Kelantan,0,0,0
1/03/2022,France,Melaka,0,0,0
1/03/2022,France,Negeri Sembilan,0,0,0
1/03/2022,France,Pahang,0,0,0
1/03/2022,France,Perak,0,0,0
1/03/2022,France,Perlis,0,0,0
1/03/2022,France,Pulau Pinang,14,10,4
1/03/2022,France,Sabah,0,0,0
1/03/2022,France,Sarawak,0,0,0
1/03/2022,France,Selangor,605,450,155
1/03/2022,France,Terengganu,0,0,0
1/03/2022,France,W.P. Labuan,0,0,0
1/03/2022,"Micronesia, Federated States of",Johor,0,0,0
1/03/2022,"Micronesia, Federated States of",Pulau Pinang,0,0,0
1/03/2022,"Micronesia, Federated States of",Selangor,0,0,0
1/03/2022,Gabon,Johor,0,0,0
1/03/2022,Gabon,Pulau Pinang,0,0,0
1/03/2022,Gabon,Sarawak,0,0,0
1/03/2022,Gabon,Selangor,1,0,1
1/03/2022,United Kingdom of Great Britain and Northern Ireland,Johor,7,6,1
1/03/2022,United Kingdom of Great Britain and Northern Ireland,Kedah,38,20,18
1/03/2022,United Kingdom of Great Britain and Northern Ireland,Kelantan,0,0,0
1/03/2022,United Kingdom of Great Britain and Northern Ireland,Melaka,0,0,0
1/03/2022,United Kingdom of Great Britain and Northern Ireland,Negeri Sembilan,0,0,0
1/03/2022,United Kingdom of Great Britain and Northern Ireland,Pahang,0,0,0
1/03/2022,United Kingdom of Great Britain and Northern Ireland,Perak,0,0,0
1/03/2022,United Kingdom of Great Britain and Northern Ireland,Perlis,0,0,0
1/03/2022,United Kingdom of Great Britain and Northern Ireland,Pulau Pinang,48,40,8
1/03/2022,United Kingdom of Great Britain and Northern Ireland,Sabah,0,0,0
1/03/2022,United Kingdom of Great Britain and Northern Ireland,Sarawak,4,3,1
1/03/2022,United Kingdom of Great Britain and Northern Ireland,Selangor,1260,924,336
1/03/2022,United Kingdom of Great Britain and Northern Ireland,Terengganu,0,0,0
1/03/2022,United Kingdom of Great Britain and Northern Ireland,W.P. Labuan,0,0,0
1/03/2022,Georgia,Johor,0,0,0
1/03/2022,Georgia,Kedah,0,0,0
1/03/2022,Georgia,Melaka,0,0,0
1/03/2022,Georgia,Perak,0,0,0
1/03/2022,Georgia,Perlis,0,0,0
1/03/2022,Georgia,Pulau Pinang,0,0,0
1/03/2022,Georgia,Sabah,0,0,0
1/03/2022,Georgia,Sarawak,0,0,0
1/03/2022,Georgia,Selangor,14,14,0
1/03/2022,Ghana,Johor,0,0,0
1/03/2022,Ghana,Kedah,0,0,0
1/03/2022,Ghana,Kelantan,0,0,0
1/03/2022,Ghana,Pulau Pinang,0,0,0
1/03/2022,Ghana,Sabah,0,0,0
1/03/2022,Ghana,Sarawak,0,0,0
1/03/2022,Ghana,Selangor,5,4,1
1/03/2022,Gibraltar,Johor,0,0,0
1/03/2022,Gibraltar,Sarawak,0,0,0
1/03/2022,Guinea,Johor,0,0,0
1/03/2022,Guinea,Kedah,0,0,0
1/03/2022,Guinea,Kelantan,0,0,0
1/03/2022,Guinea,Perlis,0,0,0
1/03/2022,Guinea,Pulau Pinang,0,0,0
1/03/2022,Guinea,Sabah,0,0,0
1/03/2022,Guinea,Sarawak,0,0,0
1/03/2022,Guinea,Selangor,11,8,3
1/03/2022,Guadeloupe,Selangor,0,0,0
1/03/2022,Gambia,Johor,0,0,0
1/03/2022,Gambia,Kedah,0,0,0
1/03/2022,Gambia,Kelantan,0,0,0
1/03/2022,Gambia,Pulau Pinang,0,0,0
1/03/2022,Gambia,Sabah,0,0,0
1/03/2022,Gambia,Sarawak,0,0,0
1/03/2022,Gambia,Selangor,10,3,7
1/03/2022,Guinea-Bissau,Johor,0,0,0
1/03/2022,Guinea-Bissau,Selangor,1,1,0
1/03/2022,Equatorial Guinea,Johor,0,0,0
1/03/2022,Equatorial Guinea,Selangor,0,0,0
1/03/2022,Greece,Johor,2,2,0
1/03/2022,Greece,Kedah,2,1,1
1/03/2022,Greece,Kelantan,0,0,0
1/03/2022,Greece,Melaka,0,0,0
1/03/2022,Greece,Negeri Sembilan,0,0,0
1/03/2022,Greece,Pahang,0,0,0
1/03/2022,Greece,Perak,0,0,0
1/03/2022,Greece,Perlis,0,0,0
1/03/2022,Greece,Pulau Pinang,0,0,0
1/03/2022,Greece,Sabah,0,0,0
1/03/2022,Greece,Sarawak,0,0,0
1/03/2022,Greece,Selangor,22,19,3
1/03/2022,Grenada,Johor,0,0,0
1/03/2022,Grenada,Kedah,0,0,0
1/03/2022,Grenada,Pulau Pinang,0,0,0
1/03/2022,Grenada,Sabah,0,0,0
1/03/2022,Grenada,Sarawak,0,0,0
1/03/2022,Grenada,Selangor,4,3,1
1/03/2022,Greenland,Johor,0,0,0
1/03/2022,Greenland,Selangor,0,0,0
1/03/2022,Guatemala,Johor,0,0,0
1/03/2022,Guatemala,Kedah,0,0,0
1/03/2022,Guatemala,Pahang,0,0,0
1/03/2022,Guatemala,Perak,0,0,0
1/03/2022,Guatemala,Pulau Pinang,0,0,0
1/03/2022,Guatemala,Sabah,0,0,0
1/03/2022,Guatemala,Sarawak,0,0,0
1/03/2022,Guatemala,Selangor,2,1,1
1/03/2022,Guatemala,W.P. Labuan,0,0,0
1/03/2022,Guyana,Johor,0,0,0
1/03/2022,Guyana,Kedah,0,0,0
1/03/2022,Guyana,Pulau Pinang,0,0,0
1/03/2022,Guyana,Sarawak,0,0,0
1/03/2022,Guyana,Selangor,0,0,0
1/03/2022,Hong Kong,Johor,0,0,0
1/03/2022,Hong Kong,Kedah,18,8,10
1/03/2022,Hong Kong,Kelantan,0,0,0
1/03/2022,Hong Kong,Pahang,0,0,0
1/03/2022,Hong Kong,Perak,0,0,0
1/03/2022,Hong Kong,Perlis,0,0,0
1/03/2022,Hong Kong,Pulau Pinang,4,0,4
1/03/2022,Hong Kong,Sabah,0,0,0
1/03/2022,Hong Kong,Sarawak,26,25,1
1/03/2022,Hong Kong,Selangor,2,0,2
1/03/2022,Hong Kong,Terengganu,0,0,0
1/03/2022,Heard Island and McDonald Islands,Johor,0,0,0
1/03/2022,Honduras,Johor,0,0,0
1/03/2022,Honduras,Kedah,0,0,0
1/03/2022,Honduras,Perak,0,0,0
1/03/2022,Honduras,Pulau Pinang,0,0,0
1/03/2022,Honduras,Sabah,0,0,0
1/03/2022,Honduras,Sarawak,0,0,0
1/03/2022,Honduras,Selangor,0,0,0
1/03/2022,Croatia,Johor,3,3,0
1/03/2022,Croatia,Kedah,0,0,0
1/03/2022,Croatia,Kelantan,0,0,0
1/03/2022,Croatia,Melaka,0,0,0
1/03/2022,Croatia,Pahang,0,0,0
1/03/2022,Croatia,Perak,0,0,0
1/03/2022,Croatia,Perlis,0,0,0
1/03/2022,Croatia,Pulau Pinang,0,0,0
1/03/2022,Croatia,Sabah,0,0,0
1/03/2022,Croatia,Sarawak,0,0,0
1/03/2022,Croatia,Selangor,33,29,4
1/03/2022,Haiti,Johor,0,0,0
1/03/2022,Haiti,Kedah,0,0,0
1/03/2022,Haiti,Kelantan,0,0,0
1/03/2022,Haiti,Perak,0,0,0
1/03/2022,Haiti,Pulau Pinang,0,0,0
1/03/2022,Haiti,Sabah,0,0,0
1/03/2022,Haiti,Selangor,0,0,0
1/03/2022,Hungary,Johor,0,0,0
1/03/2022,Hungary,Kedah,0,0,0
1/03/2022,Hungary,Kelantan,0,0,0
1/03/2022,Hungary,Pahang,0,0,0
1/03/2022,Hungary,Perak,0,0,0
1/03/2022,Hungary,Perlis,0,0,0
1/03/2022,Hungary,Pulau Pinang,0,0,0
1/03/2022,Hungary,Sabah,0,0,0
1/03/2022,Hungary,Sarawak,0,0,0
1/03/2022,Hungary,Selangor,11,6,5
1/03/2022,Hungary,W.P. Labuan,0,0,0
1/03/2022,Indonesia,Johor,628,444,184
1/03/2022,Indonesia,Kedah,44,18,26
1/03/2022,Indonesia,Kelantan,1,1,0
1/03/2022,Indonesia,Melaka,13,0,13
1/03/2022,Indonesia,Negeri Sembilan,0,0,0
1/03/2022,Indonesia,Pahang,0,0,0
1/03/2022,Indonesia,Perak,0,0,0
1/03/2022,Indonesia,Perlis,0,0,0
1/03/2022,Indonesia,Pulau Pinang,49,21,28
1/03/2022,Indonesia,Sabah,6,1,5
1/03/2022,Indonesia,Sarawak,331,307,24
1/03/2022,Indonesia,Selangor,5438,2088,3350
1/03/2022,Indonesia,Terengganu,0,0,0
1/03/2022,Indonesia,W.P. Labuan,1,1,0
1/03/2022,India,Johor,99,98,1
1/03/2022,India,Kedah,3,3,0
1/03/2022,India,Kelantan,0,0,0
1/03/2022,India,Melaka,0,0,0
1/03/2022,India,Negeri Sembilan,0,0,0
1/03/2022,India,Pahang,0,0,0
1/03/2022,India,Perak,0,0,0
1/03/2022,India,Perlis,0,0,0
1/03/2022,India,Pulau Pinang,22,17,5
1/03/2022,India,Sabah,4,4,0
1/03/2022,India,Sarawak,6,5,1
1/03/2022,India,Selangor,4248,3182,1066
1/03/2022,India,Terengganu,0,0,0
1/03/2022,India,W.P. Labuan,0,0,0
1/03/2022, British Indian Ocean Territory,Pulau Pinang,0,0,0
1/03/2022, British Indian Ocean Territory,Selangor,0,0,0
1/03/2022,Ireland,Johor,0,0,0
1/03/2022,Ireland,Kedah,2,2,0
1/03/2022,Ireland,Kelantan,0,0,0
1/03/2022,Ireland,Negeri Sembilan,0,0,0
1/03/2022,Ireland,Pahang,0,0,0
1/03/2022,Ireland,Perak,0,0,0
1/03/2022,Ireland,Perlis,0,0,0
1/03/2022,Ireland,Pulau Pinang,0,0,0
1/03/2022,Ireland,Sabah,0,0,0
1/03/2022,Ireland,Sarawak,0,0,0
1/03/2022,Ireland,Selangor,71,52,19
1/03/2022,Ireland,Terengganu,0,0,0
1/03/2022,Ireland,W.P. Labuan,0,0,0
1/03/2022,"Iran, Islamic Republic of",Johor,0,0,0
1/03/2022,"Iran, Islamic Republic of",Kedah,0,0,0
1/03/2022,"Iran, Islamic Republic of",Kelantan,0,0,0
1/03/2022,"Iran, Islamic Republic of",Perak,0,0,0
1/03/2022,"Iran, Islamic Republic of",Perlis,0,0,0
1/03/2022,"Iran, Islamic Republic of",Pulau Pinang,0,0,0
1/03/2022,"Iran, Islamic Republic of",Sabah,0,0,0
1/03/2022,"Iran, Islamic Republic of",Sarawak,0,0,0
1/03/2022,"Iran, Islamic Republic of",Selangor,217,121,96
1/03/2022,"Iran, Islamic Republic of",W.P. Labuan,0,0,0
1/03/2022,Iraq,Johor,0,0,0
1/03/2022,Iraq,Kedah,0,0,0
1/03/2022,Iraq,Kelantan,0,0,0
1/03/2022,Iraq,Melaka,0,0,0
1/03/2022,Iraq,Pahang,0,0,0
1/03/2022,Iraq,Perak,0,0,0
1/03/2022,Iraq,Perlis,0,0,0
1/03/2022,Iraq,Pulau Pinang,0,0,0
1/03/2022,Iraq,Sabah,0,0,0
1/03/2022,Iraq,Sarawak,0,0,0
1/03/2022,Iraq,Selangor,228,151,77
1/03/2022,Iceland,Johor,0,0,0
1/03/2022,Iceland,Kedah,0,0,0
1/03/2022,Iceland,Kelantan,0,0,0
1/03/2022,Iceland,Perak,0,0,0
1/03/2022,Iceland,Perlis,0,0,0
1/03/2022,Iceland,Pulau Pinang,0,0,0
1/03/2022,Iceland,Sabah,0,0,0
1/03/2022,Iceland,Sarawak,0,0,0
1/03/2022,Iceland,Selangor,1,0,1
1/03/2022,Iceland,W.P. Labuan,0,0,0
1/03/2022,Israel,Pulau Pinang,0,0,0
1/03/2022,Italy,Johor,1,1,0
1/03/2022,Italy,Kedah,7,5,2
1/03/2022,Italy,Kelantan,0,0,0
1/03/2022,Italy,Melaka,0,0,0
1/03/2022,Italy,Negeri Sembilan,0,0,0
1/03/2022,Italy,Pahang,0,0,0
1/03/2022,Italy,Perak,0,0,0
1/03/2022,Italy,Perlis,0,0,0
1/03/2022,Italy,Pulau Pinang,4,4,0
1/03/2022,Italy,Sabah,0,0,0
1/03/2022,Italy,Sarawak,1,1,0
1/03/2022,Italy,Selangor,212,168,44
1/03/2022,Italy,W.P. Labuan,0,0,0
1/03/2022,Jamaica,Johor,0,0,0
1/03/2022,Jamaica,Kedah,0,0,0
1/03/2022,Jamaica,Perak,0,0,0
1/03/2022,Jamaica,Pulau Pinang,0,0,0
1/03/2022,Jamaica,Sabah,0,0,0
1/03/2022,Jamaica,Sarawak,0,0,0
1/03/2022,Jamaica,Selangor,2,1,1
1/03/2022,Jamaica,W.P. Labuan,0,0,0
1/03/2022,Jordan,Johor,0,0,0
1/03/2022,Jordan,Kedah,0,0,0
1/03/2022,Jordan,Kelantan,0,0,0
1/03/2022,Jordan,Melaka,0,0,0
1/03/2022,Jordan,Perlis,0,0,0
1/03/2022,Jordan,Pulau Pinang,0,0,0
1/03/2022,Jordan,Sabah,0,0,0
1/03/2022,Jordan,Sarawak,0,0,0
1/03/2022,Jordan,Selangor,71,51,20
1/03/2022,Jordan,W.P. Labuan,0,0,0
1/03/2022,Japan,Johor,6,3,3
1/03/2022,Japan,Kedah,8,2,6
1/03/2022,Japan,Kelantan,0,0,0
1/03/2022,Japan,Melaka,0,0,0
1/03/2022,Japan,Negeri Sembilan,0,0,0
1/03/2022,Japan,Pahang,0,0,0
1/03/2022,Japan,Perak,0,0,0
1/03/2022,Japan,Perlis,0,0,0
1/03/2022,Japan,Pulau Pinang,50,29,21
1/03/2022,Japan,Sabah,1,0,1
1/03/2022,Japan,Sarawak,17,14,3
1/03/2022,Japan,Selangor,1082,736,346
1/03/2022,Japan,W.P. Labuan,0,0,0
1/03/2022,Kazakhstan,Johor,0,0,0
1/03/2022,Kazakhstan,Kedah,0,0,0
1/03/2022,Kazakhstan,Kelantan,0,0,0
1/03/2022,Kazakhstan,Melaka,0,0,0
1/03/2022,Kazakhstan,Perak,0,0,0
1/03/2022,Kazakhstan,Perlis,0,0,0
1/03/2022,Kazakhstan,Pulau Pinang,0,0,0
1/03/2022,Kazakhstan,Sabah,0,0,0
1/03/2022,Kazakhstan,Sarawak,0,0,0
1/03/2022,Kazakhstan,Selangor,40,18,22
1/03/2022,Kazakhstan,W.P. Labuan,0,0,0
1/03/2022,Kenya,Johor,0,0,0
1/03/2022,Kenya,Kedah,0,0,0
1/03/2022,Kenya,Kelantan,0,0,0
1/03/2022,Kenya,Perak,0,0,0
1/03/2022,Kenya,Perlis,0,0,0
1/03/2022,Kenya,Pulau Pinang,0,0,0
1/03/2022,Kenya,Sabah,0,0,0
1/03/2022,Kenya,Sarawak,0,0,0
1/03/2022,Kenya,Selangor,46,19,27
1/03/2022,Kyrgyzstan,Johor,0,0,0
1/03/2022,Kyrgyzstan,Kedah,0,0,0
1/03/2022,Kyrgyzstan,Kelantan,0,0,0
1/03/2022,Kyrgyzstan,Perak,0,0,0
1/03/2022,Kyrgyzstan,Perlis,0,0,0
1/03/2022,Kyrgyzstan,Pulau Pinang,0,0,0
1/03/2022,Kyrgyzstan,Sabah,0,0,0
1/03/2022,Kyrgyzstan,Sarawak,0,0,0
1/03/2022,Kyrgyzstan,Selangor,25,17,8
1/03/2022,Cambodia,Johor,1,0,1
1/03/2022,Cambodia,Kedah,0,0,0
1/03/2022,Cambodia,Kelantan,0,0,0
1/03/2022,Cambodia,Melaka,0,0,0
1/03/2022,Cambodia,Negeri Sembilan,0,0,0
1/03/2022,Cambodia,Pahang,0,0,0
1/03/2022,Cambodia,Perak,0,0,0
1/03/2022,Cambodia,Perlis,0,0,0
1/03/2022,Cambodia,Pulau Pinang,0,0,0
1/03/2022,Cambodia,Sabah,0,0,0
1/03/2022,Cambodia,Sarawak,0,0,0
1/03/2022,Cambodia,Selangor,212,173,39
1/03/2022,Cambodia,W.P. Labuan,0,0,0
1/03/2022,Kiribati,Johor,0,0,0
1/03/2022,Kiribati,Sabah,0,0,0
1/03/2022,Kiribati,Selangor,0,0,0
1/03/2022,Saint Kitts and Nevis,Johor,0,0,0
1/03/2022,Saint Kitts and Nevis,Kedah,0,0,0
1/03/2022,Saint Kitts and Nevis,Perlis,0,0,0
1/03/2022,Saint Kitts and Nevis,Pulau Pinang,0,0,0
1/03/2022,Saint Kitts and Nevis,Sabah,0,0,0
1/03/2022,Saint Kitts and Nevis,Selangor,2,2,0
1/03/2022,Saint Kitts and Nevis,W.P. Labuan,0,0,0
1/03/2022,"Korea, Republic of",Johor,3,2,1
1/03/2022,"Korea, Republic of",Kedah,7,4,3
1/03/2022,"Korea, Republic of",Kelantan,0,0,0
1/03/2022,"Korea, Republic of",Melaka,0,0,0
1/03/2022,"Korea, Republic of",Negeri Sembilan,0,0,0
1/03/2022,"Korea, Republic of",Pahang,0,0,0
1/03/2022,"Korea, Republic of",Perak,0,0,0
1/03/2022,"Korea, Republic of",Perlis,0,0,0
1/03/2022,"Korea, Republic of",Pulau Pinang,15,11,4
1/03/2022,"Korea, Republic of",Sabah,5,2,3
1/03/2022,"Korea, Republic of",Sarawak,32,26,6
1/03/2022,"Korea, Republic of",Selangor,949,656,293
1/03/2022,"Korea, Republic of",Terengganu,0,0,0
1/03/2022,"Korea, Republic of",W.P. Labuan,0,0,0
1/03/2022,Kuwait,Johor,0,0,0
1/03/2022,Kuwait,Kedah,0,0,0
1/03/2022,Kuwait,Kelantan,0,0,0
1/03/2022,Kuwait,Perak,0,0,0
1/03/2022,Kuwait,Perlis,0,0,0
1/03/2022,Kuwait,Pulau Pinang,0,0,0
1/03/2022,Kuwait,Sabah,0,0,0
1/03/2022,Kuwait,Sarawak,0,0,0
1/03/2022,Kuwait,Selangor,19,12,7
1/03/2022,Kuwait,W.P. Labuan,0,0,0
1/03/2022, Lao People's Democratic Republic,Johor,0,0,0
1/03/2022, Lao People's Democratic Republic,Kedah,0,0,0
1/03/2022, Lao People's Democratic Republic,Kelantan,0,0,0
1/03/2022, Lao People's Democratic Republic,Melaka,0,0,0
1/03/2022, Lao People's Democratic Republic,Perak,0,0,0
1/03/2022, Lao People's Democratic Republic,Perlis,0,0,0
1/03/2022, Lao People's Democratic Republic,Pulau Pinang,0,0,0
1/03/2022, Lao People's Democratic Republic,Sabah,0,0,0
1/03/2022, Lao People's Democratic Republic,Sarawak,0,0,0
1/03/2022, Lao People's Democratic Republic,Selangor,117,114,3
1/03/2022, Lao People's Democratic Republic,W.P. Labuan,0,0,0
1/03/2022,Lebanon,Johor,0,0,0
1/03/2022,Lebanon,Kedah,1,0,1
1/03/2022,Lebanon,Kelantan,0,0,0
1/03/2022,Lebanon,Pahang,0,0,0
1/03/2022,Lebanon,Perak,0,0,0
1/03/2022,Lebanon,Perlis,0,0,0
1/03/2022,Lebanon,Pulau Pinang,0,0,0
1/03/2022,Lebanon,Sabah,0,0,0
1/03/2022,Lebanon,Sarawak,0,0,0
1/03/2022,Lebanon,Selangor,23,17,6
1/03/2022,Lebanon,W.P. Labuan,0,0,0
1/03/2022,Liberia,Johor,0,0,0
1/03/2022,Liberia,Kedah,0,0,0
1/03/2022,Liberia,Sabah,0,0,0
1/03/2022,Liberia,Sarawak,0,0,0
1/03/2022,Liberia,Selangor,2,2,0
1/03/2022,Libya,Johor,0,0,0
1/03/2022,Libya,Kedah,0,0,0
1/03/2022,Libya,Perlis,0,0,0
1/03/2022,Libya,Pulau Pinang,0,0,0
1/03/2022,Libya,Sabah,0,0,0
1/03/2022,Libya,Sarawak,0,0,0
1/03/2022,Libya,Selangor,188,122,66
1/03/2022,Saint Lucia,Johor,0,0,0
1/03/2022,Saint Lucia,Kedah,0,0,0
1/03/2022,Saint Lucia,Pulau Pinang,0,0,0
1/03/2022,Saint Lucia,Sarawak,0,0,0
1/03/2022,Saint Lucia,Selangor,1,1,0
1/03/2022,Liechtenstein,Johor,0,0,0
1/03/2022,Liechtenstein,Kedah,0,0,0
1/03/2022,Liechtenstein,Perlis,0,0,0
1/03/2022,Liechtenstein,Pulau Pinang,0,0,0
1/03/2022,Liechtenstein,Sabah,0,0,0
1/03/2022,Liechtenstein,Sarawak,0,0,0
1/03/2022,Liechtenstein,Selangor,0,0,0
1/03/2022,LKA,Johor,3,3,0
1/03/2022,LKA,Kedah,2,2,0
1/03/2022,LKA,Kelantan,0,0,0
1/03/2022,LKA,Melaka,0,0,0
1/03/2022,LKA,Pahang,0,0,0
1/03/2022,LKA,Perak,0,0,0
1/03/2022,LKA,Perlis,0,0,0
1/03/2022,LKA,Pulau Pinang,0,0,0
1/03/2022,LKA,Sabah,0,0,0
1/03/2022,LKA,Sarawak,2,1,1
1/03/2022,LKA,Selangor,353,203,150
1/03/2022,LKA,W.P. Labuan,0,0,0
1/03/2022,Lesotho,Johor,0,0,0
1/03/2022,Lesotho,Kedah,0,0,0
1/03/2022,Lesotho,Pulau Pinang,0,0,0
1/03/2022,Lesotho,Sarawak,0,0,0
1/03/2022,Lesotho,Selangor,4,1,3
1/03/2022,Lithuania,Johor,0,0,0
1/03/2022,Lithuania,Kedah,0,0,0
1/03/2022,Lithuania,Kelantan,0,0,0
1/03/2022,Lithuania,Pahang,0,0,0
1/03/2022,Lithuania,Perak,0,0,0
1/03/2022,Lithuania,Perlis,0,0,0
1/03/2022,Lithuania,Pulau Pinang,0,0,0
1/03/2022,Lithuania,Sabah,0,0,0
1/03/2022,Lithuania,Sarawak,0,0,0
1/03/2022,Lithuania,Selangor,19,13,6
1/03/2022,Lithuania,W.P. Labuan,0,0,0
1/03/2022,Luxembourg,Johor,0,0,0
1/03/2022,Luxembourg,Kedah,0,0,0
1/03/2022,Luxembourg,Kelantan,0,0,0
1/03/2022,Luxembourg,Perak,0,0,0
1/03/2022,Luxembourg,Perlis,0,0,0
1/03/2022,Luxembourg,Pulau Pinang,0,0,0
1/03/2022,Luxembourg,Sabah,0,0,0
1/03/2022,Luxembourg,Sarawak,0,0,0
1/03/2022,Luxembourg,Selangor,1,1,0
1/03/2022,Latvia,Johor,0,0,0
1/03/2022,Latvia,Kedah,0,0,0
1/03/2022,Latvia,Kelantan,0,0,0
1/03/2022,Latvia,Pahang,0,0,0
1/03/2022,Latvia,Perak,0,0,0
1/03/2022,Latvia,Perlis,0,0,0
1/03/2022,Latvia,Pulau Pinang,0,0,0
1/03/2022,Latvia,Sabah,0,0,0
1/03/2022,Latvia,Sarawak,0,0,0
1/03/2022,Latvia,Selangor,3,2,1
1/03/2022,Latvia,W.P. Labuan,0,0,0
1/03/2022,Macao,Johor,0,0,0
1/03/2022,Macao,Pahang,0,0,0
1/03/2022,Macao,Perak,0,0,0
1/03/2022,Macao,Selangor,0,0,0
1/03/2022,Macao,W.P. Labuan,0,0,0
1/03/2022,Morocco,Johor,0,0,0
1/03/2022,Morocco,Kedah,0,0,0
1/03/2022,Morocco,Kelantan,0,0,0
1/03/2022,Morocco,Melaka,0,0,0
1/03/2022,Morocco,Pahang,0,0,0
1/03/2022,Morocco,Perak,0,0,0
1/03/2022,Morocco,Perlis,0,0,0
1/03/2022,Morocco,Pulau Pinang,0,0,0
1/03/2022,Morocco,Sabah,0,0,0
1/03/2022,Morocco,Sarawak,0,0,0
1/03/2022,Morocco,Selangor,37,16,21
1/03/2022,Morocco,W.P. Labuan,0,0,0
1/03/2022,Monaco,Johor,0,0,0
1/03/2022,Monaco,Kedah,0,0,0
1/03/2022,Monaco,Sabah,0,0,0
1/03/2022,Monaco,Selangor,0,0,0
1/03/2022,"Moldova, Republic of",Johor,0,0,0
1/03/2022,"Moldova, Republic of",Kedah,0,0,0
1/03/2022,"Moldova, Republic of",Kelantan,0,0,0
1/03/2022,"Moldova, Republic of",Negeri Sembilan,0,0,0
1/03/2022,"Moldova, Republic of",Perlis,0,0,0
1/03/2022,"Moldova, Republic of",Pulau Pinang,0,0,0
1/03/2022,"Moldova, Republic of",Sabah,0,0,0
1/03/2022,"Moldova, Republic of",Sarawak,0,0,0
1/03/2022,"Moldova, Republic of",Selangor,0,0,0
1/03/2022,Madagascar,Johor,0,0,0
1/03/2022,Madagascar,Kedah,0,0,0
1/03/2022,Madagascar,Perak,0,0,0
1/03/2022,Madagascar,Perlis,0,0,0
1/03/2022,Madagascar,Pulau Pinang,0,0,0
1/03/2022,Madagascar,Sabah,0,0,0
1/03/2022,Madagascar,Sarawak,0,0,0
1/03/2022,Madagascar,Selangor,1,1,0
1/03/2022,Maldives,Johor,0,0,0
1/03/2022,Maldives,Kedah,26,14,12
1/03/2022,Maldives,Kelantan,0,0,0
1/03/2022,Maldives,Perak,0,0,0
1/03/2022,Maldives,Perlis,0,0,0
1/03/2022,Maldives,Pulau Pinang,0,0,0
1/03/2022,Maldives,Sabah,0,0,0
1/03/2022,Maldives,Sarawak,0,0,0
1/03/2022,Maldives,Selangor,211,115,96
1/03/2022,Mexico,Johor,0,0,0
1/03/2022,Mexico,Kedah,0,0,0
1/03/2022,Mexico,Kelantan,0,0,0
1/03/2022,Mexico,Pahang,0,0,0
1/03/2022,Mexico,Perak,0,0,0
1/03/2022,Mexico,Perlis,0,0,0
1/03/2022,Mexico,Pulau Pinang,0,0,0
1/03/2022,Mexico,Sabah,0,0,0
1/03/2022,Mexico,Sarawak,0,0,0
1/03/2022,Mexico,Selangor,24,14,10
1/03/2022,Mexico,W.P. Labuan,0,0,0
1/03/2022,Marshall Islands,Johor,0,0,0
1/03/2022,Marshall Islands,Kedah,0,0,0
1/03/2022,Marshall Islands,Perak,0,0,0
1/03/2022,Marshall Islands,Pulau Pinang,0,0,0
1/03/2022,Marshall Islands,Sabah,0,0,0
1/03/2022,Marshall Islands,Selangor,0,0,0
1/03/2022,North Macedonia,Johor,0,0,0
1/03/2022,North Macedonia,Kedah,0,0,0
1/03/2022,North Macedonia,Perak,0,0,0
1/03/2022,North Macedonia,Pulau Pinang,0,0,0
1/03/2022,North Macedonia,Sabah,0,0,0
1/03/2022,North Macedonia,Sarawak,0,0,0
1/03/2022,North Macedonia,Selangor,1,0,1
1/03/2022,Mali,Johor,0,0,0
1/03/2022,Mali,Sabah,0,0,0
1/03/2022,Mali,Selangor,2,1,1
1/03/2022,Malta,Johor,0,0,0
1/03/2022,Malta,Kedah,0,0,0
1/03/2022,Malta,Kelantan,0,0,0
1/03/2022,Malta,Perak,0,0,0
1/03/2022,Malta,Perlis,0,0,0
1/03/2022,Malta,Pulau Pinang,0,0,0
1/03/2022,Malta,Sabah,0,0,0
1/03/2022,Malta,Sarawak,0,0,0
1/03/2022,Malta,Selangor,1,0,1
1/03/2022,Malta,W.P. Labuan,0,0,0
1/03/2022,Myanmar,Johor,24,23,1
1/03/2022,Myanmar,Kedah,0,0,0
1/03/2022,Myanmar,Kelantan,0,0,0
1/03/2022,Myanmar,Negeri Sembilan,0,0,0
1/03/2022,Myanmar,Pahang,0,0,0
1/03/2022,Myanmar,Perak,0,0,0
1/03/2022,Myanmar,Perlis,0,0,0
1/03/2022,Myanmar,Pulau Pinang,1,1,0
1/03/2022,Myanmar,Sabah,0,0,0
1/03/2022,Myanmar,Sarawak,0,0,0
1/03/2022,Myanmar,Selangor,425,348,77
1/03/2022,Myanmar,Terengganu,0,0,0
1/03/2022,Myanmar,W.P. Labuan,0,0,0
1/03/2022,Montenegro,Johor,0,0,0
1/03/2022,Montenegro,Kedah,0,0,0
1/03/2022,Montenegro,Pulau Pinang,0,0,0
1/03/2022,Montenegro,Sabah,0,0,0
1/03/2022,Montenegro,Sarawak,0,0,0
1/03/2022,Montenegro,Selangor,5,4,1
1/03/2022,Mongolia,Johor,0,0,0
1/03/2022,Mongolia,Kedah,0,0,0
1/03/2022,Mongolia,Kelantan,0,0,0
1/03/2022,Mongolia,Perak,0,0,0
1/03/2022,Mongolia,Perlis,0,0,0
1/03/2022,Mongolia,Pulau Pinang,0,0,0
1/03/2022,Mongolia,Sabah,0,0,0
1/03/2022,Mongolia,Sarawak,0,0,0
1/03/2022,Mongolia,Selangor,14,3,11
1/03/2022,Northern Mariana Islands,Selangor,0,0,0
1/03/2022,Mozambique,Johor,0,0,0
1/03/2022,Mozambique,Kedah,0,0,0
1/03/2022,Mozambique,Perak,0,0,0
1/03/2022,Mozambique,Pulau Pinang,0,0,0
1/03/2022,Mozambique,Sabah,0,0,0
1/03/2022,Mozambique,Sarawak,0,0,0
1/03/2022,Mozambique,Selangor,12,5,7
1/03/2022,Mauritania,Johor,0,0,0
1/03/2022,Mauritania,Kedah,0,0,0
1/03/2022,Mauritania,Pulau Pinang,0,0,0
1/03/2022,Mauritania,Sabah,0,0,0
1/03/2022,Mauritania,Sarawak,0,0,0
1/03/2022,Mauritania,Selangor,2,2,0
1/03/2022,Mauritius,Johor,0,0,0
1/03/2022,Mauritius,Kedah,0,0,0
1/03/2022,Mauritius,Kelantan,0,0,0
1/03/2022,Mauritius,Pahang,0,0,0
1/03/2022,Mauritius,Perak,0,0,0
1/03/2022,Mauritius,Perlis,0,0,0
1/03/2022,Mauritius,Pulau Pinang,0,0,0
1/03/2022,Mauritius,Sabah,0,0,0
1/03/2022,Mauritius,Sarawak,0,0,0
1/03/2022,Mauritius,Selangor,43,25,18
1/03/2022,Malawi,Johor,0,0,0
1/03/2022,Malawi,Pulau Pinang,0,0,0
1/03/2022,Malawi,Sabah,0,0,0
1/03/2022,Malawi,Sarawak,0,0,0
1/03/2022,Malawi,Selangor,7,4,3
1/03/2022,Mayotte,Selangor,0,0,0
1/03/2022,Namibia,Johor,0,0,0
1/03/2022,Namibia,Kedah,0,0,0
1/03/2022,Namibia,Perak,0,0,0
1/03/2022,Namibia,Perlis,0,0,0
1/03/2022,Namibia,Pulau Pinang,0,0,0
1/03/2022,Namibia,Sabah,0,0,0
1/03/2022,Namibia,Sarawak,0,0,0
1/03/2022,Namibia,Selangor,1,1,0
1/03/2022,New Caledonia,Selangor,0,0,0
1/03/2022,Niger,Johor,0,0,0
1/03/2022,Niger,Sabah,0,0,0
1/03/2022,Niger,Selangor,0,0,0
1/03/2022,Nigeria,Johor,0,0,0
1/03/2022,Nigeria,Kedah,0,0,0
1/03/2022,Nigeria,Perlis,0,0,0
1/03/2022,Nigeria,Pulau Pinang,1,1,0
1/03/2022,Nigeria,Sabah,0,0,0
1/03/2022,Nigeria,Sarawak,0,0,0
1/03/2022,Nigeria,Selangor,290,234,56
1/03/2022,Nicaragua,Johor,0,0,0
1/03/2022,Nicaragua,Kedah,0,0,0
1/03/2022,Nicaragua,Pulau Pinang,0,0,0
1/03/2022,Nicaragua,Sabah,0,0,0
1/03/2022,Nicaragua,Selangor,2,2,0
1/03/2022,Netherlands,Johor,1,1,0
1/03/2022,Netherlands,Kedah,6,3,3
1/03/2022,Netherlands,Kelantan,0,0,0
1/03/2022,Netherlands,Melaka,0,0,0
1/03/2022,Netherlands,Negeri Sembilan,0,0,0
1/03/2022,Netherlands,Pahang,0,0,0
1/03/2022,Netherlands,Perak,0,0,0
1/03/2022,Netherlands,Perlis,0,0,0
1/03/2022,Netherlands,Pulau Pinang,4,2,2
1/03/2022,Netherlands,Sabah,0,0,0
1/03/2022,Netherlands,Sarawak,1,1,0
1/03/2022,Netherlands,Selangor,252,198,54
1/03/2022,Netherlands,Terengganu,0,0,0
1/03/2022,Netherlands,W.P. Labuan,0,0,0
1/03/2022,Norway,Johor,0,0,0
1/03/2022,Norway,Kedah,0,0,0
1/03/2022,Norway,Kelantan,0,0,0
1/03/2022,Norway,Melaka,0,0,0
1/03/2022,Norway,Pahang,0,0,0
1/03/2022,Norway,Perak,0,0,0
1/03/2022,Norway,Perlis,0,0,0
1/03/2022,Norway,Pulau Pinang,5,2,3
1/03/2022,Norway,Sabah,0,0,0
1/03/2022,Norway,Sarawak,0,0,0
1/03/2022,Norway,Selangor,50,44,6
1/03/2022,Norway,W.P. Labuan,0,0,0
1/03/2022,Nepal,Johor,0,0,0
1/03/2022,Nepal,Kedah,0,0,0
1/03/2022,Nepal,Pahang,0,0,0
1/03/2022,Nepal,Perak,0,0,0
1/03/2022,Nepal,Perlis,0,0,0
1/03/2022,Nepal,Pulau Pinang,3,3,0
1/03/2022,Nepal,Sabah,0,0,0
1/03/2022,Nepal,Sarawak,0,0,0
1/03/2022,Nepal,Selangor,830,809,21
1/03/2022,Nepal,W.P. Labuan,0,0,0
1/03/2022,Nauru,Johor,0,0,0
1/03/2022,Nauru,Pulau Pinang,0,0,0
1/03/2022,Nauru,Selangor,0,0,0
1/03/2022,New Zealand,Johor,0,0,0
1/03/2022,New Zealand,Kedah,11,7,4
1/03/2022,New Zealand,Kelantan,0,0,0
1/03/2022,New Zealand,Melaka,0,0,0
1/03/2022,New Zealand,Negeri Sembilan,0,0,0
1/03/2022,New Zealand,Pahang,0,0,0
1/03/2022,New Zealand,Perak,0,0,0
1/03/2022,New Zealand,Perlis,0,0,0
1/03/2022,New Zealand,Pulau Pinang,10,7,3
1/03/2022,New Zealand,Sabah,0,0,0
1/03/2022,New Zealand,Sarawak,0,0,0
1/03/2022,New Zealand,Selangor,91,62,29
1/03/2022,New Zealand,Terengganu,0,0,0
1/03/2022,New Zealand,W.P. Labuan,0,0,0
1/03/2022,Oman,Johor,0,0,0
1/03/2022,Oman,Kedah,0,0,0
1/03/2022,Oman,Kelantan,0,0,0
1/03/2022,Oman,Melaka,0,0,0
1/03/2022,Oman,Perak,0,0,0
1/03/2022,Oman,Perlis,0,0,0
1/03/2022,Oman,Pulau Pinang,0,0,0
1/03/2022,Oman,Sabah,0,0,0
1/03/2022,Oman,Sarawak,0,0,0
1/03/2022,Oman,Selangor,74,62,12
1/03/2022,Pakistan,Johor,0,0,0
1/03/2022,Pakistan,Kedah,0,0,0
1/03/2022,Pakistan,Kelantan,0,0,0
1/03/2022,Pakistan,Melaka,0,0,0
1/03/2022,Pakistan,Negeri Sembilan,0,0,0
1/03/2022,Pakistan,Pahang,0,0,0
1/03/2022,Pakistan,Perak,0,0,0
1/03/2022,Pakistan,Perlis,0,0,0
1/03/2022,Pakistan,Pulau Pinang,0,0,0
1/03/2022,Pakistan,Sabah,0,0,0
1/03/2022,Pakistan,Sarawak,1,1,0
1/03/2022,Pakistan,Selangor,3137,2815,322
1/03/2022,Pakistan,W.P. Labuan,0,0,0
1/03/2022,Panama,Johor,0,0,0
1/03/2022,Panama,Kedah,0,0,0
1/03/2022,Panama,Perak,0,0,0
1/03/2022,Panama,Perlis,0,0,0
1/03/2022,Panama,Pulau Pinang,0,0,0
1/03/2022,Panama,Sabah,0,0,0
1/03/2022,Panama,Sarawak,0,0,0
1/03/2022,Panama,Selangor,1,1,0
1/03/2022,Peru,Johor,0,0,0
1/03/2022,Peru,Kedah,0,0,0
1/03/2022,Peru,Kelantan,0,0,0
1/03/2022,Peru,Pahang,0,0,0
1/03/2022,Peru,Perak,0,0,0
1/03/2022,Peru,Perlis,0,0,0
1/03/2022,Peru,Pulau Pinang,0,0,0
1/03/2022,Peru,Sabah,0,0,0
1/03/2022,Peru,Sarawak,0,0,0
1/03/2022,Peru,Selangor,5,4,1
1/03/2022,Peru,W.P. Labuan,0,0,0
1/03/2022,Philippines,Johor,223,212,11
1/03/2022,Philippines,Kedah,6,0,6
1/03/2022,Philippines,Kelantan,0,0,0
1/03/2022,Philippines,Melaka,0,0,0
1/03/2022,Philippines,Negeri Sembilan,0,0,0
1/03/2022,Philippines,Pahang,0,0,0
1/03/2022,Philippines,Perak,0,0,0
1/03/2022,Philippines,Perlis,0,0,0
1/03/2022,Philippines,Pulau Pinang,22,7,15
1/03/2022,Philippines,Sabah,2,1,1
1/03/2022,Philippines,Sarawak,23,20,3
1/03/2022,Philippines,Selangor,1594,927,667
1/03/2022,Philippines,Terengganu,0,0,0
1/03/2022,Philippines,W.P. Labuan,8,8,0
1/03/2022,Palau,Johor,0,0,0
1/03/2022,Palau,Pulau Pinang,0,0,0
1/03/2022,Palau,Selangor,0,0,0
1/03/2022,Papua New Guinea,Johor,0,0,0
1/03/2022,Papua New Guinea,Kedah,0,0,0
1/03/2022,Papua New Guinea,Kelantan,0,0,0
1/03/2022,Papua New Guinea,Perak,0,0,0
1/03/2022,Papua New Guinea,Pulau Pinang,0,0,0
1/03/2022,Papua New Guinea,Sabah,0,0,0
1/03/2022,Papua New Guinea,Sarawak,0,0,0
1/03/2022,Papua New Guinea,Selangor,3,3,0
1/03/2022,Poland,Johor,1,1,0
1/03/2022,Poland,Kedah,3,0,3
1/03/2022,Poland,Kelantan,0,0,0
1/03/2022,Poland,Melaka,0,0,0
1/03/2022,Poland,Negeri Sembilan,0,0,0
1/03/2022,Poland,Pahang,0,0,0
1/03/2022,Poland,Perak,0,0,0
1/03/2022,Poland,Perlis,0,0,0
1/03/2022,Poland,Pulau Pinang,1,1,0
1/03/2022,Poland,Sabah,0,0,0
1/03/2022,Poland,Sarawak,1,1,0
1/03/2022,Poland,Selangor,64,47,17
1/03/2022,Poland,Terengganu,0,0,0
1/03/2022,Poland,W.P. Labuan,0,0,0
1/03/2022,"North Korea, Democratic People's Republic of",Selangor,0,0,0
1/03/2022,Portugal,Johor,0,0,0
1/03/2022,Portugal,Kedah,1,1,0
1/03/2022,Portugal,Kelantan,0,0,0
1/03/2022,Portugal,Melaka,0,0,0
1/03/2022,Portugal,Pahang,0,0,0
1/03/2022,Portugal,Perak,0,0,0
1/03/2022,Portugal,Perlis,0,0,0
1/03/2022,Portugal,Pulau Pinang,1,1,0
1/03/2022,Portugal,Sabah,0,0,0
1/03/2022,Portugal,Sarawak,0,0,0
1/03/2022,Portugal,Selangor,40,25,15
1/03/2022,Portugal,W.P. Labuan,0,0,0
1/03/2022,Paraguay,Johor,0,0,0
1/03/2022,Paraguay,Kedah,0,0,0
1/03/2022,Paraguay,Perak,0,0,0
1/03/2022,Paraguay,Perlis,0,0,0
1/03/2022,Paraguay,Pulau Pinang,0,0,0
1/03/2022,Paraguay,Sabah,0,0,0
1/03/2022,Paraguay,Sarawak,0,0,0
1/03/2022,Paraguay,Selangor,1,0,1
1/03/2022,"Palestine, State of",Johor,0,0,0
1/03/2022,"Palestine, State of",Kedah,0,0,0
1/03/2022,"Palestine, State of",Kelantan,0,0,0
1/03/2022,"Palestine, State of",Melaka,0,0,0
1/03/2022,"Palestine, State of",Perak,0,0,0
1/03/2022,"Palestine, State of",Perlis,0,0,0
1/03/2022,"Palestine, State of",Pulau Pinang,0,0,0
1/03/2022,"Palestine, State of",Sabah,0,0,0
1/03/2022,"Palestine, State of",Sarawak,0,0,0
1/03/2022,"Palestine, State of",Selangor,76,55,21
1/03/2022,Qatar,Johor,0,0,0
1/03/2022,Qatar,Kedah,0,0,0
1/03/2022,Qatar,Perlis,0,0,0
1/03/2022,Qatar,Pulau Pinang,0,0,0
1/03/2022,Qatar,Sabah,0,0,0
1/03/2022,Qatar,Sarawak,0,0,0
1/03/2022,Qatar,Selangor,14,14,0
1/03/2022,Réunion,Johor,0,0,0
1/03/2022,Réunion,Sarawak,0,0,0
1/03/2022,Romania,Johor,2,2,0
1/03/2022,Romania,Kedah,1,0,1
1/03/2022,Romania,Kelantan,0,0,0
1/03/2022,Romania,Negeri Sembilan,0,0,0
1/03/2022,Romania,Pahang,0,0,0
1/03/2022,Romania,Perak,0,0,0
1/03/2022,Romania,Perlis,0,0,0
1/03/2022,Romania,Pulau Pinang,0,0,0
1/03/2022,Romania,Sabah,0,0,0
1/03/2022,Romania,Sarawak,0,0,0
1/03/2022,Romania,Selangor,33,27,6
1/03/2022,Romania,W.P. Labuan,0,0,0
1/03/2022,Russian Federation (Russia),Johor,5,5,0
1/03/2022,Russian Federation (Russia),Kedah,3,2,1
1/03/2022,Russian Federation (Russia),Kelantan,0,0,0
1/03/2022,Russian Federation (Russia),Melaka,0,0,0
1/03/2022,Russian Federation (Russia),Negeri Sembilan,0,0,0
1/03/2022,Russian Federation (Russia),Pahang,0,0,0
1/03/2022,Russian Federation (Russia),Perak,0,0,0
1/03/2022,Russian Federation (Russia),Perlis,0,0,0
1/03/2022,Russian Federation (Russia),Pulau Pinang,1,0,1
1/03/2022,Russian Federation (Russia),Sabah,0,0,0
1/03/2022,Russian Federation (Russia),Sarawak,0,0,0
1/03/2022,Russian Federation (Russia),Selangor,218,137,81
1/03/2022,Russian Federation (Russia),W.P. Labuan,0,0,0
1/03/2022,Rwanda,Johor,0,0,0
1/03/2022,Rwanda,Kedah,0,0,0
1/03/2022,Rwanda,Pulau Pinang,0,0,0
1/03/2022,Rwanda,Selangor,4,3,1
1/03/2022,Saudi Arabia,Johor,0,0,0
1/03/2022,Saudi Arabia,Kedah,0,0,0
1/03/2022,Saudi Arabia,Kelantan,0,0,0
1/03/2022,Saudi Arabia,Melaka,0,0,0
1/03/2022,Saudi Arabia,Perak,0,0,0
1/03/2022,Saudi Arabia,Perlis,0,0,0
1/03/2022,Saudi Arabia,Pulau Pinang,0,0,0
1/03/2022,Saudi Arabia,Sabah,0,0,0
1/03/2022,Saudi Arabia,Sarawak,0,0,0
1/03/2022,Saudi Arabia,Selangor,318,212,106
1/03/2022,Saudi Arabia,W.P. Labuan,0,0,0
1/03/2022,Sudan,Johor,0,0,0
1/03/2022,Sudan,Kedah,1,1,0
1/03/2022,Sudan,Kelantan,0,0,0
1/03/2022,Sudan,Perlis,0,0,0
1/03/2022,Sudan,Pulau Pinang,0,0,0
1/03/2022,Sudan,Sabah,0,0,0
1/03/2022,Sudan,Sarawak,0,0,0
1/03/2022,Sudan,Selangor,217,131,86
1/03/2022,Sudan,W.P. Labuan,1,1,0
1/03/2022,Senegal,Johor,0,0,0
1/03/2022,Senegal,Kedah,0,0,0
1/03/2022,Senegal,Kelantan,0,0,0
1/03/2022,Senegal,Perak,0,0,0
1/03/2022,Senegal,Perlis,0,0,0
1/03/2022,Senegal,Pulau Pinang,0,0,0
1/03/2022,Senegal,Sabah,0,0,0
1/03/2022,Senegal,Sarawak,0,0,0
1/03/2022,Senegal,Selangor,11,7,4
1/03/2022,Singapore,Johor,6932,3759,3173
1/03/2022,Singapore,Kedah,23,11,12
1/03/2022,Singapore,Kelantan,0,0,0
1/03/2022,Singapore,Melaka,0,0,0
1/03/2022,Singapore,Negeri Sembilan,0,0,0
1/03/2022,Singapore,Pahang,0,0,0
1/03/2022,Singapore,Perak,6,5,1
1/03/2022,Singapore,Perlis,0,0,0
1/03/2022,Singapore,Pulau Pinang,1061,555,506
1/03/2022,Singapore,Sabah,2,1,1
1/03/2022,Singapore,Sarawak,39,19,20
1/03/2022,Singapore,Selangor,8282,4891,3391
1/03/2022,Singapore,Terengganu,0,0,0
1/03/2022,Singapore,W.P. Labuan,0,0,0
1/03/2022,South Georgia and the South Sandwich Islands,Johor,0,0,0
1/03/2022,South Georgia and the South Sandwich Islands,Sabah,0,0,0
1/03/2022,South Georgia and the South Sandwich Islands,Selangor,0,0,0
1/03/2022,Saint Helena,Sarawak,0,0,0
1/03/2022,Solomon Islands,Johor,0,0,0
1/03/2022,Solomon Islands,Perlis,0,0,0
1/03/2022,Solomon Islands,Pulau Pinang,0,0,0
1/03/2022,Solomon Islands,Sabah,0,0,0
1/03/2022,Solomon Islands,Sarawak,0,0,0
1/03/2022,Solomon Islands,Selangor,2,0,2
1/03/2022,Solomon Islands,W.P. Labuan,0,0,0
1/03/2022,Sierra Leone,Johor,0,0,0
1/03/2022,Sierra Leone,Kedah,0,0,0
1/03/2022,Sierra Leone,Perak,0,0,0
1/03/2022,Sierra Leone,Pulau Pinang,0,0,0
1/03/2022,Sierra Leone,Sabah,0,0,0
1/03/2022,Sierra Leone,Selangor,1,1,0
1/03/2022,El Salvador,Johor,0,0,0
1/03/2022,El Salvador,Kedah,0,0,0
1/03/2022,El Salvador,Perak,0,0,0
1/03/2022,El Salvador,Perlis,0,0,0
1/03/2022,El Salvador,Pulau Pinang,0,0,0
1/03/2022,El Salvador,Sabah,0,0,0
1/03/2022,El Salvador,Selangor,0,0,0
1/03/2022,El Salvador,W.P. Labuan,0,0,0
1/03/2022,San Marino,Johor,0,0,0
1/03/2022,San Marino,Selangor,0,0,0
1/03/2022,Somalia,Johor,0,0,0
1/03/2022,Somalia,Kedah,0,0,0
1/03/2022,Somalia,Kelantan,0,0,0
1/03/2022,Somalia,Perlis,0,0,0
1/03/2022,Somalia,Sabah,0,0,0
1/03/2022,Somalia,Sarawak,0,0,0
1/03/2022,Somalia,Selangor,94,70,24
1/03/2022,Serbia,Johor,0,0,0
1/03/2022,Serbia,Kedah,0,0,0
1/03/2022,Serbia,Kelantan,0,0,0
1/03/2022,Serbia,Pahang,0,0,0
1/03/2022,Serbia,Perak,0,0,0
1/03/2022,Serbia,Perlis,0,0,0
1/03/2022,Serbia,Pulau Pinang,0,0,0
1/03/2022,Serbia,Sabah,0,0,0
1/03/2022,Serbia,Sarawak,0,0,0
1/03/2022,Serbia,Selangor,14,11,3
1/03/2022,South Sudan,Johor,0,0,0
1/03/2022,South Sudan,Kedah,0,0,0
1/03/2022,South Sudan,Sarawak,0,0,0
1/03/2022,South Sudan,Selangor,7,1,6
1/03/2022,South Sudan,W.P. Labuan,0,0,0
1/03/2022,Sao Tome and Principe,Selangor,0,0,0
1/03/2022,Suriname,Johor,0,0,0
1/03/2022,Suriname,Kedah,0,0,0
1/03/2022,Suriname,Kelantan,0,0,0
1/03/2022,Suriname,Perak,0,0,0
1/03/2022,Suriname,Perlis,0,0,0
1/03/2022,Suriname,Pulau Pinang,0,0,0
1/03/2022,Suriname,Sabah,0,0,0
1/03/2022,Suriname,Sarawak,0,0,0
1/03/2022,Suriname,Selangor,0,0,0
1/03/2022,Slovakia,Johor,0,0,0
1/03/2022,Slovakia,Kedah,0,0,0
1/03/2022,Slovakia,Kelantan,0,0,0
1/03/2022,Slovakia,Negeri Sembilan,0,0,0
1/03/2022,Slovakia,Pahang,0,0,0
1/03/2022,Slovakia,Perak,0,0,0
1/03/2022,Slovakia,Perlis,0,0,0
1/03/2022,Slovakia,Pulau Pinang,0,0,0
1/03/2022,Slovakia,Sabah,0,0,0
1/03/2022,Slovakia,Sarawak,0,0,0
1/03/2022,Slovakia,Selangor,44,25,19
1/03/2022,Slovakia,W.P. Labuan,0,0,0
1/03/2022,Slovenia,Johor,0,0,0
1/03/2022,Slovenia,Kedah,0,0,0
1/03/2022,Slovenia,Kelantan,0,0,0
1/03/2022,Slovenia,Perak,0,0,0
1/03/2022,Slovenia,Perlis,0,0,0
1/03/2022,Slovenia,Pulau Pinang,0,0,0
1/03/2022,Slovenia,Sabah,0,0,0
1/03/2022,Slovenia,Sarawak,0,0,0
1/03/2022,Slovenia,Selangor,3,2,1
1/03/2022,Slovenia,W.P. Labuan,0,0,0
1/03/2022,Sweden,Johor,0,0,0
1/03/2022,Sweden,Kedah,0,0,0
1/03/2022,Sweden,Kelantan,0,0,0
1/03/2022,Sweden,Melaka,0,0,0
1/03/2022,Sweden,Negeri Sembilan,0,0,0
1/03/2022,Sweden,Pahang,0,0,0
1/03/2022,Sweden,Perak,0,0,0
1/03/2022,Sweden,Perlis,0,0,0
1/03/2022,Sweden,Pulau Pinang,0,0,0
1/03/2022,Sweden,Sabah,0,0,0
1/03/2022,Sweden,Sarawak,0,0,0
1/03/2022,Sweden,Selangor,92,72,20
1/03/2022,Sweden,W.P. Labuan,0,0,0
1/03/2022,Eswatini,Johor,0,0,0
1/03/2022,Eswatini,Kedah,0,0,0
1/03/2022,Eswatini,Pulau Pinang,0,0,0
1/03/2022,Eswatini,Sabah,0,0,0
1/03/2022,Eswatini,Selangor,15,5,10
1/03/2022,Seychelles,Johor,0,0,0
1/03/2022,Seychelles,Kedah,0,0,0
1/03/2022,Seychelles,Pulau Pinang,0,0,0
1/03/2022,Seychelles,Sabah,0,0,0
1/03/2022,Seychelles,Sarawak,1,1,0
1/03/2022,Seychelles,Selangor,17,4,13
1/03/2022,Syrian Arab Republic,Johor,0,0,0
1/03/2022,Syrian Arab Republic,Kedah,0,0,0
1/03/2022,Syrian Arab Republic,Kelantan,0,0,0
1/03/2022,Syrian Arab Republic,Pahang,0,0,0
1/03/2022,Syrian Arab Republic,Perlis,0,0,0
1/03/2022,Syrian Arab Republic,Pulau Pinang,0,0,0
1/03/2022,Syrian Arab Republic,Sabah,0,0,0
1/03/2022,Syrian Arab Republic,Sarawak,0,0,0
1/03/2022,Syrian Arab Republic,Selangor,132,81,51
1/03/2022,Syrian Arab Republic,W.P. Labuan,0,0,0
1/03/2022,Turks and Caicos Islands,Perlis,0,0,0
1/03/2022,TCD,Johor,0,0,0
1/03/2022,TCD,Kedah,0,0,0
1/03/2022,TCD,Perlis,0,0,0
1/03/2022,TCD,Selangor,10,9,1
1/03/2022,Togo,Johor,0,0,0
1/03/2022,Togo,Perak,0,0,0
1/03/2022,Togo,Pulau Pinang,0,0,0
1/03/2022,Togo,Selangor,1,1,0
1/03/2022,Thailand,Johor,69,67,2
1/03/2022,Thailand,Kedah,19836,19768,68
1/03/2022,Thailand,Kelantan,12,12,0
1/03/2022,Thailand,Melaka,0,0,0
1/03/2022,Thailand,Negeri Sembilan,0,0,0
1/03/2022,Thailand,Pahang,0,0,0
1/03/2022,Thailand,Perak,0,0,0
1/03/2022,Thailand,Perlis,10164,10007,157
1/03/2022,Thailand,Pulau Pinang,97,92,5
1/03/2022,Thailand,Sabah,2,0,2
1/03/2022,Thailand,Sarawak,20,20,0
1/03/2022,Thailand,Selangor,927,414,513
1/03/2022,Thailand,Terengganu,0,0,0
1/03/2022,Thailand,W.P. Labuan,0,0,0
1/03/2022,Tajikistan,Johor,0,0,0
1/03/2022,Tajikistan,Kedah,0,0,0
1/03/2022,Tajikistan,Perlis,0,0,0
1/03/2022,Tajikistan,Pulau Pinang,0,0,0
1/03/2022,Tajikistan,Sabah,0,0,0
1/03/2022,Tajikistan,Selangor,3,2,1
1/03/2022,Tokelau,Selangor,0,0,0
1/03/2022,Turkmenistan,Johor,0,0,0
1/03/2022,Turkmenistan,Kedah,0,0,0
1/03/2022,Turkmenistan,Kelantan,0,0,0
1/03/2022,Turkmenistan,Perlis,0,0,0
1/03/2022,Turkmenistan,Pulau Pinang,0,0,0
1/03/2022,Turkmenistan,Sabah,0,0,0
1/03/2022,Turkmenistan,Sarawak,0,0,0
1/03/2022,Turkmenistan,Selangor,10,5,5
1/03/2022,Timor-Leste,Johor,0,0,0
1/03/2022,Timor-Leste,Kedah,0,0,0
1/03/2022,Timor-Leste,Perlis,0,0,0
1/03/2022,Timor-Leste,Pulau Pinang,0,0,0
1/03/2022,Timor-Leste,Sabah,0,0,0
1/03/2022,Timor-Leste,Sarawak,0,0,0
1/03/2022,Timor-Leste,Selangor,23,10,13
1/03/2022,Tonga,Johor,0,0,0
1/03/2022,Tonga,Pulau Pinang,0,0,0
1/03/2022,Tonga,Sarawak,0,0,0
1/03/2022,Tonga,Selangor,1,1,0
1/03/2022,Trinidad and Tobago,Johor,0,0,0
1/03/2022,Trinidad and Tobago,Kedah,0,0,0
1/03/2022,Trinidad and Tobago,Pahang,0,0,0
1/03/2022,Trinidad and Tobago,Pulau Pinang,0,0,0
1/03/2022,Trinidad and Tobago,Sabah,0,0,0
1/03/2022,Trinidad and Tobago,Sarawak,0,0,0
1/03/2022,Trinidad and Tobago,Selangor,5,4,1
1/03/2022,Tunisia,Johor,0,0,0
1/03/2022,Tunisia,Kedah,0,0,0
1/03/2022,Tunisia,Kelantan,0,0,0
1/03/2022,Tunisia,Melaka,0,0,0
1/03/2022,Tunisia,Perak,0,0,0
1/03/2022,Tunisia,Perlis,0,0,0
1/03/2022,Tunisia,Pulau Pinang,0,0,0
1/03/2022,Tunisia,Sabah,1,1,0
1/03/2022,Tunisia,Sarawak,0,0,0
1/03/2022,Tunisia,Selangor,19,5,14
1/03/2022,Tunisia,W.P. Labuan,0,0,0
1/03/2022,Türkiye,Johor,6,4,2
1/03/2022,Türkiye,Kedah,2,2,0
1/03/2022,Türkiye,Kelantan,0,0,0
1/03/2022,Türkiye,Melaka,0,0,0
1/03/2022,Türkiye,Negeri Sembilan,0,0,0
1/03/2022,Türkiye,Pahang,0,0,0
1/03/2022,Türkiye,Perak,0,0,0
1/03/2022,Türkiye,Perlis,0,0,0
1/03/2022,Türkiye,Pulau Pinang,0,0,0
1/03/2022,Türkiye,Sabah,0,0,0
1/03/2022,Türkiye,Sarawak,0,0,0
1/03/2022,Türkiye,Selangor,270,212,58
1/03/2022,Türkiye,W.P. Labuan,0,0,0
1/03/2022,Tuvalu,Selangor,0,0,0
1/03/2022,"Taiwan, Province of China",Johor,6,4,2
1/03/2022,"Taiwan, Province of China",Kedah,4,3,1
1/03/2022,"Taiwan, Province of China",Kelantan,0,0,0
1/03/2022,"Taiwan, Province of China",Melaka,0,0,0
1/03/2022,"Taiwan, Province of China",Negeri Sembilan,0,0,0
1/03/2022,"Taiwan, Province of China",Pahang,0,0,0
1/03/2022,"Taiwan, Province of China",Perak,0,0,0
1/03/2022,"Taiwan, Province of China",Perlis,0,0,0
1/03/2022,"Taiwan, Province of China",Pulau Pinang,36,28,8
1/03/2022,"Taiwan, Province of China",Sabah,0,0,0
1/03/2022,"Taiwan, Province of China",Sarawak,1,1,0
1/03/2022,"Taiwan, Province of China",Selangor,228,137,91
1/03/2022,"Taiwan, Province of China",W.P. Labuan,0,0,0
1/03/2022,"Tanzania, United Republic of",Johor,0,0,0
1/03/2022,"Tanzania, United Republic of",Kedah,0,0,0
1/03/2022,"Tanzania, United Republic of",Perak,0,0,0
1/03/2022,"Tanzania, United Republic of",Perlis,0,0,0
1/03/2022,"Tanzania, United Republic of",Pulau Pinang,0,0,0
1/03/2022,"Tanzania, United Republic of",Sabah,0,0,0
1/03/2022,"Tanzania, United Republic of",Sarawak,0,0,0
1/03/2022,"Tanzania, United Republic of",Selangor,43,26,17
1/03/2022,Uganda,Johor,0,0,0
1/03/2022,Uganda,Kedah,0,0,0
1/03/2022,Uganda,Perak,0,0,0
1/03/2022,Uganda,Perlis,0,0,0
1/03/2022,Uganda,Pulau Pinang,0,0,0
1/03/2022,Uganda,Sabah,0,0,0
1/03/2022,Uganda,Sarawak,0,0,0
1/03/2022,Uganda,Selangor,20,17,3
1/03/2022,Ukraine,Johor,11,11,0
1/03/2022,Ukraine,Kedah,0,0,0
1/03/2022,Ukraine,Kelantan,0,0,0
1/03/2022,Ukraine,Melaka,0,0,0
1/03/2022,Ukraine,Negeri Sembilan,0,0,0
1/03/2022,Ukraine,Pahang,0,0,0
1/03/2022,Ukraine,Perak,0,0,0
1/03/2022,Ukraine,Perlis,0,0,0
1/03/2022,Ukraine,Pulau Pinang,0,0,0
1/03/2022,Ukraine,Sabah,0,0,0
1/03/2022,Ukraine,Sarawak,1,1,0
1/03/2022,Ukraine,Selangor,40,20,20
1/03/2022,Ukraine,W.P. Labuan,0,0,0
1/03/2022,Uruguay,Johor,0,0,0
1/03/2022,Uruguay,Kedah,0,0,0
1/03/2022,Uruguay,Kelantan,0,0,0
1/03/2022,Uruguay,Perak,0,0,0
1/03/2022,Uruguay,Perlis,0,0,0
1/03/2022,Uruguay,Pulau Pinang,0,0,0
1/03/2022,Uruguay,Sabah,0,0,0
1/03/2022,Uruguay,Sarawak,0,0,0
1/03/2022,Uruguay,Selangor,1,1,0
1/03/2022,Uruguay,W.P. Labuan,0,0,0
1/03/2022,United States of America,Johor,4,2,2
1/03/2022,United States of America,Kedah,37,22,15
1/03/2022,United States of America,Kelantan,0,0,0
1/03/2022,United States of America,Melaka,0,0,0
1/03/2022,United States of America,Negeri Sembilan,0,0,0
1/03/2022,United States of America,Pahang,0,0,0
1/03/2022,United States of America,Perak,0,0,0
1/03/2022,United States of America,Perlis,0,0,0
1/03/2022,United States of America,Pulau Pinang,58,35,23
1/03/2022,United States of America,Sabah,1,1,0
1/03/2022,United States of America,Sarawak,4,4,0
1/03/2022,United States of America,Selangor,823,569,254
1/03/2022,United States of America,Terengganu,0,0,0
1/03/2022,United States of America,W.P. Labuan,0,0,0
1/03/2022,Uzbekistan,Johor,0,0,0
1/03/2022,Uzbekistan,Kedah,0,0,0
1/03/2022,Uzbekistan,Kelantan,0,0,0
1/03/2022,Uzbekistan,Perak,0,0,0
1/03/2022,Uzbekistan,Perlis,0,0,0
1/03/2022,Uzbekistan,Pulau Pinang,0,0,0
1/03/2022,Uzbekistan,Sabah,0,0,0
1/03/2022,Uzbekistan,Sarawak,1,1,0
1/03/2022,Uzbekistan,Selangor,23,19,4
1/03/2022,Holy See,Johor,0,0,0
1/03/2022,Holy See,Sarawak,0,0,0
1/03/2022,Holy See,Selangor,0,0,0
1/03/2022,Saint Vincent and the Grenadines,Johor,0,0,0
1/03/2022,Saint Vincent and the Grenadines,Kedah,0,0,0
1/03/2022,Saint Vincent and the Grenadines,Pulau Pinang,0,0,0
1/03/2022,Saint Vincent and the Grenadines,Sarawak,0,0,0
1/03/2022,Saint Vincent and the Grenadines,Selangor,0,0,0
1/03/2022,"Venezuela, Bolivarian Republic of",Johor,0,0,0
1/03/2022,"Venezuela, Bolivarian Republic of",Kedah,0,0,0
1/03/2022,"Venezuela, Bolivarian Republic of",Kelantan,0,0,0
1/03/2022,"Venezuela, Bolivarian Republic of",Melaka,0,0,0
1/03/2022,"Venezuela, Bolivarian Republic of",Perak,0,0,0
1/03/2022,"Venezuela, Bolivarian Republic of",Perlis,0,0,0
1/03/2022,"Venezuela, Bolivarian Republic of",Pulau Pinang,0,0,0
1/03/2022,"Venezuela, Bolivarian Republic of",Sabah,0,0,0
1/03/2022,"Venezuela, Bolivarian Republic of",Sarawak,0,0,0
1/03/2022,"Venezuela, Bolivarian Republic of",Selangor,14,10,4
1/03/2022,"Venezuela, Bolivarian Republic of",W.P. Labuan,0,0,0
1/03/2022,Viet Nam,Johor,5,0,5
1/03/2022,Viet Nam,Kedah,62,6,56
1/03/2022,Viet Nam,Kelantan,0,0,0
1/03/2022,Viet Nam,Melaka,0,0,0
1/03/2022,Viet Nam,Negeri Sembilan,0,0,0
1/03/2022,Viet Nam,Pahang,0,0,0
1/03/2022,Viet Nam,Perak,0,0,0
1/03/2022,Viet Nam,Perlis,0,0,0
1/03/2022,Viet Nam,Pulau Pinang,18,4,14
1/03/2022,Viet Nam,Sabah,0,0,0
1/03/2022,Viet Nam,Sarawak,4,0,4
1/03/2022,Viet Nam,Selangor,774,235,539
1/03/2022,Viet Nam,Terengganu,0,0,0
1/03/2022,Viet Nam,W.P. Labuan,0,0,0
1/03/2022,Vanuatu,Johor,0,0,0
1/03/2022,Vanuatu,Kedah,0,0,0
1/03/2022,Vanuatu,Pulau Pinang,0,0,0
1/03/2022,Vanuatu,Sabah,0,0,0
1/03/2022,Vanuatu,Sarawak,0,0,0
1/03/2022,Vanuatu,Selangor,3,3,0
1/03/2022, Samoa,Johor,0,0,0
1/03/2022, Samoa,Sarawak,0,0,0
1/03/2022, Samoa,Selangor,0,0,0
1/03/2022,Yemen,Johor,0,0,0
1/03/2022,Yemen,Kedah,1,1,0
1/03/2022,Yemen,Kelantan,0,0,0
1/03/2022,Yemen,Melaka,0,0,0
1/03/2022,Yemen,Pahang,0,0,0
1/03/2022,Yemen,Perak,0,0,0
1/03/2022,Yemen,Perlis,0,0,0
1/03/2022,Yemen,Pulau Pinang,0,0,0
1/03/2022,Yemen,Sabah,0,0,0
1/03/2022,Yemen,Sarawak,0,0,0
1/03/2022,Yemen,Selangor,359,258,101
1/03/2022,Yemen,W.P. Labuan,0,0,0
1/03/2022,South Africa,Johor,0,0,0
1/03/2022,South Africa,Kedah,1,0,1
1/03/2022,South Africa,Kelantan,0,0,0
1/03/2022,South Africa,Melaka,0,0,0
1/03/2022,South Africa,Pahang,0,0,0
1/03/2022,South Africa,Perak,0,0,0
1/03/2022,South Africa,Perlis,0,0,0
1/03/2022,South Africa,Pulau Pinang,1,0,1
1/03/2022,South Africa,Sabah,0,0,0
1/03/2022,South Africa,Sarawak,0,0,0
1/03/2022,South Africa,Selangor,95,64,31
1/03/2022,South Africa,Terengganu,0,0,0
1/03/2022,South Africa,W.P. Labuan,0,0,0
1/03/2022,ZAR,Selangor,0,0,0
1/03/2022,Zambia,Johor,0,0,0
1/03/2022,Zambia,Kedah,0,0,0
1/03/2022,Zambia,Perak,0,0,0
1/03/2022,Zambia,Perlis,0,0,0
1/03/2022,Zambia,Pulau Pinang,0,0,0
1/03/2022,Zambia,Sabah,0,0,0
1/03/2022,Zambia,Sarawak,0,0,0
1/03/2022,Zambia,Selangor,24,13,11
1/03/2022,Zimbabwe,Johor,0,0,0
1/03/2022,Zimbabwe,Kedah,0,0,0
1/03/2022,Zimbabwe,Kelantan,0,0,0
1/03/2022,Zimbabwe,Perak,0,0,0
1/03/2022,Zimbabwe,Perlis,0,0,0
1/03/2022,Zimbabwe,Pulau Pinang,0,0,0
1/03/2022,Zimbabwe,Sabah,0,0,0
1/03/2022,Zimbabwe,Sarawak,0,0,0
1/03/2022,Zimbabwe,Selangor,26,8,18
1/04/2022,Aruba,Kedah,1,0,1
1/04/2022,Aruba,Pulau Pinang,0,0,0
1/04/2022,Afghanistan,Johor,0,0,0
1/04/2022,Afghanistan,Kedah,0,0,0
1/04/2022,Afghanistan,Perlis,0,0,0
1/04/2022,Afghanistan,Pulau Pinang,0,0,0
1/04/2022,Afghanistan,Sarawak,0,0,0
1/04/2022,Afghanistan,Selangor,103,78,25
1/04/2022,Angola,Johor,0,0,0
1/04/2022,Angola,Kedah,0,0,0
1/04/2022,Angola,Sabah,0,0,0
1/04/2022,Angola,Selangor,3,2,1
1/04/2022,Anguilla,Selangor,0,0,0
1/04/2022,Albania,Johor,3,2,1
1/04/2022,Albania,Kedah,0,0,0
1/04/2022,Albania,Perak,0,0,0
1/04/2022,Albania,Perlis,0,0,0
1/04/2022,Albania,Pulau Pinang,0,0,0
1/04/2022,Albania,Sabah,0,0,0
1/04/2022,Albania,Sarawak,0,0,0
1/04/2022,Albania,Selangor,16,9,7
1/04/2022,Andorra,Johor,0,0,0
1/04/2022,Andorra,Kedah,0,0,0
1/04/2022,Andorra,Perlis,0,0,0
1/04/2022,Andorra,Pulau Pinang,0,0,0
1/04/2022,Andorra,Selangor,2,2,0
1/04/2022,Antigua and Barbuda,Selangor,0,0,0
1/04/2022,United Arab Emirates,Johor,4,3,1
1/04/2022,United Arab Emirates,Kedah,0,0,0
1/04/2022,United Arab Emirates,Kelantan,0,0,0
1/04/2022,United Arab Emirates,Perak,0,0,0
1/04/2022,United Arab Emirates,Perlis,0,0,0
1/04/2022,United Arab Emirates,Pulau Pinang,0,0,0
1/04/2022,United Arab Emirates,Sabah,0,0,0
1/04/2022,United Arab Emirates,Sarawak,0,0,0
1/04/2022,United Arab Emirates,Selangor,61,35,26
1/04/2022,Argentina,Johor,20,20,0
1/04/2022,Argentina,Kedah,0,0,0
1/04/2022,Argentina,Kelantan,0,0,0
1/04/2022,Argentina,Melaka,0,0,0
1/04/2022,Argentina,Perak,0,0,0
1/04/2022,Argentina,Perlis,0,0,0
1/04/2022,Argentina,Pulau Pinang,0,0,0
1/04/2022,Argentina,Sabah,0,0,0
1/04/2022,Argentina,Sarawak,1,1,0
1/04/2022,Argentina,Selangor,79,51,28
1/04/2022,Argentina,W.P. Labuan,0,0,0
1/04/2022,Armenia,Johor,4,2,2
1/04/2022,Armenia,Kedah,0,0,0
1/04/2022,Armenia,Kelantan,0,0,0
1/04/2022,Armenia,Perak,0,0,0
1/04/2022,Armenia,Perlis,0,0,0
1/04/2022,Armenia,Pulau Pinang,0,0,0
1/04/2022,Armenia,Sabah,0,0,0
1/04/2022,Armenia,Sarawak,0,0,0
1/04/2022,Armenia,Selangor,6,1,5
1/04/2022,Antarctica,Selangor,1,0,1
1/04/2022,Antigua and Barbuda,Johor,0,0,0
1/04/2022,Antigua and Barbuda,Kedah,0,0,0
1/04/2022,Antigua and Barbuda,Pulau Pinang,0,0,0
1/04/2022,Antigua and Barbuda,Sarawak,0,0,0
1/04/2022,Antigua and Barbuda,Selangor,7,5,2
1/04/2022,Australia,Johor,1385,872,513
1/04/2022,Australia,Kedah,180,104,76
1/04/2022,Australia,Kelantan,0,0,0
1/04/2022,Australia,Melaka,0,0,0
1/04/2022,Australia,Negeri Sembilan,0,0,0
1/04/2022,Australia,Pahang,1,1,0
1/04/2022,Australia,Perak,58,29,29
1/04/2022,Australia,Perlis,0,0,0
1/04/2022,Australia,Pulau Pinang,507,288,219
1/04/2022,Australia,Sabah,38,19,19
1/04/2022,Australia,Sarawak,72,38,34
1/04/2022,Australia,Selangor,4906,2956,1950
1/04/2022,Australia,Terengganu,1,1,0
1/04/2022,Australia,W.P. Labuan,0,0,0
1/04/2022,Austria,Johor,61,36,25
1/04/2022,Austria,Kedah,8,4,4
1/04/2022,Austria,Kelantan,0,0,0
1/04/2022,Austria,Melaka,0,0,0
1/04/2022,Austria,Negeri Sembilan,0,0,0
1/04/2022,Austria,Pahang,0,0,0
1/04/2022,Austria,Perak,1,0,1
1/04/2022,Austria,Perlis,0,0,0
1/04/2022,Austria,Pulau Pinang,19,17,2
1/04/2022,Austria,Sabah,7,4,3
1/04/2022,Austria,Sarawak,2,2,0
1/04/2022,Austria,Selangor,236,168,68
1/04/2022,Austria,Terengganu,0,0,0
1/04/2022,Austria,W.P. Labuan,0,0,0
1/04/2022,Azerbaijan,Johor,2,2,0
1/04/2022,Azerbaijan,Kedah,0,0,0
1/04/2022,Azerbaijan,Kelantan,0,0,0
1/04/2022,Azerbaijan,Melaka,0,0,0
1/04/2022,Azerbaijan,Perlis,0,0,0
1/04/2022,Azerbaijan,Pulau Pinang,0,0,0
1/04/2022,Azerbaijan,Sabah,0,0,0
1/04/2022,Azerbaijan,Sarawak,0,0,0
1/04/2022,Azerbaijan,Selangor,19,14,5
1/04/2022,Azerbaijan,W.P. Labuan,0,0,0
1/04/2022,Burundi,Pulau Pinang,0,0,0
1/04/2022,Burundi,Sarawak,0,0,0
1/04/2022,Burundi,Selangor,6,3,3
1/04/2022,Belgium,Johor,67,49,18
1/04/2022,Belgium,Kedah,6,1,5
1/04/2022,Belgium,Kelantan,0,0,0
1/04/2022,Belgium,Melaka,0,0,0
1/04/2022,Belgium,Negeri Sembilan,0,0,0
1/04/2022,Belgium,Pahang,0,0,0
1/04/2022,Belgium,Perak,1,1,0
1/04/2022,Belgium,Perlis,0,0,0
1/04/2022,Belgium,Pulau Pinang,19,13,6
1/04/2022,Belgium,Sabah,5,2,3
1/04/2022,Belgium,Sarawak,1,1,0
1/04/2022,Belgium,Selangor,228,156,72
1/04/2022,Belgium,W.P. Labuan,0,0,0
1/04/2022,Benin,Johor,0,0,0
1/04/2022,Benin,Kedah,0,0,0
1/04/2022,Benin,Perak,0,0,0
1/04/2022,Benin,Pulau Pinang,0,0,0
1/04/2022,Benin,Sabah,0,0,0
1/04/2022,Benin,Sarawak,0,0,0
1/04/2022,Benin,Selangor,1,1,0
1/04/2022,Burkina Faso,Perak,0,0,0
1/04/2022,Burkina Faso,Pulau Pinang,0,0,0
1/04/2022,Burkina Faso,Selangor,0,0,0
1/04/2022,Bangladesh,Johor,289,247,42
1/04/2022,Bangladesh,Kedah,0,0,0
1/04/2022,Bangladesh,Kelantan,0,0,0
1/04/2022,Bangladesh,Melaka,0,0,0
1/04/2022,Bangladesh,Negeri Sembilan,0,0,0
1/04/2022,Bangladesh,Pahang,0,0,0
1/04/2022,Bangladesh,Perak,0,0,0
1/04/2022,Bangladesh,Perlis,0,0,0
1/04/2022,Bangladesh,Pulau Pinang,7,7,0
1/04/2022,Bangladesh,Sabah,0,0,0
1/04/2022,Bangladesh,Sarawak,2,2,0
1/04/2022,Bangladesh,Selangor,8825,8242,583
1/04/2022,Bangladesh,W.P. Labuan,0,0,0
1/04/2022,Bulgaria,Johor,25,19,6
1/04/2022,Bulgaria,Kedah,4,2,2
1/04/2022,Bulgaria,Kelantan,0,0,0
1/04/2022,Bulgaria,Pahang,0,0,0
1/04/2022,Bulgaria,Perak,0,0,0
1/04/2022,Bulgaria,Perlis,0,0,0
1/04/2022,Bulgaria,Pulau Pinang,2,1,1
1/04/2022,Bulgaria,Sabah,0,0,0
1/04/2022,Bulgaria,Sarawak,0,0,0
1/04/2022,Bulgaria,Selangor,45,29,16
1/04/2022,Bulgaria,W.P. Labuan,0,0,0
1/04/2022,Bahrain,Johor,0,0,0
1/04/2022,Bahrain,Kedah,0,0,0
1/04/2022,Bahrain,Kelantan,0,0,0
1/04/2022,Bahrain,Perlis,0,0,0
1/04/2022,Bahrain,Pulau Pinang,0,0,0
1/04/2022,Bahrain,Sabah,0,0,0
1/04/2022,Bahrain,Sarawak,0,0,0
1/04/2022,Bahrain,Selangor,17,13,4
1/04/2022,Bahamas,Johor,0,0,0
1/04/2022,Bahamas,Kedah,0,0,0
1/04/2022,Bahamas,Perak,0,0,0
1/04/2022,Bahamas,Sabah,0,0,0
1/04/2022,Bahamas,Sarawak,0,0,0
1/04/2022,Bahamas,Selangor,2,0,2
1/04/2022,Bosnia and Herzegovina,Johor,1,1,0
1/04/2022,Bosnia and Herzegovina,Kedah,0,0,0
1/04/2022,Bosnia and Herzegovina,Perlis,0,0,0
1/04/2022,Bosnia and Herzegovina,Pulau Pinang,0,0,0
1/04/2022,Bosnia and Herzegovina,Sabah,0,0,0
1/04/2022,Bosnia and Herzegovina,Sarawak,0,0,0
1/04/2022,Bosnia and Herzegovina,Selangor,23,12,11
1/04/2022,Belarus,Johor,5,1,4
1/04/2022,Belarus,Kedah,2,0,2
1/04/2022,Belarus,Kelantan,0,0,0
1/04/2022,Belarus,Pahang,0,0,0
1/04/2022,Belarus,Perak,0,0,0
1/04/2022,Belarus,Perlis,0,0,0
1/04/2022,Belarus,Pulau Pinang,1,1,0
1/04/2022,Belarus,Sabah,0,0,0
1/04/2022,Belarus,Sarawak,0,0,0
1/04/2022,Belarus,Selangor,45,24,21
1/04/2022,Belarus,W.P. Labuan,0,0,0
1/04/2022,Belize,Johor,0,0,0
1/04/2022,Belize,Pulau Pinang,0,0,0
1/04/2022,Belize,Sarawak,0,0,0
1/04/2022,Belize,Selangor,2,1,1
1/04/2022,Bermuda,Selangor,0,0,0
1/04/2022,Bolivia,Johor,0,0,0
1/04/2022,Bolivia,Kedah,0,0,0
1/04/2022,Bolivia,Melaka,0,0,0
1/04/2022,Bolivia,Perak,0,0,0
1/04/2022,Bolivia,Perlis,0,0,0
1/04/2022,Bolivia,Pulau Pinang,0,0,0
1/04/2022,Bolivia,Sabah,0,0,0
1/04/2022,Bolivia,Sarawak,0,0,0
1/04/2022,Bolivia,Selangor,2,1,1
1/04/2022,Brazil,Johor,113,62,51
1/04/2022,Brazil,Kedah,15,5,10
1/04/2022,Brazil,Kelantan,0,0,0
1/04/2022,Brazil,Melaka,0,0,0
1/04/2022,Brazil,Pahang,0,0,0
1/04/2022,Brazil,Perak,0,0,0
1/04/2022,Brazil,Perlis,0,0,0
1/04/2022,Brazil,Pulau Pinang,7,4,3
1/04/2022,Brazil,Sabah,3,1,2
1/04/2022,Brazil,Sarawak,0,0,0
1/04/2022,Brazil,Selangor,223,130,93
1/04/2022,Brazil,W.P. Labuan,0,0,0
1/04/2022,Barbados,Johor,0,0,0
1/04/2022,Barbados,Kedah,0,0,0
1/04/2022,Barbados,Perlis,0,0,0
1/04/2022,Barbados,Pulau Pinang,0,0,0
1/04/2022,Barbados,Selangor,2,1,1
1/04/2022,Brunei Darussalam,Johor,36,20,16
1/04/2022,Brunei Darussalam,Kedah,0,0,0
1/04/2022,Brunei Darussalam,Kelantan,0,0,0
1/04/2022,Brunei Darussalam,Melaka,0,0,0
1/04/2022,Brunei Darussalam,Pahang,0,0,0
1/04/2022,Brunei Darussalam,Perak,0,0,0
1/04/2022,Brunei Darussalam,Perlis,0,0,0
1/04/2022,Brunei Darussalam,Pulau Pinang,0,0,0
1/04/2022,Brunei Darussalam,Sabah,1,0,1
1/04/2022,Brunei Darussalam,Sarawak,593,553,40
1/04/2022,Brunei Darussalam,Selangor,605,325,280
1/04/2022,Brunei Darussalam,W.P. Labuan,12,9,3
1/04/2022,Bhutan,Johor,0,0,0
1/04/2022,Bhutan,Kedah,0,0,0
1/04/2022,Bhutan,Perak,0,0,0
1/04/2022,Bhutan,Perlis,0,0,0
1/04/2022,Bhutan,Pulau Pinang,0,0,0
1/04/2022,Bhutan,Sabah,0,0,0
1/04/2022,Bhutan,Sarawak,0,0,0
1/04/2022,Bhutan,Selangor,3,1,2
1/04/2022,Botswana,Johor,0,0,0
1/04/2022,Botswana,Kedah,0,0,0
1/04/2022,Botswana,Perlis,0,0,0
1/04/2022,Botswana,Pulau Pinang,0,0,0
1/04/2022,Botswana,Sabah,0,0,0
1/04/2022,Botswana,Sarawak,0,0,0
1/04/2022,Botswana,Selangor,4,1,3
1/04/2022,Central African Republic,Kedah,0,0,0
1/04/2022,Central African Republic,Selangor,0,0,0
1/04/2022,Canada,Johor,423,266,157
1/04/2022,Canada,Kedah,22,11,11
1/04/2022,Canada,Kelantan,0,0,0
1/04/2022,Canada,Melaka,0,0,0
1/04/2022,Canada,Negeri Sembilan,0,0,0
1/04/2022,Canada,Pahang,0,0,0
1/04/2022,Canada,Perak,3,2,1
1/04/2022,Canada,Perlis,0,0,0
1/04/2022,Canada,Pulau Pinang,74,44,30
1/04/2022,Canada,Sabah,10,5,5
1/04/2022,Canada,Sarawak,11,8,3
1/04/2022,Canada,Selangor,1066,665,401
1/04/2022,Canada,Terengganu,0,0,0
1/04/2022,Canada,W.P. Labuan,0,0,0
1/04/2022,Cocos (Keeling) Islands,Selangor,0,0,0
1/04/2022,Switzerland,Johor,121,80,41
1/04/2022,Switzerland,Kedah,11,6,5
1/04/2022,Switzerland,Kelantan,0,0,0
1/04/2022,Switzerland,Melaka,0,0,0
1/04/2022,Switzerland,Negeri Sembilan,0,0,0
1/04/2022,Switzerland,Pahang,0,0,0
1/04/2022,Switzerland,Perak,2,2,0
1/04/2022,Switzerland,Perlis,0,0,0
1/04/2022,Switzerland,Pulau Pinang,41,29,12
1/04/2022,Switzerland,Sabah,4,3,1
1/04/2022,Switzerland,Sarawak,5,1,4
1/04/2022,Switzerland,Selangor,385,245,140
1/04/2022,Switzerland,W.P. Labuan,0,0,0
1/04/2022,Chile,Johor,7,5,2
1/04/2022,Chile,Kedah,0,0,0
1/04/2022,Chile,Kelantan,0,0,0
1/04/2022,Chile,Melaka,0,0,0
1/04/2022,Chile,Pahang,0,0,0
1/04/2022,Chile,Perak,0,0,0
1/04/2022,Chile,Perlis,0,0,0
1/04/2022,Chile,Pulau Pinang,0,0,0
1/04/2022,Chile,Sabah,0,0,0
1/04/2022,Chile,Sarawak,0,0,0
1/04/2022,Chile,Selangor,39,30,9
1/04/2022,China,Johor,3993,1819,2174
1/04/2022,China,Kedah,39,19,20
1/04/2022,China,Kelantan,0,0,0
1/04/2022,China,Melaka,0,0,0
1/04/2022,China,Pahang,5,0,5
1/04/2022,China,Perak,23,14,9
1/04/2022,China,Perlis,0,0,0
1/04/2022,China,Pulau Pinang,170,72,98
1/04/2022,China,Sabah,51,21,30
1/04/2022,China,Sarawak,63,50,13
1/04/2022,China,Selangor,5200,3512,1688
1/04/2022,China,Terengganu,0,0,0
1/04/2022,China,W.P. Labuan,1,0,1
1/04/2022,Côte d'Ivoire,Johor,0,0,0
1/04/2022,Côte d'Ivoire,Kedah,0,0,0
1/04/2022,Côte d'Ivoire,Pulau Pinang,0,0,0
1/04/2022,Côte d'Ivoire,Sabah,0,0,0
1/04/2022,Côte d'Ivoire,Sarawak,0,0,0
1/04/2022,Côte d'Ivoire,Selangor,3,0,3
1/04/2022,Cameroon,Johor,0,0,0
1/04/2022,Cameroon,Kedah,0,0,0
1/04/2022,Cameroon,Pulau Pinang,1,1,0
1/04/2022,Cameroon,Sabah,0,0,0
1/04/2022,Cameroon,Sarawak,0,0,0
1/04/2022,Cameroon,Selangor,7,5,2
1/04/2022,Congo,Johor,0,0,0
1/04/2022,Congo,Pulau Pinang,0,0,0
1/04/2022,Congo,Sarawak,0,0,0
1/04/2022,Congo,Selangor,2,2,0
1/04/2022,Congo,Johor,0,0,0
1/04/2022,Congo,Kedah,0,0,0
1/04/2022,Congo,Selangor,1,1,0
1/04/2022,Cook Islands,Selangor,0,0,0
1/04/2022,Colombia,Johor,15,4,11
1/04/2022,Colombia,Kedah,0,0,0
1/04/2022,Colombia,Perak,0,0,0
1/04/2022,Colombia,Pulau Pinang,3,1,2
1/04/2022,Colombia,Sabah,0,0,0
1/04/2022,Colombia,Sarawak,0,0,0
1/04/2022,Colombia,Selangor,34,17,17
1/04/2022,Colombia,W.P. Labuan,0,0,0
1/04/2022,Comoros,Johor,0,0,0
1/04/2022,Comoros,Kedah,0,0,0
1/04/2022,Comoros,Selangor,13,6,7
1/04/2022,Cabo Verde,Johor,0,0,0
1/04/2022,Cabo Verde,Kedah,0,0,0
1/04/2022,Cabo Verde,Pulau Pinang,0,0,0
1/04/2022,Cabo Verde,Sabah,0,0,0
1/04/2022,Cabo Verde,Selangor,2,0,2
1/04/2022,Costa Rica,Johor,2,1,1
1/04/2022,Costa Rica,Kedah,0,0,0
1/04/2022,Costa Rica,Perak,0,0,0
1/04/2022,Costa Rica,Perlis,0,0,0
1/04/2022,Costa Rica,Pulau Pinang,1,0,1
1/04/2022,Costa Rica,Sabah,0,0,0
1/04/2022,Costa Rica,Sarawak,0,0,0
1/04/2022,Costa Rica,Selangor,18,9,9
1/04/2022,Cuba,Johor,0,0,0
1/04/2022,Cuba,Kedah,0,0,0
1/04/2022,Cuba,Perlis,0,0,0
1/04/2022,Cuba,Pulau Pinang,0,0,0
1/04/2022,Cuba,Sabah,0,0,0
1/04/2022,Cuba,Sarawak,0,0,0
1/04/2022,Cuba,Selangor,5,4,1
1/04/2022,Cyprus,Johor,5,4,1
1/04/2022,Cyprus,Kedah,0,0,0
1/04/2022,Cyprus,Perak,0,0,0
1/04/2022,Cyprus,Perlis,0,0,0
1/04/2022,Cyprus,Pulau Pinang,1,1,0
1/04/2022,Cyprus,Sabah,0,0,0
1/04/2022,Cyprus,Sarawak,0,0,0
1/04/2022,Cyprus,Selangor,7,6,1
1/04/2022,Czechia,Johor,40,27,13
1/04/2022,Czechia,Kedah,9,7,2
1/04/2022,Czechia,Kelantan,0,0,0
1/04/2022,Czechia,Melaka,0,0,0
1/04/2022,Czechia,Negeri Sembilan,0,0,0
1/04/2022,Czechia,Perak,0,0,0
1/04/2022,Czechia,Perlis,0,0,0
1/04/2022,Czechia,Pulau Pinang,10,5,5
1/04/2022,Czechia,Sabah,1,0,1
1/04/2022,Czechia,Sarawak,0,0,0
1/04/2022,Czechia,Selangor,95,63,32
1/04/2022,Czechia,W.P. Labuan,0,0,0
1/04/2022,Germany,Johor,645,472,173
1/04/2022,Germany,Kedah,60,36,24
1/04/2022,Germany,Kelantan,0,0,0
1/04/2022,Germany,Melaka,0,0,0
1/04/2022,Germany,Negeri Sembilan,2,1,1
1/04/2022,Germany,Pahang,0,0,0
1/04/2022,Germany,Perak,8,6,2
1/04/2022,Germany,Perlis,0,0,0
1/04/2022,Germany,Pulau Pinang,205,139,66
1/04/2022,Germany,Sabah,39,24,15
1/04/2022,Germany,Sarawak,11,9,2
1/04/2022,Germany,Selangor,1826,1326,500
1/04/2022,Germany,Terengganu,0,0,0
1/04/2022,Germany,W.P. Labuan,0,0,0
1/04/2022,Djibouti,Johor,0,0,0
1/04/2022,Djibouti,Selangor,6,3,3
1/04/2022,Dominica,Johor,0,0,0
1/04/2022,Dominica,Kedah,0,0,0
1/04/2022,Dominica,Pulau Pinang,0,0,0
1/04/2022,Dominica,Sabah,0,0,0
1/04/2022,Dominica,Sarawak,0,0,0
1/04/2022,Dominica,Selangor,14,11,3
1/04/2022,Dominica,W.P. Labuan,0,0,0
1/04/2022,Denmark,Johor,97,67,30
1/04/2022,Denmark,Kedah,18,14,4
1/04/2022,Denmark,Kelantan,0,0,0
1/04/2022,Denmark,Melaka,0,0,0
1/04/2022,Denmark,Negeri Sembilan,0,0,0
1/04/2022,Denmark,Pahang,0,0,0
1/04/2022,Denmark,Perak,1,1,0
1/04/2022,Denmark,Perlis,0,0,0
1/04/2022,Denmark,Pulau Pinang,28,20,8
1/04/2022,Denmark,Sabah,0,0,0
1/04/2022,Denmark,Sarawak,2,2,0
1/04/2022,Denmark,Selangor,373,254,119
1/04/2022,Denmark,W.P. Labuan,0,0,0
1/04/2022,Dominican Republic,Johor,0,0,0
1/04/2022,Dominican Republic,Kedah,0,0,0
1/04/2022,Dominican Republic,Perak,0,0,0
1/04/2022,Dominican Republic,Perlis,0,0,0
1/04/2022,Dominican Republic,Pulau Pinang,0,0,0
1/04/2022,Dominican Republic,Sabah,0,0,0
1/04/2022,Dominican Republic,Sarawak,0,0,0
1/04/2022,Dominican Republic,Selangor,0,0,0
1/04/2022,Algeria,Johor,5,5,0
1/04/2022,Algeria,Kedah,2,2,0
1/04/2022,Algeria,Kelantan,0,0,0
1/04/2022,Algeria,Melaka,0,0,0
1/04/2022,Algeria,Perak,0,0,0
1/04/2022,Algeria,Perlis,0,0,0
1/04/2022,Algeria,Pulau Pinang,0,0,0
1/04/2022,Algeria,Sabah,0,0,0
1/04/2022,Algeria,Sarawak,0,0,0
1/04/2022,Algeria,Selangor,112,80,32
1/04/2022,Algeria,W.P. Labuan,0,0,0
1/04/2022,Ecuador,Johor,5,1,4
1/04/2022,Ecuador,Kedah,0,0,0
1/04/2022,Ecuador,Perak,0,0,0
1/04/2022,Ecuador,Perlis,0,0,0
1/04/2022,Ecuador,Pulau Pinang,0,0,0
1/04/2022,Ecuador,Sabah,0,0,0
1/04/2022,Ecuador,Sarawak,0,0,0
1/04/2022,Ecuador,Selangor,23,15,8
1/04/2022,Egypt,Johor,37,35,2
1/04/2022,Egypt,Kedah,1,1,0
1/04/2022,Egypt,Kelantan,0,0,0
1/04/2022,Egypt,Melaka,0,0,0
1/04/2022,Egypt,Pahang,0,0,0
1/04/2022,Egypt,Perak,0,0,0
1/04/2022,Egypt,Perlis,0,0,0
1/04/2022,Egypt,Pulau Pinang,2,2,0
1/04/2022,Egypt,Sabah,0,0,0
1/04/2022,Egypt,Sarawak,0,0,0
1/04/2022,Egypt,Selangor,608,420,188
1/04/2022,Egypt,Terengganu,0,0,0
1/04/2022,Egypt,W.P. Labuan,0,0,0
1/04/2022,Eritrea,Johor,0,0,0
1/04/2022,Eritrea,Pulau Pinang,0,0,0
1/04/2022,Eritrea,Sabah,0,0,0
1/04/2022,Eritrea,Selangor,9,6,3
1/04/2022,Spain,Johor,115,68,47
1/04/2022,Spain,Kedah,17,9,8
1/04/2022,Spain,Kelantan,0,0,0
1/04/2022,Spain,Melaka,0,0,0
1/04/2022,Spain,Negeri Sembilan,0,0,0
1/04/2022,Spain,Pahang,0,0,0
1/04/2022,Spain,Perak,0,0,0
1/04/2022,Spain,Perlis,0,0,0
1/04/2022,Spain,Pulau Pinang,7,4,3
1/04/2022,Spain,Sabah,2,0,2
1/04/2022,Spain,Sarawak,2,0,2
1/04/2022,Spain,Selangor,456,285,171
1/04/2022,Spain,W.P. Labuan,0,0,0
1/04/2022,Estonia,Johor,5,2,3
1/04/2022,Estonia,Kedah,0,0,0
1/04/2022,Estonia,Kelantan,0,0,0
1/04/2022,Estonia,Pahang,0,0,0
1/04/2022,Estonia,Perak,0,0,0
1/04/2022,Estonia,Perlis,0,0,0
1/04/2022,Estonia,Pulau Pinang,2,2,0
1/04/2022,Estonia,Sabah,0,0,0
1/04/2022,Estonia,Sarawak,1,1,0
1/04/2022,Estonia,Selangor,24,12,12
1/04/2022,Estonia,W.P. Labuan,0,0,0
1/04/2022,Ethiopia,Johor,0,0,0
1/04/2022,Ethiopia,Kedah,0,0,0
1/04/2022,Ethiopia,Pulau Pinang,0,0,0
1/04/2022,Ethiopia,Sarawak,0,0,0
1/04/2022,Ethiopia,Selangor,6,4,2
1/04/2022,Finland,Johor,92,59,33
1/04/2022,Finland,Kedah,6,3,3
1/04/2022,Finland,Kelantan,0,0,0
1/04/2022,Finland,Melaka,0,0,0
1/04/2022,Finland,Negeri Sembilan,0,0,0
1/04/2022,Finland,Pahang,0,0,0
1/04/2022,Finland,Perak,0,0,0
1/04/2022,Finland,Perlis,0,0,0
1/04/2022,Finland,Pulau Pinang,6,3,3
1/04/2022,Finland,Sabah,3,0,3
1/04/2022,Finland,Sarawak,0,0,0
1/04/2022,Finland,Selangor,170,115,55
1/04/2022,Finland,W.P. Labuan,0,0,0
1/04/2022,Fiji,Johor,6,2,4
1/04/2022,Fiji,Kedah,1,0,1
1/04/2022,Fiji,Kelantan,0,0,0
1/04/2022,Fiji,Perak,0,0,0
1/04/2022,Fiji,Perlis,0,0,0
1/04/2022,Fiji,Pulau Pinang,0,0,0
1/04/2022,Fiji,Sabah,0,0,0
1/04/2022,Fiji,Sarawak,1,0,1
1/04/2022,Fiji,Selangor,21,11,10
1/04/2022,France,Johor,956,602,354
1/04/2022,France,Kedah,74,45,29
1/04/2022,France,Kelantan,0,0,0
1/04/2022,France,Melaka,0,0,0
1/04/2022,France,Negeri Sembilan,0,0,0
1/04/2022,France,Pahang,0,0,0
1/04/2022,France,Perak,4,2,2
1/04/2022,France,Perlis,2,2,0
1/04/2022,France,Pulau Pinang,151,93,58
1/04/2022,France,Sabah,32,18,14
1/04/2022,France,Sarawak,11,8,3
1/04/2022,France,Selangor,1898,1268,630
1/04/2022,France,Terengganu,0,0,0
1/04/2022,France,W.P. Labuan,1,1,0
1/04/2022,"Micronesia, Federated States of",Johor,0,0,0
1/04/2022,"Micronesia, Federated States of",Pulau Pinang,0,0,0
1/04/2022,"Micronesia, Federated States of",Selangor,0,0,0
1/04/2022,Gabon,Johor,4,0,4
1/04/2022,Gabon,Pulau Pinang,0,0,0
1/04/2022,Gabon,Sarawak,0,0,0
1/04/2022,Gabon,Selangor,4,1,3
1/04/2022,United Kingdom of Great Britain and Northern Ireland,Johor,1787,1174,613
1/04/2022,United Kingdom of Great Britain and Northern Ireland,Kedah,194,107,87
1/04/2022,United Kingdom of Great Britain and Northern Ireland,Kelantan,0,0,0
1/04/2022,United Kingdom of Great Britain and Northern Ireland,Melaka,0,0,0
1/04/2022,United Kingdom of Great Britain and Northern Ireland,Negeri Sembilan,0,0,0
1/04/2022,United Kingdom of Great Britain and Northern Ireland,Pahang,3,3,0
1/04/2022,United Kingdom of Great Britain and Northern Ireland,Perak,12,8,4
1/04/2022,United Kingdom of Great Britain and Northern Ireland,Perlis,1,1,0
1/04/2022,United Kingdom of Great Britain and Northern Ireland,Pulau Pinang,434,241,193
1/04/2022,United Kingdom of Great Britain and Northern Ireland,Sabah,61,35,26
1/04/2022,United Kingdom of Great Britain and Northern Ireland,Sarawak,26,21,5
1/04/2022,United Kingdom of Great Britain and Northern Ireland,Selangor,5778,3741,2037
1/04/2022,United Kingdom of Great Britain and Northern Ireland,Terengganu,1,1,0
1/04/2022,United Kingdom of Great Britain and Northern Ireland,W.P. Labuan,0,0,0
1/04/2022,Georgia,Johor,3,1,2
1/04/2022,Georgia,Kedah,0,0,0
1/04/2022,Georgia,Melaka,0,0,0
1/04/2022,Georgia,Perak,0,0,0
1/04/2022,Georgia,Perlis,0,0,0
1/04/2022,Georgia,Pulau Pinang,0,0,0
1/04/2022,Georgia,Sabah,0,0,0
1/04/2022,Georgia,Sarawak,0,0,0
1/04/2022,Georgia,Selangor,9,7,2
1/04/2022,Ghana,Johor,3,0,3
1/04/2022,Ghana,Kedah,0,0,0
1/04/2022,Ghana,Kelantan,0,0,0
1/04/2022,Ghana,Pulau Pinang,0,0,0
1/04/2022,Ghana,Sabah,0,0,0
1/04/2022,Ghana,Sarawak,0,0,0
1/04/2022,Ghana,Selangor,13,11,2
1/04/2022,Gibraltar,Johor,0,0,0
1/04/2022,Gibraltar,Sarawak,0,0,0
1/04/2022,Guinea,Johor,0,0,0
1/04/2022,Guinea,Kedah,0,0,0
1/04/2022,Guinea,Kelantan,0,0,0
1/04/2022,Guinea,Perlis,0,0,0
1/04/2022,Guinea,Pulau Pinang,0,0,0
1/04/2022,Guinea,Sabah,0,0,0
1/04/2022,Guinea,Sarawak,0,0,0
1/04/2022,Guinea,Selangor,14,10,4
1/04/2022,Guadeloupe,Selangor,0,0,0
1/04/2022,Gambia,Johor,0,0,0
1/04/2022,Gambia,Kedah,0,0,0
1/04/2022,Gambia,Kelantan,0,0,0
1/04/2022,Gambia,Pulau Pinang,0,0,0
1/04/2022,Gambia,Sabah,0,0,0
1/04/2022,Gambia,Sarawak,0,0,0
1/04/2022,Gambia,Selangor,13,5,8
1/04/2022,Guinea-Bissau,Johor,0,0,0
1/04/2022,Guinea-Bissau,Selangor,0,0,0
1/04/2022,Equatorial Guinea,Johor,0,0,0
1/04/2022,Equatorial Guinea,Selangor,0,0,0
1/04/2022,Greece,Johor,22,16,6
1/04/2022,Greece,Kedah,3,2,1
1/04/2022,Greece,Kelantan,0,0,0
1/04/2022,Greece,Melaka,0,0,0
1/04/2022,Greece,Negeri Sembilan,0,0,0
1/04/2022,Greece,Pahang,0,0,0
1/04/2022,Greece,Perak,0,0,0
1/04/2022,Greece,Perlis,0,0,0
1/04/2022,Greece,Pulau Pinang,1,1,0
1/04/2022,Greece,Sabah,0,0,0
1/04/2022,Greece,Sarawak,0,0,0
1/04/2022,Greece,Selangor,59,48,11
1/04/2022,Grenada,Johor,4,3,1
1/04/2022,Grenada,Kedah,0,0,0
1/04/2022,Grenada,Pulau Pinang,0,0,0
1/04/2022,Grenada,Sabah,0,0,0
1/04/2022,Grenada,Sarawak,0,0,0
1/04/2022,Grenada,Selangor,6,5,1
1/04/2022,Greenland,Johor,0,0,0
1/04/2022,Greenland,Selangor,0,0,0
1/04/2022,Guatemala,Johor,0,0,0
1/04/2022,Guatemala,Kedah,0,0,0
1/04/2022,Guatemala,Pahang,0,0,0
1/04/2022,Guatemala,Perak,0,0,0
1/04/2022,Guatemala,Pulau Pinang,0,0,0
1/04/2022,Guatemala,Sabah,0,0,0
1/04/2022,Guatemala,Sarawak,0,0,0
1/04/2022,Guatemala,Selangor,7,5,2
1/04/2022,Guatemala,W.P. Labuan,0,0,0
1/04/2022,Guyana,Johor,0,0,0
1/04/2022,Guyana,Kedah,0,0,0
1/04/2022,Guyana,Pulau Pinang,0,0,0
1/04/2022,Guyana,Sarawak,0,0,0
1/04/2022,Guyana,Selangor,0,0,0
1/04/2022,Hong Kong,Johor,2,2,0
1/04/2022,Hong Kong,Kedah,12,3,9
1/04/2022,Hong Kong,Kelantan,0,0,0
1/04/2022,Hong Kong,Pahang,0,0,0
1/04/2022,Hong Kong,Perak,3,1,2
1/04/2022,Hong Kong,Perlis,0,0,0
1/04/2022,Hong Kong,Pulau Pinang,60,32,28
1/04/2022,Hong Kong,Sabah,3,1,2
1/04/2022,Hong Kong,Sarawak,24,15,9
1/04/2022,Hong Kong,Selangor,5,4,1
1/04/2022,Hong Kong,Terengganu,0,0,0
1/04/2022,Heard Island and McDonald Islands,Johor,0,0,0
1/04/2022,Honduras,Johor,3,2,1
1/04/2022,Honduras,Kedah,0,0,0
1/04/2022,Honduras,Perak,0,0,0
1/04/2022,Honduras,Pulau Pinang,0,0,0
1/04/2022,Honduras,Sabah,0,0,0
1/04/2022,Honduras,Sarawak,0,0,0
1/04/2022,Honduras,Selangor,10,6,4
1/04/2022,Croatia,Johor,8,6,2
1/04/2022,Croatia,Kedah,0,0,0
1/04/2022,Croatia,Kelantan,0,0,0
1/04/2022,Croatia,Melaka,0,0,0
1/04/2022,Croatia,Pahang,0,0,0
1/04/2022,Croatia,Perak,0,0,0
1/04/2022,Croatia,Perlis,0,0,0
1/04/2022,Croatia,Pulau Pinang,2,0,2
1/04/2022,Croatia,Sabah,0,0,0
1/04/2022,Croatia,Sarawak,0,0,0
1/04/2022,Croatia,Selangor,48,34,14
1/04/2022,Haiti,Johor,0,0,0
1/04/2022,Haiti,Kedah,0,0,0
1/04/2022,Haiti,Kelantan,0,0,0
1/04/2022,Haiti,Perak,0,0,0
1/04/2022,Haiti,Pulau Pinang,0,0,0
1/04/2022,Haiti,Sabah,0,0,0
1/04/2022,Haiti,Selangor,0,0,0
1/04/2022,Hungary,Johor,36,20,16
1/04/2022,Hungary,Kedah,5,3,2
1/04/2022,Hungary,Kelantan,0,0,0
1/04/2022,Hungary,Pahang,0,0,0
1/04/2022,Hungary,Perak,0,0,0
1/04/2022,Hungary,Perlis,0,0,0
1/04/2022,Hungary,Pulau Pinang,1,0,1
1/04/2022,Hungary,Sabah,10,5,5
1/04/2022,Hungary,Sarawak,2,2,0
1/04/2022,Hungary,Selangor,73,40,33
1/04/2022,Hungary,W.P. Labuan,0,0,0
1/04/2022,Indonesia,Johor,13063,4386,8677
1/04/2022,Indonesia,Kedah,33,17,16
1/04/2022,Indonesia,Kelantan,0,0,0
1/04/2022,Indonesia,Melaka,10,10,0
1/04/2022,Indonesia,Negeri Sembilan,0,0,0
1/04/2022,Indonesia,Pahang,9,9,0
1/04/2022,Indonesia,Perak,16,4,12
1/04/2022,Indonesia,Perlis,0,0,0
1/04/2022,Indonesia,Pulau Pinang,2382,999,1383
1/04/2022,Indonesia,Sabah,953,516,437
1/04/2022,Indonesia,Sarawak,1670,1087,583
1/04/2022,Indonesia,Selangor,17630,8318,9312
1/04/2022,Indonesia,Terengganu,0,0,0
1/04/2022,Indonesia,W.P. Labuan,10,9,1
1/04/2022,India,Johor,2938,2074,864
1/04/2022,India,Kedah,87,44,43
1/04/2022,India,Kelantan,0,0,0
1/04/2022,India,Melaka,0,0,0
1/04/2022,India,Negeri Sembilan,0,0,0
1/04/2022,India,Pahang,0,0,0
1/04/2022,India,Perak,9,7,2
1/04/2022,India,Perlis,0,0,0
1/04/2022,India,Pulau Pinang,180,125,55
1/04/2022,India,Sabah,64,34,30
1/04/2022,India,Sarawak,13,10,3
1/04/2022,India,Selangor,13641,9834,3807
1/04/2022,India,Terengganu,0,0,0
1/04/2022,India,W.P. Labuan,1,1,0
1/04/2022, British Indian Ocean Territory,Pulau Pinang,0,0,0
1/04/2022, British Indian Ocean Territory,Selangor,0,0,0
1/04/2022,Ireland,Johor,109,81,28
1/04/2022,Ireland,Kedah,7,2,5
1/04/2022,Ireland,Kelantan,0,0,0
1/04/2022,Ireland,Negeri Sembilan,0,0,0
1/04/2022,Ireland,Pahang,0,0,0
1/04/2022,Ireland,Perak,1,0,1
1/04/2022,Ireland,Perlis,0,0,0
1/04/2022,Ireland,Pulau Pinang,37,28,9
1/04/2022,Ireland,Sabah,4,2,2
1/04/2022,Ireland,Sarawak,0,0,0
1/04/2022,Ireland,Selangor,371,250,121
1/04/2022,Ireland,Terengganu,0,0,0
1/04/2022,Ireland,W.P. Labuan,0,0,0
1/04/2022,"Iran, Islamic Republic of",Johor,25,17,8
1/04/2022,"Iran, Islamic Republic of",Kedah,0,0,0
1/04/2022,"Iran, Islamic Republic of",Kelantan,0,0,0
1/04/2022,"Iran, Islamic Republic of",Perak,0,0,0
1/04/2022,"Iran, Islamic Republic of",Perlis,0,0,0
1/04/2022,"Iran, Islamic Republic of",Pulau Pinang,1,1,0
1/04/2022,"Iran, Islamic Republic of",Sabah,0,0,0
1/04/2022,"Iran, Islamic Republic of",Sarawak,0,0,0
1/04/2022,"Iran, Islamic Republic of",Selangor,704,396,308
1/04/2022,"Iran, Islamic Republic of",W.P. Labuan,0,0,0
1/04/2022,Iraq,Johor,4,4,0
1/04/2022,Iraq,Kedah,0,0,0
1/04/2022,Iraq,Kelantan,0,0,0
1/04/2022,Iraq,Melaka,0,0,0
1/04/2022,Iraq,Pahang,0,0,0
1/04/2022,Iraq,Perak,0,0,0
1/04/2022,Iraq,Perlis,0,0,0
1/04/2022,Iraq,Pulau Pinang,0,0,0
1/04/2022,Iraq,Sabah,0,0,0
1/04/2022,Iraq,Sarawak,0,0,0
1/04/2022,Iraq,Selangor,443,296,147
1/04/2022,Iceland,Johor,1,0,1
1/04/2022,Iceland,Kedah,0,0,0
1/04/2022,Iceland,Kelantan,0,0,0
1/04/2022,Iceland,Perak,0,0,0
1/04/2022,Iceland,Perlis,0,0,0
1/04/2022,Iceland,Pulau Pinang,5,4,1
1/04/2022,Iceland,Sabah,0,0,0
1/04/2022,Iceland,Sarawak,0,0,0
1/04/2022,Iceland,Selangor,7,4,3
1/04/2022,Iceland,W.P. Labuan,0,0,0
1/04/2022,Israel,Pulau Pinang,0,0,0
1/04/2022,Italy,Johor,250,162,88
1/04/2022,Italy,Kedah,10,5,5
1/04/2022,Italy,Kelantan,0,0,0
1/04/2022,Italy,Melaka,0,0,0
1/04/2022,Italy,Negeri Sembilan,0,0,0
1/04/2022,Italy,Pahang,0,0,0
1/04/2022,Italy,Perak,1,0,1
1/04/2022,Italy,Perlis,0,0,0
1/04/2022,Italy,Pulau Pinang,33,29,4
1/04/2022,Italy,Sabah,4,3,1
1/04/2022,Italy,Sarawak,3,3,0
1/04/2022,Italy,Selangor,551,433,118
1/04/2022,Italy,W.P. Labuan,0,0,0
1/04/2022,Jamaica,Johor,0,0,0
1/04/2022,Jamaica,Kedah,0,0,0
1/04/2022,Jamaica,Perak,0,0,0
1/04/2022,Jamaica,Pulau Pinang,2,0,2
1/04/2022,Jamaica,Sabah,0,0,0
1/04/2022,Jamaica,Sarawak,0,0,0
1/04/2022,Jamaica,Selangor,2,1,1
1/04/2022,Jamaica,W.P. Labuan,0,0,0
1/04/2022,Jordan,Johor,5,3,2
1/04/2022,Jordan,Kedah,0,0,0
1/04/2022,Jordan,Kelantan,0,0,0
1/04/2022,Jordan,Melaka,0,0,0
1/04/2022,Jordan,Perlis,0,0,0
1/04/2022,Jordan,Pulau Pinang,0,0,0
1/04/2022,Jordan,Sabah,0,0,0
1/04/2022,Jordan,Sarawak,0,0,0
1/04/2022,Jordan,Selangor,286,179,107
1/04/2022,Jordan,W.P. Labuan,0,0,0
1/04/2022,Japan,Johor,1387,964,423
1/04/2022,Japan,Kedah,17,8,9
1/04/2022,Japan,Kelantan,0,0,0
1/04/2022,Japan,Melaka,0,0,0
1/04/2022,Japan,Negeri Sembilan,0,0,0
1/04/2022,Japan,Pahang,0,0,0
1/04/2022,Japan,Perak,1,1,0
1/04/2022,Japan,Perlis,0,0,0
1/04/2022,Japan,Pulau Pinang,228,148,80
1/04/2022,Japan,Sabah,41,23,18
1/04/2022,Japan,Sarawak,8,5,3
1/04/2022,Japan,Selangor,3673,2445,1228
1/04/2022,Japan,W.P. Labuan,0,0,0
1/04/2022,Kazakhstan,Johor,14,6,8
1/04/2022,Kazakhstan,Kedah,1,0,1
1/04/2022,Kazakhstan,Kelantan,0,0,0
1/04/2022,Kazakhstan,Melaka,0,0,0
1/04/2022,Kazakhstan,Perak,0,0,0
1/04/2022,Kazakhstan,Perlis,0,0,0
1/04/2022,Kazakhstan,Pulau Pinang,2,2,0
1/04/2022,Kazakhstan,Sabah,0,0,0
1/04/2022,Kazakhstan,Sarawak,1,0,1
1/04/2022,Kazakhstan,Selangor,173,69,104
1/04/2022,Kazakhstan,W.P. Labuan,0,0,0
1/04/2022,Kenya,Johor,5,4,1
1/04/2022,Kenya,Kedah,1,0,1
1/04/2022,Kenya,Kelantan,0,0,0
1/04/2022,Kenya,Perak,0,0,0
1/04/2022,Kenya,Perlis,0,0,0
1/04/2022,Kenya,Pulau Pinang,0,0,0
1/04/2022,Kenya,Sabah,1,0,1
1/04/2022,Kenya,Sarawak,0,0,0
1/04/2022,Kenya,Selangor,111,57,54
1/04/2022,Kyrgyzstan,Johor,3,1,2
1/04/2022,Kyrgyzstan,Kedah,0,0,0
1/04/2022,Kyrgyzstan,Kelantan,0,0,0
1/04/2022,Kyrgyzstan,Perak,0,0,0
1/04/2022,Kyrgyzstan,Perlis,0,0,0
1/04/2022,Kyrgyzstan,Pulau Pinang,0,0,0
1/04/2022,Kyrgyzstan,Sabah,0,0,0
1/04/2022,Kyrgyzstan,Sarawak,0,0,0
1/04/2022,Kyrgyzstan,Selangor,108,70,38
1/04/2022,Cambodia,Johor,41,17,24
1/04/2022,Cambodia,Kedah,2,2,0
1/04/2022,Cambodia,Kelantan,0,0,0
1/04/2022,Cambodia,Melaka,6,0,6
1/04/2022,Cambodia,Negeri Sembilan,0,0,0
1/04/2022,Cambodia,Pahang,0,0,0
1/04/2022,Cambodia,Perak,0,0,0
1/04/2022,Cambodia,Perlis,0,0,0
1/04/2022,Cambodia,Pulau Pinang,7,4,3
1/04/2022,Cambodia,Sabah,0,0,0
1/04/2022,Cambodia,Sarawak,0,0,0
1/04/2022,Cambodia,Selangor,942,600,342
1/04/2022,Cambodia,W.P. Labuan,0,0,0
1/04/2022,Kiribati,Johor,0,0,0
1/04/2022,Kiribati,Sabah,0,0,0
1/04/2022,Kiribati,Selangor,0,0,0
1/04/2022,Saint Kitts and Nevis,Johor,10,8,2
1/04/2022,Saint Kitts and Nevis,Kedah,0,0,0
1/04/2022,Saint Kitts and Nevis,Perlis,0,0,0
1/04/2022,Saint Kitts and Nevis,Pulau Pinang,0,0,0
1/04/2022,Saint Kitts and Nevis,Sabah,0,0,0
1/04/2022,Saint Kitts and Nevis,Selangor,19,13,6
1/04/2022,Saint Kitts and Nevis,W.P. Labuan,0,0,0
1/04/2022,"Korea, Republic of",Johor,2176,1330,846
1/04/2022,"Korea, Republic of",Kedah,21,7,14
1/04/2022,"Korea, Republic of",Kelantan,0,0,0
1/04/2022,"Korea, Republic of",Melaka,0,0,0
1/04/2022,"Korea, Republic of",Negeri Sembilan,0,0,0
1/04/2022,"Korea, Republic of",Pahang,0,0,0
1/04/2022,"Korea, Republic of",Perak,2,2,0
1/04/2022,"Korea, Republic of",Perlis,0,0,0
1/04/2022,"Korea, Republic of",Pulau Pinang,78,46,32
1/04/2022,"Korea, Republic of",Sabah,30,13,17
1/04/2022,"Korea, Republic of",Sarawak,35,30,5
1/04/2022,"Korea, Republic of",Selangor,3246,2236,1010
1/04/2022,"Korea, Republic of",Terengganu,0,0,0
1/04/2022,"Korea, Republic of",W.P. Labuan,0,0,0
1/04/2022,Kuwait,Johor,0,0,0
1/04/2022,Kuwait,Kedah,0,0,0
1/04/2022,Kuwait,Kelantan,0,0,0
1/04/2022,Kuwait,Perak,0,0,0
1/04/2022,Kuwait,Perlis,0,0,0
1/04/2022,Kuwait,Pulau Pinang,0,0,0
1/04/2022,Kuwait,Sabah,0,0,0
1/04/2022,Kuwait,Sarawak,0,0,0
1/04/2022,Kuwait,Selangor,89,48,41
1/04/2022,Kuwait,W.P. Labuan,0,0,0
1/04/2022, Lao People's Democratic Republic,Johor,6,0,6
1/04/2022, Lao People's Democratic Republic,Kedah,16,3,13
1/04/2022, Lao People's Democratic Republic,Kelantan,0,0,0
1/04/2022, Lao People's Democratic Republic,Melaka,0,0,0
1/04/2022, Lao People's Democratic Republic,Perak,0,0,0
1/04/2022, Lao People's Democratic Republic,Perlis,0,0,0
1/04/2022, Lao People's Democratic Republic,Pulau Pinang,1,0,1
1/04/2022, Lao People's Democratic Republic,Sabah,0,0,0
1/04/2022, Lao People's Democratic Republic,Sarawak,0,0,0
1/04/2022, Lao People's Democratic Republic,Selangor,270,248,22
1/04/2022, Lao People's Democratic Republic,W.P. Labuan,0,0,0
1/04/2022,Lebanon,Johor,5,3,2
1/04/2022,Lebanon,Kedah,1,1,0
1/04/2022,Lebanon,Kelantan,0,0,0
1/04/2022,Lebanon,Pahang,0,0,0
1/04/2022,Lebanon,Perak,0,0,0
1/04/2022,Lebanon,Perlis,0,0,0
1/04/2022,Lebanon,Pulau Pinang,5,1,4
1/04/2022,Lebanon,Sabah,0,0,0
1/04/2022,Lebanon,Sarawak,0,0,0
1/04/2022,Lebanon,Selangor,91,57,34
1/04/2022,Lebanon,W.P. Labuan,0,0,0
1/04/2022,Liberia,Johor,0,0,0
1/04/2022,Liberia,Kedah,0,0,0
1/04/2022,Liberia,Sabah,0,0,0
1/04/2022,Liberia,Sarawak,0,0,0
1/04/2022,Liberia,Selangor,0,0,0
1/04/2022,Libya,Johor,0,0,0
1/04/2022,Libya,Kedah,0,0,0
1/04/2022,Libya,Perlis,0,0,0
1/04/2022,Libya,Pulau Pinang,0,0,0
1/04/2022,Libya,Sabah,0,0,0
1/04/2022,Libya,Sarawak,0,0,0
1/04/2022,Libya,Selangor,133,84,49
1/04/2022,Saint Lucia,Johor,2,2,0
1/04/2022,Saint Lucia,Kedah,0,0,0
1/04/2022,Saint Lucia,Pulau Pinang,0,0,0
1/04/2022,Saint Lucia,Sarawak,0,0,0
1/04/2022,Saint Lucia,Selangor,1,1,0
1/04/2022,Liechtenstein,Johor,0,0,0
1/04/2022,Liechtenstein,Kedah,0,0,0
1/04/2022,Liechtenstein,Perlis,0,0,0
1/04/2022,Liechtenstein,Pulau Pinang,0,0,0
1/04/2022,Liechtenstein,Sabah,0,0,0
1/04/2022,Liechtenstein,Sarawak,0,0,0
1/04/2022,Liechtenstein,Selangor,1,1,0
1/04/2022,LKA,Johor,189,132,57
1/04/2022,LKA,Kedah,0,0,0
1/04/2022,LKA,Kelantan,0,0,0
1/04/2022,LKA,Melaka,0,0,0
1/04/2022,LKA,Pahang,0,0,0
1/04/2022,LKA,Perak,0,0,0
1/04/2022,LKA,Perlis,0,0,0
1/04/2022,LKA,Pulau Pinang,4,3,1
1/04/2022,LKA,Sabah,0,0,0
1/04/2022,LKA,Sarawak,1,0,1
1/04/2022,LKA,Selangor,1035,605,430
1/04/2022,LKA,W.P. Labuan,0,0,0
1/04/2022,Lesotho,Johor,0,0,0
1/04/2022,Lesotho,Kedah,0,0,0
1/04/2022,Lesotho,Pulau Pinang,0,0,0
1/04/2022,Lesotho,Sarawak,0,0,0
1/04/2022,Lesotho,Selangor,5,0,5
1/04/2022,Lithuania,Johor,5,4,1
1/04/2022,Lithuania,Kedah,2,0,2
1/04/2022,Lithuania,Kelantan,0,0,0
1/04/2022,Lithuania,Pahang,0,0,0
1/04/2022,Lithuania,Perak,0,0,0
1/04/2022,Lithuania,Perlis,0,0,0
1/04/2022,Lithuania,Pulau Pinang,0,0,0
1/04/2022,Lithuania,Sabah,0,0,0
1/04/2022,Lithuania,Sarawak,2,1,1
1/04/2022,Lithuania,Selangor,54,28,26
1/04/2022,Lithuania,W.P. Labuan,0,0,0
1/04/2022,Luxembourg,Johor,2,1,1
1/04/2022,Luxembourg,Kedah,0,0,0
1/04/2022,Luxembourg,Kelantan,0,0,0
1/04/2022,Luxembourg,Perak,0,0,0
1/04/2022,Luxembourg,Perlis,0,0,0
1/04/2022,Luxembourg,Pulau Pinang,1,1,0
1/04/2022,Luxembourg,Sabah,0,0,0
1/04/2022,Luxembourg,Sarawak,0,0,0
1/04/2022,Luxembourg,Selangor,10,8,2
1/04/2022,Latvia,Johor,4,1,3
1/04/2022,Latvia,Kedah,1,1,0
1/04/2022,Latvia,Kelantan,0,0,0
1/04/2022,Latvia,Pahang,0,0,0
1/04/2022,Latvia,Perak,0,0,0
1/04/2022,Latvia,Perlis,0,0,0
1/04/2022,Latvia,Pulau Pinang,2,0,2
1/04/2022,Latvia,Sabah,1,0,1
1/04/2022,Latvia,Sarawak,0,0,0
1/04/2022,Latvia,Selangor,24,13,11
1/04/2022,Latvia,W.P. Labuan,0,0,0
1/04/2022,Macao,Johor,0,0,0
1/04/2022,Macao,Pahang,0,0,0
1/04/2022,Macao,Perak,0,0,0
1/04/2022,Macao,Selangor,0,0,0
1/04/2022,Macao,W.P. Labuan,0,0,0
1/04/2022,Morocco,Johor,26,15,11
1/04/2022,Morocco,Kedah,1,1,0
1/04/2022,Morocco,Kelantan,0,0,0
1/04/2022,Morocco,Melaka,0,0,0
1/04/2022,Morocco,Pahang,0,0,0
1/04/2022,Morocco,Perak,0,0,0
1/04/2022,Morocco,Perlis,0,0,0
1/04/2022,Morocco,Pulau Pinang,1,1,0
1/04/2022,Morocco,Sabah,0,0,0
1/04/2022,Morocco,Sarawak,0,0,0
1/04/2022,Morocco,Selangor,108,46,62
1/04/2022,Morocco,W.P. Labuan,0,0,0
1/04/2022,Monaco,Johor,0,0,0
1/04/2022,Monaco,Kedah,0,0,0
1/04/2022,Monaco,Sabah,0,0,0
1/04/2022,Monaco,Selangor,0,0,0
1/04/2022,"Moldova, Republic of",Johor,0,0,0
1/04/2022,"Moldova, Republic of",Kedah,0,0,0
1/04/2022,"Moldova, Republic of",Kelantan,0,0,0
1/04/2022,"Moldova, Republic of",Negeri Sembilan,0,0,0
1/04/2022,"Moldova, Republic of",Perlis,0,0,0
1/04/2022,"Moldova, Republic of",Pulau Pinang,0,0,0
1/04/2022,"Moldova, Republic of",Sabah,0,0,0
1/04/2022,"Moldova, Republic of",Sarawak,0,0,0
1/04/2022,"Moldova, Republic of",Selangor,12,3,9
1/04/2022,Madagascar,Johor,0,0,0
1/04/2022,Madagascar,Kedah,0,0,0
1/04/2022,Madagascar,Perak,0,0,0
1/04/2022,Madagascar,Perlis,0,0,0
1/04/2022,Madagascar,Pulau Pinang,0,0,0
1/04/2022,Madagascar,Sabah,0,0,0
1/04/2022,Madagascar,Sarawak,0,0,0
1/04/2022,Madagascar,Selangor,3,1,2
1/04/2022,Maldives,Johor,32,24,8
1/04/2022,Maldives,Kedah,1,1,0
1/04/2022,Maldives,Kelantan,0,0,0
1/04/2022,Maldives,Perak,0,0,0
1/04/2022,Maldives,Perlis,0,0,0
1/04/2022,Maldives,Pulau Pinang,0,0,0
1/04/2022,Maldives,Sabah,0,0,0
1/04/2022,Maldives,Sarawak,0,0,0
1/04/2022,Maldives,Selangor,1020,535,485
1/04/2022,Mexico,Johor,34,20,14
1/04/2022,Mexico,Kedah,2,1,1
1/04/2022,Mexico,Kelantan,0,0,0
1/04/2022,Mexico,Pahang,0,0,0
1/04/2022,Mexico,Perak,0,0,0
1/04/2022,Mexico,Perlis,0,0,0
1/04/2022,Mexico,Pulau Pinang,9,7,2
1/04/2022,Mexico,Sabah,4,3,1
1/04/2022,Mexico,Sarawak,1,1,0
1/04/2022,Mexico,Selangor,115,71,44
1/04/2022,Mexico,W.P. Labuan,0,0,0
1/04/2022,Marshall Islands,Johor,2,2,0
1/04/2022,Marshall Islands,Kedah,0,0,0
1/04/2022,Marshall Islands,Perak,0,0,0
1/04/2022,Marshall Islands,Pulau Pinang,0,0,0
1/04/2022,Marshall Islands,Sabah,0,0,0
1/04/2022,Marshall Islands,Selangor,0,0,0
1/04/2022,North Macedonia,Johor,1,0,1
1/04/2022,North Macedonia,Kedah,0,0,0
1/04/2022,North Macedonia,Perak,0,0,0
1/04/2022,North Macedonia,Pulau Pinang,2,2,0
1/04/2022,North Macedonia,Sabah,0,0,0
1/04/2022,North Macedonia,Sarawak,0,0,0
1/04/2022,North Macedonia,Selangor,7,2,5
1/04/2022,Mali,Johor,0,0,0
1/04/2022,Mali,Sabah,0,0,0
1/04/2022,Mali,Selangor,2,2,0
1/04/2022,Malta,Johor,1,1,0
1/04/2022,Malta,Kedah,0,0,0
1/04/2022,Malta,Kelantan,0,0,0
1/04/2022,Malta,Perak,0,0,0
1/04/2022,Malta,Perlis,0,0,0
1/04/2022,Malta,Pulau Pinang,0,0,0
1/04/2022,Malta,Sabah,0,0,0
1/04/2022,Malta,Sarawak,0,0,0
1/04/2022,Malta,Selangor,10,7,3
1/04/2022,Malta,W.P. Labuan,0,0,0
1/04/2022,Myanmar,Johor,542,164,378
1/04/2022,Myanmar,Kedah,3,2,1
1/04/2022,Myanmar,Kelantan,0,0,0
1/04/2022,Myanmar,Negeri Sembilan,0,0,0
1/04/2022,Myanmar,Pahang,0,0,0
1/04/2022,Myanmar,Perak,2,1,1
1/04/2022,Myanmar,Perlis,0,0,0
1/04/2022,Myanmar,Pulau Pinang,14,2,12
1/04/2022,Myanmar,Sabah,3,1,2
1/04/2022,Myanmar,Sarawak,3,1,2
1/04/2022,Myanmar,Selangor,634,410,224
1/04/2022,Myanmar,Terengganu,0,0,0
1/04/2022,Myanmar,W.P. Labuan,0,0,0
1/04/2022,Montenegro,Johor,0,0,0
1/04/2022,Montenegro,Kedah,0,0,0
1/04/2022,Montenegro,Pulau Pinang,0,0,0
1/04/2022,Montenegro,Sabah,0,0,0
1/04/2022,Montenegro,Sarawak,0,0,0
1/04/2022,Montenegro,Selangor,4,3,1
1/04/2022,Mongolia,Johor,14,5,9
1/04/2022,Mongolia,Kedah,0,0,0
1/04/2022,Mongolia,Kelantan,0,0,0
1/04/2022,Mongolia,Perak,1,0,1
1/04/2022,Mongolia,Perlis,0,0,0
1/04/2022,Mongolia,Pulau Pinang,0,0,0
1/04/2022,Mongolia,Sabah,0,0,0
1/04/2022,Mongolia,Sarawak,0,0,0
1/04/2022,Mongolia,Selangor,73,27,46
1/04/2022,Northern Mariana Islands,Selangor,0,0,0
1/04/2022,Mozambique,Johor,0,0,0
1/04/2022,Mozambique,Kedah,0,0,0
1/04/2022,Mozambique,Perak,0,0,0
1/04/2022,Mozambique,Pulau Pinang,0,0,0
1/04/2022,Mozambique,Sabah,0,0,0
1/04/2022,Mozambique,Sarawak,0,0,0
1/04/2022,Mozambique,Selangor,9,7,2
1/04/2022,Mauritania,Johor,0,0,0
1/04/2022,Mauritania,Kedah,0,0,0
1/04/2022,Mauritania,Pulau Pinang,0,0,0
1/04/2022,Mauritania,Sabah,0,0,0
1/04/2022,Mauritania,Sarawak,0,0,0
1/04/2022,Mauritania,Selangor,9,9,0
1/04/2022,Mauritius,Johor,21,9,12
1/04/2022,Mauritius,Kedah,0,0,0
1/04/2022,Mauritius,Kelantan,0,0,0
1/04/2022,Mauritius,Pahang,0,0,0
1/04/2022,Mauritius,Perak,0,0,0
1/04/2022,Mauritius,Perlis,0,0,0
1/04/2022,Mauritius,Pulau Pinang,0,0,0
1/04/2022,Mauritius,Sabah,0,0,0
1/04/2022,Mauritius,Sarawak,0,0,0
1/04/2022,Mauritius,Selangor,73,40,33
1/04/2022,Malawi,Johor,0,0,0
1/04/2022,Malawi,Pulau Pinang,0,0,0
1/04/2022,Malawi,Sabah,0,0,0
1/04/2022,Malawi,Sarawak,0,0,0
1/04/2022,Malawi,Selangor,4,3,1
1/04/2022,Mayotte,Selangor,0,0,0
1/04/2022,Namibia,Johor,0,0,0
1/04/2022,Namibia,Kedah,0,0,0
1/04/2022,Namibia,Perak,0,0,0
1/04/2022,Namibia,Perlis,0,0,0
1/04/2022,Namibia,Pulau Pinang,0,0,0
1/04/2022,Namibia,Sabah,0,0,0
1/04/2022,Namibia,Sarawak,0,0,0
1/04/2022,Namibia,Selangor,8,4,4
1/04/2022,New Caledonia,Selangor,0,0,0
1/04/2022,Niger,Johor,0,0,0
1/04/2022,Niger,Sabah,0,0,0
1/04/2022,Niger,Selangor,3,3,0
1/04/2022,Nigeria,Johor,10,6,4
1/04/2022,Nigeria,Kedah,0,0,0
1/04/2022,Nigeria,Perlis,0,0,0
1/04/2022,Nigeria,Pulau Pinang,2,2,0
1/04/2022,Nigeria,Sabah,0,0,0
1/04/2022,Nigeria,Sarawak,2,2,0
1/04/2022,Nigeria,Selangor,249,192,57
1/04/2022,Nicaragua,Johor,1,0,1
1/04/2022,Nicaragua,Kedah,0,0,0
1/04/2022,Nicaragua,Pulau Pinang,0,0,0
1/04/2022,Nicaragua,Sabah,0,0,0
1/04/2022,Nicaragua,Selangor,4,1,3
1/04/2022,Netherlands,Johor,316,217,99
1/04/2022,Netherlands,Kedah,34,21,13
1/04/2022,Netherlands,Kelantan,0,0,0
1/04/2022,Netherlands,Melaka,0,0,0
1/04/2022,Netherlands,Negeri Sembilan,0,0,0
1/04/2022,Netherlands,Pahang,0,0,0
1/04/2022,Netherlands,Perak,0,0,0
1/04/2022,Netherlands,Perlis,2,2,0
1/04/2022,Netherlands,Pulau Pinang,65,48,17
1/04/2022,Netherlands,Sabah,8,6,2
1/04/2022,Netherlands,Sarawak,6,5,1
1/04/2022,Netherlands,Selangor,1164,783,381
1/04/2022,Netherlands,Terengganu,0,0,0
1/04/2022,Netherlands,W.P. Labuan,0,0,0
1/04/2022,Norway,Johor,65,44,21
1/04/2022,Norway,Kedah,1,1,0
1/04/2022,Norway,Kelantan,0,0,0
1/04/2022,Norway,Melaka,0,0,0
1/04/2022,Norway,Pahang,0,0,0
1/04/2022,Norway,Perak,0,0,0
1/04/2022,Norway,Perlis,0,0,0
1/04/2022,Norway,Pulau Pinang,9,5,4
1/04/2022,Norway,Sabah,0,0,0
1/04/2022,Norway,Sarawak,0,0,0
1/04/2022,Norway,Selangor,309,178,131
1/04/2022,Norway,W.P. Labuan,0,0,0
1/04/2022,Nepal,Johor,18,16,2
1/04/2022,Nepal,Kedah,2,1,1
1/04/2022,Nepal,Pahang,0,0,0
1/04/2022,Nepal,Perak,0,0,0
1/04/2022,Nepal,Perlis,0,0,0
1/04/2022,Nepal,Pulau Pinang,1,1,0
1/04/2022,Nepal,Sabah,0,0,0
1/04/2022,Nepal,Sarawak,0,0,0
1/04/2022,Nepal,Selangor,2635,2464,171
1/04/2022,Nepal,W.P. Labuan,0,0,0
1/04/2022,Nauru,Johor,0,0,0
1/04/2022,Nauru,Pulau Pinang,0,0,0
1/04/2022,Nauru,Selangor,0,0,0
1/04/2022,New Zealand,Johor,177,119,58
1/04/2022,New Zealand,Kedah,15,9,6
1/04/2022,New Zealand,Kelantan,0,0,0
1/04/2022,New Zealand,Melaka,0,0,0
1/04/2022,New Zealand,Negeri Sembilan,0,0,0
1/04/2022,New Zealand,Pahang,0,0,0
1/04/2022,New Zealand,Perak,5,1,4
1/04/2022,New Zealand,Perlis,0,0,0
1/04/2022,New Zealand,Pulau Pinang,53,33,20
1/04/2022,New Zealand,Sabah,5,2,3
1/04/2022,New Zealand,Sarawak,12,10,2
1/04/2022,New Zealand,Selangor,502,316,186
1/04/2022,New Zealand,Terengganu,0,0,0
1/04/2022,New Zealand,W.P. Labuan,0,0,0
1/04/2022,Oman,Johor,0,0,0
1/04/2022,Oman,Kedah,0,0,0
1/04/2022,Oman,Kelantan,0,0,0
1/04/2022,Oman,Melaka,0,0,0
1/04/2022,Oman,Perak,0,0,0
1/04/2022,Oman,Perlis,0,0,0
1/04/2022,Oman,Pulau Pinang,0,0,0
1/04/2022,Oman,Sabah,0,0,0
1/04/2022,Oman,Sarawak,0,0,0
1/04/2022,Oman,Selangor,149,88,61
1/04/2022,Pakistan,Johor,140,119,21
1/04/2022,Pakistan,Kedah,22,16,6
1/04/2022,Pakistan,Kelantan,0,0,0
1/04/2022,Pakistan,Melaka,0,0,0
1/04/2022,Pakistan,Negeri Sembilan,0,0,0
1/04/2022,Pakistan,Pahang,0,0,0
1/04/2022,Pakistan,Perak,0,0,0
1/04/2022,Pakistan,Perlis,0,0,0
1/04/2022,Pakistan,Pulau Pinang,2,2,0
1/04/2022,Pakistan,Sabah,0,0,0
1/04/2022,Pakistan,Sarawak,1,1,0
1/04/2022,Pakistan,Selangor,3638,3113,525
1/04/2022,Pakistan,W.P. Labuan,0,0,0
1/04/2022,Panama,Johor,2,1,1
1/04/2022,Panama,Kedah,0,0,0
1/04/2022,Panama,Perak,0,0,0
1/04/2022,Panama,Perlis,0,0,0
1/04/2022,Panama,Pulau Pinang,0,0,0
1/04/2022,Panama,Sabah,0,0,0
1/04/2022,Panama,Sarawak,0,0,0
1/04/2022,Panama,Selangor,4,3,1
1/04/2022,Peru,Johor,8,5,3
1/04/2022,Peru,Kedah,0,0,0
1/04/2022,Peru,Kelantan,0,0,0
1/04/2022,Peru,Pahang,0,0,0
1/04/2022,Peru,Perak,0,0,0
1/04/2022,Peru,Perlis,0,0,0
1/04/2022,Peru,Pulau Pinang,5,2,3
1/04/2022,Peru,Sabah,0,0,0
1/04/2022,Peru,Sarawak,0,0,0
1/04/2022,Peru,Selangor,34,22,12
1/04/2022,Peru,W.P. Labuan,0,0,0
1/04/2022,Philippines,Johor,3228,845,2383
1/04/2022,Philippines,Kedah,25,6,19
1/04/2022,Philippines,Kelantan,0,0,0
1/04/2022,Philippines,Melaka,0,0,0
1/04/2022,Philippines,Negeri Sembilan,0,0,0
1/04/2022,Philippines,Pahang,2,2,0
1/04/2022,Philippines,Perak,7,4,3
1/04/2022,Philippines,Perlis,0,0,0
1/04/2022,Philippines,Pulau Pinang,108,49,59
1/04/2022,Philippines,Sabah,9,4,5
1/04/2022,Philippines,Sarawak,41,35,6
1/04/2022,Philippines,Selangor,3792,1739,2053
1/04/2022,Philippines,Terengganu,0,0,0
1/04/2022,Philippines,W.P. Labuan,6,2,4
1/04/2022,Palau,Johor,0,0,0
1/04/2022,Palau,Pulau Pinang,0,0,0
1/04/2022,Palau,Selangor,0,0,0
1/04/2022,Papua New Guinea,Johor,2,1,1
1/04/2022,Papua New Guinea,Kedah,0,0,0
1/04/2022,Papua New Guinea,Kelantan,0,0,0
1/04/2022,Papua New Guinea,Perak,0,0,0
1/04/2022,Papua New Guinea,Pulau Pinang,1,1,0
1/04/2022,Papua New Guinea,Sabah,0,0,0
1/04/2022,Papua New Guinea,Sarawak,1,0,1
1/04/2022,Papua New Guinea,Selangor,8,7,1
1/04/2022,Poland,Johor,93,57,36
1/04/2022,Poland,Kedah,6,2,4
1/04/2022,Poland,Kelantan,0,0,0
1/04/2022,Poland,Melaka,0,0,0
1/04/2022,Poland,Negeri Sembilan,0,0,0
1/04/2022,Poland,Pahang,0,0,0
1/04/2022,Poland,Perak,0,0,0
1/04/2022,Poland,Perlis,0,0,0
1/04/2022,Poland,Pulau Pinang,11,5,6
1/04/2022,Poland,Sabah,1,1,0
1/04/2022,Poland,Sarawak,0,0,0
1/04/2022,Poland,Selangor,209,133,76
1/04/2022,Poland,Terengganu,0,0,0
1/04/2022,Poland,W.P. Labuan,0,0,0
1/04/2022,"North Korea, Democratic People's Republic of",Selangor,0,0,0
1/04/2022,Portugal,Johor,79,48,31
1/04/2022,Portugal,Kedah,13,9,4
1/04/2022,Portugal,Kelantan,0,0,0
1/04/2022,Portugal,Melaka,0,0,0
1/04/2022,Portugal,Pahang,0,0,0
1/04/2022,Portugal,Perak,0,0,0
1/04/2022,Portugal,Perlis,0,0,0
1/04/2022,Portugal,Pulau Pinang,14,5,9
1/04/2022,Portugal,Sabah,1,0,1
1/04/2022,Portugal,Sarawak,0,0,0
1/04/2022,Portugal,Selangor,184,121,63
1/04/2022,Portugal,W.P. Labuan,0,0,0
1/04/2022,Paraguay,Johor,1,0,1
1/04/2022,Paraguay,Kedah,0,0,0
1/04/2022,Paraguay,Perak,0,0,0
1/04/2022,Paraguay,Perlis,0,0,0
1/04/2022,Paraguay,Pulau Pinang,0,0,0
1/04/2022,Paraguay,Sabah,0,0,0
1/04/2022,Paraguay,Sarawak,0,0,0
1/04/2022,Paraguay,Selangor,3,1,2
1/04/2022,"Palestine, State of",Johor,4,4,0
1/04/2022,"Palestine, State of",Kedah,0,0,0
1/04/2022,"Palestine, State of",Kelantan,0,0,0
1/04/2022,"Palestine, State of",Melaka,0,0,0
1/04/2022,"Palestine, State of",Perak,0,0,0
1/04/2022,"Palestine, State of",Perlis,0,0,0
1/04/2022,"Palestine, State of",Pulau Pinang,0,0,0
1/04/2022,"Palestine, State of",Sabah,0,0,0
1/04/2022,"Palestine, State of",Sarawak,0,0,0
1/04/2022,"Palestine, State of",Selangor,142,111,31
1/04/2022,Qatar,Johor,0,0,0
1/04/2022,Qatar,Kedah,0,0,0
1/04/2022,Qatar,Perlis,0,0,0
1/04/2022,Qatar,Pulau Pinang,0,0,0
1/04/2022,Qatar,Sabah,0,0,0
1/04/2022,Qatar,Sarawak,0,0,0
1/04/2022,Qatar,Selangor,21,13,8
1/04/2022,Réunion,Johor,0,0,0
1/04/2022,Réunion,Sarawak,0,0,0
1/04/2022,Romania,Johor,30,17,13
1/04/2022,Romania,Kedah,1,0,1
1/04/2022,Romania,Kelantan,0,0,0
1/04/2022,Romania,Negeri Sembilan,0,0,0
1/04/2022,Romania,Pahang,0,0,0
1/04/2022,Romania,Perak,0,0,0
1/04/2022,Romania,Perlis,0,0,0
1/04/2022,Romania,Pulau Pinang,3,1,2
1/04/2022,Romania,Sabah,0,0,0
1/04/2022,Romania,Sarawak,1,1,0
1/04/2022,Romania,Selangor,126,73,53
1/04/2022,Romania,W.P. Labuan,0,0,0
1/04/2022,Russian Federation (Russia),Johor,102,58,44
1/04/2022,Russian Federation (Russia),Kedah,26,15,11
1/04/2022,Russian Federation (Russia),Kelantan,0,0,0
1/04/2022,Russian Federation (Russia),Melaka,0,0,0
1/04/2022,Russian Federation (Russia),Negeri Sembilan,0,0,0
1/04/2022,Russian Federation (Russia),Pahang,0,0,0
1/04/2022,Russian Federation (Russia),Perak,0,0,0
1/04/2022,Russian Federation (Russia),Perlis,0,0,0
1/04/2022,Russian Federation (Russia),Pulau Pinang,13,6,7
1/04/2022,Russian Federation (Russia),Sabah,3,1,2
1/04/2022,Russian Federation (Russia),Sarawak,1,1,0
1/04/2022,Russian Federation (Russia),Selangor,674,377,297
1/04/2022,Russian Federation (Russia),W.P. Labuan,0,0,0
1/04/2022,Rwanda,Johor,2,1,1
1/04/2022,Rwanda,Kedah,0,0,0
1/04/2022,Rwanda,Pulau Pinang,0,0,0
1/04/2022,Rwanda,Selangor,3,2,1
1/04/2022,Saudi Arabia,Johor,36,22,14
1/04/2022,Saudi Arabia,Kedah,0,0,0
1/04/2022,Saudi Arabia,Kelantan,0,0,0
1/04/2022,Saudi Arabia,Melaka,0,0,0
1/04/2022,Saudi Arabia,Perak,0,0,0
1/04/2022,Saudi Arabia,Perlis,0,0,0
1/04/2022,Saudi Arabia,Pulau Pinang,0,0,0
1/04/2022,Saudi Arabia,Sabah,0,0,0
1/04/2022,Saudi Arabia,Sarawak,0,0,0
1/04/2022,Saudi Arabia,Selangor,812,455,357
1/04/2022,Saudi Arabia,W.P. Labuan,0,0,0
1/04/2022,Sudan,Johor,1,1,0
1/04/2022,Sudan,Kedah,0,0,0
1/04/2022,Sudan,Kelantan,0,0,0
1/04/2022,Sudan,Perlis,0,0,0
1/04/2022,Sudan,Pulau Pinang,0,0,0
1/04/2022,Sudan,Sabah,0,0,0
1/04/2022,Sudan,Sarawak,0,0,0
1/04/2022,Sudan,Selangor,298,203,95
1/04/2022,Sudan,W.P. Labuan,0,0,0
1/04/2022,Senegal,Johor,0,0,0
1/04/2022,Senegal,Kedah,0,0,0
1/04/2022,Senegal,Kelantan,0,0,0
1/04/2022,Senegal,Perak,0,0,0
1/04/2022,Senegal,Perlis,0,0,0
1/04/2022,Senegal,Pulau Pinang,0,0,0
1/04/2022,Senegal,Sabah,0,0,0
1/04/2022,Senegal,Sarawak,0,0,0
1/04/2022,Senegal,Selangor,6,2,4
1/04/2022,Singapore,Johor,394144,249335,144809
1/04/2022,Singapore,Kedah,175,82,93
1/04/2022,Singapore,Kelantan,0,0,0
1/04/2022,Singapore,Melaka,0,0,0
1/04/2022,Singapore,Negeri Sembilan,0,0,0
1/04/2022,Singapore,Pahang,16,14,2
1/04/2022,Singapore,Perak,1058,486,572
1/04/2022,Singapore,Perlis,1,1,0
1/04/2022,Singapore,Pulau Pinang,4202,2328,1874
1/04/2022,Singapore,Sabah,282,165,117
1/04/2022,Singapore,Sarawak,378,201,177
1/04/2022,Singapore,Selangor,11595,6702,4893
1/04/2022,Singapore,Terengganu,0,0,0
1/04/2022,Singapore,W.P. Labuan,0,0,0
1/04/2022,South Georgia and the South Sandwich Islands,Johor,0,0,0
1/04/2022,South Georgia and the South Sandwich Islands,Sabah,0,0,0
1/04/2022,South Georgia and the South Sandwich Islands,Selangor,0,0,0
1/04/2022,Saint Helena,Sarawak,0,0,0
1/04/2022,Solomon Islands,Johor,0,0,0
1/04/2022,Solomon Islands,Perlis,0,0,0
1/04/2022,Solomon Islands,Pulau Pinang,0,0,0
1/04/2022,Solomon Islands,Sabah,0,0,0
1/04/2022,Solomon Islands,Sarawak,0,0,0
1/04/2022,Solomon Islands,Selangor,1,0,1
1/04/2022,Solomon Islands,W.P. Labuan,0,0,0
1/04/2022,Sierra Leone,Johor,0,0,0
1/04/2022,Sierra Leone,Kedah,0,0,0
1/04/2022,Sierra Leone,Perak,0,0,0
1/04/2022,Sierra Leone,Pulau Pinang,0,0,0
1/04/2022,Sierra Leone,Sabah,0,0,0
1/04/2022,Sierra Leone,Selangor,9,5,4
1/04/2022,El Salvador,Johor,0,0,0
1/04/2022,El Salvador,Kedah,0,0,0
1/04/2022,El Salvador,Perak,0,0,0
1/04/2022,El Salvador,Perlis,0,0,0
1/04/2022,El Salvador,Pulau Pinang,1,1,0
1/04/2022,El Salvador,Sabah,0,0,0
1/04/2022,El Salvador,Selangor,0,0,0
1/04/2022,El Salvador,W.P. Labuan,0,0,0
1/04/2022,San Marino,Johor,0,0,0
1/04/2022,San Marino,Selangor,0,0,0
1/04/2022,Somalia,Johor,0,0,0
1/04/2022,Somalia,Kedah,0,0,0
1/04/2022,Somalia,Kelantan,0,0,0
1/04/2022,Somalia,Perlis,0,0,0
1/04/2022,Somalia,Sabah,0,0,0
1/04/2022,Somalia,Sarawak,0,0,0
1/04/2022,Somalia,Selangor,121,84,37
1/04/2022,Serbia,Johor,1,0,1
1/04/2022,Serbia,Kedah,0,0,0
1/04/2022,Serbia,Kelantan,0,0,0
1/04/2022,Serbia,Pahang,1,1,0
1/04/2022,Serbia,Perak,0,0,0
1/04/2022,Serbia,Perlis,0,0,0
1/04/2022,Serbia,Pulau Pinang,0,0,0
1/04/2022,Serbia,Sabah,0,0,0
1/04/2022,Serbia,Sarawak,0,0,0
1/04/2022,Serbia,Selangor,12,5,7
1/04/2022,South Sudan,Johor,0,0,0
1/04/2022,South Sudan,Kedah,0,0,0
1/04/2022,South Sudan,Sarawak,0,0,0
1/04/2022,South Sudan,Selangor,23,13,10
1/04/2022,South Sudan,W.P. Labuan,0,0,0
1/04/2022,Sao Tome and Principe,Selangor,2,2,0
1/04/2022,Suriname,Johor,0,0,0
1/04/2022,Suriname,Kedah,0,0,0
1/04/2022,Suriname,Kelantan,0,0,0
1/04/2022,Suriname,Perak,0,0,0
1/04/2022,Suriname,Perlis,0,0,0
1/04/2022,Suriname,Pulau Pinang,0,0,0
1/04/2022,Suriname,Sabah,0,0,0
1/04/2022,Suriname,Sarawak,0,0,0
1/04/2022,Suriname,Selangor,1,1,0
1/04/2022,Slovakia,Johor,7,5,2
1/04/2022,Slovakia,Kedah,1,0,1
1/04/2022,Slovakia,Kelantan,0,0,0
1/04/2022,Slovakia,Negeri Sembilan,0,0,0
1/04/2022,Slovakia,Pahang,0,0,0
1/04/2022,Slovakia,Perak,0,0,0
1/04/2022,Slovakia,Perlis,0,0,0
1/04/2022,Slovakia,Pulau Pinang,8,7,1
1/04/2022,Slovakia,Sabah,0,0,0
1/04/2022,Slovakia,Sarawak,0,0,0
1/04/2022,Slovakia,Selangor,64,39,25
1/04/2022,Slovakia,W.P. Labuan,0,0,0
1/04/2022,Slovenia,Johor,7,3,4
1/04/2022,Slovenia,Kedah,0,0,0
1/04/2022,Slovenia,Kelantan,0,0,0
1/04/2022,Slovenia,Perak,0,0,0
1/04/2022,Slovenia,Perlis,0,0,0
1/04/2022,Slovenia,Pulau Pinang,0,0,0
1/04/2022,Slovenia,Sabah,0,0,0
1/04/2022,Slovenia,Sarawak,0,0,0
1/04/2022,Slovenia,Selangor,17,13,4
1/04/2022,Slovenia,W.P. Labuan,0,0,0
1/04/2022,Sweden,Johor,123,75,48
1/04/2022,Sweden,Kedah,4,4,0
1/04/2022,Sweden,Kelantan,0,0,0
1/04/2022,Sweden,Melaka,0,0,0
1/04/2022,Sweden,Negeri Sembilan,0,0,0
1/04/2022,Sweden,Pahang,0,0,0
1/04/2022,Sweden,Perak,1,1,0
1/04/2022,Sweden,Perlis,1,1,0
1/04/2022,Sweden,Pulau Pinang,20,16,4
1/04/2022,Sweden,Sabah,1,1,0
1/04/2022,Sweden,Sarawak,1,1,0
1/04/2022,Sweden,Selangor,392,256,136
1/04/2022,Sweden,W.P. Labuan,0,0,0
1/04/2022,Eswatini,Johor,0,0,0
1/04/2022,Eswatini,Kedah,0,0,0
1/04/2022,Eswatini,Pulau Pinang,0,0,0
1/04/2022,Eswatini,Sabah,0,0,0
1/04/2022,Eswatini,Selangor,3,2,1
1/04/2022,Seychelles,Johor,0,0,0
1/04/2022,Seychelles,Kedah,0,0,0
1/04/2022,Seychelles,Pulau Pinang,0,0,0
1/04/2022,Seychelles,Sabah,0,0,0
1/04/2022,Seychelles,Sarawak,0,0,0
1/04/2022,Seychelles,Selangor,42,18,24
1/04/2022,Syrian Arab Republic,Johor,3,1,2
1/04/2022,Syrian Arab Republic,Kedah,0,0,0
1/04/2022,Syrian Arab Republic,Kelantan,0,0,0
1/04/2022,Syrian Arab Republic,Pahang,0,0,0
1/04/2022,Syrian Arab Republic,Perlis,0,0,0
1/04/2022,Syrian Arab Republic,Pulau Pinang,0,0,0
1/04/2022,Syrian Arab Republic,Sabah,0,0,0
1/04/2022,Syrian Arab Republic,Sarawak,0,0,0
1/04/2022,Syrian Arab Republic,Selangor,352,222,130
1/04/2022,Syrian Arab Republic,W.P. Labuan,0,0,0
1/04/2022,Turks and Caicos Islands,Perlis,0,0,0
1/04/2022,TCD,Johor,0,0,0
1/04/2022,TCD,Kedah,0,0,0
1/04/2022,TCD,Perlis,0,0,0
1/04/2022,TCD,Selangor,13,9,4
1/04/2022,Togo,Johor,3,3,0
1/04/2022,Togo,Perak,0,0,0
1/04/2022,Togo,Pulau Pinang,0,0,0
1/04/2022,Togo,Selangor,0,0,0
1/04/2022,Thailand,Johor,890,143,747
1/04/2022,Thailand,Kedah,19821,17791,2030
1/04/2022,Thailand,Kelantan,6,5,1
1/04/2022,Thailand,Melaka,0,0,0
1/04/2022,Thailand,Negeri Sembilan,0,0,0
1/04/2022,Thailand,Pahang,2,0,2
1/04/2022,Thailand,Perak,1,0,1
1/04/2022,Thailand,Perlis,10082,9807,275
1/04/2022,Thailand,Pulau Pinang,131,59,72
1/04/2022,Thailand,Sabah,5,4,1
1/04/2022,Thailand,Sarawak,13,10,3
1/04/2022,Thailand,Selangor,2718,920,1798
1/04/2022,Thailand,Terengganu,0,0,0
1/04/2022,Thailand,W.P. Labuan,0,0,0
1/04/2022,Tajikistan,Johor,0,0,0
1/04/2022,Tajikistan,Kedah,0,0,0
1/04/2022,Tajikistan,Perlis,0,0,0
1/04/2022,Tajikistan,Pulau Pinang,0,0,0
1/04/2022,Tajikistan,Sabah,0,0,0
1/04/2022,Tajikistan,Selangor,14,9,5
1/04/2022,Tokelau,Selangor,0,0,0
1/04/2022,Turkmenistan,Johor,1,0,1
1/04/2022,Turkmenistan,Kedah,0,0,0
1/04/2022,Turkmenistan,Kelantan,0,0,0
1/04/2022,Turkmenistan,Perlis,0,0,0
1/04/2022,Turkmenistan,Pulau Pinang,0,0,0
1/04/2022,Turkmenistan,Sabah,0,0,0
1/04/2022,Turkmenistan,Sarawak,0,0,0
1/04/2022,Turkmenistan,Selangor,18,9,9
1/04/2022,Timor-Leste,Johor,0,0,0
1/04/2022,Timor-Leste,Kedah,0,0,0
1/04/2022,Timor-Leste,Perlis,0,0,0
1/04/2022,Timor-Leste,Pulau Pinang,1,0,1
1/04/2022,Timor-Leste,Sabah,0,0,0
1/04/2022,Timor-Leste,Sarawak,0,0,0
1/04/2022,Timor-Leste,Selangor,99,73,26
1/04/2022,Tonga,Johor,0,0,0
1/04/2022,Tonga,Pulau Pinang,0,0,0
1/04/2022,Tonga,Sarawak,0,0,0
1/04/2022,Tonga,Selangor,13,6,7
1/04/2022,Trinidad and Tobago,Johor,3,3,0
1/04/2022,Trinidad and Tobago,Kedah,0,0,0
1/04/2022,Trinidad and Tobago,Pahang,0,0,0
1/04/2022,Trinidad and Tobago,Pulau Pinang,0,0,0
1/04/2022,Trinidad and Tobago,Sabah,0,0,0
1/04/2022,Trinidad and Tobago,Sarawak,0,0,0
1/04/2022,Trinidad and Tobago,Selangor,13,8,5
1/04/2022,Tunisia,Johor,5,2,3
1/04/2022,Tunisia,Kedah,0,0,0
1/04/2022,Tunisia,Kelantan,0,0,0
1/04/2022,Tunisia,Melaka,0,0,0
1/04/2022,Tunisia,Perak,0,0,0
1/04/2022,Tunisia,Perlis,0,0,0
1/04/2022,Tunisia,Pulau Pinang,0,0,0
1/04/2022,Tunisia,Sabah,0,0,0
1/04/2022,Tunisia,Sarawak,0,0,0
1/04/2022,Tunisia,Selangor,72,46,26
1/04/2022,Tunisia,W.P. Labuan,0,0,0
1/04/2022,Türkiye,Johor,68,48,20
1/04/2022,Türkiye,Kedah,6,3,3
1/04/2022,Türkiye,Kelantan,0,0,0
1/04/2022,Türkiye,Melaka,0,0,0
1/04/2022,Türkiye,Negeri Sembilan,3,3,0
1/04/2022,Türkiye,Pahang,0,0,0
1/04/2022,Türkiye,Perak,1,1,0
1/04/2022,Türkiye,Perlis,0,0,0
1/04/2022,Türkiye,Pulau Pinang,16,9,7
1/04/2022,Türkiye,Sabah,0,0,0
1/04/2022,Türkiye,Sarawak,1,0,1
1/04/2022,Türkiye,Selangor,362,283,79
1/04/2022,Türkiye,W.P. Labuan,0,0,0
1/04/2022,Tuvalu,Selangor,0,0,0
1/04/2022,"Taiwan, Province of China",Johor,891,363,528
1/04/2022,"Taiwan, Province of China",Kedah,12,6,6
1/04/2022,"Taiwan, Province of China",Kelantan,0,0,0
1/04/2022,"Taiwan, Province of China",Melaka,0,0,0
1/04/2022,"Taiwan, Province of China",Negeri Sembilan,0,0,0
1/04/2022,"Taiwan, Province of China",Pahang,0,0,0
1/04/2022,"Taiwan, Province of China",Perak,4,2,2
1/04/2022,"Taiwan, Province of China",Perlis,0,0,0
1/04/2022,"Taiwan, Province of China",Pulau Pinang,164,115,49
1/04/2022,"Taiwan, Province of China",Sabah,3,2,1
1/04/2022,"Taiwan, Province of China",Sarawak,15,14,1
1/04/2022,"Taiwan, Province of China",Selangor,781,484,297
1/04/2022,"Taiwan, Province of China",W.P. Labuan,0,0,0
1/04/2022,"Tanzania, United Republic of",Johor,2,2,0
1/04/2022,"Tanzania, United Republic of",Kedah,0,0,0
1/04/2022,"Tanzania, United Republic of",Perak,0,0,0
1/04/2022,"Tanzania, United Republic of",Perlis,0,0,0
1/04/2022,"Tanzania, United Republic of",Pulau Pinang,0,0,0
1/04/2022,"Tanzania, United Republic of",Sabah,0,0,0
1/04/2022,"Tanzania, United Republic of",Sarawak,0,0,0
1/04/2022,"Tanzania, United Republic of",Selangor,44,20,24
1/04/2022,Uganda,Johor,0,0,0
1/04/2022,Uganda,Kedah,0,0,0
1/04/2022,Uganda,Perak,0,0,0
1/04/2022,Uganda,Perlis,0,0,0
1/04/2022,Uganda,Pulau Pinang,0,0,0
1/04/2022,Uganda,Sabah,0,0,0
1/04/2022,Uganda,Sarawak,0,0,0
1/04/2022,Uganda,Selangor,24,14,10
1/04/2022,Ukraine,Johor,34,20,14
1/04/2022,Ukraine,Kedah,2,0,2
1/04/2022,Ukraine,Kelantan,0,0,0
1/04/2022,Ukraine,Melaka,0,0,0
1/04/2022,Ukraine,Negeri Sembilan,0,0,0
1/04/2022,Ukraine,Pahang,0,0,0
1/04/2022,Ukraine,Perak,0,0,0
1/04/2022,Ukraine,Perlis,0,0,0
1/04/2022,Ukraine,Pulau Pinang,4,1,3
1/04/2022,Ukraine,Sabah,0,0,0
1/04/2022,Ukraine,Sarawak,0,0,0
1/04/2022,Ukraine,Selangor,166,76,90
1/04/2022,Ukraine,W.P. Labuan,0,0,0
1/04/2022,Uruguay,Johor,10,5,5
1/04/2022,Uruguay,Kedah,0,0,0
1/04/2022,Uruguay,Kelantan,0,0,0
1/04/2022,Uruguay,Perak,0,0,0
1/04/2022,Uruguay,Perlis,0,0,0
1/04/2022,Uruguay,Pulau Pinang,0,0,0
1/04/2022,Uruguay,Sabah,0,0,0
1/04/2022,Uruguay,Sarawak,0,0,0
1/04/2022,Uruguay,Selangor,8,3,5
1/04/2022,Uruguay,W.P. Labuan,0,0,0
1/04/2022,United States of America,Johor,1105,724,381
1/04/2022,United States of America,Kedah,103,54,49
1/04/2022,United States of America,Kelantan,2,2,0
1/04/2022,United States of America,Melaka,0,0,0
1/04/2022,United States of America,Negeri Sembilan,1,1,0
1/04/2022,United States of America,Pahang,2,1,1
1/04/2022,United States of America,Perak,13,8,5
1/04/2022,United States of America,Perlis,0,0,0
1/04/2022,United States of America,Pulau Pinang,471,321,150
1/04/2022,United States of America,Sabah,32,17,15
1/04/2022,United States of America,Sarawak,24,16,8
1/04/2022,United States of America,Selangor,3296,2105,1191
1/04/2022,United States of America,Terengganu,0,0,0
1/04/2022,United States of America,W.P. Labuan,0,0,0
1/04/2022,Uzbekistan,Johor,18,4,14
1/04/2022,Uzbekistan,Kedah,0,0,0
1/04/2022,Uzbekistan,Kelantan,0,0,0
1/04/2022,Uzbekistan,Perak,0,0,0
1/04/2022,Uzbekistan,Perlis,0,0,0
1/04/2022,Uzbekistan,Pulau Pinang,1,0,1
1/04/2022,Uzbekistan,Sabah,0,0,0
1/04/2022,Uzbekistan,Sarawak,0,0,0
1/04/2022,Uzbekistan,Selangor,92,52,40
1/04/2022,Holy See,Johor,0,0,0
1/04/2022,Holy See,Sarawak,0,0,0
1/04/2022,Holy See,Selangor,0,0,0
1/04/2022,Saint Vincent and the Grenadines,Johor,0,0,0
1/04/2022,Saint Vincent and the Grenadines,Kedah,0,0,0
1/04/2022,Saint Vincent and the Grenadines,Pulau Pinang,0,0,0
1/04/2022,Saint Vincent and the Grenadines,Sarawak,0,0,0
1/04/2022,Saint Vincent and the Grenadines,Selangor,0,0,0
1/04/2022,"Venezuela, Bolivarian Republic of",Johor,3,0,3
1/04/2022,"Venezuela, Bolivarian Republic of",Kedah,0,0,0
1/04/2022,"Venezuela, Bolivarian Republic of",Kelantan,0,0,0
1/04/2022,"Venezuela, Bolivarian Republic of",Melaka,0,0,0
1/04/2022,"Venezuela, Bolivarian Republic of",Perak,0,0,0
1/04/2022,"Venezuela, Bolivarian Republic of",Perlis,0,0,0
1/04/2022,"Venezuela, Bolivarian Republic of",Pulau Pinang,2,0,2
1/04/2022,"Venezuela, Bolivarian Republic of",Sabah,0,0,0
1/04/2022,"Venezuela, Bolivarian Republic of",Sarawak,0,0,0
1/04/2022,"Venezuela, Bolivarian Republic of",Selangor,18,13,5
1/04/2022,"Venezuela, Bolivarian Republic of",W.P. Labuan,0,0,0
1/04/2022,Viet Nam,Johor,2487,659,1828
1/04/2022,Viet Nam,Kedah,3,1,2
1/04/2022,Viet Nam,Kelantan,0,0,0
1/04/2022,Viet Nam,Melaka,0,0,0
1/04/2022,Viet Nam,Negeri Sembilan,0,0,0
1/04/2022,Viet Nam,Pahang,0,0,0
1/04/2022,Viet Nam,Perak,1,0,1
1/04/2022,Viet Nam,Perlis,0,0,0
1/04/2022,Viet Nam,Pulau Pinang,389,104,285
1/04/2022,Viet Nam,Sabah,3,1,2
1/04/2022,Viet Nam,Sarawak,13,6,7
1/04/2022,Viet Nam,Selangor,4837,1612,3225
1/04/2022,Viet Nam,Terengganu,0,0,0
1/04/2022,Viet Nam,W.P. Labuan,0,0,0
1/04/2022,Vanuatu,Johor,5,5,0
1/04/2022,Vanuatu,Kedah,0,0,0
1/04/2022,Vanuatu,Pulau Pinang,0,0,0
1/04/2022,Vanuatu,Sabah,0,0,0
1/04/2022,Vanuatu,Sarawak,0,0,0
1/04/2022,Vanuatu,Selangor,8,8,0
1/04/2022, Samoa,Johor,0,0,0
1/04/2022, Samoa,Sarawak,0,0,0
1/04/2022, Samoa,Selangor,0,0,0
1/04/2022,Yemen,Johor,25,15,10
1/04/2022,Yemen,Kedah,0,0,0
1/04/2022,Yemen,Kelantan,0,0,0
1/04/2022,Yemen,Melaka,0,0,0
1/04/2022,Yemen,Pahang,0,0,0
1/04/2022,Yemen,Perak,0,0,0
1/04/2022,Yemen,Perlis,0,0,0
1/04/2022,Yemen,Pulau Pinang,0,0,0
1/04/2022,Yemen,Sabah,0,0,0
1/04/2022,Yemen,Sarawak,0,0,0
1/04/2022,Yemen,Selangor,695,482,213
1/04/2022,Yemen,W.P. Labuan,0,0,0
1/04/2022,South Africa,Johor,102,62,40
1/04/2022,South Africa,Kedah,7,4,3
1/04/2022,South Africa,Kelantan,0,0,0
1/04/2022,South Africa,Melaka,0,0,0
1/04/2022,South Africa,Pahang,0,0,0
1/04/2022,South Africa,Perak,1,1,0
1/04/2022,South Africa,Perlis,0,0,0
1/04/2022,South Africa,Pulau Pinang,21,12,9
1/04/2022,South Africa,Sabah,3,2,1
1/04/2022,South Africa,Sarawak,5,5,0
1/04/2022,South Africa,Selangor,386,231,155
1/04/2022,South Africa,Terengganu,0,0,0
1/04/2022,South Africa,W.P. Labuan,0,0,0
1/04/2022,ZAR,Selangor,0,0,0
1/04/2022,Zambia,Johor,0,0,0
1/04/2022,Zambia,Kedah,0,0,0
1/04/2022,Zambia,Perak,0,0,0
1/04/2022,Zambia,Perlis,0,0,0
1/04/2022,Zambia,Pulau Pinang,0,0,0
1/04/2022,Zambia,Sabah,1,1,0
1/04/2022,Zambia,Sarawak,0,0,0
1/04/2022,Zambia,Selangor,13,8,5
1/04/2022,Zimbabwe,Johor,2,1,1
1/04/2022,Zimbabwe,Kedah,0,0,0
1/04/2022,Zimbabwe,Kelantan,0,0,0
1/04/2022,Zimbabwe,Perak,0,0,0
1/04/2022,Zimbabwe,Perlis,0,0,0
1/04/2022,Zimbabwe,Pulau Pinang,0,0,0
1/04/2022,Zimbabwe,Sabah,0,0,0
1/04/2022,Zimbabwe,Sarawak,0,0,0
1/04/2022,Zimbabwe,Selangor,51,26,25
1/05/2022,Aruba,Kedah,0,0,0
1/05/2022,Aruba,Pulau Pinang,0,0,0
1/05/2022,Afghanistan,Johor,1,1,0
1/05/2022,Afghanistan,Kedah,0,0,0
1/05/2022,Afghanistan,Perlis,0,0,0
1/05/2022,Afghanistan,Pulau Pinang,0,0,0
1/05/2022,Afghanistan,Sarawak,0,0,0
1/05/2022,Afghanistan,Selangor,126,93,33
1/05/2022,Angola,Johor,0,0,0
1/05/2022,Angola,Kedah,0,0,0
1/05/2022,Angola,Sabah,0,0,0
1/05/2022,Angola,Selangor,2,2,0
1/05/2022,Anguilla,Selangor,0,0,0
1/05/2022,Albania,Johor,2,2,0
1/05/2022,Albania,Kedah,0,0,0
1/05/2022,Albania,Perak,0,0,0
1/05/2022,Albania,Perlis,1,1,0
1/05/2022,Albania,Pulau Pinang,0,0,0
1/05/2022,Albania,Sabah,0,0,0
1/05/2022,Albania,Sarawak,0,0,0
1/05/2022,Albania,Selangor,17,12,5
1/05/2022,Andorra,Johor,0,0,0
1/05/2022,Andorra,Kedah,0,0,0
1/05/2022,Andorra,Perlis,0,0,0
1/05/2022,Andorra,Pulau Pinang,0,0,0
1/05/2022,Andorra,Selangor,2,1,1
1/05/2022,Antigua and Barbuda,Selangor,0,0,0
1/05/2022,United Arab Emirates,Johor,11,9,2
1/05/2022,United Arab Emirates,Kedah,0,0,0
1/05/2022,United Arab Emirates,Kelantan,0,0,0
1/05/2022,United Arab Emirates,Perak,0,0,0
1/05/2022,United Arab Emirates,Perlis,0,0,0
1/05/2022,United Arab Emirates,Pulau Pinang,0,0,0
1/05/2022,United Arab Emirates,Sabah,0,0,0
1/05/2022,United Arab Emirates,Sarawak,0,0,0
1/05/2022,United Arab Emirates,Selangor,219,149,70
1/05/2022,Argentina,Johor,36,23,13
1/05/2022,Argentina,Kedah,4,3,1
1/05/2022,Argentina,Kelantan,0,0,0
1/05/2022,Argentina,Melaka,0,0,0
1/05/2022,Argentina,Perak,1,1,0
1/05/2022,Argentina,Perlis,6,4,2
1/05/2022,Argentina,Pulau Pinang,3,1,2
1/05/2022,Argentina,Sabah,1,0,1
1/05/2022,Argentina,Sarawak,0,0,0
1/05/2022,Argentina,Selangor,121,73,48
1/05/2022,Argentina,W.P. Labuan,0,0,0
1/05/2022,Armenia,Johor,1,1,0
1/05/2022,Armenia,Kedah,0,0,0
1/05/2022,Armenia,Kelantan,0,0,0
1/05/2022,Armenia,Perak,0,0,0
1/05/2022,Armenia,Perlis,0,0,0
1/05/2022,Armenia,Pulau Pinang,0,0,0
1/05/2022,Armenia,Sabah,0,0,0
1/05/2022,Armenia,Sarawak,0,0,0
1/05/2022,Armenia,Selangor,10,3,7
1/05/2022,Antarctica,Selangor,1,1,0
1/05/2022,Antigua and Barbuda,Johor,0,0,0
1/05/2022,Antigua and Barbuda,Kedah,2,2,0
1/05/2022,Antigua and Barbuda,Pulau Pinang,0,0,0
1/05/2022,Antigua and Barbuda,Sarawak,0,0,0
1/05/2022,Antigua and Barbuda,Selangor,3,3,0
1/05/2022,Australia,Johor,2184,1440,744
1/05/2022,Australia,Kedah,140,87,53
1/05/2022,Australia,Kelantan,0,0,0
1/05/2022,Australia,Melaka,0,0,0
1/05/2022,Australia,Negeri Sembilan,0,0,0
1/05/2022,Australia,Pahang,1,1,0
1/05/2022,Australia,Perak,64,39,25
1/05/2022,Australia,Perlis,10,10,0
1/05/2022,Australia,Pulau Pinang,640,368,272
1/05/2022,Australia,Sabah,144,79,65
1/05/2022,Australia,Sarawak,145,83,62
1/05/2022,Australia,Selangor,6141,3970,2171
1/05/2022,Australia,Terengganu,0,0,0
1/05/2022,Australia,W.P. Labuan,0,0,0
1/05/2022,Austria,Johor,78,52,26
1/05/2022,Austria,Kedah,6,6,0
1/05/2022,Austria,Kelantan,0,0,0
1/05/2022,Austria,Melaka,0,0,0
1/05/2022,Austria,Negeri Sembilan,1,1,0
1/05/2022,Austria,Pahang,0,0,0
1/05/2022,Austria,Perak,2,2,0
1/05/2022,Austria,Perlis,3,1,2
1/05/2022,Austria,Pulau Pinang,36,29,7
1/05/2022,Austria,Sabah,3,3,0
1/05/2022,Austria,Sarawak,3,2,1
1/05/2022,Austria,Selangor,306,214,92
1/05/2022,Austria,Terengganu,0,0,0
1/05/2022,Austria,W.P. Labuan,0,0,0
1/05/2022,Azerbaijan,Johor,1,0,1
1/05/2022,Azerbaijan,Kedah,1,0,1
1/05/2022,Azerbaijan,Kelantan,0,0,0
1/05/2022,Azerbaijan,Melaka,0,0,0
1/05/2022,Azerbaijan,Perlis,0,0,0
1/05/2022,Azerbaijan,Pulau Pinang,0,0,0
1/05/2022,Azerbaijan,Sabah,0,0,0
1/05/2022,Azerbaijan,Sarawak,0,0,0
1/05/2022,Azerbaijan,Selangor,31,20,11
1/05/2022,Azerbaijan,W.P. Labuan,0,0,0
1/05/2022,Burundi,Pulau Pinang,0,0,0
1/05/2022,Burundi,Sarawak,0,0,0
1/05/2022,Burundi,Selangor,0,0,0
1/05/2022,Belgium,Johor,148,110,38
1/05/2022,Belgium,Kedah,10,8,2
1/05/2022,Belgium,Kelantan,0,0,0
1/05/2022,Belgium,Melaka,0,0,0
1/05/2022,Belgium,Negeri Sembilan,0,0,0
1/05/2022,Belgium,Pahang,0,0,0
1/05/2022,Belgium,Perak,3,3,0
1/05/2022,Belgium,Perlis,3,2,1
1/05/2022,Belgium,Pulau Pinang,22,14,8
1/05/2022,Belgium,Sabah,3,2,1
1/05/2022,Belgium,Sarawak,0,0,0
1/05/2022,Belgium,Selangor,356,256,100
1/05/2022,Belgium,W.P. Labuan,0,0,0
1/05/2022,Benin,Johor,0,0,0
1/05/2022,Benin,Kedah,0,0,0
1/05/2022,Benin,Perak,0,0,0
1/05/2022,Benin,Pulau Pinang,0,0,0
1/05/2022,Benin,Sabah,0,0,0
1/05/2022,Benin,Sarawak,0,0,0
1/05/2022,Benin,Selangor,0,0,0
1/05/2022,Burkina Faso,Perak,0,0,0
1/05/2022,Burkina Faso,Pulau Pinang,0,0,0
1/05/2022,Burkina Faso,Selangor,1,0,1
1/05/2022,Bangladesh,Johor,645,535,110
1/05/2022,Bangladesh,Kedah,5,3,2
1/05/2022,Bangladesh,Kelantan,0,0,0
1/05/2022,Bangladesh,Melaka,0,0,0
1/05/2022,Bangladesh,Negeri Sembilan,0,0,0
1/05/2022,Bangladesh,Pahang,0,0,0
1/05/2022,Bangladesh,Perak,0,0,0
1/05/2022,Bangladesh,Perlis,2,2,0
1/05/2022,Bangladesh,Pulau Pinang,40,33,7
1/05/2022,Bangladesh,Sabah,0,0,0
1/05/2022,Bangladesh,Sarawak,5,5,0
1/05/2022,Bangladesh,Selangor,12646,11636,1010
1/05/2022,Bangladesh,W.P. Labuan,0,0,0
1/05/2022,Bulgaria,Johor,21,9,12
1/05/2022,Bulgaria,Kedah,8,4,4
1/05/2022,Bulgaria,Kelantan,0,0,0
1/05/2022,Bulgaria,Pahang,0,0,0
1/05/2022,Bulgaria,Perak,0,0,0
1/05/2022,Bulgaria,Perlis,0,0,0
1/05/2022,Bulgaria,Pulau Pinang,3,1,2
1/05/2022,Bulgaria,Sabah,0,0,0
1/05/2022,Bulgaria,Sarawak,0,0,0
1/05/2022,Bulgaria,Selangor,69,47,22
1/05/2022,Bulgaria,W.P. Labuan,0,0,0
1/05/2022,Bahrain,Johor,1,0,1
1/05/2022,Bahrain,Kedah,0,0,0
1/05/2022,Bahrain,Kelantan,0,0,0
1/05/2022,Bahrain,Perlis,0,0,0
1/05/2022,Bahrain,Pulau Pinang,0,0,0
1/05/2022,Bahrain,Sabah,0,0,0
1/05/2022,Bahrain,Sarawak,0,0,0
1/05/2022,Bahrain,Selangor,86,51,35
1/05/2022,Bahamas,Johor,1,0,1
1/05/2022,Bahamas,Kedah,0,0,0
1/05/2022,Bahamas,Perak,0,0,0
1/05/2022,Bahamas,Sabah,0,0,0
1/05/2022,Bahamas,Sarawak,0,0,0
1/05/2022,Bahamas,Selangor,2,1,1
1/05/2022,Bosnia and Herzegovina,Johor,3,3,0
1/05/2022,Bosnia and Herzegovina,Kedah,0,0,0
1/05/2022,Bosnia and Herzegovina,Perlis,0,0,0
1/05/2022,Bosnia and Herzegovina,Pulau Pinang,0,0,0
1/05/2022,Bosnia and Herzegovina,Sabah,0,0,0
1/05/2022,Bosnia and Herzegovina,Sarawak,0,0,0
1/05/2022,Bosnia and Herzegovina,Selangor,25,16,9
1/05/2022,Belarus,Johor,8,5,3
1/05/2022,Belarus,Kedah,0,0,0
1/05/2022,Belarus,Kelantan,0,0,0
1/05/2022,Belarus,Pahang,0,0,0
1/05/2022,Belarus,Perak,0,0,0
1/05/2022,Belarus,Perlis,1,0,1
1/05/2022,Belarus,Pulau Pinang,8,5,3
1/05/2022,Belarus,Sabah,2,1,1
1/05/2022,Belarus,Sarawak,1,1,0
1/05/2022,Belarus,Selangor,59,28,31
1/05/2022,Belarus,W.P. Labuan,0,0,0
1/05/2022,Belize,Johor,0,0,0
1/05/2022,Belize,Pulau Pinang,0,0,0
1/05/2022,Belize,Sarawak,0,0,0
1/05/2022,Belize,Selangor,1,1,0
1/05/2022,Bermuda,Selangor,0,0,0
1/05/2022,Bolivia,Johor,0,0,0
1/05/2022,Bolivia,Kedah,0,0,0
1/05/2022,Bolivia,Melaka,0,0,0
1/05/2022,Bolivia,Perak,0,0,0
1/05/2022,Bolivia,Perlis,0,0,0
1/05/2022,Bolivia,Pulau Pinang,4,3,1
1/05/2022,Bolivia,Sabah,0,0,0
1/05/2022,Bolivia,Sarawak,0,0,0
1/05/2022,Bolivia,Selangor,21,13,8
1/05/2022,Brazil,Johor,174,88,86
1/05/2022,Brazil,Kedah,15,6,9
1/05/2022,Brazil,Kelantan,1,1,0
1/05/2022,Brazil,Melaka,0,0,0
1/05/2022,Brazil,Pahang,0,0,0
1/05/2022,Brazil,Perak,1,1,0
1/05/2022,Brazil,Perlis,2,0,2
1/05/2022,Brazil,Pulau Pinang,6,5,1
1/05/2022,Brazil,Sabah,5,1,4
1/05/2022,Brazil,Sarawak,1,1,0
1/05/2022,Brazil,Selangor,365,217,148
1/05/2022,Brazil,W.P. Labuan,0,0,0
1/05/2022,Barbados,Johor,0,0,0
1/05/2022,Barbados,Kedah,0,0,0
1/05/2022,Barbados,Perlis,0,0,0
1/05/2022,Barbados,Pulau Pinang,0,0,0
1/05/2022,Barbados,Selangor,0,0,0
1/05/2022,Brunei Darussalam,Johor,104,59,45
1/05/2022,Brunei Darussalam,Kedah,5,3,2
1/05/2022,Brunei Darussalam,Kelantan,0,0,0
1/05/2022,Brunei Darussalam,Melaka,0,0,0
1/05/2022,Brunei Darussalam,Pahang,0,0,0
1/05/2022,Brunei Darussalam,Perak,0,0,0
1/05/2022,Brunei Darussalam,Perlis,0,0,0
1/05/2022,Brunei Darussalam,Pulau Pinang,5,3,2
1/05/2022,Brunei Darussalam,Sabah,318,172,146
1/05/2022,Brunei Darussalam,Sarawak,861,684,177
1/05/2022,Brunei Darussalam,Selangor,1777,974,803
1/05/2022,Brunei Darussalam,W.P. Labuan,24,17,7
1/05/2022,Bhutan,Johor,1,1,0
1/05/2022,Bhutan,Kedah,0,0,0
1/05/2022,Bhutan,Perak,0,0,0
1/05/2022,Bhutan,Perlis,0,0,0
1/05/2022,Bhutan,Pulau Pinang,0,0,0
1/05/2022,Bhutan,Sabah,0,0,0
1/05/2022,Bhutan,Sarawak,0,0,0
1/05/2022,Bhutan,Selangor,20,6,14
1/05/2022,Botswana,Johor,1,0,1
1/05/2022,Botswana,Kedah,1,1,0
1/05/2022,Botswana,Perlis,0,0,0
1/05/2022,Botswana,Pulau Pinang,0,0,0
1/05/2022,Botswana,Sabah,0,0,0
1/05/2022,Botswana,Sarawak,0,0,0
1/05/2022,Botswana,Selangor,20,13,7
1/05/2022,Central African Republic,Kedah,0,0,0
1/05/2022,Central African Republic,Selangor,0,0,0
1/05/2022,Canada,Johor,569,353,216
1/05/2022,Canada,Kedah,48,27,21
1/05/2022,Canada,Kelantan,1,1,0
1/05/2022,Canada,Melaka,1,1,0
1/05/2022,Canada,Negeri Sembilan,0,0,0
1/05/2022,Canada,Pahang,0,0,0
1/05/2022,Canada,Perak,3,3,0
1/05/2022,Canada,Perlis,6,5,1
1/05/2022,Canada,Pulau Pinang,113,67,46
1/05/2022,Canada,Sabah,26,14,12
1/05/2022,Canada,Sarawak,22,8,14
1/05/2022,Canada,Selangor,1552,961,591
1/05/2022,Canada,Terengganu,0,0,0
1/05/2022,Canada,W.P. Labuan,0,0,0
1/05/2022,Cocos (Keeling) Islands,Selangor,0,0,0
1/05/2022,Switzerland,Johor,234,158,76
1/05/2022,Switzerland,Kedah,28,16,12
1/05/2022,Switzerland,Kelantan,0,0,0
1/05/2022,Switzerland,Melaka,0,0,0
1/05/2022,Switzerland,Negeri Sembilan,0,0,0
1/05/2022,Switzerland,Pahang,1,0,1
1/05/2022,Switzerland,Perak,2,2,0
1/05/2022,Switzerland,Perlis,1,1,0
1/05/2022,Switzerland,Pulau Pinang,38,27,11
1/05/2022,Switzerland,Sabah,7,5,2
1/05/2022,Switzerland,Sarawak,11,7,4
1/05/2022,Switzerland,Selangor,451,300,151
1/05/2022,Switzerland,W.P. Labuan,0,0,0
1/05/2022,Chile,Johor,17,8,9
1/05/2022,Chile,Kedah,5,2,3
1/05/2022,Chile,Kelantan,0,0,0
1/05/2022,Chile,Melaka,0,0,0
1/05/2022,Chile,Pahang,0,0,0
1/05/2022,Chile,Perak,0,0,0
1/05/2022,Chile,Perlis,2,2,0
1/05/2022,Chile,Pulau Pinang,2,2,0
1/05/2022,Chile,Sabah,0,0,0
1/05/2022,Chile,Sarawak,0,0,0
1/05/2022,Chile,Selangor,69,38,31
1/05/2022,China,Johor,8874,3776,5098
1/05/2022,China,Kedah,121,48,73
1/05/2022,China,Kelantan,1,0,1
1/05/2022,China,Melaka,1,1,0
1/05/2022,China,Pahang,3,1,2
1/05/2022,China,Perak,38,20,18
1/05/2022,China,Perlis,1,0,1
1/05/2022,China,Pulau Pinang,405,202,203
1/05/2022,China,Sabah,128,59,69
1/05/2022,China,Sarawak,79,46,33
1/05/2022,China,Selangor,6684,4288,2396
1/05/2022,China,Terengganu,0,0,0
1/05/2022,China,W.P. Labuan,0,0,0
1/05/2022,Côte d'Ivoire,Johor,0,0,0
1/05/2022,Côte d'Ivoire,Kedah,0,0,0
1/05/2022,Côte d'Ivoire,Pulau Pinang,0,0,0
1/05/2022,Côte d'Ivoire,Sabah,1,0,1
1/05/2022,Côte d'Ivoire,Sarawak,0,0,0
1/05/2022,Côte d'Ivoire,Selangor,7,5,2
1/05/2022,Cameroon,Johor,1,1,0
1/05/2022,Cameroon,Kedah,0,0,0
1/05/2022,Cameroon,Pulau Pinang,0,0,0
1/05/2022,Cameroon,Sabah,0,0,0
1/05/2022,Cameroon,Sarawak,1,0,1
1/05/2022,Cameroon,Selangor,7,4,3
1/05/2022,Congo,Johor,0,0,0
1/05/2022,Congo,Pulau Pinang,0,0,0
1/05/2022,Congo,Sarawak,0,0,0
1/05/2022,Congo,Selangor,6,5,1
1/05/2022,Congo,Johor,0,0,0
1/05/2022,Congo,Kedah,0,0,0
1/05/2022,Congo,Selangor,0,0,0
1/05/2022,Cook Islands,Selangor,0,0,0
1/05/2022,Colombia,Johor,21,11,10
1/05/2022,Colombia,Kedah,3,1,2
1/05/2022,Colombia,Perak,2,1,1
1/05/2022,Colombia,Pulau Pinang,2,0,2
1/05/2022,Colombia,Sabah,0,0,0
1/05/2022,Colombia,Sarawak,0,0,0
1/05/2022,Colombia,Selangor,99,54,45
1/05/2022,Colombia,W.P. Labuan,0,0,0
1/05/2022,Comoros,Johor,0,0,0
1/05/2022,Comoros,Kedah,0,0,0
1/05/2022,Comoros,Selangor,6,5,1
1/05/2022,Cabo Verde,Johor,0,0,0
1/05/2022,Cabo Verde,Kedah,0,0,0
1/05/2022,Cabo Verde,Pulau Pinang,0,0,0
1/05/2022,Cabo Verde,Sabah,0,0,0
1/05/2022,Cabo Verde,Selangor,3,2,1
1/05/2022,Costa Rica,Johor,3,2,1
1/05/2022,Costa Rica,Kedah,2,1,1
1/05/2022,Costa Rica,Perak,0,0,0
1/05/2022,Costa Rica,Perlis,1,1,0
1/05/2022,Costa Rica,Pulau Pinang,2,0,2
1/05/2022,Costa Rica,Sabah,0,0,0
1/05/2022,Costa Rica,Sarawak,0,0,0
1/05/2022,Costa Rica,Selangor,25,20,5
1/05/2022,Cuba,Johor,2,2,0
1/05/2022,Cuba,Kedah,0,0,0
1/05/2022,Cuba,Perlis,0,0,0
1/05/2022,Cuba,Pulau Pinang,0,0,0
1/05/2022,Cuba,Sabah,0,0,0
1/05/2022,Cuba,Sarawak,0,0,0
1/05/2022,Cuba,Selangor,12,7,5
1/05/2022,Cyprus,Johor,8,8,0
1/05/2022,Cyprus,Kedah,3,1,2
1/05/2022,Cyprus,Perak,0,0,0
1/05/2022,Cyprus,Perlis,0,0,0
1/05/2022,Cyprus,Pulau Pinang,4,3,1
1/05/2022,Cyprus,Sabah,0,0,0
1/05/2022,Cyprus,Sarawak,0,0,0
1/05/2022,Cyprus,Selangor,27,18,9
1/05/2022,Czechia,Johor,27,20,7
1/05/2022,Czechia,Kedah,6,3,3
1/05/2022,Czechia,Kelantan,1,1,0
1/05/2022,Czechia,Melaka,0,0,0
1/05/2022,Czechia,Negeri Sembilan,0,0,0
1/05/2022,Czechia,Perak,0,0,0
1/05/2022,Czechia,Perlis,0,0,0
1/05/2022,Czechia,Pulau Pinang,1,0,1
1/05/2022,Czechia,Sabah,0,0,0
1/05/2022,Czechia,Sarawak,0,0,0
1/05/2022,Czechia,Selangor,122,83,39
1/05/2022,Czechia,W.P. Labuan,0,0,0
1/05/2022,Germany,Johor,973,665,308
1/05/2022,Germany,Kedah,97,59,38
1/05/2022,Germany,Kelantan,2,1,1
1/05/2022,Germany,Melaka,1,1,0
1/05/2022,Germany,Negeri Sembilan,0,0,0
1/05/2022,Germany,Pahang,0,0,0
1/05/2022,Germany,Perak,12,7,5
1/05/2022,Germany,Perlis,27,18,9
1/05/2022,Germany,Pulau Pinang,283,208,75
1/05/2022,Germany,Sabah,36,22,14
1/05/2022,Germany,Sarawak,57,36,21
1/05/2022,Germany,Selangor,2906,1989,917
1/05/2022,Germany,Terengganu,0,0,0
1/05/2022,Germany,W.P. Labuan,0,0,0
1/05/2022,Djibouti,Johor,0,0,0
1/05/2022,Djibouti,Selangor,6,3,3
1/05/2022,Dominica,Johor,6,4,2
1/05/2022,Dominica,Kedah,0,0,0
1/05/2022,Dominica,Pulau Pinang,0,0,0
1/05/2022,Dominica,Sabah,0,0,0
1/05/2022,Dominica,Sarawak,0,0,0
1/05/2022,Dominica,Selangor,21,17,4
1/05/2022,Dominica,W.P. Labuan,0,0,0
1/05/2022,Denmark,Johor,150,94,56
1/05/2022,Denmark,Kedah,17,10,7
1/05/2022,Denmark,Kelantan,0,0,0
1/05/2022,Denmark,Melaka,0,0,0
1/05/2022,Denmark,Negeri Sembilan,0,0,0
1/05/2022,Denmark,Pahang,0,0,0
1/05/2022,Denmark,Perak,0,0,0
1/05/2022,Denmark,Perlis,0,0,0
1/05/2022,Denmark,Pulau Pinang,25,16,9
1/05/2022,Denmark,Sabah,4,2,2
1/05/2022,Denmark,Sarawak,2,2,0
1/05/2022,Denmark,Selangor,422,288,134
1/05/2022,Denmark,W.P. Labuan,0,0,0
1/05/2022,Dominican Republic,Johor,2,1,1
1/05/2022,Dominican Republic,Kedah,0,0,0
1/05/2022,Dominican Republic,Perak,0,0,0
1/05/2022,Dominican Republic,Perlis,0,0,0
1/05/2022,Dominican Republic,Pulau Pinang,1,0,1
1/05/2022,Dominican Republic,Sabah,0,0,0
1/05/2022,Dominican Republic,Sarawak,0,0,0
1/05/2022,Dominican Republic,Selangor,11,3,8
1/05/2022,Algeria,Johor,27,24,3
1/05/2022,Algeria,Kedah,0,0,0
1/05/2022,Algeria,Kelantan,0,0,0
1/05/2022,Algeria,Melaka,1,1,0
1/05/2022,Algeria,Perak,0,0,0
1/05/2022,Algeria,Perlis,0,0,0
1/05/2022,Algeria,Pulau Pinang,1,0,1
1/05/2022,Algeria,Sabah,0,0,0
1/05/2022,Algeria,Sarawak,0,0,0
1/05/2022,Algeria,Selangor,196,133,63
1/05/2022,Algeria,W.P. Labuan,0,0,0
1/05/2022,Ecuador,Johor,5,3,2
1/05/2022,Ecuador,Kedah,1,0,1
1/05/2022,Ecuador,Perak,0,0,0
1/05/2022,Ecuador,Perlis,0,0,0
1/05/2022,Ecuador,Pulau Pinang,3,1,2
1/05/2022,Ecuador,Sabah,0,0,0
1/05/2022,Ecuador,Sarawak,0,0,0
1/05/2022,Ecuador,Selangor,22,10,12
1/05/2022,Egypt,Johor,147,109,38
1/05/2022,Egypt,Kedah,2,2,0
1/05/2022,Egypt,Kelantan,0,0,0
1/05/2022,Egypt,Melaka,0,0,0
1/05/2022,Egypt,Pahang,0,0,0
1/05/2022,Egypt,Perak,0,0,0
1/05/2022,Egypt,Perlis,1,1,0
1/05/2022,Egypt,Pulau Pinang,0,0,0
1/05/2022,Egypt,Sabah,4,4,0
1/05/2022,Egypt,Sarawak,2,2,0
1/05/2022,Egypt,Selangor,1110,776,334
1/05/2022,Egypt,Terengganu,0,0,0
1/05/2022,Egypt,W.P. Labuan,0,0,0
1/05/2022,Eritrea,Johor,0,0,0
1/05/2022,Eritrea,Pulau Pinang,0,0,0
1/05/2022,Eritrea,Sabah,0,0,0
1/05/2022,Eritrea,Selangor,9,3,6
1/05/2022,Spain,Johor,230,145,85
1/05/2022,Spain,Kedah,10,8,2
1/05/2022,Spain,Kelantan,0,0,0
1/05/2022,Spain,Melaka,0,0,0
1/05/2022,Spain,Negeri Sembilan,0,0,0
1/05/2022,Spain,Pahang,0,0,0
1/05/2022,Spain,Perak,1,1,0
1/05/2022,Spain,Perlis,0,0,0
1/05/2022,Spain,Pulau Pinang,27,18,9
1/05/2022,Spain,Sabah,13,11,2
1/05/2022,Spain,Sarawak,3,2,1
1/05/2022,Spain,Selangor,712,467,245
1/05/2022,Spain,W.P. Labuan,0,0,0
1/05/2022,Estonia,Johor,10,7,3
1/05/2022,Estonia,Kedah,1,1,0
1/05/2022,Estonia,Kelantan,0,0,0
1/05/2022,Estonia,Pahang,0,0,0
1/05/2022,Estonia,Perak,0,0,0
1/05/2022,Estonia,Perlis,0,0,0
1/05/2022,Estonia,Pulau Pinang,2,0,2
1/05/2022,Estonia,Sabah,1,1,0
1/05/2022,Estonia,Sarawak,0,0,0
1/05/2022,Estonia,Selangor,36,22,14
1/05/2022,Estonia,W.P. Labuan,0,0,0
1/05/2022,Ethiopia,Johor,1,0,1
1/05/2022,Ethiopia,Kedah,0,0,0
1/05/2022,Ethiopia,Pulau Pinang,0,0,0
1/05/2022,Ethiopia,Sarawak,0,0,0
1/05/2022,Ethiopia,Selangor,25,23,2
1/05/2022,Finland,Johor,153,97,56
1/05/2022,Finland,Kedah,11,4,7
1/05/2022,Finland,Kelantan,0,0,0
1/05/2022,Finland,Melaka,0,0,0
1/05/2022,Finland,Negeri Sembilan,0,0,0
1/05/2022,Finland,Pahang,0,0,0
1/05/2022,Finland,Perak,0,0,0
1/05/2022,Finland,Perlis,0,0,0
1/05/2022,Finland,Pulau Pinang,6,3,3
1/05/2022,Finland,Sabah,7,5,2
1/05/2022,Finland,Sarawak,1,0,1
1/05/2022,Finland,Selangor,200,136,64
1/05/2022,Finland,W.P. Labuan,0,0,0
1/05/2022,Fiji,Johor,8,3,5
1/05/2022,Fiji,Kedah,0,0,0
1/05/2022,Fiji,Kelantan,0,0,0
1/05/2022,Fiji,Perak,0,0,0
1/05/2022,Fiji,Perlis,0,0,0
1/05/2022,Fiji,Pulau Pinang,0,0,0
1/05/2022,Fiji,Sabah,0,0,0
1/05/2022,Fiji,Sarawak,0,0,0
1/05/2022,Fiji,Selangor,27,16,11
1/05/2022,France,Johor,1290,804,486
1/05/2022,France,Kedah,129,73,56
1/05/2022,France,Kelantan,1,0,1
1/05/2022,France,Melaka,0,0,0
1/05/2022,France,Negeri Sembilan,4,2,2
1/05/2022,France,Pahang,0,0,0
1/05/2022,France,Perak,9,5,4
1/05/2022,France,Perlis,15,6,9
1/05/2022,France,Pulau Pinang,169,104,65
1/05/2022,France,Sabah,60,39,21
1/05/2022,France,Sarawak,12,9,3
1/05/2022,France,Selangor,3278,2103,1175
1/05/2022,France,Terengganu,0,0,0
1/05/2022,France,W.P. Labuan,0,0,0
1/05/2022,"Micronesia, Federated States of",Johor,0,0,0
1/05/2022,"Micronesia, Federated States of",Pulau Pinang,0,0,0
1/05/2022,"Micronesia, Federated States of",Selangor,0,0,0
1/05/2022,Gabon,Johor,0,0,0
1/05/2022,Gabon,Pulau Pinang,0,0,0
1/05/2022,Gabon,Sarawak,0,0,0
1/05/2022,Gabon,Selangor,1,1,0
1/05/2022,United Kingdom of Great Britain and Northern Ireland,Johor,2686,1794,892
1/05/2022,United Kingdom of Great Britain and Northern Ireland,Kedah,219,124,95
1/05/2022,United Kingdom of Great Britain and Northern Ireland,Kelantan,1,1,0
1/05/2022,United Kingdom of Great Britain and Northern Ireland,Melaka,1,0,1
1/05/2022,United Kingdom of Great Britain and Northern Ireland,Negeri Sembilan,0,0,0
1/05/2022,United Kingdom of Great Britain and Northern Ireland,Pahang,7,7,0
1/05/2022,United Kingdom of Great Britain and Northern Ireland,Perak,32,16,16
1/05/2022,United Kingdom of Great Britain and Northern Ireland,Perlis,23,16,7
1/05/2022,United Kingdom of Great Britain and Northern Ireland,Pulau Pinang,479,313,166
1/05/2022,United Kingdom of Great Britain and Northern Ireland,Sabah,262,149,113
1/05/2022,United Kingdom of Great Britain and Northern Ireland,Sarawak,88,53,35
1/05/2022,United Kingdom of Great Britain and Northern Ireland,Selangor,7316,4837,2479
1/05/2022,United Kingdom of Great Britain and Northern Ireland,Terengganu,0,0,0
1/05/2022,United Kingdom of Great Britain and Northern Ireland,W.P. Labuan,0,0,0
1/05/2022,Georgia,Johor,0,0,0
1/05/2022,Georgia,Kedah,2,1,1
1/05/2022,Georgia,Melaka,0,0,0
1/05/2022,Georgia,Perak,0,0,0
1/05/2022,Georgia,Perlis,0,0,0
1/05/2022,Georgia,Pulau Pinang,0,0,0
1/05/2022,Georgia,Sabah,0,0,0
1/05/2022,Georgia,Sarawak,0,0,0
1/05/2022,Georgia,Selangor,24,10,14
1/05/2022,Ghana,Johor,1,1,0
1/05/2022,Ghana,Kedah,0,0,0
1/05/2022,Ghana,Kelantan,0,0,0
1/05/2022,Ghana,Pulau Pinang,0,0,0
1/05/2022,Ghana,Sabah,0,0,0
1/05/2022,Ghana,Sarawak,0,0,0
1/05/2022,Ghana,Selangor,19,14,5
1/05/2022,Gibraltar,Johor,0,0,0
1/05/2022,Gibraltar,Sarawak,0,0,0
1/05/2022,Guinea,Johor,0,0,0
1/05/2022,Guinea,Kedah,0,0,0
1/05/2022,Guinea,Kelantan,0,0,0
1/05/2022,Guinea,Perlis,0,0,0
1/05/2022,Guinea,Pulau Pinang,0,0,0
1/05/2022,Guinea,Sabah,0,0,0
1/05/2022,Guinea,Sarawak,0,0,0
1/05/2022,Guinea,Selangor,30,19,11
1/05/2022,Guadeloupe,Selangor,0,0,0
1/05/2022,Gambia,Johor,2,1,1
1/05/2022,Gambia,Kedah,0,0,0
1/05/2022,Gambia,Kelantan,0,0,0
1/05/2022,Gambia,Pulau Pinang,0,0,0
1/05/2022,Gambia,Sabah,0,0,0
1/05/2022,Gambia,Sarawak,0,0,0
1/05/2022,Gambia,Selangor,7,5,2
1/05/2022,Guinea-Bissau,Johor,0,0,0
1/05/2022,Guinea-Bissau,Selangor,0,0,0
1/05/2022,Equatorial Guinea,Johor,0,0,0
1/05/2022,Equatorial Guinea,Selangor,0,0,0
1/05/2022,Greece,Johor,13,11,2
1/05/2022,Greece,Kedah,2,1,1
1/05/2022,Greece,Kelantan,0,0,0
1/05/2022,Greece,Melaka,0,0,0
1/05/2022,Greece,Negeri Sembilan,0,0,0
1/05/2022,Greece,Pahang,0,0,0
1/05/2022,Greece,Perak,0,0,0
1/05/2022,Greece,Perlis,0,0,0
1/05/2022,Greece,Pulau Pinang,3,2,1
1/05/2022,Greece,Sabah,0,0,0
1/05/2022,Greece,Sarawak,1,0,1
1/05/2022,Greece,Selangor,85,67,18
1/05/2022,Grenada,Johor,4,4,0
1/05/2022,Grenada,Kedah,0,0,0
1/05/2022,Grenada,Pulau Pinang,0,0,0
1/05/2022,Grenada,Sabah,0,0,0
1/05/2022,Grenada,Sarawak,0,0,0
1/05/2022,Grenada,Selangor,3,1,2
1/05/2022,Greenland,Johor,0,0,0
1/05/2022,Greenland,Selangor,0,0,0
1/05/2022,Guatemala,Johor,3,0,3
1/05/2022,Guatemala,Kedah,0,0,0
1/05/2022,Guatemala,Pahang,0,0,0
1/05/2022,Guatemala,Perak,0,0,0
1/05/2022,Guatemala,Pulau Pinang,3,1,2
1/05/2022,Guatemala,Sabah,0,0,0
1/05/2022,Guatemala,Sarawak,0,0,0
1/05/2022,Guatemala,Selangor,8,1,7
1/05/2022,Guatemala,W.P. Labuan,0,0,0
1/05/2022,Guyana,Johor,0,0,0
1/05/2022,Guyana,Kedah,0,0,0
1/05/2022,Guyana,Pulau Pinang,0,0,0
1/05/2022,Guyana,Sarawak,0,0,0
1/05/2022,Guyana,Selangor,1,1,0
1/05/2022,Hong Kong,Johor,9,5,4
1/05/2022,Hong Kong,Kedah,5,1,4
1/05/2022,Hong Kong,Kelantan,0,0,0
1/05/2022,Hong Kong,Pahang,0,0,0
1/05/2022,Hong Kong,Perak,7,5,2
1/05/2022,Hong Kong,Perlis,0,0,0
1/05/2022,Hong Kong,Pulau Pinang,150,93,57
1/05/2022,Hong Kong,Sabah,36,17,19
1/05/2022,Hong Kong,Sarawak,47,25,22
1/05/2022,Hong Kong,Selangor,1,1,0
1/05/2022,Hong Kong,Terengganu,0,0,0
1/05/2022,Heard Island and McDonald Islands,Johor,0,0,0
1/05/2022,Honduras,Johor,3,2,1
1/05/2022,Honduras,Kedah,0,0,0
1/05/2022,Honduras,Perak,0,0,0
1/05/2022,Honduras,Pulau Pinang,0,0,0
1/05/2022,Honduras,Sabah,0,0,0
1/05/2022,Honduras,Sarawak,0,0,0
1/05/2022,Honduras,Selangor,2,0,2
1/05/2022,Croatia,Johor,13,12,1
1/05/2022,Croatia,Kedah,0,0,0
1/05/2022,Croatia,Kelantan,0,0,0
1/05/2022,Croatia,Melaka,0,0,0
1/05/2022,Croatia,Pahang,0,0,0
1/05/2022,Croatia,Perak,0,0,0
1/05/2022,Croatia,Perlis,0,0,0
1/05/2022,Croatia,Pulau Pinang,1,1,0
1/05/2022,Croatia,Sabah,0,0,0
1/05/2022,Croatia,Sarawak,1,1,0
1/05/2022,Croatia,Selangor,73,61,12
1/05/2022,Haiti,Johor,0,0,0
1/05/2022,Haiti,Kedah,0,0,0
1/05/2022,Haiti,Kelantan,0,0,0
1/05/2022,Haiti,Perak,0,0,0
1/05/2022,Haiti,Pulau Pinang,0,0,0
1/05/2022,Haiti,Sabah,0,0,0
1/05/2022,Haiti,Selangor,7,2,5
1/05/2022,Hungary,Johor,72,55,17
1/05/2022,Hungary,Kedah,7,3,4
1/05/2022,Hungary,Kelantan,0,0,0
1/05/2022,Hungary,Pahang,0,0,0
1/05/2022,Hungary,Perak,0,0,0
1/05/2022,Hungary,Perlis,0,0,0
1/05/2022,Hungary,Pulau Pinang,3,3,0
1/05/2022,Hungary,Sabah,3,2,1
1/05/2022,Hungary,Sarawak,2,2,0
1/05/2022,Hungary,Selangor,110,65,45
1/05/2022,Hungary,W.P. Labuan,0,0,0
1/05/2022,Indonesia,Johor,33449,15578,17871
1/05/2022,Indonesia,Kedah,170,65,105
1/05/2022,Indonesia,Kelantan,7,2,5
1/05/2022,Indonesia,Melaka,2968,1349,1619
1/05/2022,Indonesia,Negeri Sembilan,2772,1802,970
1/05/2022,Indonesia,Pahang,8,6,2
1/05/2022,Indonesia,Perak,29,4,25
1/05/2022,Indonesia,Perlis,35,24,11
1/05/2022,Indonesia,Pulau Pinang,9946,4185,5761
1/05/2022,Indonesia,Sabah,2035,966,1069
1/05/2022,Indonesia,Sarawak,12522,8386,4136
1/05/2022,Indonesia,Selangor,45170,21148,24022
1/05/2022,Indonesia,Terengganu,0,0,0
1/05/2022,Indonesia,W.P. Labuan,2,2,0
1/05/2022,India,Johor,6606,4593,2013
1/05/2022,India,Kedah,618,412,206
1/05/2022,India,Kelantan,1,1,0
1/05/2022,India,Melaka,0,0,0
1/05/2022,India,Negeri Sembilan,0,0,0
1/05/2022,India,Pahang,2,2,0
1/05/2022,India,Perak,20,14,6
1/05/2022,India,Perlis,106,90,16
1/05/2022,India,Pulau Pinang,345,243,102
1/05/2022,India,Sabah,80,54,26
1/05/2022,India,Sarawak,31,28,3
1/05/2022,India,Selangor,27249,19319,7930
1/05/2022,India,Terengganu,0,0,0
1/05/2022,India,W.P. Labuan,0,0,0
1/05/2022, British Indian Ocean Territory,Pulau Pinang,0,0,0
1/05/2022, British Indian Ocean Territory,Selangor,0,0,0
1/05/2022,Ireland,Johor,209,153,56
1/05/2022,Ireland,Kedah,16,9,7
1/05/2022,Ireland,Kelantan,0,0,0
1/05/2022,Ireland,Negeri Sembilan,0,0,0
1/05/2022,Ireland,Pahang,0,0,0
1/05/2022,Ireland,Perak,1,0,1
1/05/2022,Ireland,Perlis,3,2,1
1/05/2022,Ireland,Pulau Pinang,25,17,8
1/05/2022,Ireland,Sabah,6,4,2
1/05/2022,Ireland,Sarawak,8,3,5
1/05/2022,Ireland,Selangor,451,278,173
1/05/2022,Ireland,Terengganu,0,0,0
1/05/2022,Ireland,W.P. Labuan,0,0,0
1/05/2022,"Iran, Islamic Republic of",Johor,98,57,41
1/05/2022,"Iran, Islamic Republic of",Kedah,1,1,0
1/05/2022,"Iran, Islamic Republic of",Kelantan,0,0,0
1/05/2022,"Iran, Islamic Republic of",Perak,1,1,0
1/05/2022,"Iran, Islamic Republic of",Perlis,2,1,1
1/05/2022,"Iran, Islamic Republic of",Pulau Pinang,3,1,2
1/05/2022,"Iran, Islamic Republic of",Sabah,2,1,1
1/05/2022,"Iran, Islamic Republic of",Sarawak,0,0,0
1/05/2022,"Iran, Islamic Republic of",Selangor,842,486,356
1/05/2022,"Iran, Islamic Republic of",W.P. Labuan,0,0,0
1/05/2022,Iraq,Johor,7,5,2
1/05/2022,Iraq,Kedah,0,0,0
1/05/2022,Iraq,Kelantan,0,0,0
1/05/2022,Iraq,Melaka,0,0,0
1/05/2022,Iraq,Pahang,0,0,0
1/05/2022,Iraq,Perak,0,0,0
1/05/2022,Iraq,Perlis,0,0,0
1/05/2022,Iraq,Pulau Pinang,0,0,0
1/05/2022,Iraq,Sabah,0,0,0
1/05/2022,Iraq,Sarawak,0,0,0
1/05/2022,Iraq,Selangor,543,373,170
1/05/2022,Iceland,Johor,29,9,20
1/05/2022,Iceland,Kedah,0,0,0
1/05/2022,Iceland,Kelantan,0,0,0
1/05/2022,Iceland,Perak,0,0,0
1/05/2022,Iceland,Perlis,0,0,0
1/05/2022,Iceland,Pulau Pinang,0,0,0
1/05/2022,Iceland,Sabah,0,0,0
1/05/2022,Iceland,Sarawak,0,0,0
1/05/2022,Iceland,Selangor,5,2,3
1/05/2022,Iceland,W.P. Labuan,0,0,0
1/05/2022,Israel,Pulau Pinang,4,2,2
1/05/2022,Italy,Johor,274,208,66
1/05/2022,Italy,Kedah,28,18,10
1/05/2022,Italy,Kelantan,0,0,0
1/05/2022,Italy,Melaka,0,0,0
1/05/2022,Italy,Negeri Sembilan,0,0,0
1/05/2022,Italy,Pahang,1,1,0
1/05/2022,Italy,Perak,2,2,0
1/05/2022,Italy,Perlis,1,1,0
1/05/2022,Italy,Pulau Pinang,38,33,5
1/05/2022,Italy,Sabah,9,6,3
1/05/2022,Italy,Sarawak,5,5,0
1/05/2022,Italy,Selangor,955,696,259
1/05/2022,Italy,W.P. Labuan,0,0,0
1/05/2022,Jamaica,Johor,0,0,0
1/05/2022,Jamaica,Kedah,0,0,0
1/05/2022,Jamaica,Perak,0,0,0
1/05/2022,Jamaica,Pulau Pinang,0,0,0
1/05/2022,Jamaica,Sabah,0,0,0
1/05/2022,Jamaica,Sarawak,0,0,0
1/05/2022,Jamaica,Selangor,1,1,0
1/05/2022,Jamaica,W.P. Labuan,0,0,0
1/05/2022,Jordan,Johor,15,6,9
1/05/2022,Jordan,Kedah,8,4,4
1/05/2022,Jordan,Kelantan,0,0,0
1/05/2022,Jordan,Melaka,0,0,0
1/05/2022,Jordan,Perlis,0,0,0
1/05/2022,Jordan,Pulau Pinang,8,5,3
1/05/2022,Jordan,Sabah,0,0,0
1/05/2022,Jordan,Sarawak,0,0,0
1/05/2022,Jordan,Selangor,517,326,191
1/05/2022,Jordan,W.P. Labuan,0,0,0
1/05/2022,Japan,Johor,3507,2424,1083
1/05/2022,Japan,Kedah,69,41,28
1/05/2022,Japan,Kelantan,0,0,0
1/05/2022,Japan,Melaka,0,0,0
1/05/2022,Japan,Negeri Sembilan,0,0,0
1/05/2022,Japan,Pahang,0,0,0
1/05/2022,Japan,Perak,7,5,2
1/05/2022,Japan,Perlis,0,0,0
1/05/2022,Japan,Pulau Pinang,365,273,92
1/05/2022,Japan,Sabah,73,42,31
1/05/2022,Japan,Sarawak,34,23,11
1/05/2022,Japan,Selangor,5015,3676,1339
1/05/2022,Japan,W.P. Labuan,0,0,0
1/05/2022,Kazakhstan,Johor,11,8,3
1/05/2022,Kazakhstan,Kedah,0,0,0
1/05/2022,Kazakhstan,Kelantan,0,0,0
1/05/2022,Kazakhstan,Melaka,0,0,0
1/05/2022,Kazakhstan,Perak,0,0,0
1/05/2022,Kazakhstan,Perlis,0,0,0
1/05/2022,Kazakhstan,Pulau Pinang,0,0,0
1/05/2022,Kazakhstan,Sabah,2,1,1
1/05/2022,Kazakhstan,Sarawak,1,0,1
1/05/2022,Kazakhstan,Selangor,195,75,120
1/05/2022,Kazakhstan,W.P. Labuan,0,0,0
1/05/2022,Kenya,Johor,41,19,22
1/05/2022,Kenya,Kedah,6,2,4
1/05/2022,Kenya,Kelantan,0,0,0
1/05/2022,Kenya,Perak,0,0,0
1/05/2022,Kenya,Perlis,0,0,0
1/05/2022,Kenya,Pulau Pinang,1,0,1
1/05/2022,Kenya,Sabah,0,0,0
1/05/2022,Kenya,Sarawak,1,1,0
1/05/2022,Kenya,Selangor,133,75,58
1/05/2022,Kyrgyzstan,Johor,13,5,8
1/05/2022,Kyrgyzstan,Kedah,0,0,0
1/05/2022,Kyrgyzstan,Kelantan,0,0,0
1/05/2022,Kyrgyzstan,Perak,0,0,0
1/05/2022,Kyrgyzstan,Perlis,0,0,0
1/05/2022,Kyrgyzstan,Pulau Pinang,0,0,0
1/05/2022,Kyrgyzstan,Sabah,0,0,0
1/05/2022,Kyrgyzstan,Sarawak,0,0,0
1/05/2022,Kyrgyzstan,Selangor,152,93,59
1/05/2022,Cambodia,Johor,153,70,83
1/05/2022,Cambodia,Kedah,345,299,46
1/05/2022,Cambodia,Kelantan,6,6,0
1/05/2022,Cambodia,Melaka,0,0,0
1/05/2022,Cambodia,Negeri Sembilan,0,0,0
1/05/2022,Cambodia,Pahang,0,0,0
1/05/2022,Cambodia,Perak,1,1,0
1/05/2022,Cambodia,Perlis,151,108,43
1/05/2022,Cambodia,Pulau Pinang,30,20,10
1/05/2022,Cambodia,Sabah,0,0,0
1/05/2022,Cambodia,Sarawak,2,1,1
1/05/2022,Cambodia,Selangor,2022,1203,819
1/05/2022,Cambodia,W.P. Labuan,0,0,0
1/05/2022,Kiribati,Johor,0,0,0
1/05/2022,Kiribati,Sabah,0,0,0
1/05/2022,Kiribati,Selangor,0,0,0
1/05/2022,Saint Kitts and Nevis,Johor,15,13,2
1/05/2022,Saint Kitts and Nevis,Kedah,0,0,0
1/05/2022,Saint Kitts and Nevis,Perlis,0,0,0
1/05/2022,Saint Kitts and Nevis,Pulau Pinang,0,0,0
1/05/2022,Saint Kitts and Nevis,Sabah,1,0,1
1/05/2022,Saint Kitts and Nevis,Selangor,42,28,14
1/05/2022,Saint Kitts and Nevis,W.P. Labuan,0,0,0
1/05/2022,"Korea, Republic of",Johor,5302,3243,2059
1/05/2022,"Korea, Republic of",Kedah,40,18,22
1/05/2022,"Korea, Republic of",Kelantan,0,0,0
1/05/2022,"Korea, Republic of",Melaka,1,1,0
1/05/2022,"Korea, Republic of",Negeri Sembilan,0,0,0
1/05/2022,"Korea, Republic of",Pahang,0,0,0
1/05/2022,"Korea, Republic of",Perak,6,4,2
1/05/2022,"Korea, Republic of",Perlis,7,5,2
1/05/2022,"Korea, Republic of",Pulau Pinang,154,98,56
1/05/2022,"Korea, Republic of",Sabah,382,191,191
1/05/2022,"Korea, Republic of",Sarawak,55,41,14
1/05/2022,"Korea, Republic of",Selangor,3906,2610,1296
1/05/2022,"Korea, Republic of",Terengganu,0,0,0
1/05/2022,"Korea, Republic of",W.P. Labuan,0,0,0
1/05/2022,Kuwait,Johor,21,10,11
1/05/2022,Kuwait,Kedah,1,0,1
1/05/2022,Kuwait,Kelantan,0,0,0
1/05/2022,Kuwait,Perak,0,0,0
1/05/2022,Kuwait,Perlis,0,0,0
1/05/2022,Kuwait,Pulau Pinang,2,0,2
1/05/2022,Kuwait,Sabah,0,0,0
1/05/2022,Kuwait,Sarawak,0,0,0
1/05/2022,Kuwait,Selangor,167,109,58
1/05/2022,Kuwait,W.P. Labuan,0,0,0
1/05/2022, Lao People's Democratic Republic,Johor,8,1,7
1/05/2022, Lao People's Democratic Republic,Kedah,188,57,131
1/05/2022, Lao People's Democratic Republic,Kelantan,2,0,2
1/05/2022, Lao People's Democratic Republic,Melaka,0,0,0
1/05/2022, Lao People's Democratic Republic,Perak,0,0,0
1/05/2022, Lao People's Democratic Republic,Perlis,2,1,1
1/05/2022, Lao People's Democratic Republic,Pulau Pinang,3,2,1
1/05/2022, Lao People's Democratic Republic,Sabah,1,0,1
1/05/2022, Lao People's Democratic Republic,Sarawak,0,0,0
1/05/2022, Lao People's Democratic Republic,Selangor,239,186,53
1/05/2022, Lao People's Democratic Republic,W.P. Labuan,0,0,0
1/05/2022,Lebanon,Johor,10,6,4
1/05/2022,Lebanon,Kedah,6,4,2
1/05/2022,Lebanon,Kelantan,0,0,0
1/05/2022,Lebanon,Pahang,0,0,0
1/05/2022,Lebanon,Perak,0,0,0
1/05/2022,Lebanon,Perlis,0,0,0
1/05/2022,Lebanon,Pulau Pinang,3,1,2
1/05/2022,Lebanon,Sabah,0,0,0
1/05/2022,Lebanon,Sarawak,0,0,0
1/05/2022,Lebanon,Selangor,146,99,47
1/05/2022,Lebanon,W.P. Labuan,0,0,0
1/05/2022,Liberia,Johor,0,0,0
1/05/2022,Liberia,Kedah,0,0,0
1/05/2022,Liberia,Sabah,0,0,0
1/05/2022,Liberia,Sarawak,0,0,0
1/05/2022,Liberia,Selangor,3,1,2
1/05/2022,Libya,Johor,1,1,0
1/05/2022,Libya,Kedah,0,0,0
1/05/2022,Libya,Perlis,0,0,0
1/05/2022,Libya,Pulau Pinang,0,0,0
1/05/2022,Libya,Sabah,0,0,0
1/05/2022,Libya,Sarawak,0,0,0
1/05/2022,Libya,Selangor,239,169,70
1/05/2022,Saint Lucia,Johor,2,2,0
1/05/2022,Saint Lucia,Kedah,0,0,0
1/05/2022,Saint Lucia,Pulau Pinang,0,0,0
1/05/2022,Saint Lucia,Sarawak,0,0,0
1/05/2022,Saint Lucia,Selangor,3,3,0
1/05/2022,Liechtenstein,Johor,0,0,0
1/05/2022,Liechtenstein,Kedah,0,0,0
1/05/2022,Liechtenstein,Perlis,0,0,0
1/05/2022,Liechtenstein,Pulau Pinang,1,1,0
1/05/2022,Liechtenstein,Sabah,0,0,0
1/05/2022,Liechtenstein,Sarawak,0,0,0
1/05/2022,Liechtenstein,Selangor,6,3,3
1/05/2022,LKA,Johor,361,241,120
1/05/2022,LKA,Kedah,3,2,1
1/05/2022,LKA,Kelantan,0,0,0
1/05/2022,LKA,Melaka,0,0,0
1/05/2022,LKA,Pahang,0,0,0
1/05/2022,LKA,Perak,0,0,0
1/05/2022,LKA,Perlis,0,0,0
1/05/2022,LKA,Pulau Pinang,17,13,4
1/05/2022,LKA,Sabah,0,0,0
1/05/2022,LKA,Sarawak,4,4,0
1/05/2022,LKA,Selangor,1797,1119,678
1/05/2022,LKA,W.P. Labuan,0,0,0
1/05/2022,Lesotho,Johor,0,0,0
1/05/2022,Lesotho,Kedah,0,0,0
1/05/2022,Lesotho,Pulau Pinang,0,0,0
1/05/2022,Lesotho,Sarawak,0,0,0
1/05/2022,Lesotho,Selangor,6,3,3
1/05/2022,Lithuania,Johor,13,4,9
1/05/2022,Lithuania,Kedah,4,3,1
1/05/2022,Lithuania,Kelantan,0,0,0
1/05/2022,Lithuania,Pahang,1,0,1
1/05/2022,Lithuania,Perak,0,0,0
1/05/2022,Lithuania,Perlis,0,0,0
1/05/2022,Lithuania,Pulau Pinang,4,2,2
1/05/2022,Lithuania,Sabah,5,5,0
1/05/2022,Lithuania,Sarawak,0,0,0
1/05/2022,Lithuania,Selangor,73,42,31
1/05/2022,Lithuania,W.P. Labuan,0,0,0
1/05/2022,Luxembourg,Johor,1,1,0
1/05/2022,Luxembourg,Kedah,0,0,0
1/05/2022,Luxembourg,Kelantan,0,0,0
1/05/2022,Luxembourg,Perak,0,0,0
1/05/2022,Luxembourg,Perlis,1,1,0
1/05/2022,Luxembourg,Pulau Pinang,1,1,0
1/05/2022,Luxembourg,Sabah,0,0,0
1/05/2022,Luxembourg,Sarawak,0,0,0
1/05/2022,Luxembourg,Selangor,12,11,1
1/05/2022,Latvia,Johor,6,3,3
1/05/2022,Latvia,Kedah,3,2,1
1/05/2022,Latvia,Kelantan,0,0,0
1/05/2022,Latvia,Pahang,0,0,0
1/05/2022,Latvia,Perak,0,0,0
1/05/2022,Latvia,Perlis,0,0,0
1/05/2022,Latvia,Pulau Pinang,0,0,0
1/05/2022,Latvia,Sabah,2,1,1
1/05/2022,Latvia,Sarawak,0,0,0
1/05/2022,Latvia,Selangor,28,16,12
1/05/2022,Latvia,W.P. Labuan,0,0,0
1/05/2022,Macao,Johor,1,0,1
1/05/2022,Macao,Pahang,0,0,0
1/05/2022,Macao,Perak,0,0,0
1/05/2022,Macao,Selangor,0,0,0
1/05/2022,Macao,W.P. Labuan,0,0,0
1/05/2022,Morocco,Johor,40,24,16
1/05/2022,Morocco,Kedah,3,2,1
1/05/2022,Morocco,Kelantan,1,1,0
1/05/2022,Morocco,Melaka,0,0,0
1/05/2022,Morocco,Pahang,0,0,0
1/05/2022,Morocco,Perak,0,0,0
1/05/2022,Morocco,Perlis,0,0,0
1/05/2022,Morocco,Pulau Pinang,0,0,0
1/05/2022,Morocco,Sabah,1,1,0
1/05/2022,Morocco,Sarawak,0,0,0
1/05/2022,Morocco,Selangor,354,152,202
1/05/2022,Morocco,W.P. Labuan,0,0,0
1/05/2022,Monaco,Johor,1,1,0
1/05/2022,Monaco,Kedah,0,0,0
1/05/2022,Monaco,Sabah,0,0,0
1/05/2022,Monaco,Selangor,5,1,4
1/05/2022,"Moldova, Republic of",Johor,0,0,0
1/05/2022,"Moldova, Republic of",Kedah,0,0,0
1/05/2022,"Moldova, Republic of",Kelantan,0,0,0
1/05/2022,"Moldova, Republic of",Negeri Sembilan,0,0,0
1/05/2022,"Moldova, Republic of",Perlis,0,0,0
1/05/2022,"Moldova, Republic of",Pulau Pinang,0,0,0
1/05/2022,"Moldova, Republic of",Sabah,0,0,0
1/05/2022,"Moldova, Republic of",Sarawak,0,0,0
1/05/2022,"Moldova, Republic of",Selangor,12,5,7
1/05/2022,Madagascar,Johor,2,1,1
1/05/2022,Madagascar,Kedah,0,0,0
1/05/2022,Madagascar,Perak,0,0,0
1/05/2022,Madagascar,Perlis,0,0,0
1/05/2022,Madagascar,Pulau Pinang,0,0,0
1/05/2022,Madagascar,Sabah,0,0,0
1/05/2022,Madagascar,Sarawak,0,0,0
1/05/2022,Madagascar,Selangor,4,2,2
1/05/2022,Maldives,Johor,89,68,21
1/05/2022,Maldives,Kedah,9,6,3
1/05/2022,Maldives,Kelantan,0,0,0
1/05/2022,Maldives,Perak,1,0,1
1/05/2022,Maldives,Perlis,0,0,0
1/05/2022,Maldives,Pulau Pinang,6,2,4
1/05/2022,Maldives,Sabah,6,2,4
1/05/2022,Maldives,Sarawak,1,1,0
1/05/2022,Maldives,Selangor,1500,770,730
1/05/2022,Mexico,Johor,41,24,17
1/05/2022,Mexico,Kedah,8,5,3
1/05/2022,Mexico,Kelantan,0,0,0
1/05/2022,Mexico,Pahang,0,0,0
1/05/2022,Mexico,Perak,0,0,0
1/05/2022,Mexico,Perlis,0,0,0
1/05/2022,Mexico,Pulau Pinang,35,29,6
1/05/2022,Mexico,Sabah,1,0,1
1/05/2022,Mexico,Sarawak,0,0,0
1/05/2022,Mexico,Selangor,168,96,72
1/05/2022,Mexico,W.P. Labuan,0,0,0
1/05/2022,Marshall Islands,Johor,0,0,0
1/05/2022,Marshall Islands,Kedah,0,0,0
1/05/2022,Marshall Islands,Perak,0,0,0
1/05/2022,Marshall Islands,Pulau Pinang,0,0,0
1/05/2022,Marshall Islands,Sabah,0,0,0
1/05/2022,Marshall Islands,Selangor,0,0,0
1/05/2022,North Macedonia,Johor,1,0,1
1/05/2022,North Macedonia,Kedah,4,2,2
1/05/2022,North Macedonia,Perak,0,0,0
1/05/2022,North Macedonia,Pulau Pinang,0,0,0
1/05/2022,North Macedonia,Sabah,0,0,0
1/05/2022,North Macedonia,Sarawak,0,0,0
1/05/2022,North Macedonia,Selangor,7,2,5
1/05/2022,Mali,Johor,0,0,0
1/05/2022,Mali,Sabah,0,0,0
1/05/2022,Mali,Selangor,0,0,0
1/05/2022,Malta,Johor,8,4,4
1/05/2022,Malta,Kedah,0,0,0
1/05/2022,Malta,Kelantan,0,0,0
1/05/2022,Malta,Perak,0,0,0
1/05/2022,Malta,Perlis,0,0,0
1/05/2022,Malta,Pulau Pinang,3,3,0
1/05/2022,Malta,Sabah,0,0,0
1/05/2022,Malta,Sarawak,0,0,0
1/05/2022,Malta,Selangor,19,13,6
1/05/2022,Malta,W.P. Labuan,0,0,0
1/05/2022,Myanmar,Johor,1485,525,960
1/05/2022,Myanmar,Kedah,4,1,3
1/05/2022,Myanmar,Kelantan,0,0,0
1/05/2022,Myanmar,Negeri Sembilan,0,0,0
1/05/2022,Myanmar,Pahang,0,0,0
1/05/2022,Myanmar,Perak,6,2,4
1/05/2022,Myanmar,Perlis,1,0,1
1/05/2022,Myanmar,Pulau Pinang,31,15,16
1/05/2022,Myanmar,Sabah,5,4,1
1/05/2022,Myanmar,Sarawak,7,3,4
1/05/2022,Myanmar,Selangor,1553,943,610
1/05/2022,Myanmar,Terengganu,0,0,0
1/05/2022,Myanmar,W.P. Labuan,0,0,0
1/05/2022,Montenegro,Johor,0,0,0
1/05/2022,Montenegro,Kedah,0,0,0
1/05/2022,Montenegro,Pulau Pinang,0,0,0
1/05/2022,Montenegro,Sabah,0,0,0
1/05/2022,Montenegro,Sarawak,0,0,0
1/05/2022,Montenegro,Selangor,8,7,1
1/05/2022,Mongolia,Johor,32,10,22
1/05/2022,Mongolia,Kedah,3,1,2
1/05/2022,Mongolia,Kelantan,0,0,0
1/05/2022,Mongolia,Perak,0,0,0
1/05/2022,Mongolia,Perlis,0,0,0
1/05/2022,Mongolia,Pulau Pinang,2,0,2
1/05/2022,Mongolia,Sabah,0,0,0
1/05/2022,Mongolia,Sarawak,0,0,0
1/05/2022,Mongolia,Selangor,112,56,56
1/05/2022,Northern Mariana Islands,Selangor,0,0,0
1/05/2022,Mozambique,Johor,0,0,0
1/05/2022,Mozambique,Kedah,0,0,0
1/05/2022,Mozambique,Perak,0,0,0
1/05/2022,Mozambique,Pulau Pinang,0,0,0
1/05/2022,Mozambique,Sabah,0,0,0
1/05/2022,Mozambique,Sarawak,0,0,0
1/05/2022,Mozambique,Selangor,10,6,4
1/05/2022,Mauritania,Johor,0,0,0
1/05/2022,Mauritania,Kedah,0,0,0
1/05/2022,Mauritania,Pulau Pinang,0,0,0
1/05/2022,Mauritania,Sabah,0,0,0
1/05/2022,Mauritania,Sarawak,0,0,0
1/05/2022,Mauritania,Selangor,17,14,3
1/05/2022,Mauritius,Johor,29,17,12
1/05/2022,Mauritius,Kedah,2,1,1
1/05/2022,Mauritius,Kelantan,0,0,0
1/05/2022,Mauritius,Pahang,0,0,0
1/05/2022,Mauritius,Perak,0,0,0
1/05/2022,Mauritius,Perlis,0,0,0
1/05/2022,Mauritius,Pulau Pinang,2,2,0
1/05/2022,Mauritius,Sabah,0,0,0
1/05/2022,Mauritius,Sarawak,0,0,0
1/05/2022,Mauritius,Selangor,140,74,66
1/05/2022,Malawi,Johor,0,0,0
1/05/2022,Malawi,Pulau Pinang,0,0,0
1/05/2022,Malawi,Sabah,0,0,0
1/05/2022,Malawi,Sarawak,0,0,0
1/05/2022,Malawi,Selangor,7,4,3
1/05/2022,Mayotte,Selangor,0,0,0
1/05/2022,Namibia,Johor,0,0,0
1/05/2022,Namibia,Kedah,0,0,0
1/05/2022,Namibia,Perak,0,0,0
1/05/2022,Namibia,Perlis,0,0,0
1/05/2022,Namibia,Pulau Pinang,0,0,0
1/05/2022,Namibia,Sabah,0,0,0
1/05/2022,Namibia,Sarawak,0,0,0
1/05/2022,Namibia,Selangor,8,3,5
1/05/2022,New Caledonia,Selangor,0,0,0
1/05/2022,Niger,Johor,2,2,0
1/05/2022,Niger,Sabah,0,0,0
1/05/2022,Niger,Selangor,0,0,0
1/05/2022,Nigeria,Johor,17,14,3
1/05/2022,Nigeria,Kedah,0,0,0
1/05/2022,Nigeria,Perlis,0,0,0
1/05/2022,Nigeria,Pulau Pinang,0,0,0
1/05/2022,Nigeria,Sabah,0,0,0
1/05/2022,Nigeria,Sarawak,2,2,0
1/05/2022,Nigeria,Selangor,283,249,34
1/05/2022,Nicaragua,Johor,1,0,1
1/05/2022,Nicaragua,Kedah,0,0,0
1/05/2022,Nicaragua,Pulau Pinang,1,1,0
1/05/2022,Nicaragua,Sabah,0,0,0
1/05/2022,Nicaragua,Selangor,3,2,1
1/05/2022,Netherlands,Johor,595,393,202
1/05/2022,Netherlands,Kedah,42,25,17
1/05/2022,Netherlands,Kelantan,0,0,0
1/05/2022,Netherlands,Melaka,0,0,0
1/05/2022,Netherlands,Negeri Sembilan,0,0,0
1/05/2022,Netherlands,Pahang,1,1,0
1/05/2022,Netherlands,Perak,0,0,0
1/05/2022,Netherlands,Perlis,14,8,6
1/05/2022,Netherlands,Pulau Pinang,94,63,31
1/05/2022,Netherlands,Sabah,18,12,6
1/05/2022,Netherlands,Sarawak,11,8,3
1/05/2022,Netherlands,Selangor,1498,1030,468
1/05/2022,Netherlands,Terengganu,0,0,0
1/05/2022,Netherlands,W.P. Labuan,0,0,0
1/05/2022,Norway,Johor,88,60,28
1/05/2022,Norway,Kedah,7,2,5
1/05/2022,Norway,Kelantan,0,0,0
1/05/2022,Norway,Melaka,0,0,0
1/05/2022,Norway,Pahang,0,0,0
1/05/2022,Norway,Perak,1,1,0
1/05/2022,Norway,Perlis,2,1,1
1/05/2022,Norway,Pulau Pinang,4,2,2
1/05/2022,Norway,Sabah,9,5,4
1/05/2022,Norway,Sarawak,2,1,1
1/05/2022,Norway,Selangor,266,188,78
1/05/2022,Norway,W.P. Labuan,0,0,0
1/05/2022,Nepal,Johor,418,382,36
1/05/2022,Nepal,Kedah,0,0,0
1/05/2022,Nepal,Pahang,0,0,0
1/05/2022,Nepal,Perak,0,0,0
1/05/2022,Nepal,Perlis,0,0,0
1/05/2022,Nepal,Pulau Pinang,6,5,1
1/05/2022,Nepal,Sabah,6,4,2
1/05/2022,Nepal,Sarawak,2,1,1
1/05/2022,Nepal,Selangor,5458,5047,411
1/05/2022,Nepal,W.P. Labuan,0,0,0
1/05/2022,Nauru,Johor,0,0,0
1/05/2022,Nauru,Pulau Pinang,0,0,0
1/05/2022,Nauru,Selangor,0,0,0
1/05/2022,New Zealand,Johor,312,200,112
1/05/2022,New Zealand,Kedah,36,21,15
1/05/2022,New Zealand,Kelantan,0,0,0
1/05/2022,New Zealand,Melaka,0,0,0
1/05/2022,New Zealand,Negeri Sembilan,0,0,0
1/05/2022,New Zealand,Pahang,0,0,0
1/05/2022,New Zealand,Perak,4,2,2
1/05/2022,New Zealand,Perlis,0,0,0
1/05/2022,New Zealand,Pulau Pinang,66,32,34
1/05/2022,New Zealand,Sabah,18,11,7
1/05/2022,New Zealand,Sarawak,11,7,4
1/05/2022,New Zealand,Selangor,682,455,227
1/05/2022,New Zealand,Terengganu,0,0,0
1/05/2022,New Zealand,W.P. Labuan,0,0,0
1/05/2022,Oman,Johor,4,4,0
1/05/2022,Oman,Kedah,6,4,2
1/05/2022,Oman,Kelantan,0,0,0
1/05/2022,Oman,Melaka,0,0,0
1/05/2022,Oman,Perak,0,0,0
1/05/2022,Oman,Perlis,0,0,0
1/05/2022,Oman,Pulau Pinang,0,0,0
1/05/2022,Oman,Sabah,0,0,0
1/05/2022,Oman,Sarawak,1,1,0
1/05/2022,Oman,Selangor,490,313,177
1/05/2022,Pakistan,Johor,266,207,59
1/05/2022,Pakistan,Kedah,17,15,2
1/05/2022,Pakistan,Kelantan,6,6,0
1/05/2022,Pakistan,Melaka,0,0,0
1/05/2022,Pakistan,Negeri Sembilan,0,0,0
1/05/2022,Pakistan,Pahang,0,0,0
1/05/2022,Pakistan,Perak,5,5,0
1/05/2022,Pakistan,Perlis,19,18,1
1/05/2022,Pakistan,Pulau Pinang,16,14,2
1/05/2022,Pakistan,Sabah,2,2,0
1/05/2022,Pakistan,Sarawak,8,8,0
1/05/2022,Pakistan,Selangor,5582,4561,1021
1/05/2022,Pakistan,W.P. Labuan,0,0,0
1/05/2022,Panama,Johor,5,3,2
1/05/2022,Panama,Kedah,0,0,0
1/05/2022,Panama,Perak,0,0,0
1/05/2022,Panama,Perlis,0,0,0
1/05/2022,Panama,Pulau Pinang,0,0,0
1/05/2022,Panama,Sabah,0,0,0
1/05/2022,Panama,Sarawak,0,0,0
1/05/2022,Panama,Selangor,3,3,0
1/05/2022,Peru,Johor,22,13,9
1/05/2022,Peru,Kedah,2,1,1
1/05/2022,Peru,Kelantan,0,0,0
1/05/2022,Peru,Pahang,0,0,0
1/05/2022,Peru,Perak,0,0,0
1/05/2022,Peru,Perlis,0,0,0
1/05/2022,Peru,Pulau Pinang,0,0,0
1/05/2022,Peru,Sabah,0,0,0
1/05/2022,Peru,Sarawak,0,0,0
1/05/2022,Peru,Selangor,39,21,18
1/05/2022,Peru,W.P. Labuan,0,0,0
1/05/2022,Philippines,Johor,7206,2109,5097
1/05/2022,Philippines,Kedah,50,16,34
1/05/2022,Philippines,Kelantan,1,1,0
1/05/2022,Philippines,Melaka,0,0,0
1/05/2022,Philippines,Negeri Sembilan,0,0,0
1/05/2022,Philippines,Pahang,4,4,0
1/05/2022,Philippines,Perak,18,6,12
1/05/2022,Philippines,Perlis,10,4,6
1/05/2022,Philippines,Pulau Pinang,262,108,154
1/05/2022,Philippines,Sabah,102,28,74
1/05/2022,Philippines,Sarawak,68,33,35
1/05/2022,Philippines,Selangor,6349,2706,3643
1/05/2022,Philippines,Terengganu,0,0,0
1/05/2022,Philippines,W.P. Labuan,2,2,0
1/05/2022,Palau,Johor,1,1,0
1/05/2022,Palau,Pulau Pinang,0,0,0
1/05/2022,Palau,Selangor,1,0,1
1/05/2022,Papua New Guinea,Johor,6,5,1
1/05/2022,Papua New Guinea,Kedah,0,0,0
1/05/2022,Papua New Guinea,Kelantan,0,0,0
1/05/2022,Papua New Guinea,Perak,0,0,0
1/05/2022,Papua New Guinea,Pulau Pinang,1,0,1
1/05/2022,Papua New Guinea,Sabah,0,0,0
1/05/2022,Papua New Guinea,Sarawak,0,0,0
1/05/2022,Papua New Guinea,Selangor,33,24,9
1/05/2022,Poland,Johor,109,71,38
1/05/2022,Poland,Kedah,10,7,3
1/05/2022,Poland,Kelantan,0,0,0
1/05/2022,Poland,Melaka,0,0,0
1/05/2022,Poland,Negeri Sembilan,0,0,0
1/05/2022,Poland,Pahang,0,0,0
1/05/2022,Poland,Perak,1,0,1
1/05/2022,Poland,Perlis,0,0,0
1/05/2022,Poland,Pulau Pinang,27,15,12
1/05/2022,Poland,Sabah,14,7,7
1/05/2022,Poland,Sarawak,9,6,3
1/05/2022,Poland,Selangor,339,219,120
1/05/2022,Poland,Terengganu,0,0,0
1/05/2022,Poland,W.P. Labuan,0,0,0
1/05/2022,"North Korea, Democratic People's Republic of",Selangor,0,0,0
1/05/2022,Portugal,Johor,83,49,34
1/05/2022,Portugal,Kedah,5,2,3
1/05/2022,Portugal,Kelantan,0,0,0
1/05/2022,Portugal,Melaka,0,0,0
1/05/2022,Portugal,Pahang,0,0,0
1/05/2022,Portugal,Perak,0,0,0
1/05/2022,Portugal,Perlis,2,1,1
1/05/2022,Portugal,Pulau Pinang,9,5,4
1/05/2022,Portugal,Sabah,2,0,2
1/05/2022,Portugal,Sarawak,2,1,1
1/05/2022,Portugal,Selangor,271,190,81
1/05/2022,Portugal,W.P. Labuan,0,0,0
1/05/2022,Paraguay,Johor,1,0,1
1/05/2022,Paraguay,Kedah,0,0,0
1/05/2022,Paraguay,Perak,0,0,0
1/05/2022,Paraguay,Perlis,0,0,0
1/05/2022,Paraguay,Pulau Pinang,0,0,0
1/05/2022,Paraguay,Sabah,0,0,0
1/05/2022,Paraguay,Sarawak,0,0,0
1/05/2022,Paraguay,Selangor,4,2,2
1/05/2022,"Palestine, State of",Johor,2,2,0
1/05/2022,"Palestine, State of",Kedah,1,1,0
1/05/2022,"Palestine, State of",Kelantan,0,0,0
1/05/2022,"Palestine, State of",Melaka,0,0,0
1/05/2022,"Palestine, State of",Perak,0,0,0
1/05/2022,"Palestine, State of",Perlis,1,1,0
1/05/2022,"Palestine, State of",Pulau Pinang,0,0,0
1/05/2022,"Palestine, State of",Sabah,0,0,0
1/05/2022,"Palestine, State of",Sarawak,0,0,0
1/05/2022,"Palestine, State of",Selangor,266,179,87
1/05/2022,Qatar,Johor,16,9,7
1/05/2022,Qatar,Kedah,0,0,0
1/05/2022,Qatar,Perlis,0,0,0
1/05/2022,Qatar,Pulau Pinang,0,0,0
1/05/2022,Qatar,Sabah,0,0,0
1/05/2022,Qatar,Sarawak,0,0,0
1/05/2022,Qatar,Selangor,80,48,32
1/05/2022,Réunion,Johor,0,0,0
1/05/2022,Réunion,Sarawak,0,0,0
1/05/2022,Romania,Johor,61,31,30
1/05/2022,Romania,Kedah,1,0,1
1/05/2022,Romania,Kelantan,0,0,0
1/05/2022,Romania,Negeri Sembilan,0,0,0
1/05/2022,Romania,Pahang,0,0,0
1/05/2022,Romania,Perak,1,0,1
1/05/2022,Romania,Perlis,0,0,0
1/05/2022,Romania,Pulau Pinang,5,4,1
1/05/2022,Romania,Sabah,2,2,0
1/05/2022,Romania,Sarawak,2,1,1
1/05/2022,Romania,Selangor,185,112,73
1/05/2022,Romania,W.P. Labuan,0,0,0
1/05/2022,Russian Federation (Russia),Johor,237,139,98
1/05/2022,Russian Federation (Russia),Kedah,31,20,11
1/05/2022,Russian Federation (Russia),Kelantan,0,0,0
1/05/2022,Russian Federation (Russia),Melaka,0,0,0
1/05/2022,Russian Federation (Russia),Negeri Sembilan,0,0,0
1/05/2022,Russian Federation (Russia),Pahang,0,0,0
1/05/2022,Russian Federation (Russia),Perak,0,0,0
1/05/2022,Russian Federation (Russia),Perlis,5,3,2
1/05/2022,Russian Federation (Russia),Pulau Pinang,15,10,5
1/05/2022,Russian Federation (Russia),Sabah,10,9,1
1/05/2022,Russian Federation (Russia),Sarawak,7,2,5
1/05/2022,Russian Federation (Russia),Selangor,1084,570,514
1/05/2022,Russian Federation (Russia),W.P. Labuan,0,0,0
1/05/2022,Rwanda,Johor,0,0,0
1/05/2022,Rwanda,Kedah,0,0,0
1/05/2022,Rwanda,Pulau Pinang,0,0,0
1/05/2022,Rwanda,Selangor,7,1,6
1/05/2022,Saudi Arabia,Johor,66,39,27
1/05/2022,Saudi Arabia,Kedah,5,2,3
1/05/2022,Saudi Arabia,Kelantan,0,0,0
1/05/2022,Saudi Arabia,Melaka,0,0,0
1/05/2022,Saudi Arabia,Perak,1,0,1
1/05/2022,Saudi Arabia,Perlis,0,0,0
1/05/2022,Saudi Arabia,Pulau Pinang,12,7,5
1/05/2022,Saudi Arabia,Sabah,0,0,0
1/05/2022,Saudi Arabia,Sarawak,0,0,0
1/05/2022,Saudi Arabia,Selangor,4039,2282,1757
1/05/2022,Saudi Arabia,W.P. Labuan,0,0,0
1/05/2022,Sudan,Johor,4,4,0
1/05/2022,Sudan,Kedah,0,0,0
1/05/2022,Sudan,Kelantan,0,0,0
1/05/2022,Sudan,Perlis,0,0,0
1/05/2022,Sudan,Pulau Pinang,2,2,0
1/05/2022,Sudan,Sabah,0,0,0
1/05/2022,Sudan,Sarawak,0,0,0
1/05/2022,Sudan,Selangor,662,402,260
1/05/2022,Sudan,W.P. Labuan,0,0,0
1/05/2022,Senegal,Johor,3,3,0
1/05/2022,Senegal,Kedah,0,0,0
1/05/2022,Senegal,Kelantan,0,0,0
1/05/2022,Senegal,Perak,0,0,0
1/05/2022,Senegal,Perlis,0,0,0
1/05/2022,Senegal,Pulau Pinang,0,0,0
1/05/2022,Senegal,Sabah,0,0,0
1/05/2022,Senegal,Sarawak,0,0,0
1/05/2022,Senegal,Selangor,34,23,11
1/05/2022,Singapore,Johor,617144,385634,231510
1/05/2022,Singapore,Kedah,921,503,418
1/05/2022,Singapore,Kelantan,3,3,0
1/05/2022,Singapore,Melaka,1,0,1
1/05/2022,Singapore,Negeri Sembilan,1,1,0
1/05/2022,Singapore,Pahang,41,33,8
1/05/2022,Singapore,Perak,1921,900,1021
1/05/2022,Singapore,Perlis,27,17,10
1/05/2022,Singapore,Pulau Pinang,7700,4101,3599
1/05/2022,Singapore,Sabah,1146,652,494
1/05/2022,Singapore,Sarawak,1734,1029,705
1/05/2022,Singapore,Selangor,19426,10889,8537
1/05/2022,Singapore,Terengganu,0,0,0
1/05/2022,Singapore,W.P. Labuan,0,0,0
1/05/2022,South Georgia and the South Sandwich Islands,Johor,0,0,0
1/05/2022,South Georgia and the South Sandwich Islands,Sabah,0,0,0
1/05/2022,South Georgia and the South Sandwich Islands,Selangor,0,0,0
1/05/2022,Saint Helena,Sarawak,0,0,0
1/05/2022,Solomon Islands,Johor,0,0,0
1/05/2022,Solomon Islands,Perlis,0,0,0
1/05/2022,Solomon Islands,Pulau Pinang,0,0,0
1/05/2022,Solomon Islands,Sabah,0,0,0
1/05/2022,Solomon Islands,Sarawak,0,0,0
1/05/2022,Solomon Islands,Selangor,0,0,0
1/05/2022,Solomon Islands,W.P. Labuan,0,0,0
1/05/2022,Sierra Leone,Johor,0,0,0
1/05/2022,Sierra Leone,Kedah,0,0,0
1/05/2022,Sierra Leone,Perak,0,0,0
1/05/2022,Sierra Leone,Pulau Pinang,0,0,0
1/05/2022,Sierra Leone,Sabah,0,0,0
1/05/2022,Sierra Leone,Selangor,7,6,1
1/05/2022,El Salvador,Johor,0,0,0
1/05/2022,El Salvador,Kedah,2,0,2
1/05/2022,El Salvador,Perak,0,0,0
1/05/2022,El Salvador,Perlis,0,0,0
1/05/2022,El Salvador,Pulau Pinang,0,0,0
1/05/2022,El Salvador,Sabah,0,0,0
1/05/2022,El Salvador,Selangor,4,1,3
1/05/2022,El Salvador,W.P. Labuan,0,0,0
1/05/2022,San Marino,Johor,0,0,0
1/05/2022,San Marino,Selangor,1,1,0
1/05/2022,Somalia,Johor,0,0,0
1/05/2022,Somalia,Kedah,0,0,0
1/05/2022,Somalia,Kelantan,0,0,0
1/05/2022,Somalia,Perlis,0,0,0
1/05/2022,Somalia,Sabah,0,0,0
1/05/2022,Somalia,Sarawak,0,0,0
1/05/2022,Somalia,Selangor,132,80,52
1/05/2022,Serbia,Johor,5,4,1
1/05/2022,Serbia,Kedah,0,0,0
1/05/2022,Serbia,Kelantan,0,0,0
1/05/2022,Serbia,Pahang,0,0,0
1/05/2022,Serbia,Perak,0,0,0
1/05/2022,Serbia,Perlis,1,1,0
1/05/2022,Serbia,Pulau Pinang,0,0,0
1/05/2022,Serbia,Sabah,0,0,0
1/05/2022,Serbia,Sarawak,1,0,1
1/05/2022,Serbia,Selangor,21,12,9
1/05/2022,South Sudan,Johor,0,0,0
1/05/2022,South Sudan,Kedah,0,0,0
1/05/2022,South Sudan,Sarawak,0,0,0
1/05/2022,South Sudan,Selangor,19,16,3
1/05/2022,South Sudan,W.P. Labuan,0,0,0
1/05/2022,Sao Tome and Principe,Selangor,0,0,0
1/05/2022,Suriname,Johor,0,0,0
1/05/2022,Suriname,Kedah,0,0,0
1/05/2022,Suriname,Kelantan,0,0,0
1/05/2022,Suriname,Perak,0,0,0
1/05/2022,Suriname,Perlis,0,0,0
1/05/2022,Suriname,Pulau Pinang,0,0,0
1/05/2022,Suriname,Sabah,0,0,0
1/05/2022,Suriname,Sarawak,0,0,0
1/05/2022,Suriname,Selangor,3,0,3
1/05/2022,Slovakia,Johor,14,8,6
1/05/2022,Slovakia,Kedah,3,2,1
1/05/2022,Slovakia,Kelantan,0,0,0
1/05/2022,Slovakia,Negeri Sembilan,0,0,0
1/05/2022,Slovakia,Pahang,0,0,0
1/05/2022,Slovakia,Perak,0,0,0
1/05/2022,Slovakia,Perlis,0,0,0
1/05/2022,Slovakia,Pulau Pinang,4,4,0
1/05/2022,Slovakia,Sabah,1,1,0
1/05/2022,Slovakia,Sarawak,0,0,0
1/05/2022,Slovakia,Selangor,111,74,37
1/05/2022,Slovakia,W.P. Labuan,0,0,0
1/05/2022,Slovenia,Johor,6,1,5
1/05/2022,Slovenia,Kedah,0,0,0
1/05/2022,Slovenia,Kelantan,0,0,0
1/05/2022,Slovenia,Perak,0,0,0
1/05/2022,Slovenia,Perlis,0,0,0
1/05/2022,Slovenia,Pulau Pinang,3,1,2
1/05/2022,Slovenia,Sabah,1,0,1
1/05/2022,Slovenia,Sarawak,0,0,0
1/05/2022,Slovenia,Selangor,25,12,13
1/05/2022,Slovenia,W.P. Labuan,0,0,0
1/05/2022,Sweden,Johor,179,120,59
1/05/2022,Sweden,Kedah,17,11,6
1/05/2022,Sweden,Kelantan,1,0,1
1/05/2022,Sweden,Melaka,0,0,0
1/05/2022,Sweden,Negeri Sembilan,0,0,0
1/05/2022,Sweden,Pahang,0,0,0
1/05/2022,Sweden,Perak,0,0,0
1/05/2022,Sweden,Perlis,5,4,1
1/05/2022,Sweden,Pulau Pinang,14,12,2
1/05/2022,Sweden,Sabah,14,9,5
1/05/2022,Sweden,Sarawak,2,0,2
1/05/2022,Sweden,Selangor,400,273,127
1/05/2022,Sweden,W.P. Labuan,0,0,0
1/05/2022,Eswatini,Johor,0,0,0
1/05/2022,Eswatini,Kedah,0,0,0
1/05/2022,Eswatini,Pulau Pinang,1,1,0
1/05/2022,Eswatini,Sabah,0,0,0
1/05/2022,Eswatini,Selangor,14,6,8
1/05/2022,Seychelles,Johor,4,3,1
1/05/2022,Seychelles,Kedah,0,0,0
1/05/2022,Seychelles,Pulau Pinang,0,0,0
1/05/2022,Seychelles,Sabah,0,0,0
1/05/2022,Seychelles,Sarawak,1,0,1
1/05/2022,Seychelles,Selangor,35,19,16
1/05/2022,Syrian Arab Republic,Johor,5,2,3
1/05/2022,Syrian Arab Republic,Kedah,1,1,0
1/05/2022,Syrian Arab Republic,Kelantan,0,0,0
1/05/2022,Syrian Arab Republic,Pahang,0,0,0
1/05/2022,Syrian Arab Republic,Perlis,0,0,0
1/05/2022,Syrian Arab Republic,Pulau Pinang,0,0,0
1/05/2022,Syrian Arab Republic,Sabah,0,0,0
1/05/2022,Syrian Arab Republic,Sarawak,1,0,1
1/05/2022,Syrian Arab Republic,Selangor,448,263,185
1/05/2022,Syrian Arab Republic,W.P. Labuan,0,0,0
1/05/2022,Turks and Caicos Islands,Perlis,0,0,0
1/05/2022,TCD,Johor,5,5,0
1/05/2022,TCD,Kedah,0,0,0
1/05/2022,TCD,Perlis,0,0,0
1/05/2022,TCD,Selangor,3,2,1
1/05/2022,Togo,Johor,0,0,0
1/05/2022,Togo,Perak,0,0,0
1/05/2022,Togo,Pulau Pinang,0,0,0
1/05/2022,Togo,Selangor,3,2,1
1/05/2022,Thailand,Johor,1969,355,1614
1/05/2022,Thailand,Kedah,27841,20609,7232
1/05/2022,Thailand,Kelantan,3808,1902,1906
1/05/2022,Thailand,Melaka,0,0,0
1/05/2022,Thailand,Negeri Sembilan,0,0,0
1/05/2022,Thailand,Pahang,21,15,6
1/05/2022,Thailand,Perak,697,205,492
1/05/2022,Thailand,Perlis,24792,17411,7381
1/05/2022,Thailand,Pulau Pinang,637,299,338
1/05/2022,Thailand,Sabah,13,4,9
1/05/2022,Thailand,Sarawak,31,15,16
1/05/2022,Thailand,Selangor,4898,2038,2860
1/05/2022,Thailand,Terengganu,0,0,0
1/05/2022,Thailand,W.P. Labuan,0,0,0
1/05/2022,Tajikistan,Johor,0,0,0
1/05/2022,Tajikistan,Kedah,0,0,0
1/05/2022,Tajikistan,Perlis,0,0,0
1/05/2022,Tajikistan,Pulau Pinang,0,0,0
1/05/2022,Tajikistan,Sabah,0,0,0
1/05/2022,Tajikistan,Selangor,29,12,17
1/05/2022,Tokelau,Selangor,0,0,0
1/05/2022,Turkmenistan,Johor,4,0,4
1/05/2022,Turkmenistan,Kedah,0,0,0
1/05/2022,Turkmenistan,Kelantan,0,0,0
1/05/2022,Turkmenistan,Perlis,0,0,0
1/05/2022,Turkmenistan,Pulau Pinang,0,0,0
1/05/2022,Turkmenistan,Sabah,0,0,0
1/05/2022,Turkmenistan,Sarawak,0,0,0
1/05/2022,Turkmenistan,Selangor,34,24,10
1/05/2022,Timor-Leste,Johor,3,1,2
1/05/2022,Timor-Leste,Kedah,0,0,0
1/05/2022,Timor-Leste,Perlis,0,0,0
1/05/2022,Timor-Leste,Pulau Pinang,2,1,1
1/05/2022,Timor-Leste,Sabah,0,0,0
1/05/2022,Timor-Leste,Sarawak,0,0,0
1/05/2022,Timor-Leste,Selangor,173,122,51
1/05/2022,Tonga,Johor,0,0,0
1/05/2022,Tonga,Pulau Pinang,0,0,0
1/05/2022,Tonga,Sarawak,0,0,0
1/05/2022,Tonga,Selangor,3,1,2
1/05/2022,Trinidad and Tobago,Johor,0,0,0
1/05/2022,Trinidad and Tobago,Kedah,2,1,1
1/05/2022,Trinidad and Tobago,Pahang,0,0,0
1/05/2022,Trinidad and Tobago,Pulau Pinang,0,0,0
1/05/2022,Trinidad and Tobago,Sabah,0,0,0
1/05/2022,Trinidad and Tobago,Sarawak,0,0,0
1/05/2022,Trinidad and Tobago,Selangor,9,5,4
1/05/2022,Tunisia,Johor,8,6,2
1/05/2022,Tunisia,Kedah,0,0,0
1/05/2022,Tunisia,Kelantan,0,0,0
1/05/2022,Tunisia,Melaka,0,0,0
1/05/2022,Tunisia,Perak,0,0,0
1/05/2022,Tunisia,Perlis,0,0,0
1/05/2022,Tunisia,Pulau Pinang,4,3,1
1/05/2022,Tunisia,Sabah,1,0,1
1/05/2022,Tunisia,Sarawak,0,0,0
1/05/2022,Tunisia,Selangor,138,79,59
1/05/2022,Tunisia,W.P. Labuan,0,0,0
1/05/2022,Türkiye,Johor,134,87,47
1/05/2022,Türkiye,Kedah,9,5,4
1/05/2022,Türkiye,Kelantan,0,0,0
1/05/2022,Türkiye,Melaka,0,0,0
1/05/2022,Türkiye,Negeri Sembilan,0,0,0
1/05/2022,Türkiye,Pahang,0,0,0
1/05/2022,Türkiye,Perak,0,0,0
1/05/2022,Türkiye,Perlis,2,2,0
1/05/2022,Türkiye,Pulau Pinang,11,6,5
1/05/2022,Türkiye,Sabah,0,0,0
1/05/2022,Türkiye,Sarawak,1,1,0
1/05/2022,Türkiye,Selangor,607,452,155
1/05/2022,Türkiye,W.P. Labuan,0,0,0
1/05/2022,Tuvalu,Selangor,0,0,0
1/05/2022,"Taiwan, Province of China",Johor,1863,762,1101
1/05/2022,"Taiwan, Province of China",Kedah,32,13,19
1/05/2022,"Taiwan, Province of China",Kelantan,0,0,0
1/05/2022,"Taiwan, Province of China",Melaka,0,0,0
1/05/2022,"Taiwan, Province of China",Negeri Sembilan,0,0,0
1/05/2022,"Taiwan, Province of China",Pahang,0,0,0
1/05/2022,"Taiwan, Province of China",Perak,5,1,4
1/05/2022,"Taiwan, Province of China",Perlis,3,3,0
1/05/2022,"Taiwan, Province of China",Pulau Pinang,233,143,90
1/05/2022,"Taiwan, Province of China",Sabah,38,16,22
1/05/2022,"Taiwan, Province of China",Sarawak,25,17,8
1/05/2022,"Taiwan, Province of China",Selangor,881,537,344
1/05/2022,"Taiwan, Province of China",W.P. Labuan,0,0,0
1/05/2022,"Tanzania, United Republic of",Johor,2,2,0
1/05/2022,"Tanzania, United Republic of",Kedah,0,0,0
1/05/2022,"Tanzania, United Republic of",Perak,0,0,0
1/05/2022,"Tanzania, United Republic of",Perlis,0,0,0
1/05/2022,"Tanzania, United Republic of",Pulau Pinang,0,0,0
1/05/2022,"Tanzania, United Republic of",Sabah,0,0,0
1/05/2022,"Tanzania, United Republic of",Sarawak,0,0,0
1/05/2022,"Tanzania, United Republic of",Selangor,72,32,40
1/05/2022,Uganda,Johor,0,0,0
1/05/2022,Uganda,Kedah,0,0,0
1/05/2022,Uganda,Perak,0,0,0
1/05/2022,Uganda,Perlis,0,0,0
1/05/2022,Uganda,Pulau Pinang,1,1,0
1/05/2022,Uganda,Sabah,0,0,0
1/05/2022,Uganda,Sarawak,0,0,0
1/05/2022,Uganda,Selangor,49,22,27
1/05/2022,Ukraine,Johor,54,24,30
1/05/2022,Ukraine,Kedah,6,3,3
1/05/2022,Ukraine,Kelantan,0,0,0
1/05/2022,Ukraine,Melaka,0,0,0
1/05/2022,Ukraine,Negeri Sembilan,0,0,0
1/05/2022,Ukraine,Pahang,0,0,0
1/05/2022,Ukraine,Perak,0,0,0
1/05/2022,Ukraine,Perlis,0,0,0
1/05/2022,Ukraine,Pulau Pinang,7,2,5
1/05/2022,Ukraine,Sabah,0,0,0
1/05/2022,Ukraine,Sarawak,1,1,0
1/05/2022,Ukraine,Selangor,257,131,126
1/05/2022,Ukraine,W.P. Labuan,0,0,0
1/05/2022,Uruguay,Johor,5,1,4
1/05/2022,Uruguay,Kedah,0,0,0
1/05/2022,Uruguay,Kelantan,0,0,0
1/05/2022,Uruguay,Perak,0,0,0
1/05/2022,Uruguay,Perlis,0,0,0
1/05/2022,Uruguay,Pulau Pinang,0,0,0
1/05/2022,Uruguay,Sabah,0,0,0
1/05/2022,Uruguay,Sarawak,0,0,0
1/05/2022,Uruguay,Selangor,7,5,2
1/05/2022,Uruguay,W.P. Labuan,0,0,0
1/05/2022,United States of America,Johor,1968,1234,734
1/05/2022,United States of America,Kedah,108,52,56
1/05/2022,United States of America,Kelantan,2,2,0
1/05/2022,United States of America,Melaka,0,0,0
1/05/2022,United States of America,Negeri Sembilan,0,0,0
1/05/2022,United States of America,Pahang,0,0,0
1/05/2022,United States of America,Perak,27,16,11
1/05/2022,United States of America,Perlis,5,4,1
1/05/2022,United States of America,Pulau Pinang,683,460,223
1/05/2022,United States of America,Sabah,83,49,34
1/05/2022,United States of America,Sarawak,72,41,31
1/05/2022,United States of America,Selangor,5752,3628,2124
1/05/2022,United States of America,Terengganu,0,0,0
1/05/2022,United States of America,W.P. Labuan,0,0,0
1/05/2022,Uzbekistan,Johor,20,12,8
1/05/2022,Uzbekistan,Kedah,3,2,1
1/05/2022,Uzbekistan,Kelantan,0,0,0
1/05/2022,Uzbekistan,Perak,0,0,0
1/05/2022,Uzbekistan,Perlis,0,0,0
1/05/2022,Uzbekistan,Pulau Pinang,0,0,0
1/05/2022,Uzbekistan,Sabah,0,0,0
1/05/2022,Uzbekistan,Sarawak,0,0,0
1/05/2022,Uzbekistan,Selangor,137,81,56
1/05/2022,Holy See,Johor,1,0,1
1/05/2022,Holy See,Sarawak,0,0,0
1/05/2022,Holy See,Selangor,0,0,0
1/05/2022,Saint Vincent and the Grenadines,Johor,0,0,0
1/05/2022,Saint Vincent and the Grenadines,Kedah,0,0,0
1/05/2022,Saint Vincent and the Grenadines,Pulau Pinang,0,0,0
1/05/2022,Saint Vincent and the Grenadines,Sarawak,0,0,0
1/05/2022,Saint Vincent and the Grenadines,Selangor,1,1,0
1/05/2022,"Venezuela, Bolivarian Republic of",Johor,4,3,1
1/05/2022,"Venezuela, Bolivarian Republic of",Kedah,0,0,0
1/05/2022,"Venezuela, Bolivarian Republic of",Kelantan,0,0,0
1/05/2022,"Venezuela, Bolivarian Republic of",Melaka,0,0,0
1/05/2022,"Venezuela, Bolivarian Republic of",Perak,0,0,0
1/05/2022,"Venezuela, Bolivarian Republic of",Perlis,0,0,0
1/05/2022,"Venezuela, Bolivarian Republic of",Pulau Pinang,1,0,1
1/05/2022,"Venezuela, Bolivarian Republic of",Sabah,0,0,0
1/05/2022,"Venezuela, Bolivarian Republic of",Sarawak,0,0,0
1/05/2022,"Venezuela, Bolivarian Republic of",Selangor,42,25,17
1/05/2022,"Venezuela, Bolivarian Republic of",W.P. Labuan,0,0,0
1/05/2022,Viet Nam,Johor,5759,1587,4172
1/05/2022,Viet Nam,Kedah,108,14,94
1/05/2022,Viet Nam,Kelantan,0,0,0
1/05/2022,Viet Nam,Melaka,0,0,0
1/05/2022,Viet Nam,Negeri Sembilan,0,0,0
1/05/2022,Viet Nam,Pahang,0,0,0
1/05/2022,Viet Nam,Perak,11,0,11
1/05/2022,Viet Nam,Perlis,4,2,2
1/05/2022,Viet Nam,Pulau Pinang,651,160,491
1/05/2022,Viet Nam,Sabah,12,5,7
1/05/2022,Viet Nam,Sarawak,26,3,23
1/05/2022,Viet Nam,Selangor,7088,2200,4888
1/05/2022,Viet Nam,Terengganu,0,0,0
1/05/2022,Viet Nam,W.P. Labuan,0,0,0
1/05/2022,Vanuatu,Johor,30,20,10
1/05/2022,Vanuatu,Kedah,3,3,0
1/05/2022,Vanuatu,Pulau Pinang,1,1,0
1/05/2022,Vanuatu,Sabah,0,0,0
1/05/2022,Vanuatu,Sarawak,0,0,0
1/05/2022,Vanuatu,Selangor,24,19,5
1/05/2022, Samoa,Johor,0,0,0
1/05/2022, Samoa,Sarawak,0,0,0
1/05/2022, Samoa,Selangor,1,0,1
1/05/2022,Yemen,Johor,19,15,4
1/05/2022,Yemen,Kedah,1,1,0
1/05/2022,Yemen,Kelantan,0,0,0
1/05/2022,Yemen,Melaka,4,2,2
1/05/2022,Yemen,Pahang,0,0,0
1/05/2022,Yemen,Perak,0,0,0
1/05/2022,Yemen,Perlis,1,1,0
1/05/2022,Yemen,Pulau Pinang,2,2,0
1/05/2022,Yemen,Sabah,0,0,0
1/05/2022,Yemen,Sarawak,1,0,1
1/05/2022,Yemen,Selangor,1031,690,341
1/05/2022,Yemen,W.P. Labuan,0,0,0
1/05/2022,South Africa,Johor,136,85,51
1/05/2022,South Africa,Kedah,7,3,4
1/05/2022,South Africa,Kelantan,0,0,0
1/05/2022,South Africa,Melaka,0,0,0
1/05/2022,South Africa,Pahang,1,1,0
1/05/2022,South Africa,Perak,0,0,0
1/05/2022,South Africa,Perlis,2,1,1
1/05/2022,South Africa,Pulau Pinang,20,11,9
1/05/2022,South Africa,Sabah,4,2,2
1/05/2022,South Africa,Sarawak,6,5,1
1/05/2022,South Africa,Selangor,514,304,210
1/05/2022,South Africa,Terengganu,0,0,0
1/05/2022,South Africa,W.P. Labuan,0,0,0
1/05/2022,ZAR,Selangor,0,0,0
1/05/2022,Zambia,Johor,3,3,0
1/05/2022,Zambia,Kedah,0,0,0
1/05/2022,Zambia,Perak,0,0,0
1/05/2022,Zambia,Perlis,0,0,0
1/05/2022,Zambia,Pulau Pinang,0,0,0
1/05/2022,Zambia,Sabah,0,0,0
1/05/2022,Zambia,Sarawak,0,0,0
1/05/2022,Zambia,Selangor,27,18,9
1/05/2022,Zimbabwe,Johor,4,3,1
1/05/2022,Zimbabwe,Kedah,0,0,0
1/05/2022,Zimbabwe,Kelantan,0,0,0
1/05/2022,Zimbabwe,Perak,0,0,0
1/05/2022,Zimbabwe,Perlis,0,0,0
1/05/2022,Zimbabwe,Pulau Pinang,2,0,2
1/05/2022,Zimbabwe,Sabah,0,0,0
1/05/2022,Zimbabwe,Sarawak,0,0,0
1/05/2022,Zimbabwe,Selangor,63,40,23
1/06/2022,Aruba,Kedah,0,0,0
1/06/2022,Aruba,Pulau Pinang,1,0,1
1/06/2022,Afghanistan,Johor,1,1,0
1/06/2022,Afghanistan,Kedah,0,0,0
1/06/2022,Afghanistan,Perlis,0,0,0
1/06/2022,Afghanistan,Pulau Pinang,0,0,0
1/06/2022,Afghanistan,Sarawak,0,0,0
1/06/2022,Afghanistan,Selangor,101,72,29
1/06/2022,Angola,Johor,0,0,0
1/06/2022,Angola,Kedah,0,0,0
1/06/2022,Angola,Sabah,0,0,0
1/06/2022,Angola,Selangor,0,0,0
1/06/2022,Anguilla,Selangor,0,0,0
1/06/2022,Albania,Johor,3,1,2
1/06/2022,Albania,Kedah,1,1,0
1/06/2022,Albania,Perak,0,0,0
1/06/2022,Albania,Perlis,0,0,0
1/06/2022,Albania,Pulau Pinang,1,1,0
1/06/2022,Albania,Sabah,0,0,0
1/06/2022,Albania,Sarawak,0,0,0
1/06/2022,Albania,Selangor,8,5,3
1/06/2022,Andorra,Johor,0,0,0
1/06/2022,Andorra,Kedah,1,0,1
1/06/2022,Andorra,Perlis,0,0,0
1/06/2022,Andorra,Pulau Pinang,0,0,0
1/06/2022,Andorra,Selangor,2,1,1
1/06/2022,Antigua and Barbuda,Selangor,0,0,0
1/06/2022,United Arab Emirates,Johor,20,12,8
1/06/2022,United Arab Emirates,Kedah,2,1,1
1/06/2022,United Arab Emirates,Kelantan,0,0,0
1/06/2022,United Arab Emirates,Perak,0,0,0
1/06/2022,United Arab Emirates,Perlis,0,0,0
1/06/2022,United Arab Emirates,Pulau Pinang,0,0,0
1/06/2022,United Arab Emirates,Sabah,0,0,0
1/06/2022,United Arab Emirates,Sarawak,0,0,0
1/06/2022,United Arab Emirates,Selangor,173,119,54
1/06/2022,Argentina,Johor,33,23,10
1/06/2022,Argentina,Kedah,4,2,2
1/06/2022,Argentina,Kelantan,5,3,2
1/06/2022,Argentina,Melaka,0,0,0
1/06/2022,Argentina,Perak,0,0,0
1/06/2022,Argentina,Perlis,3,1,2
1/06/2022,Argentina,Pulau Pinang,0,0,0
1/06/2022,Argentina,Sabah,7,3,4
1/06/2022,Argentina,Sarawak,0,0,0
1/06/2022,Argentina,Selangor,132,77,55
1/06/2022,Argentina,W.P. Labuan,0,0,0
1/06/2022,Armenia,Johor,2,0,2
1/06/2022,Armenia,Kedah,1,0,1
1/06/2022,Armenia,Kelantan,0,0,0
1/06/2022,Armenia,Perak,0,0,0
1/06/2022,Armenia,Perlis,0,0,0
1/06/2022,Armenia,Pulau Pinang,0,0,0
1/06/2022,Armenia,Sabah,0,0,0
1/06/2022,Armenia,Sarawak,0,0,0
1/06/2022,Armenia,Selangor,14,5,9
1/06/2022,Antarctica,Selangor,0,0,0
1/06/2022,Antigua and Barbuda,Johor,7,5,2
1/06/2022,Antigua and Barbuda,Kedah,0,0,0
1/06/2022,Antigua and Barbuda,Pulau Pinang,0,0,0
1/06/2022,Antigua and Barbuda,Sarawak,0,0,0
1/06/2022,Antigua and Barbuda,Selangor,8,5,3
1/06/2022,Australia,Johor,2835,1770,1065
1/06/2022,Australia,Kedah,188,101,87
1/06/2022,Australia,Kelantan,5,4,1
1/06/2022,Australia,Melaka,3,2,1
1/06/2022,Australia,Negeri Sembilan,0,0,0
1/06/2022,Australia,Pahang,0,0,0
1/06/2022,Australia,Perak,100,45,55
1/06/2022,Australia,Perlis,6,4,2
1/06/2022,Australia,Pulau Pinang,1042,582,460
1/06/2022,Australia,Sabah,234,129,105
1/06/2022,Australia,Sarawak,227,112,115
1/06/2022,Australia,Selangor,8651,5218,3433
1/06/2022,Australia,Terengganu,0,0,0
1/06/2022,Australia,W.P. Labuan,1,1,0
1/06/2022,Austria,Johor,75,57,18
1/06/2022,Austria,Kedah,7,6,1
1/06/2022,Austria,Kelantan,1,1,0
1/06/2022,Austria,Melaka,0,0,0
1/06/2022,Austria,Negeri Sembilan,0,0,0
1/06/2022,Austria,Pahang,0,0,0
1/06/2022,Austria,Perak,2,1,1
1/06/2022,Austria,Perlis,2,2,0
1/06/2022,Austria,Pulau Pinang,31,27,4
1/06/2022,Austria,Sabah,8,2,6
1/06/2022,Austria,Sarawak,3,2,1
1/06/2022,Austria,Selangor,315,209,106
1/06/2022,Austria,Terengganu,0,0,0
1/06/2022,Austria,W.P. Labuan,0,0,0
1/06/2022,Azerbaijan,Johor,8,8,0
1/06/2022,Azerbaijan,Kedah,0,0,0
1/06/2022,Azerbaijan,Kelantan,0,0,0
1/06/2022,Azerbaijan,Melaka,0,0,0
1/06/2022,Azerbaijan,Perlis,0,0,0
1/06/2022,Azerbaijan,Pulau Pinang,0,0,0
1/06/2022,Azerbaijan,Sabah,0,0,0
1/06/2022,Azerbaijan,Sarawak,0,0,0
1/06/2022,Azerbaijan,Selangor,34,19,15
1/06/2022,Azerbaijan,W.P. Labuan,0,0,0
1/06/2022,Burundi,Pulau Pinang,0,0,0
1/06/2022,Burundi,Sarawak,0,0,0
1/06/2022,Burundi,Selangor,0,0,0
1/06/2022,Belgium,Johor,123,91,32
1/06/2022,Belgium,Kedah,10,4,6
1/06/2022,Belgium,Kelantan,0,0,0
1/06/2022,Belgium,Melaka,0,0,0
1/06/2022,Belgium,Negeri Sembilan,0,0,0
1/06/2022,Belgium,Pahang,0,0,0
1/06/2022,Belgium,Perak,2,1,1
1/06/2022,Belgium,Perlis,3,3,0
1/06/2022,Belgium,Pulau Pinang,16,9,7
1/06/2022,Belgium,Sabah,12,9,3
1/06/2022,Belgium,Sarawak,11,7,4
1/06/2022,Belgium,Selangor,496,341,155
1/06/2022,Belgium,W.P. Labuan,0,0,0
1/06/2022,Benin,Johor,0,0,0
1/06/2022,Benin,Kedah,0,0,0
1/06/2022,Benin,Perak,0,0,0
1/06/2022,Benin,Pulau Pinang,0,0,0
1/06/2022,Benin,Sabah,0,0,0
1/06/2022,Benin,Sarawak,0,0,0
1/06/2022,Benin,Selangor,1,1,0
1/06/2022,Burkina Faso,Perak,0,0,0
1/06/2022,Burkina Faso,Pulau Pinang,0,0,0
1/06/2022,Burkina Faso,Selangor,2,1,1
1/06/2022,Bangladesh,Johor,1012,823,189
1/06/2022,Bangladesh,Kedah,24,16,8
1/06/2022,Bangladesh,Kelantan,1,1,0
1/06/2022,Bangladesh,Melaka,0,0,0
1/06/2022,Bangladesh,Negeri Sembilan,0,0,0
1/06/2022,Bangladesh,Pahang,0,0,0
1/06/2022,Bangladesh,Perak,0,0,0
1/06/2022,Bangladesh,Perlis,3,3,0
1/06/2022,Bangladesh,Pulau Pinang,36,29,7
1/06/2022,Bangladesh,Sabah,0,0,0
1/06/2022,Bangladesh,Sarawak,22,22,0
1/06/2022,Bangladesh,Selangor,13817,12880,937
1/06/2022,Bangladesh,W.P. Labuan,0,0,0
1/06/2022,Bulgaria,Johor,14,7,7
1/06/2022,Bulgaria,Kedah,2,0,2
1/06/2022,Bulgaria,Kelantan,0,0,0
1/06/2022,Bulgaria,Pahang,0,0,0
1/06/2022,Bulgaria,Perak,0,0,0
1/06/2022,Bulgaria,Perlis,0,0,0
1/06/2022,Bulgaria,Pulau Pinang,3,2,1
1/06/2022,Bulgaria,Sabah,1,0,1
1/06/2022,Bulgaria,Sarawak,1,0,1
1/06/2022,Bulgaria,Selangor,104,58,46
1/06/2022,Bulgaria,W.P. Labuan,0,0,0
1/06/2022,Bahrain,Johor,6,3,3
1/06/2022,Bahrain,Kedah,2,1,1
1/06/2022,Bahrain,Kelantan,0,0,0
1/06/2022,Bahrain,Perlis,0,0,0
1/06/2022,Bahrain,Pulau Pinang,2,1,1
1/06/2022,Bahrain,Sabah,0,0,0
1/06/2022,Bahrain,Sarawak,0,0,0
1/06/2022,Bahrain,Selangor,219,139,80
1/06/2022,Bahamas,Johor,0,0,0
1/06/2022,Bahamas,Kedah,0,0,0
1/06/2022,Bahamas,Perak,0,0,0
1/06/2022,Bahamas,Sabah,0,0,0
1/06/2022,Bahamas,Sarawak,0,0,0
1/06/2022,Bahamas,Selangor,4,2,2
1/06/2022,Bosnia and Herzegovina,Johor,6,4,2
1/06/2022,Bosnia and Herzegovina,Kedah,0,0,0
1/06/2022,Bosnia and Herzegovina,Perlis,0,0,0
1/06/2022,Bosnia and Herzegovina,Pulau Pinang,0,0,0
1/06/2022,Bosnia and Herzegovina,Sabah,0,0,0
1/06/2022,Bosnia and Herzegovina,Sarawak,0,0,0
1/06/2022,Bosnia and Herzegovina,Selangor,29,18,11
1/06/2022,Belarus,Johor,7,2,5
1/06/2022,Belarus,Kedah,5,1,4
1/06/2022,Belarus,Kelantan,0,0,0
1/06/2022,Belarus,Pahang,0,0,0
1/06/2022,Belarus,Perak,0,0,0
1/06/2022,Belarus,Perlis,1,1,0
1/06/2022,Belarus,Pulau Pinang,1,1,0
1/06/2022,Belarus,Sabah,1,1,0
1/06/2022,Belarus,Sarawak,0,0,0
1/06/2022,Belarus,Selangor,70,32,38
1/06/2022,Belarus,W.P. Labuan,0,0,0
1/06/2022,Belize,Johor,1,0,1
1/06/2022,Belize,Pulau Pinang,0,0,0
1/06/2022,Belize,Sarawak,0,0,0
1/06/2022,Belize,Selangor,0,0,0
1/06/2022,Bermuda,Selangor,0,0,0
1/06/2022,Bolivia,Johor,1,0,1
1/06/2022,Bolivia,Kedah,0,0,0
1/06/2022,Bolivia,Melaka,0,0,0
1/06/2022,Bolivia,Perak,0,0,0
1/06/2022,Bolivia,Perlis,0,0,0
1/06/2022,Bolivia,Pulau Pinang,0,0,0
1/06/2022,Bolivia,Sabah,0,0,0
1/06/2022,Bolivia,Sarawak,0,0,0
1/06/2022,Bolivia,Selangor,9,6,3
1/06/2022,Brazil,Johor,113,80,33
1/06/2022,Brazil,Kedah,5,2,3
1/06/2022,Brazil,Kelantan,0,0,0
1/06/2022,Brazil,Melaka,4,2,2
1/06/2022,Brazil,Pahang,0,0,0
1/06/2022,Brazil,Perak,0,0,0
1/06/2022,Brazil,Perlis,1,1,0
1/06/2022,Brazil,Pulau Pinang,4,3,1
1/06/2022,Brazil,Sabah,3,0,3
1/06/2022,Brazil,Sarawak,1,0,1
1/06/2022,Brazil,Selangor,376,236,140
1/06/2022,Brazil,W.P. Labuan,0,0,0
1/06/2022,Barbados,Johor,0,0,0
1/06/2022,Barbados,Kedah,0,0,0
1/06/2022,Barbados,Perlis,0,0,0
1/06/2022,Barbados,Pulau Pinang,0,0,0
1/06/2022,Barbados,Selangor,3,1,2
1/06/2022,Brunei Darussalam,Johor,177,105,72
1/06/2022,Brunei Darussalam,Kedah,1,0,1
1/06/2022,Brunei Darussalam,Kelantan,2,2,0
1/06/2022,Brunei Darussalam,Melaka,0,0,0
1/06/2022,Brunei Darussalam,Pahang,0,0,0
1/06/2022,Brunei Darussalam,Perak,1,0,1
1/06/2022,Brunei Darussalam,Perlis,0,0,0
1/06/2022,Brunei Darussalam,Pulau Pinang,9,2,7
1/06/2022,Brunei Darussalam,Sabah,394,199,195
1/06/2022,Brunei Darussalam,Sarawak,1622,1182,440
1/06/2022,Brunei Darussalam,Selangor,1930,1020,910
1/06/2022,Brunei Darussalam,W.P. Labuan,29,13,16
1/06/2022,Bhutan,Johor,0,0,0
1/06/2022,Bhutan,Kedah,0,0,0
1/06/2022,Bhutan,Perak,0,0,0
1/06/2022,Bhutan,Perlis,0,0,0
1/06/2022,Bhutan,Pulau Pinang,1,1,0
1/06/2022,Bhutan,Sabah,0,0,0
1/06/2022,Bhutan,Sarawak,0,0,0
1/06/2022,Bhutan,Selangor,44,25,19
1/06/2022,Botswana,Johor,0,0,0
1/06/2022,Botswana,Kedah,1,1,0
1/06/2022,Botswana,Perlis,0,0,0
1/06/2022,Botswana,Pulau Pinang,0,0,0
1/06/2022,Botswana,Sabah,0,0,0
1/06/2022,Botswana,Sarawak,0,0,0
1/06/2022,Botswana,Selangor,10,8,2
1/06/2022,Central African Republic,Kedah,0,0,0
1/06/2022,Central African Republic,Selangor,1,1,0
1/06/2022,Canada,Johor,660,412,248
1/06/2022,Canada,Kedah,39,18,21
1/06/2022,Canada,Kelantan,0,0,0
1/06/2022,Canada,Melaka,0,0,0
1/06/2022,Canada,Negeri Sembilan,0,0,0
1/06/2022,Canada,Pahang,0,0,0
1/06/2022,Canada,Perak,9,7,2
1/06/2022,Canada,Perlis,6,5,1
1/06/2022,Canada,Pulau Pinang,151,92,59
1/06/2022,Canada,Sabah,55,27,28
1/06/2022,Canada,Sarawak,44,22,22
1/06/2022,Canada,Selangor,1675,1013,662
1/06/2022,Canada,Terengganu,0,0,0
1/06/2022,Canada,W.P. Labuan,0,0,0
1/06/2022,Cocos (Keeling) Islands,Selangor,0,0,0
1/06/2022,Switzerland,Johor,208,148,60
1/06/2022,Switzerland,Kedah,23,10,13
1/06/2022,Switzerland,Kelantan,0,0,0
1/06/2022,Switzerland,Melaka,0,0,0
1/06/2022,Switzerland,Negeri Sembilan,0,0,0
1/06/2022,Switzerland,Pahang,0,0,0
1/06/2022,Switzerland,Perak,3,2,1
1/06/2022,Switzerland,Perlis,7,4,3
1/06/2022,Switzerland,Pulau Pinang,61,43,18
1/06/2022,Switzerland,Sabah,19,9,10
1/06/2022,Switzerland,Sarawak,16,11,5
1/06/2022,Switzerland,Selangor,528,327,201
1/06/2022,Switzerland,W.P. Labuan,0,0,0
1/06/2022,Chile,Johor,24,12,12
1/06/2022,Chile,Kedah,2,1,1
1/06/2022,Chile,Kelantan,1,1,0
1/06/2022,Chile,Melaka,0,0,0
1/06/2022,Chile,Pahang,0,0,0
1/06/2022,Chile,Perak,0,0,0
1/06/2022,Chile,Perlis,0,0,0
1/06/2022,Chile,Pulau Pinang,0,0,0
1/06/2022,Chile,Sabah,2,1,1
1/06/2022,Chile,Sarawak,0,0,0
1/06/2022,Chile,Selangor,103,52,51
1/06/2022,China,Johor,13803,5571,8232
1/06/2022,China,Kedah,227,104,123
1/06/2022,China,Kelantan,4,1,3
1/06/2022,China,Melaka,0,0,0
1/06/2022,China,Pahang,1,1,0
1/06/2022,China,Perak,89,35,54
1/06/2022,China,Perlis,17,10,7
1/06/2022,China,Pulau Pinang,704,333,371
1/06/2022,China,Sabah,244,96,148
1/06/2022,China,Sarawak,93,40,53
1/06/2022,China,Selangor,7602,4605,2997
1/06/2022,China,Terengganu,0,0,0
1/06/2022,China,W.P. Labuan,0,0,0
1/06/2022,Côte d'Ivoire,Johor,0,0,0
1/06/2022,Côte d'Ivoire,Kedah,0,0,0
1/06/2022,Côte d'Ivoire,Pulau Pinang,0,0,0
1/06/2022,Côte d'Ivoire,Sabah,0,0,0
1/06/2022,Côte d'Ivoire,Sarawak,0,0,0
1/06/2022,Côte d'Ivoire,Selangor,7,2,5
1/06/2022,Cameroon,Johor,1,1,0
1/06/2022,Cameroon,Kedah,0,0,0
1/06/2022,Cameroon,Pulau Pinang,1,1,0
1/06/2022,Cameroon,Sabah,0,0,0
1/06/2022,Cameroon,Sarawak,0,0,0
1/06/2022,Cameroon,Selangor,10,9,1
1/06/2022,Congo,Johor,0,0,0
1/06/2022,Congo,Pulau Pinang,0,0,0
1/06/2022,Congo,Sarawak,0,0,0
1/06/2022,Congo,Selangor,9,5,4
1/06/2022,Congo,Johor,0,0,0
1/06/2022,Congo,Kedah,0,0,0
1/06/2022,Congo,Selangor,2,2,0
1/06/2022,Cook Islands,Selangor,0,0,0
1/06/2022,Colombia,Johor,13,5,8
1/06/2022,Colombia,Kedah,1,0,1
1/06/2022,Colombia,Perak,0,0,0
1/06/2022,Colombia,Pulau Pinang,0,0,0
1/06/2022,Colombia,Sabah,1,1,0
1/06/2022,Colombia,Sarawak,2,1,1
1/06/2022,Colombia,Selangor,61,28,33
1/06/2022,Colombia,W.P. Labuan,0,0,0
1/06/2022,Comoros,Johor,0,0,0
1/06/2022,Comoros,Kedah,0,0,0
1/06/2022,Comoros,Selangor,9,5,4
1/06/2022,Cabo Verde,Johor,0,0,0
1/06/2022,Cabo Verde,Kedah,0,0,0
1/06/2022,Cabo Verde,Pulau Pinang,0,0,0
1/06/2022,Cabo Verde,Sabah,0,0,0
1/06/2022,Cabo Verde,Selangor,1,1,0
1/06/2022,Costa Rica,Johor,8,7,1
1/06/2022,Costa Rica,Kedah,0,0,0
1/06/2022,Costa Rica,Perak,0,0,0
1/06/2022,Costa Rica,Perlis,0,0,0
1/06/2022,Costa Rica,Pulau Pinang,5,4,1
1/06/2022,Costa Rica,Sabah,0,0,0
1/06/2022,Costa Rica,Sarawak,1,0,1
1/06/2022,Costa Rica,Selangor,17,8,9
1/06/2022,Cuba,Johor,2,2,0
1/06/2022,Cuba,Kedah,0,0,0
1/06/2022,Cuba,Perlis,0,0,0
1/06/2022,Cuba,Pulau Pinang,0,0,0
1/06/2022,Cuba,Sabah,0,0,0
1/06/2022,Cuba,Sarawak,0,0,0
1/06/2022,Cuba,Selangor,4,3,1
1/06/2022,Cyprus,Johor,9,7,2
1/06/2022,Cyprus,Kedah,0,0,0
1/06/2022,Cyprus,Perak,0,0,0
1/06/2022,Cyprus,Perlis,0,0,0
1/06/2022,Cyprus,Pulau Pinang,1,1,0
1/06/2022,Cyprus,Sabah,0,0,0
1/06/2022,Cyprus,Sarawak,0,0,0
1/06/2022,Cyprus,Selangor,29,22,7
1/06/2022,Czechia,Johor,33,21,12
1/06/2022,Czechia,Kedah,10,8,2
1/06/2022,Czechia,Kelantan,2,2,0
1/06/2022,Czechia,Melaka,0,0,0
1/06/2022,Czechia,Negeri Sembilan,0,0,0
1/06/2022,Czechia,Perak,0,0,0
1/06/2022,Czechia,Perlis,2,2,0
1/06/2022,Czechia,Pulau Pinang,7,6,1
1/06/2022,Czechia,Sabah,3,1,2
1/06/2022,Czechia,Sarawak,1,1,0
1/06/2022,Czechia,Selangor,233,134,99
1/06/2022,Czechia,W.P. Labuan,0,0,0
1/06/2022,Germany,Johor,1010,716,294
1/06/2022,Germany,Kedah,103,61,42
1/06/2022,Germany,Kelantan,3,2,1
1/06/2022,Germany,Melaka,0,0,0
1/06/2022,Germany,Negeri Sembilan,0,0,0
1/06/2022,Germany,Pahang,0,0,0
1/06/2022,Germany,Perak,14,10,4
1/06/2022,Germany,Perlis,29,15,14
1/06/2022,Germany,Pulau Pinang,309,239,70
1/06/2022,Germany,Sabah,48,26,22
1/06/2022,Germany,Sarawak,49,34,15
1/06/2022,Germany,Selangor,3499,2308,1191
1/06/2022,Germany,Terengganu,0,0,0
1/06/2022,Germany,W.P. Labuan,0,0,0
1/06/2022,Djibouti,Johor,1,1,0
1/06/2022,Djibouti,Selangor,4,3,1
1/06/2022,Dominica,Johor,1,1,0
1/06/2022,Dominica,Kedah,0,0,0
1/06/2022,Dominica,Pulau Pinang,0,0,0
1/06/2022,Dominica,Sabah,0,0,0
1/06/2022,Dominica,Sarawak,0,0,0
1/06/2022,Dominica,Selangor,15,12,3
1/06/2022,Dominica,W.P. Labuan,0,0,0
1/06/2022,Denmark,Johor,143,118,25
1/06/2022,Denmark,Kedah,10,5,5
1/06/2022,Denmark,Kelantan,2,1,1
1/06/2022,Denmark,Melaka,0,0,0
1/06/2022,Denmark,Negeri Sembilan,0,0,0
1/06/2022,Denmark,Pahang,0,0,0
1/06/2022,Denmark,Perak,0,0,0
1/06/2022,Denmark,Perlis,3,3,0
1/06/2022,Denmark,Pulau Pinang,24,17,7
1/06/2022,Denmark,Sabah,26,17,9
1/06/2022,Denmark,Sarawak,13,9,4
1/06/2022,Denmark,Selangor,520,333,187
1/06/2022,Denmark,W.P. Labuan,0,0,0
1/06/2022,Dominican Republic,Johor,1,1,0
1/06/2022,Dominican Republic,Kedah,0,0,0
1/06/2022,Dominican Republic,Perak,0,0,0
1/06/2022,Dominican Republic,Perlis,0,0,0
1/06/2022,Dominican Republic,Pulau Pinang,0,0,0
1/06/2022,Dominican Republic,Sabah,0,0,0
1/06/2022,Dominican Republic,Sarawak,1,0,1
1/06/2022,Dominican Republic,Selangor,7,4,3
1/06/2022,Algeria,Johor,23,21,2
1/06/2022,Algeria,Kedah,3,3,0
1/06/2022,Algeria,Kelantan,0,0,0
1/06/2022,Algeria,Melaka,0,0,0
1/06/2022,Algeria,Perak,0,0,0
1/06/2022,Algeria,Perlis,0,0,0
1/06/2022,Algeria,Pulau Pinang,0,0,0
1/06/2022,Algeria,Sabah,0,0,0
1/06/2022,Algeria,Sarawak,0,0,0
1/06/2022,Algeria,Selangor,196,112,84
1/06/2022,Algeria,W.P. Labuan,0,0,0
1/06/2022,Ecuador,Johor,9,4,5
1/06/2022,Ecuador,Kedah,1,0,1
1/06/2022,Ecuador,Perak,0,0,0
1/06/2022,Ecuador,Perlis,0,0,0
1/06/2022,Ecuador,Pulau Pinang,0,0,0
1/06/2022,Ecuador,Sabah,0,0,0
1/06/2022,Ecuador,Sarawak,0,0,0
1/06/2022,Ecuador,Selangor,19,12,7
1/06/2022,Egypt,Johor,117,99,18
1/06/2022,Egypt,Kedah,5,3,2
1/06/2022,Egypt,Kelantan,2,2,0
1/06/2022,Egypt,Melaka,0,0,0
1/06/2022,Egypt,Pahang,0,0,0
1/06/2022,Egypt,Perak,0,0,0
1/06/2022,Egypt,Perlis,0,0,0
1/06/2022,Egypt,Pulau Pinang,1,1,0
1/06/2022,Egypt,Sabah,3,1,2
1/06/2022,Egypt,Sarawak,2,2,0
1/06/2022,Egypt,Selangor,1006,667,339
1/06/2022,Egypt,Terengganu,0,0,0
1/06/2022,Egypt,W.P. Labuan,0,0,0
1/06/2022,Eritrea,Johor,1,1,0
1/06/2022,Eritrea,Pulau Pinang,0,0,0
1/06/2022,Eritrea,Sabah,0,0,0
1/06/2022,Eritrea,Selangor,5,1,4
1/06/2022,Spain,Johor,279,168,111
1/06/2022,Spain,Kedah,17,8,9
1/06/2022,Spain,Kelantan,1,1,0
1/06/2022,Spain,Melaka,2,1,1
1/06/2022,Spain,Negeri Sembilan,1,1,0
1/06/2022,Spain,Pahang,0,0,0
1/06/2022,Spain,Perak,2,2,0
1/06/2022,Spain,Perlis,5,2,3
1/06/2022,Spain,Pulau Pinang,19,10,9
1/06/2022,Spain,Sabah,25,11,14
1/06/2022,Spain,Sarawak,6,5,1
1/06/2022,Spain,Selangor,1133,734,399
1/06/2022,Spain,W.P. Labuan,0,0,0
1/06/2022,Estonia,Johor,11,7,4
1/06/2022,Estonia,Kedah,0,0,0
1/06/2022,Estonia,Kelantan,0,0,0
1/06/2022,Estonia,Pahang,0,0,0
1/06/2022,Estonia,Perak,0,0,0
1/06/2022,Estonia,Perlis,0,0,0
1/06/2022,Estonia,Pulau Pinang,3,1,2
1/06/2022,Estonia,Sabah,0,0,0
1/06/2022,Estonia,Sarawak,0,0,0
1/06/2022,Estonia,Selangor,33,14,19
1/06/2022,Estonia,W.P. Labuan,0,0,0
1/06/2022,Ethiopia,Johor,3,2,1
1/06/2022,Ethiopia,Kedah,0,0,0
1/06/2022,Ethiopia,Pulau Pinang,1,1,0
1/06/2022,Ethiopia,Sarawak,0,0,0
1/06/2022,Ethiopia,Selangor,16,11,5
1/06/2022,Finland,Johor,136,87,49
1/06/2022,Finland,Kedah,1,0,1
1/06/2022,Finland,Kelantan,0,0,0
1/06/2022,Finland,Melaka,0,0,0
1/06/2022,Finland,Negeri Sembilan,0,0,0
1/06/2022,Finland,Pahang,4,2,2
1/06/2022,Finland,Perak,5,4,1
1/06/2022,Finland,Perlis,2,1,1
1/06/2022,Finland,Pulau Pinang,25,20,5
1/06/2022,Finland,Sabah,5,1,4
1/06/2022,Finland,Sarawak,1,1,0
1/06/2022,Finland,Selangor,195,135,60
1/06/2022,Finland,W.P. Labuan,0,0,0
1/06/2022,Fiji,Johor,19,13,6
1/06/2022,Fiji,Kedah,1,1,0
1/06/2022,Fiji,Kelantan,0,0,0
1/06/2022,Fiji,Perak,0,0,0
1/06/2022,Fiji,Perlis,0,0,0
1/06/2022,Fiji,Pulau Pinang,2,2,0
1/06/2022,Fiji,Sabah,1,0,1
1/06/2022,Fiji,Sarawak,0,0,0
1/06/2022,Fiji,Selangor,49,35,14
1/06/2022,France,Johor,1095,704,391
1/06/2022,France,Kedah,110,64,46
1/06/2022,France,Kelantan,2,0,2
1/06/2022,France,Melaka,5,3,2
1/06/2022,France,Negeri Sembilan,1,0,1
1/06/2022,France,Pahang,1,1,0
1/06/2022,France,Perak,10,7,3
1/06/2022,France,Perlis,29,17,12
1/06/2022,France,Pulau Pinang,144,105,39
1/06/2022,France,Sabah,74,40,34
1/06/2022,France,Sarawak,38,23,15
1/06/2022,France,Selangor,3398,2148,1250
1/06/2022,France,Terengganu,1,1,0
1/06/2022,France,W.P. Labuan,0,0,0
1/06/2022,"Micronesia, Federated States of",Johor,0,0,0
1/06/2022,"Micronesia, Federated States of",Pulau Pinang,0,0,0
1/06/2022,"Micronesia, Federated States of",Selangor,0,0,0
1/06/2022,Gabon,Johor,1,1,0
1/06/2022,Gabon,Pulau Pinang,0,0,0
1/06/2022,Gabon,Sarawak,0,0,0
1/06/2022,Gabon,Selangor,1,1,0
1/06/2022,United Kingdom of Great Britain and Northern Ireland,Johor,2907,2017,890
1/06/2022,United Kingdom of Great Britain and Northern Ireland,Kedah,328,179,149
1/06/2022,United Kingdom of Great Britain and Northern Ireland,Kelantan,7,5,2
1/06/2022,United Kingdom of Great Britain and Northern Ireland,Melaka,0,0,0
1/06/2022,United Kingdom of Great Britain and Northern Ireland,Negeri Sembilan,0,0,0
1/06/2022,United Kingdom of Great Britain and Northern Ireland,Pahang,7,7,0
1/06/2022,United Kingdom of Great Britain and Northern Ireland,Perak,32,16,16
1/06/2022,United Kingdom of Great Britain and Northern Ireland,Perlis,40,25,15
1/06/2022,United Kingdom of Great Britain and Northern Ireland,Pulau Pinang,532,348,184
1/06/2022,United Kingdom of Great Britain and Northern Ireland,Sabah,197,109,88
1/06/2022,United Kingdom of Great Britain and Northern Ireland,Sarawak,119,73,46
1/06/2022,United Kingdom of Great Britain and Northern Ireland,Selangor,8474,5417,3057
1/06/2022,United Kingdom of Great Britain and Northern Ireland,Terengganu,3,3,0
1/06/2022,United Kingdom of Great Britain and Northern Ireland,W.P. Labuan,0,0,0
1/06/2022,Georgia,Johor,9,6,3
1/06/2022,Georgia,Kedah,2,1,1
1/06/2022,Georgia,Melaka,0,0,0
1/06/2022,Georgia,Perak,0,0,0
1/06/2022,Georgia,Perlis,0,0,0
1/06/2022,Georgia,Pulau Pinang,1,1,0
1/06/2022,Georgia,Sabah,0,0,0
1/06/2022,Georgia,Sarawak,0,0,0
1/06/2022,Georgia,Selangor,18,13,5
1/06/2022,Ghana,Johor,3,1,2
1/06/2022,Ghana,Kedah,0,0,0
1/06/2022,Ghana,Kelantan,0,0,0
1/06/2022,Ghana,Pulau Pinang,0,0,0
1/06/2022,Ghana,Sabah,0,0,0
1/06/2022,Ghana,Sarawak,1,0,1
1/06/2022,Ghana,Selangor,22,13,9
1/06/2022,Gibraltar,Johor,0,0,0
1/06/2022,Gibraltar,Sarawak,0,0,0
1/06/2022,Guinea,Johor,4,4,0
1/06/2022,Guinea,Kedah,0,0,0
1/06/2022,Guinea,Kelantan,0,0,0
1/06/2022,Guinea,Perlis,0,0,0
1/06/2022,Guinea,Pulau Pinang,0,0,0
1/06/2022,Guinea,Sabah,0,0,0
1/06/2022,Guinea,Sarawak,0,0,0
1/06/2022,Guinea,Selangor,19,14,5
1/06/2022,Guadeloupe,Selangor,0,0,0
1/06/2022,Gambia,Johor,0,0,0
1/06/2022,Gambia,Kedah,0,0,0
1/06/2022,Gambia,Kelantan,0,0,0
1/06/2022,Gambia,Pulau Pinang,0,0,0
1/06/2022,Gambia,Sabah,0,0,0
1/06/2022,Gambia,Sarawak,0,0,0
1/06/2022,Gambia,Selangor,10,6,4
1/06/2022,Guinea-Bissau,Johor,0,0,0
1/06/2022,Guinea-Bissau,Selangor,0,0,0
1/06/2022,Equatorial Guinea,Johor,0,0,0
1/06/2022,Equatorial Guinea,Selangor,1,1,0
1/06/2022,Greece,Johor,24,22,2
1/06/2022,Greece,Kedah,2,1,1
1/06/2022,Greece,Kelantan,0,0,0
1/06/2022,Greece,Melaka,0,0,0
1/06/2022,Greece,Negeri Sembilan,1,1,0
1/06/2022,Greece,Pahang,3,3,0
1/06/2022,Greece,Perak,0,0,0
1/06/2022,Greece,Perlis,0,0,0
1/06/2022,Greece,Pulau Pinang,1,0,1
1/06/2022,Greece,Sabah,0,0,0
1/06/2022,Greece,Sarawak,2,1,1
1/06/2022,Greece,Selangor,94,73,21
1/06/2022,Grenada,Johor,1,0,1
1/06/2022,Grenada,Kedah,0,0,0
1/06/2022,Grenada,Pulau Pinang,2,2,0
1/06/2022,Grenada,Sabah,0,0,0
1/06/2022,Grenada,Sarawak,0,0,0
1/06/2022,Grenada,Selangor,6,6,0
1/06/2022,Greenland,Johor,0,0,0
1/06/2022,Greenland,Selangor,0,0,0
1/06/2022,Guatemala,Johor,2,0,2
1/06/2022,Guatemala,Kedah,0,0,0
1/06/2022,Guatemala,Pahang,0,0,0
1/06/2022,Guatemala,Perak,0,0,0
1/06/2022,Guatemala,Pulau Pinang,0,0,0
1/06/2022,Guatemala,Sabah,0,0,0
1/06/2022,Guatemala,Sarawak,0,0,0
1/06/2022,Guatemala,Selangor,13,5,8
1/06/2022,Guatemala,W.P. Labuan,0,0,0
1/06/2022,Guyana,Johor,0,0,0
1/06/2022,Guyana,Kedah,0,0,0
1/06/2022,Guyana,Pulau Pinang,0,0,0
1/06/2022,Guyana,Sarawak,0,0,0
1/06/2022,Guyana,Selangor,5,4,1
1/06/2022,Hong Kong,Johor,9,3,6
1/06/2022,Hong Kong,Kedah,1,1,0
1/06/2022,Hong Kong,Kelantan,0,0,0
1/06/2022,Hong Kong,Pahang,0,0,0
1/06/2022,Hong Kong,Perak,8,5,3
1/06/2022,Hong Kong,Perlis,1,1,0
1/06/2022,Hong Kong,Pulau Pinang,137,84,53
1/06/2022,Hong Kong,Sabah,70,23,47
1/06/2022,Hong Kong,Sarawak,53,23,30
1/06/2022,Hong Kong,Selangor,11,4,7
1/06/2022,Hong Kong,Terengganu,0,0,0
1/06/2022,Heard Island and McDonald Islands,Johor,0,0,0
1/06/2022,Honduras,Johor,1,0,1
1/06/2022,Honduras,Kedah,0,0,0
1/06/2022,Honduras,Perak,0,0,0
1/06/2022,Honduras,Pulau Pinang,0,0,0
1/06/2022,Honduras,Sabah,0,0,0
1/06/2022,Honduras,Sarawak,0,0,0
1/06/2022,Honduras,Selangor,7,5,2
1/06/2022,Croatia,Johor,11,11,0
1/06/2022,Croatia,Kedah,0,0,0
1/06/2022,Croatia,Kelantan,0,0,0
1/06/2022,Croatia,Melaka,0,0,0
1/06/2022,Croatia,Pahang,1,1,0
1/06/2022,Croatia,Perak,0,0,0
1/06/2022,Croatia,Perlis,0,0,0
1/06/2022,Croatia,Pulau Pinang,2,1,1
1/06/2022,Croatia,Sabah,1,0,1
1/06/2022,Croatia,Sarawak,0,0,0
1/06/2022,Croatia,Selangor,62,51,11
1/06/2022,Haiti,Johor,0,0,0
1/06/2022,Haiti,Kedah,0,0,0
1/06/2022,Haiti,Kelantan,0,0,0
1/06/2022,Haiti,Perak,0,0,0
1/06/2022,Haiti,Pulau Pinang,0,0,0
1/06/2022,Haiti,Sabah,0,0,0
1/06/2022,Haiti,Selangor,1,1,0
1/06/2022,Hungary,Johor,51,40,11
1/06/2022,Hungary,Kedah,5,4,1
1/06/2022,Hungary,Kelantan,0,0,0
1/06/2022,Hungary,Pahang,0,0,0
1/06/2022,Hungary,Perak,0,0,0
1/06/2022,Hungary,Perlis,0,0,0
1/06/2022,Hungary,Pulau Pinang,8,1,7
1/06/2022,Hungary,Sabah,6,1,5
1/06/2022,Hungary,Sarawak,1,0,1
1/06/2022,Hungary,Selangor,134,75,59
1/06/2022,Hungary,W.P. Labuan,0,0,0
1/06/2022,Indonesia,Johor,69380,35949,33431
1/06/2022,Indonesia,Kedah,577,207,370
1/06/2022,Indonesia,Kelantan,33,15,18
1/06/2022,Indonesia,Melaka,5685,2555,3130
1/06/2022,Indonesia,Negeri Sembilan,5752,4019,1733
1/06/2022,Indonesia,Pahang,0,0,0
1/06/2022,Indonesia,Perak,58,14,44
1/06/2022,Indonesia,Perlis,77,37,40
1/06/2022,Indonesia,Pulau Pinang,15595,6352,9243
1/06/2022,Indonesia,Sabah,3148,1492,1656
1/06/2022,Indonesia,Sarawak,23177,14458,8719
1/06/2022,Indonesia,Selangor,39776,19320,20456
1/06/2022,Indonesia,Terengganu,0,0,0
1/06/2022,Indonesia,W.P. Labuan,7,7,0
1/06/2022,India,Johor,9893,6559,3334
1/06/2022,India,Kedah,1420,1095,325
1/06/2022,India,Kelantan,12,11,1
1/06/2022,India,Melaka,1,1,0
1/06/2022,India,Negeri Sembilan,0,0,0
1/06/2022,India,Pahang,1,1,0
1/06/2022,India,Perak,209,153,56
1/06/2022,India,Perlis,40,39,1
1/06/2022,India,Pulau Pinang,472,327,145
1/06/2022,India,Sabah,163,99,64
1/06/2022,India,Sarawak,55,39,16
1/06/2022,India,Selangor,34418,24965,9453
1/06/2022,India,Terengganu,0,0,0
1/06/2022,India,W.P. Labuan,0,0,0
1/06/2022, British Indian Ocean Territory,Pulau Pinang,0,0,0
1/06/2022, British Indian Ocean Territory,Selangor,0,0,0
1/06/2022,Ireland,Johor,213,155,58
1/06/2022,Ireland,Kedah,36,21,15
1/06/2022,Ireland,Kelantan,0,0,0
1/06/2022,Ireland,Negeri Sembilan,0,0,0
1/06/2022,Ireland,Pahang,0,0,0
1/06/2022,Ireland,Perak,4,1,3
1/06/2022,Ireland,Perlis,8,3,5
1/06/2022,Ireland,Pulau Pinang,49,31,18
1/06/2022,Ireland,Sabah,9,2,7
1/06/2022,Ireland,Sarawak,0,0,0
1/06/2022,Ireland,Selangor,643,411,232
1/06/2022,Ireland,Terengganu,0,0,0
1/06/2022,Ireland,W.P. Labuan,0,0,0
1/06/2022,"Iran, Islamic Republic of",Johor,132,74,58
1/06/2022,"Iran, Islamic Republic of",Kedah,8,6,2
1/06/2022,"Iran, Islamic Republic of",Kelantan,0,0,0
1/06/2022,"Iran, Islamic Republic of",Perak,0,0,0
1/06/2022,"Iran, Islamic Republic of",Perlis,0,0,0
1/06/2022,"Iran, Islamic Republic of",Pulau Pinang,2,1,1
1/06/2022,"Iran, Islamic Republic of",Sabah,0,0,0
1/06/2022,"Iran, Islamic Republic of",Sarawak,1,1,0
1/06/2022,"Iran, Islamic Republic of",Selangor,1132,612,520
1/06/2022,"Iran, Islamic Republic of",W.P. Labuan,0,0,0
1/06/2022,Iraq,Johor,15,9,6
1/06/2022,Iraq,Kedah,0,0,0
1/06/2022,Iraq,Kelantan,0,0,0
1/06/2022,Iraq,Melaka,0,0,0
1/06/2022,Iraq,Pahang,0,0,0
1/06/2022,Iraq,Perak,0,0,0
1/06/2022,Iraq,Perlis,0,0,0
1/06/2022,Iraq,Pulau Pinang,0,0,0
1/06/2022,Iraq,Sabah,0,0,0
1/06/2022,Iraq,Sarawak,0,0,0
1/06/2022,Iraq,Selangor,645,445,200
1/06/2022,Iceland,Johor,5,2,3
1/06/2022,Iceland,Kedah,0,0,0
1/06/2022,Iceland,Kelantan,0,0,0
1/06/2022,Iceland,Perak,0,0,0
1/06/2022,Iceland,Perlis,0,0,0
1/06/2022,Iceland,Pulau Pinang,0,0,0
1/06/2022,Iceland,Sabah,0,0,0
1/06/2022,Iceland,Sarawak,0,0,0
1/06/2022,Iceland,Selangor,25,11,14
1/06/2022,Iceland,W.P. Labuan,0,0,0
1/06/2022,Israel,Pulau Pinang,0,0,0
1/06/2022,Italy,Johor,333,257,76
1/06/2022,Italy,Kedah,23,10,13
1/06/2022,Italy,Kelantan,1,1,0
1/06/2022,Italy,Melaka,0,0,0
1/06/2022,Italy,Negeri Sembilan,0,0,0
1/06/2022,Italy,Pahang,0,0,0
1/06/2022,Italy,Perak,1,1,0
1/06/2022,Italy,Perlis,0,0,0
1/06/2022,Italy,Pulau Pinang,43,35,8
1/06/2022,Italy,Sabah,15,11,4
1/06/2022,Italy,Sarawak,10,7,3
1/06/2022,Italy,Selangor,1027,740,287
1/06/2022,Italy,W.P. Labuan,0,0,0
1/06/2022,Jamaica,Johor,1,1,0
1/06/2022,Jamaica,Kedah,1,0,1
1/06/2022,Jamaica,Perak,0,0,0
1/06/2022,Jamaica,Pulau Pinang,0,0,0
1/06/2022,Jamaica,Sabah,0,0,0
1/06/2022,Jamaica,Sarawak,0,0,0
1/06/2022,Jamaica,Selangor,7,4,3
1/06/2022,Jamaica,W.P. Labuan,0,0,0
1/06/2022,Jordan,Johor,3,1,2
1/06/2022,Jordan,Kedah,3,2,1
1/06/2022,Jordan,Kelantan,0,0,0
1/06/2022,Jordan,Melaka,0,0,0
1/06/2022,Jordan,Perlis,1,1,0
1/06/2022,Jordan,Pulau Pinang,0,0,0
1/06/2022,Jordan,Sabah,0,0,0
1/06/2022,Jordan,Sarawak,0,0,0
1/06/2022,Jordan,Selangor,569,338,231
1/06/2022,Jordan,W.P. Labuan,0,0,0
1/06/2022,Japan,Johor,3081,2282,799
1/06/2022,Japan,Kedah,88,44,44
1/06/2022,Japan,Kelantan,1,1,0
1/06/2022,Japan,Melaka,0,0,0
1/06/2022,Japan,Negeri Sembilan,0,0,0
1/06/2022,Japan,Pahang,1,0,1
1/06/2022,Japan,Perak,15,12,3
1/06/2022,Japan,Perlis,6,6,0
1/06/2022,Japan,Pulau Pinang,491,383,108
1/06/2022,Japan,Sabah,60,31,29
1/06/2022,Japan,Sarawak,51,38,13
1/06/2022,Japan,Selangor,5495,4016,1479
1/06/2022,Japan,W.P. Labuan,1,1,0
1/06/2022,Kazakhstan,Johor,14,8,6
1/06/2022,Kazakhstan,Kedah,3,1,2
1/06/2022,Kazakhstan,Kelantan,0,0,0
1/06/2022,Kazakhstan,Melaka,0,0,0
1/06/2022,Kazakhstan,Perak,0,0,0
1/06/2022,Kazakhstan,Perlis,0,0,0
1/06/2022,Kazakhstan,Pulau Pinang,1,0,1
1/06/2022,Kazakhstan,Sabah,0,0,0
1/06/2022,Kazakhstan,Sarawak,0,0,0
1/06/2022,Kazakhstan,Selangor,205,82,123
1/06/2022,Kazakhstan,W.P. Labuan,0,0,0
1/06/2022,Kenya,Johor,22,9,13
1/06/2022,Kenya,Kedah,0,0,0
1/06/2022,Kenya,Kelantan,0,0,0
1/06/2022,Kenya,Perak,0,0,0
1/06/2022,Kenya,Perlis,1,1,0
1/06/2022,Kenya,Pulau Pinang,0,0,0
1/06/2022,Kenya,Sabah,0,0,0
1/06/2022,Kenya,Sarawak,1,0,1
1/06/2022,Kenya,Selangor,163,94,69
1/06/2022,Kyrgyzstan,Johor,17,11,6
1/06/2022,Kyrgyzstan,Kedah,0,0,0
1/06/2022,Kyrgyzstan,Kelantan,0,0,0
1/06/2022,Kyrgyzstan,Perak,0,0,0
1/06/2022,Kyrgyzstan,Perlis,0,0,0
1/06/2022,Kyrgyzstan,Pulau Pinang,1,0,1
1/06/2022,Kyrgyzstan,Sabah,0,0,0
1/06/2022,Kyrgyzstan,Sarawak,0,0,0
1/06/2022,Kyrgyzstan,Selangor,138,86,52
1/06/2022,Cambodia,Johor,644,274,370
1/06/2022,Cambodia,Kedah,385,253,132
1/06/2022,Cambodia,Kelantan,35,21,14
1/06/2022,Cambodia,Melaka,0,0,0
1/06/2022,Cambodia,Negeri Sembilan,0,0,0
1/06/2022,Cambodia,Pahang,0,0,0
1/06/2022,Cambodia,Perak,4,3,1
1/06/2022,Cambodia,Perlis,605,431,174
1/06/2022,Cambodia,Pulau Pinang,18,3,15
1/06/2022,Cambodia,Sabah,0,0,0
1/06/2022,Cambodia,Sarawak,3,2,1
1/06/2022,Cambodia,Selangor,2407,1272,1135
1/06/2022,Cambodia,W.P. Labuan,0,0,0
1/06/2022,Kiribati,Johor,0,0,0
1/06/2022,Kiribati,Sabah,0,0,0
1/06/2022,Kiribati,Selangor,0,0,0
1/06/2022,Saint Kitts and Nevis,Johor,18,14,4
1/06/2022,Saint Kitts and Nevis,Kedah,0,0,0
1/06/2022,Saint Kitts and Nevis,Perlis,0,0,0
1/06/2022,Saint Kitts and Nevis,Pulau Pinang,1,1,0
1/06/2022,Saint Kitts and Nevis,Sabah,0,0,0
1/06/2022,Saint Kitts and Nevis,Selangor,29,23,6
1/06/2022,Saint Kitts and Nevis,W.P. Labuan,0,0,0
1/06/2022,"Korea, Republic of",Johor,5453,3265,2188
1/06/2022,"Korea, Republic of",Kedah,45,24,21
1/06/2022,"Korea, Republic of",Kelantan,0,0,0
1/06/2022,"Korea, Republic of",Melaka,1,1,0
1/06/2022,"Korea, Republic of",Negeri Sembilan,0,0,0
1/06/2022,"Korea, Republic of",Pahang,0,0,0
1/06/2022,"Korea, Republic of",Perak,13,7,6
1/06/2022,"Korea, Republic of",Perlis,20,17,3
1/06/2022,"Korea, Republic of",Pulau Pinang,189,122,67
1/06/2022,"Korea, Republic of",Sabah,1976,901,1075
1/06/2022,"Korea, Republic of",Sarawak,76,50,26
1/06/2022,"Korea, Republic of",Selangor,5050,3145,1905
1/06/2022,"Korea, Republic of",Terengganu,0,0,0
1/06/2022,"Korea, Republic of",W.P. Labuan,0,0,0
1/06/2022,Kuwait,Johor,20,10,10
1/06/2022,Kuwait,Kedah,11,5,6
1/06/2022,Kuwait,Kelantan,0,0,0
1/06/2022,Kuwait,Perak,0,0,0
1/06/2022,Kuwait,Perlis,0,0,0
1/06/2022,Kuwait,Pulau Pinang,4,3,1
1/06/2022,Kuwait,Sabah,1,0,1
1/06/2022,Kuwait,Sarawak,5,3,2
1/06/2022,Kuwait,Selangor,323,170,153
1/06/2022,Kuwait,W.P. Labuan,0,0,0
1/06/2022, Lao People's Democratic Republic,Johor,27,7,20
1/06/2022, Lao People's Democratic Republic,Kedah,295,39,256
1/06/2022, Lao People's Democratic Republic,Kelantan,25,1,24
1/06/2022, Lao People's Democratic Republic,Melaka,0,0,0
1/06/2022, Lao People's Democratic Republic,Perak,0,0,0
1/06/2022, Lao People's Democratic Republic,Perlis,36,26,10
1/06/2022, Lao People's Democratic Republic,Pulau Pinang,6,0,6
1/06/2022, Lao People's Democratic Republic,Sabah,0,0,0
1/06/2022, Lao People's Democratic Republic,Sarawak,1,1,0
1/06/2022, Lao People's Democratic Republic,Selangor,100,43,57
1/06/2022, Lao People's Democratic Republic,W.P. Labuan,0,0,0
1/06/2022,Lebanon,Johor,6,4,2
1/06/2022,Lebanon,Kedah,0,0,0
1/06/2022,Lebanon,Kelantan,0,0,0
1/06/2022,Lebanon,Pahang,0,0,0
1/06/2022,Lebanon,Perak,0,0,0
1/06/2022,Lebanon,Perlis,0,0,0
1/06/2022,Lebanon,Pulau Pinang,3,2,1
1/06/2022,Lebanon,Sabah,1,0,1
1/06/2022,Lebanon,Sarawak,0,0,0
1/06/2022,Lebanon,Selangor,127,81,46
1/06/2022,Lebanon,W.P. Labuan,0,0,0
1/06/2022,Liberia,Johor,1,1,0
1/06/2022,Liberia,Kedah,0,0,0
1/06/2022,Liberia,Sabah,0,0,0
1/06/2022,Liberia,Sarawak,0,0,0
1/06/2022,Liberia,Selangor,4,4,0
1/06/2022,Libya,Johor,0,0,0
1/06/2022,Libya,Kedah,0,0,0
1/06/2022,Libya,Perlis,0,0,0
1/06/2022,Libya,Pulau Pinang,0,0,0
1/06/2022,Libya,Sabah,0,0,0
1/06/2022,Libya,Sarawak,0,0,0
1/06/2022,Libya,Selangor,242,172,70
1/06/2022,Saint Lucia,Johor,5,5,0
1/06/2022,Saint Lucia,Kedah,0,0,0
1/06/2022,Saint Lucia,Pulau Pinang,0,0,0
1/06/2022,Saint Lucia,Sarawak,0,0,0
1/06/2022,Saint Lucia,Selangor,0,0,0
1/06/2022,Liechtenstein,Johor,1,0,1
1/06/2022,Liechtenstein,Kedah,0,0,0
1/06/2022,Liechtenstein,Perlis,0,0,0
1/06/2022,Liechtenstein,Pulau Pinang,0,0,0
1/06/2022,Liechtenstein,Sabah,2,1,1
1/06/2022,Liechtenstein,Sarawak,0,0,0
1/06/2022,Liechtenstein,Selangor,1,1,0
1/06/2022,LKA,Johor,535,338,197
1/06/2022,LKA,Kedah,33,18,15
1/06/2022,LKA,Kelantan,0,0,0
1/06/2022,LKA,Melaka,0,0,0
1/06/2022,LKA,Pahang,0,0,0
1/06/2022,LKA,Perak,2,1,1
1/06/2022,LKA,Perlis,0,0,0
1/06/2022,LKA,Pulau Pinang,19,13,6
1/06/2022,LKA,Sabah,8,5,3
1/06/2022,LKA,Sarawak,5,3,2
1/06/2022,LKA,Selangor,1798,1189,609
1/06/2022,LKA,W.P. Labuan,0,0,0
1/06/2022,Lesotho,Johor,1,0,1
1/06/2022,Lesotho,Kedah,0,0,0
1/06/2022,Lesotho,Pulau Pinang,0,0,0
1/06/2022,Lesotho,Sarawak,0,0,0
1/06/2022,Lesotho,Selangor,1,1,0
1/06/2022,Lithuania,Johor,7,4,3
1/06/2022,Lithuania,Kedah,5,3,2
1/06/2022,Lithuania,Kelantan,1,0,1
1/06/2022,Lithuania,Pahang,0,0,0
1/06/2022,Lithuania,Perak,0,0,0
1/06/2022,Lithuania,Perlis,0,0,0
1/06/2022,Lithuania,Pulau Pinang,1,1,0
1/06/2022,Lithuania,Sabah,2,1,1
1/06/2022,Lithuania,Sarawak,2,1,1
1/06/2022,Lithuania,Selangor,59,28,31
1/06/2022,Lithuania,W.P. Labuan,0,0,0
1/06/2022,Luxembourg,Johor,3,2,1
1/06/2022,Luxembourg,Kedah,0,0,0
1/06/2022,Luxembourg,Kelantan,0,0,0
1/06/2022,Luxembourg,Perak,0,0,0
1/06/2022,Luxembourg,Perlis,0,0,0
1/06/2022,Luxembourg,Pulau Pinang,2,1,1
1/06/2022,Luxembourg,Sabah,0,0,0
1/06/2022,Luxembourg,Sarawak,0,0,0
1/06/2022,Luxembourg,Selangor,14,8,6
1/06/2022,Latvia,Johor,6,4,2
1/06/2022,Latvia,Kedah,0,0,0
1/06/2022,Latvia,Kelantan,0,0,0
1/06/2022,Latvia,Pahang,0,0,0
1/06/2022,Latvia,Perak,0,0,0
1/06/2022,Latvia,Perlis,0,0,0
1/06/2022,Latvia,Pulau Pinang,0,0,0
1/06/2022,Latvia,Sabah,1,0,1
1/06/2022,Latvia,Sarawak,0,0,0
1/06/2022,Latvia,Selangor,25,10,15
1/06/2022,Latvia,W.P. Labuan,0,0,0
1/06/2022,Macao,Johor,0,0,0
1/06/2022,Macao,Pahang,0,0,0
1/06/2022,Macao,Perak,0,0,0
1/06/2022,Macao,Selangor,0,0,0
1/06/2022,Macao,W.P. Labuan,0,0,0
1/06/2022,Morocco,Johor,43,32,11
1/06/2022,Morocco,Kedah,1,0,1
1/06/2022,Morocco,Kelantan,0,0,0
1/06/2022,Morocco,Melaka,0,0,0
1/06/2022,Morocco,Pahang,0,0,0
1/06/2022,Morocco,Perak,0,0,0
1/06/2022,Morocco,Perlis,0,0,0
1/06/2022,Morocco,Pulau Pinang,2,0,2
1/06/2022,Morocco,Sabah,1,1,0
1/06/2022,Morocco,Sarawak,0,0,0
1/06/2022,Morocco,Selangor,302,144,158
1/06/2022,Morocco,W.P. Labuan,0,0,0
1/06/2022,Monaco,Johor,4,3,1
1/06/2022,Monaco,Kedah,0,0,0
1/06/2022,Monaco,Sabah,0,0,0
1/06/2022,Monaco,Selangor,0,0,0
1/06/2022,"Moldova, Republic of",Johor,6,3,3
1/06/2022,"Moldova, Republic of",Kedah,0,0,0
1/06/2022,"Moldova, Republic of",Kelantan,0,0,0
1/06/2022,"Moldova, Republic of",Negeri Sembilan,0,0,0
1/06/2022,"Moldova, Republic of",Perlis,0,0,0
1/06/2022,"Moldova, Republic of",Pulau Pinang,0,0,0
1/06/2022,"Moldova, Republic of",Sabah,0,0,0
1/06/2022,"Moldova, Republic of",Sarawak,0,0,0
1/06/2022,"Moldova, Republic of",Selangor,3,1,2
1/06/2022,Madagascar,Johor,1,0,1
1/06/2022,Madagascar,Kedah,0,0,0
1/06/2022,Madagascar,Perak,0,0,0
1/06/2022,Madagascar,Perlis,0,0,0
1/06/2022,Madagascar,Pulau Pinang,0,0,0
1/06/2022,Madagascar,Sabah,0,0,0
1/06/2022,Madagascar,Sarawak,0,0,0
1/06/2022,Madagascar,Selangor,14,7,7
1/06/2022,Maldives,Johor,82,49,33
1/06/2022,Maldives,Kedah,0,0,0
1/06/2022,Maldives,Kelantan,0,0,0
1/06/2022,Maldives,Perak,0,0,0
1/06/2022,Maldives,Perlis,1,1,0
1/06/2022,Maldives,Pulau Pinang,14,9,5
1/06/2022,Maldives,Sabah,0,0,0
1/06/2022,Maldives,Sarawak,1,1,0
1/06/2022,Maldives,Selangor,1376,697,679
1/06/2022,Mexico,Johor,45,25,20
1/06/2022,Mexico,Kedah,0,0,0
1/06/2022,Mexico,Kelantan,0,0,0
1/06/2022,Mexico,Pahang,0,0,0
1/06/2022,Mexico,Perak,0,0,0
1/06/2022,Mexico,Perlis,0,0,0
1/06/2022,Mexico,Pulau Pinang,26,21,5
1/06/2022,Mexico,Sabah,1,1,0
1/06/2022,Mexico,Sarawak,1,1,0
1/06/2022,Mexico,Selangor,197,102,95
1/06/2022,Mexico,W.P. Labuan,0,0,0
1/06/2022,Marshall Islands,Johor,3,0,3
1/06/2022,Marshall Islands,Kedah,0,0,0
1/06/2022,Marshall Islands,Perak,0,0,0
1/06/2022,Marshall Islands,Pulau Pinang,0,0,0
1/06/2022,Marshall Islands,Sabah,0,0,0
1/06/2022,Marshall Islands,Selangor,0,0,0
1/06/2022,North Macedonia,Johor,2,1,1
1/06/2022,North Macedonia,Kedah,0,0,0
1/06/2022,North Macedonia,Perak,0,0,0
1/06/2022,North Macedonia,Pulau Pinang,0,0,0
1/06/2022,North Macedonia,Sabah,0,0,0
1/06/2022,North Macedonia,Sarawak,0,0,0
1/06/2022,North Macedonia,Selangor,13,10,3
1/06/2022,Mali,Johor,2,2,0
1/06/2022,Mali,Sabah,0,0,0
1/06/2022,Mali,Selangor,3,2,1
1/06/2022,Malta,Johor,6,5,1
1/06/2022,Malta,Kedah,1,0,1
1/06/2022,Malta,Kelantan,0,0,0
1/06/2022,Malta,Perak,0,0,0
1/06/2022,Malta,Perlis,0,0,0
1/06/2022,Malta,Pulau Pinang,1,1,0
1/06/2022,Malta,Sabah,3,2,1
1/06/2022,Malta,Sarawak,0,0,0
1/06/2022,Malta,Selangor,19,12,7
1/06/2022,Malta,W.P. Labuan,0,0,0
1/06/2022,Myanmar,Johor,2342,713,1629
1/06/2022,Myanmar,Kedah,13,4,9
1/06/2022,Myanmar,Kelantan,0,0,0
1/06/2022,Myanmar,Negeri Sembilan,0,0,0
1/06/2022,Myanmar,Pahang,0,0,0
1/06/2022,Myanmar,Perak,11,2,9
1/06/2022,Myanmar,Perlis,0,0,0
1/06/2022,Myanmar,Pulau Pinang,64,14,50
1/06/2022,Myanmar,Sabah,10,4,6
1/06/2022,Myanmar,Sarawak,15,6,9
1/06/2022,Myanmar,Selangor,3261,1974,1287
1/06/2022,Myanmar,Terengganu,0,0,0
1/06/2022,Myanmar,W.P. Labuan,0,0,0
1/06/2022,Montenegro,Johor,1,1,0
1/06/2022,Montenegro,Kedah,0,0,0
1/06/2022,Montenegro,Pulau Pinang,0,0,0
1/06/2022,Montenegro,Sabah,0,0,0
1/06/2022,Montenegro,Sarawak,0,0,0
1/06/2022,Montenegro,Selangor,4,3,1
1/06/2022,Mongolia,Johor,61,18,43
1/06/2022,Mongolia,Kedah,1,0,1
1/06/2022,Mongolia,Kelantan,0,0,0
1/06/2022,Mongolia,Perak,0,0,0
1/06/2022,Mongolia,Perlis,1,0,1
1/06/2022,Mongolia,Pulau Pinang,7,3,4
1/06/2022,Mongolia,Sabah,3,1,2
1/06/2022,Mongolia,Sarawak,0,0,0
1/06/2022,Mongolia,Selangor,115,47,68
1/06/2022,Northern Mariana Islands,Selangor,0,0,0
1/06/2022,Mozambique,Johor,1,1,0
1/06/2022,Mozambique,Kedah,0,0,0
1/06/2022,Mozambique,Perak,0,0,0
1/06/2022,Mozambique,Pulau Pinang,0,0,0
1/06/2022,Mozambique,Sabah,0,0,0
1/06/2022,Mozambique,Sarawak,0,0,0
1/06/2022,Mozambique,Selangor,41,22,19
1/06/2022,Mauritania,Johor,1,1,0
1/06/2022,Mauritania,Kedah,0,0,0
1/06/2022,Mauritania,Pulau Pinang,0,0,0
1/06/2022,Mauritania,Sabah,0,0,0
1/06/2022,Mauritania,Sarawak,0,0,0
1/06/2022,Mauritania,Selangor,8,6,2
1/06/2022,Mauritius,Johor,40,20,20
1/06/2022,Mauritius,Kedah,4,2,2
1/06/2022,Mauritius,Kelantan,0,0,0
1/06/2022,Mauritius,Pahang,0,0,0
1/06/2022,Mauritius,Perak,0,0,0
1/06/2022,Mauritius,Perlis,0,0,0
1/06/2022,Mauritius,Pulau Pinang,0,0,0
1/06/2022,Mauritius,Sabah,0,0,0
1/06/2022,Mauritius,Sarawak,0,0,0
1/06/2022,Mauritius,Selangor,156,80,76
1/06/2022,Malawi,Johor,0,0,0
1/06/2022,Malawi,Pulau Pinang,0,0,0
1/06/2022,Malawi,Sabah,0,0,0
1/06/2022,Malawi,Sarawak,0,0,0
1/06/2022,Malawi,Selangor,18,8,10
1/06/2022,Mayotte,Selangor,0,0,0
1/06/2022,Namibia,Johor,1,0,1
1/06/2022,Namibia,Kedah,0,0,0
1/06/2022,Namibia,Perak,0,0,0
1/06/2022,Namibia,Perlis,0,0,0
1/06/2022,Namibia,Pulau Pinang,0,0,0
1/06/2022,Namibia,Sabah,0,0,0
1/06/2022,Namibia,Sarawak,0,0,0
1/06/2022,Namibia,Selangor,5,2,3
1/06/2022,New Caledonia,Selangor,0,0,0
1/06/2022,Niger,Johor,0,0,0
1/06/2022,Niger,Sabah,0,0,0
1/06/2022,Niger,Selangor,6,2,4
1/06/2022,Nigeria,Johor,31,25,6
1/06/2022,Nigeria,Kedah,0,0,0
1/06/2022,Nigeria,Perlis,0,0,0
1/06/2022,Nigeria,Pulau Pinang,1,1,0
1/06/2022,Nigeria,Sabah,1,1,0
1/06/2022,Nigeria,Sarawak,1,1,0
1/06/2022,Nigeria,Selangor,303,241,62
1/06/2022,Nicaragua,Johor,0,0,0
1/06/2022,Nicaragua,Kedah,0,0,0
1/06/2022,Nicaragua,Pulau Pinang,0,0,0
1/06/2022,Nicaragua,Sabah,0,0,0
1/06/2022,Nicaragua,Selangor,2,2,0
1/06/2022,Netherlands,Johor,531,384,147
1/06/2022,Netherlands,Kedah,40,28,12
1/06/2022,Netherlands,Kelantan,4,3,1
1/06/2022,Netherlands,Melaka,0,0,0
1/06/2022,Netherlands,Negeri Sembilan,3,0,3
1/06/2022,Netherlands,Pahang,2,1,1
1/06/2022,Netherlands,Perak,2,1,1
1/06/2022,Netherlands,Perlis,12,7,5
1/06/2022,Netherlands,Pulau Pinang,97,71,26
1/06/2022,Netherlands,Sabah,39,23,16
1/06/2022,Netherlands,Sarawak,26,15,11
1/06/2022,Netherlands,Selangor,1856,1228,628
1/06/2022,Netherlands,Terengganu,0,0,0
1/06/2022,Netherlands,W.P. Labuan,0,0,0
1/06/2022,Norway,Johor,84,59,25
1/06/2022,Norway,Kedah,3,2,1
1/06/2022,Norway,Kelantan,1,1,0
1/06/2022,Norway,Melaka,0,0,0
1/06/2022,Norway,Pahang,0,0,0
1/06/2022,Norway,Perak,0,0,0
1/06/2022,Norway,Perlis,3,1,2
1/06/2022,Norway,Pulau Pinang,25,12,13
1/06/2022,Norway,Sabah,9,8,1
1/06/2022,Norway,Sarawak,5,2,3
1/06/2022,Norway,Selangor,427,253,174
1/06/2022,Norway,W.P. Labuan,0,0,0
1/06/2022,Nepal,Johor,668,572,96
1/06/2022,Nepal,Kedah,2,2,0
1/06/2022,Nepal,Pahang,0,0,0
1/06/2022,Nepal,Perak,0,0,0
1/06/2022,Nepal,Perlis,1,1,0
1/06/2022,Nepal,Pulau Pinang,4,3,1
1/06/2022,Nepal,Sabah,3,3,0
1/06/2022,Nepal,Sarawak,3,3,0
1/06/2022,Nepal,Selangor,11640,11011,629
1/06/2022,Nepal,W.P. Labuan,0,0,0
1/06/2022,Nauru,Johor,0,0,0
1/06/2022,Nauru,Pulau Pinang,0,0,0
1/06/2022,Nauru,Selangor,0,0,0
1/06/2022,New Zealand,Johor,394,268,126
1/06/2022,New Zealand,Kedah,26,15,11
1/06/2022,New Zealand,Kelantan,2,2,0
1/06/2022,New Zealand,Melaka,0,0,0
1/06/2022,New Zealand,Negeri Sembilan,0,0,0
1/06/2022,New Zealand,Pahang,2,1,1
1/06/2022,New Zealand,Perak,10,6,4
1/06/2022,New Zealand,Perlis,0,0,0
1/06/2022,New Zealand,Pulau Pinang,91,58,33
1/06/2022,New Zealand,Sabah,19,9,10
1/06/2022,New Zealand,Sarawak,23,15,8
1/06/2022,New Zealand,Selangor,997,647,350
1/06/2022,New Zealand,Terengganu,1,1,0
1/06/2022,New Zealand,W.P. Labuan,0,0,0
1/06/2022,Oman,Johor,52,32,20
1/06/2022,Oman,Kedah,0,0,0
1/06/2022,Oman,Kelantan,0,0,0
1/06/2022,Oman,Melaka,0,0,0
1/06/2022,Oman,Perak,0,0,0
1/06/2022,Oman,Perlis,0,0,0
1/06/2022,Oman,Pulau Pinang,2,1,1
1/06/2022,Oman,Sabah,2,1,1
1/06/2022,Oman,Sarawak,0,0,0
1/06/2022,Oman,Selangor,870,499,371
1/06/2022,Pakistan,Johor,598,423,175
1/06/2022,Pakistan,Kedah,57,35,22
1/06/2022,Pakistan,Kelantan,11,11,0
1/06/2022,Pakistan,Melaka,0,0,0
1/06/2022,Pakistan,Negeri Sembilan,0,0,0
1/06/2022,Pakistan,Pahang,0,0,0
1/06/2022,Pakistan,Perak,0,0,0
1/06/2022,Pakistan,Perlis,9,9,0
1/06/2022,Pakistan,Pulau Pinang,21,19,2
1/06/2022,Pakistan,Sabah,2,2,0
1/06/2022,Pakistan,Sarawak,14,7,7
1/06/2022,Pakistan,Selangor,7132,5840,1292
1/06/2022,Pakistan,W.P. Labuan,0,0,0
1/06/2022,Panama,Johor,0,0,0
1/06/2022,Panama,Kedah,0,0,0
1/06/2022,Panama,Perak,0,0,0
1/06/2022,Panama,Perlis,0,0,0
1/06/2022,Panama,Pulau Pinang,0,0,0
1/06/2022,Panama,Sabah,0,0,0
1/06/2022,Panama,Sarawak,0,0,0
1/06/2022,Panama,Selangor,6,1,5
1/06/2022,Peru,Johor,14,6,8
1/06/2022,Peru,Kedah,1,1,0
1/06/2022,Peru,Kelantan,0,0,0
1/06/2022,Peru,Pahang,0,0,0
1/06/2022,Peru,Perak,0,0,0
1/06/2022,Peru,Perlis,0,0,0
1/06/2022,Peru,Pulau Pinang,6,3,3
1/06/2022,Peru,Sabah,0,0,0
1/06/2022,Peru,Sarawak,0,0,0
1/06/2022,Peru,Selangor,30,19,11
1/06/2022,Peru,W.P. Labuan,0,0,0
1/06/2022,Philippines,Johor,9956,3030,6926
1/06/2022,Philippines,Kedah,193,49,144
1/06/2022,Philippines,Kelantan,7,5,2
1/06/2022,Philippines,Melaka,0,0,0
1/06/2022,Philippines,Negeri Sembilan,0,0,0
1/06/2022,Philippines,Pahang,1,1,0
1/06/2022,Philippines,Perak,34,8,26
1/06/2022,Philippines,Perlis,42,21,21
1/06/2022,Philippines,Pulau Pinang,261,113,148
1/06/2022,Philippines,Sabah,344,109,235
1/06/2022,Philippines,Sarawak,117,57,60
1/06/2022,Philippines,Selangor,7501,3134,4367
1/06/2022,Philippines,Terengganu,1,1,0
1/06/2022,Philippines,W.P. Labuan,4,3,1
1/06/2022,Palau,Johor,0,0,0
1/06/2022,Palau,Pulau Pinang,0,0,0
1/06/2022,Palau,Selangor,0,0,0
1/06/2022,Papua New Guinea,Johor,11,6,5
1/06/2022,Papua New Guinea,Kedah,0,0,0
1/06/2022,Papua New Guinea,Kelantan,0,0,0
1/06/2022,Papua New Guinea,Perak,0,0,0
1/06/2022,Papua New Guinea,Pulau Pinang,4,2,2
1/06/2022,Papua New Guinea,Sabah,0,0,0
1/06/2022,Papua New Guinea,Sarawak,0,0,0
1/06/2022,Papua New Guinea,Selangor,45,23,22
1/06/2022,Poland,Johor,130,78,52
1/06/2022,Poland,Kedah,9,4,5
1/06/2022,Poland,Kelantan,1,1,0
1/06/2022,Poland,Melaka,0,0,0
1/06/2022,Poland,Negeri Sembilan,0,0,0
1/06/2022,Poland,Pahang,0,0,0
1/06/2022,Poland,Perak,0,0,0
1/06/2022,Poland,Perlis,5,2,3
1/06/2022,Poland,Pulau Pinang,10,5,5
1/06/2022,Poland,Sabah,17,6,11
1/06/2022,Poland,Sarawak,1,1,0
1/06/2022,Poland,Selangor,457,261,196
1/06/2022,Poland,Terengganu,0,0,0
1/06/2022,Poland,W.P. Labuan,0,0,0
1/06/2022,"North Korea, Democratic People's Republic of",Selangor,0,0,0
1/06/2022,Portugal,Johor,77,44,33
1/06/2022,Portugal,Kedah,13,8,5
1/06/2022,Portugal,Kelantan,0,0,0
1/06/2022,Portugal,Melaka,0,0,0
1/06/2022,Portugal,Pahang,0,0,0
1/06/2022,Portugal,Perak,0,0,0
1/06/2022,Portugal,Perlis,3,3,0
1/06/2022,Portugal,Pulau Pinang,24,15,9
1/06/2022,Portugal,Sabah,2,1,1
1/06/2022,Portugal,Sarawak,1,1,0
1/06/2022,Portugal,Selangor,440,278,162
1/06/2022,Portugal,W.P. Labuan,0,0,0
1/06/2022,Paraguay,Johor,3,3,0
1/06/2022,Paraguay,Kedah,0,0,0
1/06/2022,Paraguay,Perak,0,0,0
1/06/2022,Paraguay,Perlis,0,0,0
1/06/2022,Paraguay,Pulau Pinang,0,0,0
1/06/2022,Paraguay,Sabah,0,0,0
1/06/2022,Paraguay,Sarawak,0,0,0
1/06/2022,Paraguay,Selangor,0,0,0
1/06/2022,"Palestine, State of",Johor,11,6,5
1/06/2022,"Palestine, State of",Kedah,0,0,0
1/06/2022,"Palestine, State of",Kelantan,0,0,0
1/06/2022,"Palestine, State of",Melaka,0,0,0
1/06/2022,"Palestine, State of",Perak,0,0,0
1/06/2022,"Palestine, State of",Perlis,0,0,0
1/06/2022,"Palestine, State of",Pulau Pinang,0,0,0
1/06/2022,"Palestine, State of",Sabah,0,0,0
1/06/2022,"Palestine, State of",Sarawak,0,0,0
1/06/2022,"Palestine, State of",Selangor,219,134,85
1/06/2022,Qatar,Johor,18,8,10
1/06/2022,Qatar,Kedah,0,0,0
1/06/2022,Qatar,Perlis,0,0,0
1/06/2022,Qatar,Pulau Pinang,0,0,0
1/06/2022,Qatar,Sabah,0,0,0
1/06/2022,Qatar,Sarawak,0,0,0
1/06/2022,Qatar,Selangor,250,163,87
1/06/2022,Réunion,Johor,0,0,0
1/06/2022,Réunion,Sarawak,0,0,0
1/06/2022,Romania,Johor,78,50,28
1/06/2022,Romania,Kedah,2,2,0
1/06/2022,Romania,Kelantan,0,0,0
1/06/2022,Romania,Negeri Sembilan,0,0,0
1/06/2022,Romania,Pahang,0,0,0
1/06/2022,Romania,Perak,0,0,0
1/06/2022,Romania,Perlis,0,0,0
1/06/2022,Romania,Pulau Pinang,8,5,3
1/06/2022,Romania,Sabah,8,5,3
1/06/2022,Romania,Sarawak,4,4,0
1/06/2022,Romania,Selangor,197,112,85
1/06/2022,Romania,W.P. Labuan,0,0,0
1/06/2022,Russian Federation (Russia),Johor,178,101,77
1/06/2022,Russian Federation (Russia),Kedah,48,22,26
1/06/2022,Russian Federation (Russia),Kelantan,3,0,3
1/06/2022,Russian Federation (Russia),Melaka,0,0,0
1/06/2022,Russian Federation (Russia),Negeri Sembilan,0,0,0
1/06/2022,Russian Federation (Russia),Pahang,0,0,0
1/06/2022,Russian Federation (Russia),Perak,0,0,0
1/06/2022,Russian Federation (Russia),Perlis,14,9,5
1/06/2022,Russian Federation (Russia),Pulau Pinang,18,10,8
1/06/2022,Russian Federation (Russia),Sabah,6,3,3
1/06/2022,Russian Federation (Russia),Sarawak,8,3,5
1/06/2022,Russian Federation (Russia),Selangor,1167,641,526
1/06/2022,Russian Federation (Russia),W.P. Labuan,0,0,0
1/06/2022,Rwanda,Johor,1,1,0
1/06/2022,Rwanda,Kedah,0,0,0
1/06/2022,Rwanda,Pulau Pinang,0,0,0
1/06/2022,Rwanda,Selangor,1,1,0
1/06/2022,Saudi Arabia,Johor,64,44,20
1/06/2022,Saudi Arabia,Kedah,6,3,3
1/06/2022,Saudi Arabia,Kelantan,0,0,0
1/06/2022,Saudi Arabia,Melaka,0,0,0
1/06/2022,Saudi Arabia,Perak,0,0,0
1/06/2022,Saudi Arabia,Perlis,0,0,0
1/06/2022,Saudi Arabia,Pulau Pinang,9,3,6
1/06/2022,Saudi Arabia,Sabah,0,0,0
1/06/2022,Saudi Arabia,Sarawak,0,0,0
1/06/2022,Saudi Arabia,Selangor,4293,2370,1923
1/06/2022,Saudi Arabia,W.P. Labuan,0,0,0
1/06/2022,Sudan,Johor,9,5,4
1/06/2022,Sudan,Kedah,0,0,0
1/06/2022,Sudan,Kelantan,0,0,0
1/06/2022,Sudan,Perlis,0,0,0
1/06/2022,Sudan,Pulau Pinang,0,0,0
1/06/2022,Sudan,Sabah,0,0,0
1/06/2022,Sudan,Sarawak,0,0,0
1/06/2022,Sudan,Selangor,625,351,274
1/06/2022,Sudan,W.P. Labuan,0,0,0
1/06/2022,Senegal,Johor,2,2,0
1/06/2022,Senegal,Kedah,2,0,2
1/06/2022,Senegal,Kelantan,0,0,0
1/06/2022,Senegal,Perak,0,0,0
1/06/2022,Senegal,Perlis,0,0,0
1/06/2022,Senegal,Pulau Pinang,0,0,0
1/06/2022,Senegal,Sabah,0,0,0
1/06/2022,Senegal,Sarawak,0,0,0
1/06/2022,Senegal,Selangor,14,12,2
1/06/2022,Singapore,Johor,795093,471150,323943
1/06/2022,Singapore,Kedah,2739,1354,1385
1/06/2022,Singapore,Kelantan,16,13,3
1/06/2022,Singapore,Melaka,20,15,5
1/06/2022,Singapore,Negeri Sembilan,2,0,2
1/06/2022,Singapore,Pahang,20,15,5
1/06/2022,Singapore,Perak,3887,1893,1994
1/06/2022,Singapore,Perlis,44,33,11
1/06/2022,Singapore,Pulau Pinang,14417,7398,7019
1/06/2022,Singapore,Sabah,2986,1503,1483
1/06/2022,Singapore,Sarawak,2856,1515,1341
1/06/2022,Singapore,Selangor,29204,15654,13550
1/06/2022,Singapore,Terengganu,1,1,0
1/06/2022,Singapore,W.P. Labuan,0,0,0
1/06/2022,South Georgia and the South Sandwich Islands,Johor,0,0,0
1/06/2022,South Georgia and the South Sandwich Islands,Sabah,0,0,0
1/06/2022,South Georgia and the South Sandwich Islands,Selangor,2,2,0
1/06/2022,Saint Helena,Sarawak,0,0,0
1/06/2022,Solomon Islands,Johor,3,3,0
1/06/2022,Solomon Islands,Perlis,0,0,0
1/06/2022,Solomon Islands,Pulau Pinang,0,0,0
1/06/2022,Solomon Islands,Sabah,0,0,0
1/06/2022,Solomon Islands,Sarawak,1,0,1
1/06/2022,Solomon Islands,Selangor,2,2,0
1/06/2022,Solomon Islands,W.P. Labuan,0,0,0
1/06/2022,Sierra Leone,Johor,1,1,0
1/06/2022,Sierra Leone,Kedah,0,0,0
1/06/2022,Sierra Leone,Perak,0,0,0
1/06/2022,Sierra Leone,Pulau Pinang,0,0,0
1/06/2022,Sierra Leone,Sabah,0,0,0
1/06/2022,Sierra Leone,Selangor,14,9,5
1/06/2022,El Salvador,Johor,0,0,0
1/06/2022,El Salvador,Kedah,0,0,0
1/06/2022,El Salvador,Perak,0,0,0
1/06/2022,El Salvador,Perlis,0,0,0
1/06/2022,El Salvador,Pulau Pinang,0,0,0
1/06/2022,El Salvador,Sabah,0,0,0
1/06/2022,El Salvador,Selangor,5,3,2
1/06/2022,El Salvador,W.P. Labuan,0,0,0
1/06/2022,San Marino,Johor,0,0,0
1/06/2022,San Marino,Selangor,0,0,0
1/06/2022,Somalia,Johor,0,0,0
1/06/2022,Somalia,Kedah,0,0,0
1/06/2022,Somalia,Kelantan,0,0,0
1/06/2022,Somalia,Perlis,0,0,0
1/06/2022,Somalia,Sabah,0,0,0
1/06/2022,Somalia,Sarawak,0,0,0
1/06/2022,Somalia,Selangor,138,81,57
1/06/2022,Serbia,Johor,5,5,0
1/06/2022,Serbia,Kedah,0,0,0
1/06/2022,Serbia,Kelantan,0,0,0
1/06/2022,Serbia,Pahang,0,0,0
1/06/2022,Serbia,Perak,0,0,0
1/06/2022,Serbia,Perlis,1,0,1
1/06/2022,Serbia,Pulau Pinang,0,0,0
1/06/2022,Serbia,Sabah,0,0,0
1/06/2022,Serbia,Sarawak,0,0,0
1/06/2022,Serbia,Selangor,25,15,10
1/06/2022,South Sudan,Johor,0,0,0
1/06/2022,South Sudan,Kedah,0,0,0
1/06/2022,South Sudan,Sarawak,0,0,0
1/06/2022,South Sudan,Selangor,10,6,4
1/06/2022,South Sudan,W.P. Labuan,0,0,0
1/06/2022,Sao Tome and Principe,Selangor,0,0,0
1/06/2022,Suriname,Johor,0,0,0
1/06/2022,Suriname,Kedah,0,0,0
1/06/2022,Suriname,Kelantan,0,0,0
1/06/2022,Suriname,Perak,0,0,0
1/06/2022,Suriname,Perlis,0,0,0
1/06/2022,Suriname,Pulau Pinang,0,0,0
1/06/2022,Suriname,Sabah,0,0,0
1/06/2022,Suriname,Sarawak,0,0,0
1/06/2022,Suriname,Selangor,5,4,1
1/06/2022,Slovakia,Johor,16,8,8
1/06/2022,Slovakia,Kedah,1,1,0
1/06/2022,Slovakia,Kelantan,0,0,0
1/06/2022,Slovakia,Negeri Sembilan,0,0,0
1/06/2022,Slovakia,Pahang,0,0,0
1/06/2022,Slovakia,Perak,0,0,0
1/06/2022,Slovakia,Perlis,0,0,0
1/06/2022,Slovakia,Pulau Pinang,1,1,0
1/06/2022,Slovakia,Sabah,1,1,0
1/06/2022,Slovakia,Sarawak,0,0,0
1/06/2022,Slovakia,Selangor,109,45,64
1/06/2022,Slovakia,W.P. Labuan,0,0,0
1/06/2022,Slovenia,Johor,3,0,3
1/06/2022,Slovenia,Kedah,0,0,0
1/06/2022,Slovenia,Kelantan,0,0,0
1/06/2022,Slovenia,Perak,0,0,0
1/06/2022,Slovenia,Perlis,0,0,0
1/06/2022,Slovenia,Pulau Pinang,0,0,0
1/06/2022,Slovenia,Sabah,0,0,0
1/06/2022,Slovenia,Sarawak,1,1,0
1/06/2022,Slovenia,Selangor,30,20,10
1/06/2022,Slovenia,W.P. Labuan,0,0,0
1/06/2022,Sweden,Johor,145,107,38
1/06/2022,Sweden,Kedah,7,6,1
1/06/2022,Sweden,Kelantan,3,2,1
1/06/2022,Sweden,Melaka,0,0,0
1/06/2022,Sweden,Negeri Sembilan,0,0,0
1/06/2022,Sweden,Pahang,0,0,0
1/06/2022,Sweden,Perak,4,2,2
1/06/2022,Sweden,Perlis,6,5,1
1/06/2022,Sweden,Pulau Pinang,37,20,17
1/06/2022,Sweden,Sabah,22,11,11
1/06/2022,Sweden,Sarawak,8,5,3
1/06/2022,Sweden,Selangor,495,324,171
1/06/2022,Sweden,W.P. Labuan,0,0,0
1/06/2022,Eswatini,Johor,0,0,0
1/06/2022,Eswatini,Kedah,0,0,0
1/06/2022,Eswatini,Pulau Pinang,0,0,0
1/06/2022,Eswatini,Sabah,0,0,0
1/06/2022,Eswatini,Selangor,9,6,3
1/06/2022,Seychelles,Johor,3,3,0
1/06/2022,Seychelles,Kedah,0,0,0
1/06/2022,Seychelles,Pulau Pinang,0,0,0
1/06/2022,Seychelles,Sabah,0,0,0
1/06/2022,Seychelles,Sarawak,0,0,0
1/06/2022,Seychelles,Selangor,30,11,19
1/06/2022,Syrian Arab Republic,Johor,6,2,4
1/06/2022,Syrian Arab Republic,Kedah,1,1,0
1/06/2022,Syrian Arab Republic,Kelantan,0,0,0
1/06/2022,Syrian Arab Republic,Pahang,0,0,0
1/06/2022,Syrian Arab Republic,Perlis,0,0,0
1/06/2022,Syrian Arab Republic,Pulau Pinang,0,0,0
1/06/2022,Syrian Arab Republic,Sabah,0,0,0
1/06/2022,Syrian Arab Republic,Sarawak,0,0,0
1/06/2022,Syrian Arab Republic,Selangor,464,278,186
1/06/2022,Syrian Arab Republic,W.P. Labuan,0,0,0
1/06/2022,Turks and Caicos Islands,Perlis,0,0,0
1/06/2022,TCD,Johor,1,1,0
1/06/2022,TCD,Kedah,0,0,0
1/06/2022,TCD,Perlis,0,0,0
1/06/2022,TCD,Selangor,10,7,3
1/06/2022,Togo,Johor,0,0,0
1/06/2022,Togo,Perak,0,0,0
1/06/2022,Togo,Pulau Pinang,0,0,0
1/06/2022,Togo,Selangor,1,0,1
1/06/2022,Thailand,Johor,2429,510,1919
1/06/2022,Thailand,Kedah,36092,24203,11889
1/06/2022,Thailand,Kelantan,8681,3840,4841
1/06/2022,Thailand,Melaka,3,1,2
1/06/2022,Thailand,Negeri Sembilan,0,0,0
1/06/2022,Thailand,Pahang,3,3,0
1/06/2022,Thailand,Perak,3068,1365,1703
1/06/2022,Thailand,Perlis,40471,25967,14504
1/06/2022,Thailand,Pulau Pinang,1079,432,647
1/06/2022,Thailand,Sabah,17,9,8
1/06/2022,Thailand,Sarawak,29,20,9
1/06/2022,Thailand,Selangor,5756,2333,3423
1/06/2022,Thailand,Terengganu,0,0,0
1/06/2022,Thailand,W.P. Labuan,0,0,0
1/06/2022,Tajikistan,Johor,2,2,0
1/06/2022,Tajikistan,Kedah,0,0,0
1/06/2022,Tajikistan,Perlis,0,0,0
1/06/2022,Tajikistan,Pulau Pinang,0,0,0
1/06/2022,Tajikistan,Sabah,0,0,0
1/06/2022,Tajikistan,Selangor,38,28,10
1/06/2022,Tokelau,Selangor,0,0,0
1/06/2022,Turkmenistan,Johor,0,0,0
1/06/2022,Turkmenistan,Kedah,0,0,0
1/06/2022,Turkmenistan,Kelantan,0,0,0
1/06/2022,Turkmenistan,Perlis,0,0,0
1/06/2022,Turkmenistan,Pulau Pinang,0,0,0
1/06/2022,Turkmenistan,Sabah,0,0,0
1/06/2022,Turkmenistan,Sarawak,0,0,0
1/06/2022,Turkmenistan,Selangor,49,40,9
1/06/2022,Timor-Leste,Johor,1,1,0
1/06/2022,Timor-Leste,Kedah,0,0,0
1/06/2022,Timor-Leste,Perlis,0,0,0
1/06/2022,Timor-Leste,Pulau Pinang,3,2,1
1/06/2022,Timor-Leste,Sabah,0,0,0
1/06/2022,Timor-Leste,Sarawak,3,1,2
1/06/2022,Timor-Leste,Selangor,234,152,82
1/06/2022,Tonga,Johor,0,0,0
1/06/2022,Tonga,Pulau Pinang,0,0,0
1/06/2022,Tonga,Sarawak,0,0,0
1/06/2022,Tonga,Selangor,0,0,0
1/06/2022,Trinidad and Tobago,Johor,1,0,1
1/06/2022,Trinidad and Tobago,Kedah,0,0,0
1/06/2022,Trinidad and Tobago,Pahang,0,0,0
1/06/2022,Trinidad and Tobago,Pulau Pinang,0,0,0
1/06/2022,Trinidad and Tobago,Sabah,0,0,0
1/06/2022,Trinidad and Tobago,Sarawak,1,0,1
1/06/2022,Trinidad and Tobago,Selangor,5,5,0
1/06/2022,Tunisia,Johor,1,1,0
1/06/2022,Tunisia,Kedah,6,4,2
1/06/2022,Tunisia,Kelantan,0,0,0
1/06/2022,Tunisia,Melaka,1,0,1
1/06/2022,Tunisia,Perak,0,0,0
1/06/2022,Tunisia,Perlis,0,0,0
1/06/2022,Tunisia,Pulau Pinang,2,2,0
1/06/2022,Tunisia,Sabah,0,0,0
1/06/2022,Tunisia,Sarawak,0,0,0
1/06/2022,Tunisia,Selangor,199,95,104
1/06/2022,Tunisia,W.P. Labuan,0,0,0
1/06/2022,Türkiye,Johor,123,93,30
1/06/2022,Türkiye,Kedah,20,8,12
1/06/2022,Türkiye,Kelantan,0,0,0
1/06/2022,Türkiye,Melaka,0,0,0
1/06/2022,Türkiye,Negeri Sembilan,0,0,0
1/06/2022,Türkiye,Pahang,0,0,0
1/06/2022,Türkiye,Perak,2,2,0
1/06/2022,Türkiye,Perlis,7,4,3
1/06/2022,Türkiye,Pulau Pinang,5,3,2
1/06/2022,Türkiye,Sabah,1,1,0
1/06/2022,Türkiye,Sarawak,0,0,0
1/06/2022,Türkiye,Selangor,527,382,145
1/06/2022,Türkiye,W.P. Labuan,0,0,0
1/06/2022,Tuvalu,Selangor,0,0,0
1/06/2022,"Taiwan, Province of China",Johor,1973,779,1194
1/06/2022,"Taiwan, Province of China",Kedah,38,19,19
1/06/2022,"Taiwan, Province of China",Kelantan,0,0,0
1/06/2022,"Taiwan, Province of China",Melaka,0,0,0
1/06/2022,"Taiwan, Province of China",Negeri Sembilan,0,0,0
1/06/2022,"Taiwan, Province of China",Pahang,3,3,0
1/06/2022,"Taiwan, Province of China",Perak,7,2,5
1/06/2022,"Taiwan, Province of China",Perlis,2,2,0
1/06/2022,"Taiwan, Province of China",Pulau Pinang,368,214,154
1/06/2022,"Taiwan, Province of China",Sabah,54,18,36
1/06/2022,"Taiwan, Province of China",Sarawak,48,23,25
1/06/2022,"Taiwan, Province of China",Selangor,1306,745,561
1/06/2022,"Taiwan, Province of China",W.P. Labuan,0,0,0
1/06/2022,"Tanzania, United Republic of",Johor,6,1,5
1/06/2022,"Tanzania, United Republic of",Kedah,0,0,0
1/06/2022,"Tanzania, United Republic of",Perak,0,0,0
1/06/2022,"Tanzania, United Republic of",Perlis,0,0,0
1/06/2022,"Tanzania, United Republic of",Pulau Pinang,0,0,0
1/06/2022,"Tanzania, United Republic of",Sabah,0,0,0
1/06/2022,"Tanzania, United Republic of",Sarawak,0,0,0
1/06/2022,"Tanzania, United Republic of",Selangor,69,33,36
1/06/2022,Uganda,Johor,1,1,0
1/06/2022,Uganda,Kedah,0,0,0
1/06/2022,Uganda,Perak,0,0,0
1/06/2022,Uganda,Perlis,0,0,0
1/06/2022,Uganda,Pulau Pinang,1,0,1
1/06/2022,Uganda,Sabah,0,0,0
1/06/2022,Uganda,Sarawak,0,0,0
1/06/2022,Uganda,Selangor,39,20,19
1/06/2022,Ukraine,Johor,62,36,26
1/06/2022,Ukraine,Kedah,8,4,4
1/06/2022,Ukraine,Kelantan,0,0,0
1/06/2022,Ukraine,Melaka,0,0,0
1/06/2022,Ukraine,Negeri Sembilan,0,0,0
1/06/2022,Ukraine,Pahang,0,0,0
1/06/2022,Ukraine,Perak,0,0,0
1/06/2022,Ukraine,Perlis,1,1,0
1/06/2022,Ukraine,Pulau Pinang,3,1,2
1/06/2022,Ukraine,Sabah,5,0,5
1/06/2022,Ukraine,Sarawak,0,0,0
1/06/2022,Ukraine,Selangor,295,162,133
1/06/2022,Ukraine,W.P. Labuan,0,0,0
1/06/2022,Uruguay,Johor,8,3,5
1/06/2022,Uruguay,Kedah,0,0,0
1/06/2022,Uruguay,Kelantan,0,0,0
1/06/2022,Uruguay,Perak,0,0,0
1/06/2022,Uruguay,Perlis,0,0,0
1/06/2022,Uruguay,Pulau Pinang,0,0,0
1/06/2022,Uruguay,Sabah,0,0,0
1/06/2022,Uruguay,Sarawak,0,0,0
1/06/2022,Uruguay,Selangor,13,8,5
1/06/2022,Uruguay,W.P. Labuan,0,0,0
1/06/2022,United States of America,Johor,2673,1645,1028
1/06/2022,United States of America,Kedah,175,86,89
1/06/2022,United States of America,Kelantan,4,2,2
1/06/2022,United States of America,Melaka,3,3,0
1/06/2022,United States of America,Negeri Sembilan,0,0,0
1/06/2022,United States of America,Pahang,3,3,0
1/06/2022,United States of America,Perak,42,24,18
1/06/2022,United States of America,Perlis,25,16,9
1/06/2022,United States of America,Pulau Pinang,1072,686,386
1/06/2022,United States of America,Sabah,179,95,84
1/06/2022,United States of America,Sarawak,87,52,35
1/06/2022,United States of America,Selangor,8380,4950,3430
1/06/2022,United States of America,Terengganu,0,0,0
1/06/2022,United States of America,W.P. Labuan,0,0,0
1/06/2022,Uzbekistan,Johor,25,13,12
1/06/2022,Uzbekistan,Kedah,0,0,0
1/06/2022,Uzbekistan,Kelantan,0,0,0
1/06/2022,Uzbekistan,Perak,0,0,0
1/06/2022,Uzbekistan,Perlis,3,0,3
1/06/2022,Uzbekistan,Pulau Pinang,0,0,0
1/06/2022,Uzbekistan,Sabah,0,0,0
1/06/2022,Uzbekistan,Sarawak,0,0,0
1/06/2022,Uzbekistan,Selangor,214,93,121
1/06/2022,Holy See,Johor,1,1,0
1/06/2022,Holy See,Sarawak,0,0,0
1/06/2022,Holy See,Selangor,0,0,0
1/06/2022,Saint Vincent and the Grenadines,Johor,0,0,0
1/06/2022,Saint Vincent and the Grenadines,Kedah,0,0,0
1/06/2022,Saint Vincent and the Grenadines,Pulau Pinang,0,0,0
1/06/2022,Saint Vincent and the Grenadines,Sarawak,0,0,0
1/06/2022,Saint Vincent and the Grenadines,Selangor,0,0,0
1/06/2022,"Venezuela, Bolivarian Republic of",Johor,7,5,2
1/06/2022,"Venezuela, Bolivarian Republic of",Kedah,1,1,0
1/06/2022,"Venezuela, Bolivarian Republic of",Kelantan,0,0,0
1/06/2022,"Venezuela, Bolivarian Republic of",Melaka,0,0,0
1/06/2022,"Venezuela, Bolivarian Republic of",Perak,0,0,0
1/06/2022,"Venezuela, Bolivarian Republic of",Perlis,0,0,0
1/06/2022,"Venezuela, Bolivarian Republic of",Pulau Pinang,0,0,0
1/06/2022,"Venezuela, Bolivarian Republic of",Sabah,0,0,0
1/06/2022,"Venezuela, Bolivarian Republic of",Sarawak,0,0,0
1/06/2022,"Venezuela, Bolivarian Republic of",Selangor,36,25,11
1/06/2022,"Venezuela, Bolivarian Republic of",W.P. Labuan,0,0,0
1/06/2022,Viet Nam,Johor,9803,3265,6538
1/06/2022,Viet Nam,Kedah,198,30,168
1/06/2022,Viet Nam,Kelantan,6,6,0
1/06/2022,Viet Nam,Melaka,0,0,0
1/06/2022,Viet Nam,Negeri Sembilan,0,0,0
1/06/2022,Viet Nam,Pahang,0,0,0
1/06/2022,Viet Nam,Perak,44,9,35
1/06/2022,Viet Nam,Perlis,6,4,2
1/06/2022,Viet Nam,Pulau Pinang,685,150,535
1/06/2022,Viet Nam,Sabah,18,7,11
1/06/2022,Viet Nam,Sarawak,27,4,23
1/06/2022,Viet Nam,Selangor,10157,3087,7070
1/06/2022,Viet Nam,Terengganu,0,0,0
1/06/2022,Viet Nam,W.P. Labuan,0,0,0
1/06/2022,Vanuatu,Johor,13,10,3
1/06/2022,Vanuatu,Kedah,1,1,0
1/06/2022,Vanuatu,Pulau Pinang,0,0,0
1/06/2022,Vanuatu,Sabah,0,0,0
1/06/2022,Vanuatu,Sarawak,0,0,0
1/06/2022,Vanuatu,Selangor,25,22,3
1/06/2022, Samoa,Johor,0,0,0
1/06/2022, Samoa,Sarawak,0,0,0
1/06/2022, Samoa,Selangor,1,0,1
1/06/2022,Yemen,Johor,29,22,7
1/06/2022,Yemen,Kedah,2,2,0
1/06/2022,Yemen,Kelantan,0,0,0
1/06/2022,Yemen,Melaka,0,0,0
1/06/2022,Yemen,Pahang,0,0,0
1/06/2022,Yemen,Perak,0,0,0
1/06/2022,Yemen,Perlis,0,0,0
1/06/2022,Yemen,Pulau Pinang,0,0,0
1/06/2022,Yemen,Sabah,0,0,0
1/06/2022,Yemen,Sarawak,0,0,0
1/06/2022,Yemen,Selangor,1150,743,407
1/06/2022,Yemen,W.P. Labuan,0,0,0
1/06/2022,South Africa,Johor,168,104,64
1/06/2022,South Africa,Kedah,17,8,9
1/06/2022,South Africa,Kelantan,2,1,1
1/06/2022,South Africa,Melaka,2,1,1
1/06/2022,South Africa,Pahang,0,0,0
1/06/2022,South Africa,Perak,1,1,0
1/06/2022,South Africa,Perlis,7,5,2
1/06/2022,South Africa,Pulau Pinang,19,13,6
1/06/2022,South Africa,Sabah,6,4,2
1/06/2022,South Africa,Sarawak,11,8,3
1/06/2022,South Africa,Selangor,514,295,219
1/06/2022,South Africa,Terengganu,0,0,0
1/06/2022,South Africa,W.P. Labuan,0,0,0
1/06/2022,ZAR,Selangor,0,0,0
1/06/2022,Zambia,Johor,1,1,0
1/06/2022,Zambia,Kedah,0,0,0
1/06/2022,Zambia,Perak,0,0,0
1/06/2022,Zambia,Perlis,0,0,0
1/06/2022,Zambia,Pulau Pinang,0,0,0
1/06/2022,Zambia,Sabah,0,0,0
1/06/2022,Zambia,Sarawak,0,0,0
1/06/2022,Zambia,Selangor,37,20,17
1/06/2022,Zimbabwe,Johor,3,2,1
1/06/2022,Zimbabwe,Kedah,0,0,0
1/06/2022,Zimbabwe,Kelantan,0,0,0
1/06/2022,Zimbabwe,Perak,0,0,0
1/06/2022,Zimbabwe,Perlis,0,0,0
1/06/2022,Zimbabwe,Pulau Pinang,2,0,2
1/06/2022,Zimbabwe,Sabah,0,0,0
1/06/2022,Zimbabwe,Sarawak,0,0,0
1/06/2022,Zimbabwe,Selangor,66,33,33
1/07/2022,Aruba,Kedah,0,0,0
1/07/2022,Aruba,Pulau Pinang,0,0,0
1/07/2022,Afghanistan,Johor,1,1,0
1/07/2022,Afghanistan,Kedah,0,0,0
1/07/2022,Afghanistan,Perlis,0,0,0
1/07/2022,Afghanistan,Pulau Pinang,0,0,0
1/07/2022,Afghanistan,Sarawak,1,1,0
1/07/2022,Afghanistan,Selangor,61,42,19
1/07/2022,Angola,Johor,0,0,0
1/07/2022,Angola,Kedah,0,0,0
1/07/2022,Angola,Sabah,0,0,0
1/07/2022,Angola,Selangor,1,0,1
1/07/2022,Anguilla,Selangor,0,0,0
1/07/2022,Albania,Johor,11,5,6
1/07/2022,Albania,Kedah,0,0,0
1/07/2022,Albania,Perak,0,0,0
1/07/2022,Albania,Perlis,0,0,0
1/07/2022,Albania,Pulau Pinang,2,2,0
1/07/2022,Albania,Sabah,0,0,0
1/07/2022,Albania,Sarawak,0,0,0
1/07/2022,Albania,Selangor,20,13,7
1/07/2022,Andorra,Johor,1,0,1
1/07/2022,Andorra,Kedah,1,1,0
1/07/2022,Andorra,Perlis,0,0,0
1/07/2022,Andorra,Pulau Pinang,0,0,0
1/07/2022,Andorra,Selangor,3,1,2
1/07/2022,Antigua and Barbuda,Selangor,0,0,0
1/07/2022,United Arab Emirates,Johor,37,18,19
1/07/2022,United Arab Emirates,Kedah,15,6,9
1/07/2022,United Arab Emirates,Kelantan,0,0,0
1/07/2022,United Arab Emirates,Perak,0,0,0
1/07/2022,United Arab Emirates,Perlis,1,1,0
1/07/2022,United Arab Emirates,Pulau Pinang,5,3,2
1/07/2022,United Arab Emirates,Sabah,1,1,0
1/07/2022,United Arab Emirates,Sarawak,2,2,0
1/07/2022,United Arab Emirates,Selangor,650,340,310
1/07/2022,Argentina,Johor,59,31,28
1/07/2022,Argentina,Kedah,8,5,3
1/07/2022,Argentina,Kelantan,0,0,0
1/07/2022,Argentina,Melaka,0,0,0
1/07/2022,Argentina,Perak,0,0,0
1/07/2022,Argentina,Perlis,1,1,0
1/07/2022,Argentina,Pulau Pinang,5,3,2
1/07/2022,Argentina,Sabah,5,1,4
1/07/2022,Argentina,Sarawak,3,0,3
1/07/2022,Argentina,Selangor,201,123,78
1/07/2022,Argentina,W.P. Labuan,0,0,0
1/07/2022,Armenia,Johor,7,1,6
1/07/2022,Armenia,Kedah,0,0,0
1/07/2022,Armenia,Kelantan,0,0,0
1/07/2022,Armenia,Perak,0,0,0
1/07/2022,Armenia,Perlis,0,0,0
1/07/2022,Armenia,Pulau Pinang,0,0,0
1/07/2022,Armenia,Sabah,0,0,0
1/07/2022,Armenia,Sarawak,0,0,0
1/07/2022,Armenia,Selangor,25,16,9
1/07/2022,Antarctica,Selangor,0,0,0
1/07/2022,Antigua and Barbuda,Johor,0,0,0
1/07/2022,Antigua and Barbuda,Kedah,0,0,0
1/07/2022,Antigua and Barbuda,Pulau Pinang,0,0,0
1/07/2022,Antigua and Barbuda,Sarawak,0,0,0
1/07/2022,Antigua and Barbuda,Selangor,9,6,3
1/07/2022,Australia,Johor,3909,2355,1554
1/07/2022,Australia,Kedah,386,212,174
1/07/2022,Australia,Kelantan,3,2,1
1/07/2022,Australia,Melaka,0,0,0
1/07/2022,Australia,Negeri Sembilan,0,0,0
1/07/2022,Australia,Pahang,3,3,0
1/07/2022,Australia,Perak,203,114,89
1/07/2022,Australia,Perlis,44,24,20
1/07/2022,Australia,Pulau Pinang,1348,715,633
1/07/2022,Australia,Sabah,387,220,167
1/07/2022,Australia,Sarawak,384,214,170
1/07/2022,Australia,Selangor,12143,7141,5002
1/07/2022,Australia,Terengganu,0,0,0
1/07/2022,Australia,W.P. Labuan,0,0,0
1/07/2022,Austria,Johor,146,97,49
1/07/2022,Austria,Kedah,17,12,5
1/07/2022,Austria,Kelantan,1,1,0
1/07/2022,Austria,Melaka,0,0,0
1/07/2022,Austria,Negeri Sembilan,0,0,0
1/07/2022,Austria,Pahang,0,0,0
1/07/2022,Austria,Perak,4,4,0
1/07/2022,Austria,Perlis,11,6,5
1/07/2022,Austria,Pulau Pinang,48,36,12
1/07/2022,Austria,Sabah,18,12,6
1/07/2022,Austria,Sarawak,17,9,8
1/07/2022,Austria,Selangor,677,413,264
1/07/2022,Austria,Terengganu,0,0,0
1/07/2022,Austria,W.P. Labuan,0,0,0
1/07/2022,Azerbaijan,Johor,2,1,1
1/07/2022,Azerbaijan,Kedah,1,1,0
1/07/2022,Azerbaijan,Kelantan,0,0,0
1/07/2022,Azerbaijan,Melaka,0,0,0
1/07/2022,Azerbaijan,Perlis,0,0,0
1/07/2022,Azerbaijan,Pulau Pinang,0,0,0
1/07/2022,Azerbaijan,Sabah,0,0,0
1/07/2022,Azerbaijan,Sarawak,0,0,0
1/07/2022,Azerbaijan,Selangor,57,34,23
1/07/2022,Azerbaijan,W.P. Labuan,0,0,0
1/07/2022,Burundi,Pulau Pinang,0,0,0
1/07/2022,Burundi,Sarawak,0,0,0
1/07/2022,Burundi,Selangor,2,1,1
1/07/2022,Belgium,Johor,223,133,90
1/07/2022,Belgium,Kedah,25,14,11
1/07/2022,Belgium,Kelantan,2,0,2
1/07/2022,Belgium,Melaka,0,0,0
1/07/2022,Belgium,Negeri Sembilan,0,0,0
1/07/2022,Belgium,Pahang,0,0,0
1/07/2022,Belgium,Perak,8,5,3
1/07/2022,Belgium,Perlis,2,2,0
1/07/2022,Belgium,Pulau Pinang,59,36,23
1/07/2022,Belgium,Sabah,42,23,19
1/07/2022,Belgium,Sarawak,17,8,9
1/07/2022,Belgium,Selangor,1169,658,511
1/07/2022,Belgium,W.P. Labuan,0,0,0
1/07/2022,Benin,Johor,1,1,0
1/07/2022,Benin,Kedah,0,0,0
1/07/2022,Benin,Perak,0,0,0
1/07/2022,Benin,Pulau Pinang,0,0,0
1/07/2022,Benin,Sabah,0,0,0
1/07/2022,Benin,Sarawak,0,0,0
1/07/2022,Benin,Selangor,5,4,1
1/07/2022,Burkina Faso,Perak,0,0,0
1/07/2022,Burkina Faso,Pulau Pinang,0,0,0
1/07/2022,Burkina Faso,Selangor,4,4,0
1/07/2022,Bangladesh,Johor,1656,1366,290
1/07/2022,Bangladesh,Kedah,40,23,17
1/07/2022,Bangladesh,Kelantan,0,0,0
1/07/2022,Bangladesh,Melaka,0,0,0
1/07/2022,Bangladesh,Negeri Sembilan,0,0,0
1/07/2022,Bangladesh,Pahang,0,0,0
1/07/2022,Bangladesh,Perak,0,0,0
1/07/2022,Bangladesh,Perlis,1,1,0
1/07/2022,Bangladesh,Pulau Pinang,82,77,5
1/07/2022,Bangladesh,Sabah,3,2,1
1/07/2022,Bangladesh,Sarawak,2,1,1
1/07/2022,Bangladesh,Selangor,16380,14386,1994
1/07/2022,Bangladesh,W.P. Labuan,0,0,0
1/07/2022,Bulgaria,Johor,31,16,15
1/07/2022,Bulgaria,Kedah,1,0,1
1/07/2022,Bulgaria,Kelantan,0,0,0
1/07/2022,Bulgaria,Pahang,0,0,0
1/07/2022,Bulgaria,Perak,1,1,0
1/07/2022,Bulgaria,Perlis,0,0,0
1/07/2022,Bulgaria,Pulau Pinang,0,0,0
1/07/2022,Bulgaria,Sabah,1,0,1
1/07/2022,Bulgaria,Sarawak,1,1,0
1/07/2022,Bulgaria,Selangor,84,50,34
1/07/2022,Bulgaria,W.P. Labuan,0,0,0
1/07/2022,Bahrain,Johor,38,20,18
1/07/2022,Bahrain,Kedah,0,0,0
1/07/2022,Bahrain,Kelantan,0,0,0
1/07/2022,Bahrain,Perlis,1,1,0
1/07/2022,Bahrain,Pulau Pinang,0,0,0
1/07/2022,Bahrain,Sabah,0,0,0
1/07/2022,Bahrain,Sarawak,0,0,0
1/07/2022,Bahrain,Selangor,192,88,104
1/07/2022,Bahamas,Johor,0,0,0
1/07/2022,Bahamas,Kedah,2,1,1
1/07/2022,Bahamas,Perak,1,0,1
1/07/2022,Bahamas,Sabah,0,0,0
1/07/2022,Bahamas,Sarawak,0,0,0
1/07/2022,Bahamas,Selangor,3,1,2
1/07/2022,Bosnia and Herzegovina,Johor,5,3,2
1/07/2022,Bosnia and Herzegovina,Kedah,1,1,0
1/07/2022,Bosnia and Herzegovina,Perlis,0,0,0
1/07/2022,Bosnia and Herzegovina,Pulau Pinang,0,0,0
1/07/2022,Bosnia and Herzegovina,Sabah,0,0,0
1/07/2022,Bosnia and Herzegovina,Sarawak,0,0,0
1/07/2022,Bosnia and Herzegovina,Selangor,36,22,14
1/07/2022,Belarus,Johor,6,5,1
1/07/2022,Belarus,Kedah,0,0,0
1/07/2022,Belarus,Kelantan,0,0,0
1/07/2022,Belarus,Pahang,0,0,0
1/07/2022,Belarus,Perak,2,1,1
1/07/2022,Belarus,Perlis,0,0,0
1/07/2022,Belarus,Pulau Pinang,2,1,1
1/07/2022,Belarus,Sabah,3,1,2
1/07/2022,Belarus,Sarawak,0,0,0
1/07/2022,Belarus,Selangor,76,36,40
1/07/2022,Belarus,W.P. Labuan,0,0,0
1/07/2022,Belize,Johor,0,0,0
1/07/2022,Belize,Pulau Pinang,0,0,0
1/07/2022,Belize,Sarawak,0,0,0
1/07/2022,Belize,Selangor,7,2,5
1/07/2022,Bermuda,Selangor,0,0,0
1/07/2022,Bolivia,Johor,0,0,0
1/07/2022,Bolivia,Kedah,0,0,0
1/07/2022,Bolivia,Melaka,0,0,0
1/07/2022,Bolivia,Perak,0,0,0
1/07/2022,Bolivia,Perlis,0,0,0
1/07/2022,Bolivia,Pulau Pinang,0,0,0
1/07/2022,Bolivia,Sabah,0,0,0
1/07/2022,Bolivia,Sarawak,5,3,2
1/07/2022,Bolivia,Selangor,7,5,2
1/07/2022,Brazil,Johor,201,113,88
1/07/2022,Brazil,Kedah,30,14,16
1/07/2022,Brazil,Kelantan,1,0,1
1/07/2022,Brazil,Melaka,2,2,0
1/07/2022,Brazil,Pahang,0,0,0
1/07/2022,Brazil,Perak,5,2,3
1/07/2022,Brazil,Perlis,3,3,0
1/07/2022,Brazil,Pulau Pinang,23,18,5
1/07/2022,Brazil,Sabah,5,4,1
1/07/2022,Brazil,Sarawak,1,1,0
1/07/2022,Brazil,Selangor,498,272,226
1/07/2022,Brazil,W.P. Labuan,0,0,0
1/07/2022,Barbados,Johor,1,0,1
1/07/2022,Barbados,Kedah,0,0,0
1/07/2022,Barbados,Perlis,0,0,0
1/07/2022,Barbados,Pulau Pinang,0,0,0
1/07/2022,Barbados,Selangor,2,0,2
1/07/2022,Brunei Darussalam,Johor,198,112,86
1/07/2022,Brunei Darussalam,Kedah,1,1,0
1/07/2022,Brunei Darussalam,Kelantan,0,0,0
1/07/2022,Brunei Darussalam,Melaka,0,0,0
1/07/2022,Brunei Darussalam,Pahang,0,0,0
1/07/2022,Brunei Darussalam,Perak,1,1,0
1/07/2022,Brunei Darussalam,Perlis,9,3,6
1/07/2022,Brunei Darussalam,Pulau Pinang,3,2,1
1/07/2022,Brunei Darussalam,Sabah,889,443,446
1/07/2022,Brunei Darussalam,Sarawak,6462,3682,2780
1/07/2022,Brunei Darussalam,Selangor,2978,1542,1436
1/07/2022,Brunei Darussalam,W.P. Labuan,53,26,27
1/07/2022,Bhutan,Johor,0,0,0
1/07/2022,Bhutan,Kedah,1,1,0
1/07/2022,Bhutan,Perak,0,0,0
1/07/2022,Bhutan,Perlis,0,0,0
1/07/2022,Bhutan,Pulau Pinang,0,0,0
1/07/2022,Bhutan,Sabah,0,0,0
1/07/2022,Bhutan,Sarawak,0,0,0
1/07/2022,Bhutan,Selangor,42,25,17
1/07/2022,Botswana,Johor,1,1,0
1/07/2022,Botswana,Kedah,0,0,0
1/07/2022,Botswana,Perlis,0,0,0
1/07/2022,Botswana,Pulau Pinang,0,0,0
1/07/2022,Botswana,Sabah,0,0,0
1/07/2022,Botswana,Sarawak,0,0,0
1/07/2022,Botswana,Selangor,12,4,8
1/07/2022,Central African Republic,Kedah,0,0,0
1/07/2022,Central African Republic,Selangor,0,0,0
1/07/2022,Canada,Johor,788,482,306
1/07/2022,Canada,Kedah,57,30,27
1/07/2022,Canada,Kelantan,0,0,0
1/07/2022,Canada,Melaka,0,0,0
1/07/2022,Canada,Negeri Sembilan,0,0,0
1/07/2022,Canada,Pahang,5,1,4
1/07/2022,Canada,Perak,23,13,10
1/07/2022,Canada,Perlis,16,12,4
1/07/2022,Canada,Pulau Pinang,168,94,74
1/07/2022,Canada,Sabah,62,28,34
1/07/2022,Canada,Sarawak,51,33,18
1/07/2022,Canada,Selangor,2517,1461,1056
1/07/2022,Canada,Terengganu,0,0,0
1/07/2022,Canada,W.P. Labuan,1,1,0
1/07/2022,Cocos (Keeling) Islands,Selangor,0,0,0
1/07/2022,Switzerland,Johor,385,224,161
1/07/2022,Switzerland,Kedah,56,30,26
1/07/2022,Switzerland,Kelantan,5,4,1
1/07/2022,Switzerland,Melaka,0,0,0
1/07/2022,Switzerland,Negeri Sembilan,0,0,0
1/07/2022,Switzerland,Pahang,2,2,0
1/07/2022,Switzerland,Perak,5,3,2
1/07/2022,Switzerland,Perlis,11,6,5
1/07/2022,Switzerland,Pulau Pinang,94,58,36
1/07/2022,Switzerland,Sabah,49,22,27
1/07/2022,Switzerland,Sarawak,42,25,17
1/07/2022,Switzerland,Selangor,1235,705,530
1/07/2022,Switzerland,W.P. Labuan,1,1,0
1/07/2022,Chile,Johor,20,13,7
1/07/2022,Chile,Kedah,5,2,3
1/07/2022,Chile,Kelantan,0,0,0
1/07/2022,Chile,Melaka,0,0,0
1/07/2022,Chile,Pahang,0,0,0
1/07/2022,Chile,Perak,0,0,0
1/07/2022,Chile,Perlis,1,1,0
1/07/2022,Chile,Pulau Pinang,4,3,1
1/07/2022,Chile,Sabah,0,0,0
1/07/2022,Chile,Sarawak,0,0,0
1/07/2022,Chile,Selangor,114,62,52
1/07/2022,China,Johor,18366,7545,10821
1/07/2022,China,Kedah,341,143,198
1/07/2022,China,Kelantan,5,0,5
1/07/2022,China,Melaka,1,1,0
1/07/2022,China,Pahang,3,3,0
1/07/2022,China,Perak,144,73,71
1/07/2022,China,Perlis,44,27,17
1/07/2022,China,Pulau Pinang,1048,524,524
1/07/2022,China,Sabah,308,122,186
1/07/2022,China,Sarawak,141,62,79
1/07/2022,China,Selangor,9849,5931,3918
1/07/2022,China,Terengganu,0,0,0
1/07/2022,China,W.P. Labuan,0,0,0
1/07/2022,Côte d'Ivoire,Johor,0,0,0
1/07/2022,Côte d'Ivoire,Kedah,0,0,0
1/07/2022,Côte d'Ivoire,Pulau Pinang,0,0,0
1/07/2022,Côte d'Ivoire,Sabah,0,0,0
1/07/2022,Côte d'Ivoire,Sarawak,1,0,1
1/07/2022,Côte d'Ivoire,Selangor,16,11,5
1/07/2022,Cameroon,Johor,2,2,0
1/07/2022,Cameroon,Kedah,0,0,0
1/07/2022,Cameroon,Pulau Pinang,1,1,0
1/07/2022,Cameroon,Sabah,0,0,0
1/07/2022,Cameroon,Sarawak,1,1,0
1/07/2022,Cameroon,Selangor,16,13,3
1/07/2022,Congo,Johor,0,0,0
1/07/2022,Congo,Pulau Pinang,0,0,0
1/07/2022,Congo,Sarawak,0,0,0
1/07/2022,Congo,Selangor,6,1,5
1/07/2022,Congo,Johor,0,0,0
1/07/2022,Congo,Kedah,0,0,0
1/07/2022,Congo,Selangor,0,0,0
1/07/2022,Cook Islands,Selangor,0,0,0
1/07/2022,Colombia,Johor,27,11,16
1/07/2022,Colombia,Kedah,2,0,2
1/07/2022,Colombia,Perak,0,0,0
1/07/2022,Colombia,Pulau Pinang,5,2,3
1/07/2022,Colombia,Sabah,2,2,0
1/07/2022,Colombia,Sarawak,2,2,0
1/07/2022,Colombia,Selangor,88,41,47
1/07/2022,Colombia,W.P. Labuan,0,0,0
1/07/2022,Comoros,Johor,0,0,0
1/07/2022,Comoros,Kedah,0,0,0
1/07/2022,Comoros,Selangor,2,1,1
1/07/2022,Cabo Verde,Johor,0,0,0
1/07/2022,Cabo Verde,Kedah,0,0,0
1/07/2022,Cabo Verde,Pulau Pinang,0,0,0
1/07/2022,Cabo Verde,Sabah,0,0,0
1/07/2022,Cabo Verde,Selangor,1,1,0
1/07/2022,Costa Rica,Johor,11,6,5
1/07/2022,Costa Rica,Kedah,0,0,0
1/07/2022,Costa Rica,Perak,0,0,0
1/07/2022,Costa Rica,Perlis,0,0,0
1/07/2022,Costa Rica,Pulau Pinang,6,1,5
1/07/2022,Costa Rica,Sabah,0,0,0
1/07/2022,Costa Rica,Sarawak,0,0,0
1/07/2022,Costa Rica,Selangor,27,12,15
1/07/2022,Cuba,Johor,10,7,3
1/07/2022,Cuba,Kedah,0,0,0
1/07/2022,Cuba,Perlis,0,0,0
1/07/2022,Cuba,Pulau Pinang,0,0,0
1/07/2022,Cuba,Sabah,0,0,0
1/07/2022,Cuba,Sarawak,2,1,1
1/07/2022,Cuba,Selangor,11,5,6
1/07/2022,Cyprus,Johor,11,9,2
1/07/2022,Cyprus,Kedah,4,2,2
1/07/2022,Cyprus,Perak,2,2,0
1/07/2022,Cyprus,Perlis,0,0,0
1/07/2022,Cyprus,Pulau Pinang,1,0,1
1/07/2022,Cyprus,Sabah,3,2,1
1/07/2022,Cyprus,Sarawak,0,0,0
1/07/2022,Cyprus,Selangor,43,27,16
1/07/2022,Czechia,Johor,85,56,29
1/07/2022,Czechia,Kedah,20,9,11
1/07/2022,Czechia,Kelantan,5,3,2
1/07/2022,Czechia,Melaka,0,0,0
1/07/2022,Czechia,Negeri Sembilan,0,0,0
1/07/2022,Czechia,Perak,2,1,1
1/07/2022,Czechia,Perlis,4,3,1
1/07/2022,Czechia,Pulau Pinang,19,12,7
1/07/2022,Czechia,Sabah,8,4,4
1/07/2022,Czechia,Sarawak,16,8,8
1/07/2022,Czechia,Selangor,375,201,174
1/07/2022,Czechia,W.P. Labuan,0,0,0
1/07/2022,Germany,Johor,1486,981,505
1/07/2022,Germany,Kedah,245,130,115
1/07/2022,Germany,Kelantan,16,10,6
1/07/2022,Germany,Melaka,0,0,0
1/07/2022,Germany,Negeri Sembilan,0,0,0
1/07/2022,Germany,Pahang,1,1,0
1/07/2022,Germany,Perak,24,18,6
1/07/2022,Germany,Perlis,58,38,20
1/07/2022,Germany,Pulau Pinang,412,307,105
1/07/2022,Germany,Sabah,124,72,52
1/07/2022,Germany,Sarawak,125,74,51
1/07/2022,Germany,Selangor,5314,3167,2147
1/07/2022,Germany,Terengganu,0,0,0
1/07/2022,Germany,W.P. Labuan,1,1,0
1/07/2022,Djibouti,Johor,0,0,0
1/07/2022,Djibouti,Selangor,1,0,1
1/07/2022,Dominica,Johor,3,3,0
1/07/2022,Dominica,Kedah,0,0,0
1/07/2022,Dominica,Pulau Pinang,1,1,0
1/07/2022,Dominica,Sabah,0,0,0
1/07/2022,Dominica,Sarawak,0,0,0
1/07/2022,Dominica,Selangor,22,13,9
1/07/2022,Dominica,W.P. Labuan,0,0,0
1/07/2022,Denmark,Johor,235,130,105
1/07/2022,Denmark,Kedah,32,16,16
1/07/2022,Denmark,Kelantan,0,0,0
1/07/2022,Denmark,Melaka,0,0,0
1/07/2022,Denmark,Negeri Sembilan,0,0,0
1/07/2022,Denmark,Pahang,0,0,0
1/07/2022,Denmark,Perak,2,2,0
1/07/2022,Denmark,Perlis,7,6,1
1/07/2022,Denmark,Pulau Pinang,38,25,13
1/07/2022,Denmark,Sabah,24,16,8
1/07/2022,Denmark,Sarawak,27,17,10
1/07/2022,Denmark,Selangor,1136,637,499
1/07/2022,Denmark,W.P. Labuan,0,0,0
1/07/2022,Dominican Republic,Johor,2,0,2
1/07/2022,Dominican Republic,Kedah,0,0,0
1/07/2022,Dominican Republic,Perak,0,0,0
1/07/2022,Dominican Republic,Perlis,0,0,0
1/07/2022,Dominican Republic,Pulau Pinang,0,0,0
1/07/2022,Dominican Republic,Sabah,0,0,0
1/07/2022,Dominican Republic,Sarawak,0,0,0
1/07/2022,Dominican Republic,Selangor,15,10,5
1/07/2022,Algeria,Johor,14,13,1
1/07/2022,Algeria,Kedah,4,3,1
1/07/2022,Algeria,Kelantan,0,0,0
1/07/2022,Algeria,Melaka,0,0,0
1/07/2022,Algeria,Perak,0,0,0
1/07/2022,Algeria,Perlis,0,0,0
1/07/2022,Algeria,Pulau Pinang,1,1,0
1/07/2022,Algeria,Sabah,5,4,1
1/07/2022,Algeria,Sarawak,1,1,0
1/07/2022,Algeria,Selangor,264,144,120
1/07/2022,Algeria,W.P. Labuan,0,0,0
1/07/2022,Ecuador,Johor,4,2,2
1/07/2022,Ecuador,Kedah,3,1,2
1/07/2022,Ecuador,Perak,0,0,0
1/07/2022,Ecuador,Perlis,0,0,0
1/07/2022,Ecuador,Pulau Pinang,0,0,0
1/07/2022,Ecuador,Sabah,0,0,0
1/07/2022,Ecuador,Sarawak,1,0,1
1/07/2022,Ecuador,Selangor,34,14,20
1/07/2022,Egypt,Johor,140,112,28
1/07/2022,Egypt,Kedah,7,4,3
1/07/2022,Egypt,Kelantan,0,0,0
1/07/2022,Egypt,Melaka,0,0,0
1/07/2022,Egypt,Pahang,0,0,0
1/07/2022,Egypt,Perak,0,0,0
1/07/2022,Egypt,Perlis,0,0,0
1/07/2022,Egypt,Pulau Pinang,12,6,6
1/07/2022,Egypt,Sabah,12,8,4
1/07/2022,Egypt,Sarawak,6,2,4
1/07/2022,Egypt,Selangor,1113,666,447
1/07/2022,Egypt,Terengganu,0,0,0
1/07/2022,Egypt,W.P. Labuan,0,0,0
1/07/2022,Eritrea,Johor,1,0,1
1/07/2022,Eritrea,Pulau Pinang,0,0,0
1/07/2022,Eritrea,Sabah,0,0,0
1/07/2022,Eritrea,Selangor,7,5,2
1/07/2022,Spain,Johor,498,273,225
1/07/2022,Spain,Kedah,54,28,26
1/07/2022,Spain,Kelantan,10,4,6
1/07/2022,Spain,Melaka,0,0,0
1/07/2022,Spain,Negeri Sembilan,0,0,0
1/07/2022,Spain,Pahang,0,0,0
1/07/2022,Spain,Perak,12,8,4
1/07/2022,Spain,Perlis,10,5,5
1/07/2022,Spain,Pulau Pinang,141,69,72
1/07/2022,Spain,Sabah,41,23,18
1/07/2022,Spain,Sarawak,63,26,37
1/07/2022,Spain,Selangor,2916,1523,1393
1/07/2022,Spain,W.P. Labuan,0,0,0
1/07/2022,Estonia,Johor,5,3,2
1/07/2022,Estonia,Kedah,0,0,0
1/07/2022,Estonia,Kelantan,0,0,0
1/07/2022,Estonia,Pahang,0,0,0
1/07/2022,Estonia,Perak,1,1,0
1/07/2022,Estonia,Perlis,0,0,0
1/07/2022,Estonia,Pulau Pinang,2,0,2
1/07/2022,Estonia,Sabah,0,0,0
1/07/2022,Estonia,Sarawak,0,0,0
1/07/2022,Estonia,Selangor,31,16,15
1/07/2022,Estonia,W.P. Labuan,0,0,0
1/07/2022,Ethiopia,Johor,3,1,2
1/07/2022,Ethiopia,Kedah,0,0,0
1/07/2022,Ethiopia,Pulau Pinang,0,0,0
1/07/2022,Ethiopia,Sarawak,0,0,0
1/07/2022,Ethiopia,Selangor,34,16,18
1/07/2022,Finland,Johor,125,64,61
1/07/2022,Finland,Kedah,13,7,6
1/07/2022,Finland,Kelantan,0,0,0
1/07/2022,Finland,Melaka,0,0,0
1/07/2022,Finland,Negeri Sembilan,0,0,0
1/07/2022,Finland,Pahang,0,0,0
1/07/2022,Finland,Perak,0,0,0
1/07/2022,Finland,Perlis,0,0,0
1/07/2022,Finland,Pulau Pinang,16,9,7
1/07/2022,Finland,Sabah,0,0,0
1/07/2022,Finland,Sarawak,3,2,1
1/07/2022,Finland,Selangor,227,138,89
1/07/2022,Finland,W.P. Labuan,0,0,0
1/07/2022,Fiji,Johor,54,24,30
1/07/2022,Fiji,Kedah,1,1,0
1/07/2022,Fiji,Kelantan,0,0,0
1/07/2022,Fiji,Perak,0,0,0
1/07/2022,Fiji,Perlis,0,0,0
1/07/2022,Fiji,Pulau Pinang,0,0,0
1/07/2022,Fiji,Sabah,0,0,0
1/07/2022,Fiji,Sarawak,2,0,2
1/07/2022,Fiji,Selangor,48,24,24
1/07/2022,France,Johor,2080,1212,868
1/07/2022,France,Kedah,159,92,67
1/07/2022,France,Kelantan,8,6,2
1/07/2022,France,Melaka,1,1,0
1/07/2022,France,Negeri Sembilan,0,0,0
1/07/2022,France,Pahang,4,3,1
1/07/2022,France,Perak,22,17,5
1/07/2022,France,Perlis,27,17,10
1/07/2022,France,Pulau Pinang,275,169,106
1/07/2022,France,Sabah,131,78,53
1/07/2022,France,Sarawak,136,73,63
1/07/2022,France,Selangor,6709,3780,2929
1/07/2022,France,Terengganu,0,0,0
1/07/2022,France,W.P. Labuan,0,0,0
1/07/2022,"Micronesia, Federated States of",Johor,0,0,0
1/07/2022,"Micronesia, Federated States of",Pulau Pinang,0,0,0
1/07/2022,"Micronesia, Federated States of",Selangor,0,0,0
1/07/2022,Gabon,Johor,0,0,0
1/07/2022,Gabon,Pulau Pinang,0,0,0
1/07/2022,Gabon,Sarawak,0,0,0
1/07/2022,Gabon,Selangor,7,5,2
1/07/2022,United Kingdom of Great Britain and Northern Ireland,Johor,3444,2214,1230
1/07/2022,United Kingdom of Great Britain and Northern Ireland,Kedah,451,262,189
1/07/2022,United Kingdom of Great Britain and Northern Ireland,Kelantan,7,4,3
1/07/2022,United Kingdom of Great Britain and Northern Ireland,Melaka,1,1,0
1/07/2022,United Kingdom of Great Britain and Northern Ireland,Negeri Sembilan,1,1,0
1/07/2022,United Kingdom of Great Britain and Northern Ireland,Pahang,2,2,0
1/07/2022,United Kingdom of Great Britain and Northern Ireland,Perak,97,56,41
1/07/2022,United Kingdom of Great Britain and Northern Ireland,Perlis,120,68,52
1/07/2022,United Kingdom of Great Britain and Northern Ireland,Pulau Pinang,898,538,360
1/07/2022,United Kingdom of Great Britain and Northern Ireland,Sabah,601,328,273
1/07/2022,United Kingdom of Great Britain and Northern Ireland,Sarawak,296,179,117
1/07/2022,United Kingdom of Great Britain and Northern Ireland,Selangor,14178,8171,6007
1/07/2022,United Kingdom of Great Britain and Northern Ireland,Terengganu,0,0,0
1/07/2022,United Kingdom of Great Britain and Northern Ireland,W.P. Labuan,3,2,1
1/07/2022,Georgia,Johor,2,2,0
1/07/2022,Georgia,Kedah,0,0,0
1/07/2022,Georgia,Melaka,0,0,0
1/07/2022,Georgia,Perak,0,0,0
1/07/2022,Georgia,Perlis,0,0,0
1/07/2022,Georgia,Pulau Pinang,0,0,0
1/07/2022,Georgia,Sabah,0,0,0
1/07/2022,Georgia,Sarawak,0,0,0
1/07/2022,Georgia,Selangor,17,10,7
1/07/2022,Ghana,Johor,3,3,0
1/07/2022,Ghana,Kedah,0,0,0
1/07/2022,Ghana,Kelantan,0,0,0
1/07/2022,Ghana,Pulau Pinang,0,0,0
1/07/2022,Ghana,Sabah,0,0,0
1/07/2022,Ghana,Sarawak,0,0,0
1/07/2022,Ghana,Selangor,34,26,8
1/07/2022,Gibraltar,Johor,0,0,0
1/07/2022,Gibraltar,Sarawak,1,0,1
1/07/2022,Guinea,Johor,0,0,0
1/07/2022,Guinea,Kedah,0,0,0
1/07/2022,Guinea,Kelantan,0,0,0
1/07/2022,Guinea,Perlis,0,0,0
1/07/2022,Guinea,Pulau Pinang,0,0,0
1/07/2022,Guinea,Sabah,0,0,0
1/07/2022,Guinea,Sarawak,0,0,0
1/07/2022,Guinea,Selangor,23,19,4
1/07/2022,Guadeloupe,Selangor,0,0,0
1/07/2022,Gambia,Johor,0,0,0
1/07/2022,Gambia,Kedah,0,0,0
1/07/2022,Gambia,Kelantan,0,0,0
1/07/2022,Gambia,Pulau Pinang,0,0,0
1/07/2022,Gambia,Sabah,0,0,0
1/07/2022,Gambia,Sarawak,0,0,0
1/07/2022,Gambia,Selangor,6,3,3
1/07/2022,Guinea-Bissau,Johor,0,0,0
1/07/2022,Guinea-Bissau,Selangor,0,0,0
1/07/2022,Equatorial Guinea,Johor,0,0,0
1/07/2022,Equatorial Guinea,Selangor,1,1,0
1/07/2022,Greece,Johor,22,16,6
1/07/2022,Greece,Kedah,10,8,2
1/07/2022,Greece,Kelantan,1,0,1
1/07/2022,Greece,Melaka,0,0,0
1/07/2022,Greece,Negeri Sembilan,0,0,0
1/07/2022,Greece,Pahang,0,0,0
1/07/2022,Greece,Perak,0,0,0
1/07/2022,Greece,Perlis,1,0,1
1/07/2022,Greece,Pulau Pinang,2,2,0
1/07/2022,Greece,Sabah,2,1,1
1/07/2022,Greece,Sarawak,3,3,0
1/07/2022,Greece,Selangor,105,71,34
1/07/2022,Grenada,Johor,5,2,3
1/07/2022,Grenada,Kedah,0,0,0
1/07/2022,Grenada,Pulau Pinang,0,0,0
1/07/2022,Grenada,Sabah,0,0,0
1/07/2022,Grenada,Sarawak,0,0,0
1/07/2022,Grenada,Selangor,10,5,5
1/07/2022,Greenland,Johor,0,0,0
1/07/2022,Greenland,Selangor,0,0,0
1/07/2022,Guatemala,Johor,1,0,1
1/07/2022,Guatemala,Kedah,0,0,0
1/07/2022,Guatemala,Pahang,0,0,0
1/07/2022,Guatemala,Perak,0,0,0
1/07/2022,Guatemala,Pulau Pinang,0,0,0
1/07/2022,Guatemala,Sabah,0,0,0
1/07/2022,Guatemala,Sarawak,0,0,0
1/07/2022,Guatemala,Selangor,9,7,2
1/07/2022,Guatemala,W.P. Labuan,0,0,0
1/07/2022,Guyana,Johor,0,0,0
1/07/2022,Guyana,Kedah,0,0,0
1/07/2022,Guyana,Pulau Pinang,0,0,0
1/07/2022,Guyana,Sarawak,0,0,0
1/07/2022,Guyana,Selangor,1,0,1
1/07/2022,Hong Kong,Johor,0,0,0
1/07/2022,Hong Kong,Kedah,0,0,0
1/07/2022,Hong Kong,Kelantan,0,0,0
1/07/2022,Hong Kong,Pahang,0,0,0
1/07/2022,Hong Kong,Perak,33,10,23
1/07/2022,Hong Kong,Perlis,1,1,0
1/07/2022,Hong Kong,Pulau Pinang,12,8,4
1/07/2022,Hong Kong,Sabah,53,27,26
1/07/2022,Hong Kong,Sarawak,42,23,19
1/07/2022,Hong Kong,Selangor,12,7,5
1/07/2022,Hong Kong,Terengganu,0,0,0
1/07/2022,Heard Island and McDonald Islands,Johor,0,0,0
1/07/2022,Honduras,Johor,4,0,4
1/07/2022,Honduras,Kedah,0,0,0
1/07/2022,Honduras,Perak,0,0,0
1/07/2022,Honduras,Pulau Pinang,0,0,0
1/07/2022,Honduras,Sabah,0,0,0
1/07/2022,Honduras,Sarawak,0,0,0
1/07/2022,Honduras,Selangor,10,7,3
1/07/2022,Croatia,Johor,25,16,9
1/07/2022,Croatia,Kedah,1,0,1
1/07/2022,Croatia,Kelantan,0,0,0
1/07/2022,Croatia,Melaka,0,0,0
1/07/2022,Croatia,Pahang,0,0,0
1/07/2022,Croatia,Perak,0,0,0
1/07/2022,Croatia,Perlis,0,0,0
1/07/2022,Croatia,Pulau Pinang,2,1,1
1/07/2022,Croatia,Sabah,3,3,0
1/07/2022,Croatia,Sarawak,0,0,0
1/07/2022,Croatia,Selangor,96,66,30
1/07/2022,Haiti,Johor,5,4,1
1/07/2022,Haiti,Kedah,0,0,0
1/07/2022,Haiti,Kelantan,0,0,0
1/07/2022,Haiti,Perak,0,0,0
1/07/2022,Haiti,Pulau Pinang,0,0,0
1/07/2022,Haiti,Sabah,0,0,0
1/07/2022,Haiti,Selangor,7,4,3
1/07/2022,Hungary,Johor,64,50,14
1/07/2022,Hungary,Kedah,13,4,9
1/07/2022,Hungary,Kelantan,0,0,0
1/07/2022,Hungary,Pahang,0,0,0
1/07/2022,Hungary,Perak,2,2,0
1/07/2022,Hungary,Perlis,3,3,0
1/07/2022,Hungary,Pulau Pinang,19,11,8
1/07/2022,Hungary,Sabah,9,5,4
1/07/2022,Hungary,Sarawak,8,3,5
1/07/2022,Hungary,Selangor,234,126,108
1/07/2022,Hungary,W.P. Labuan,0,0,0
1/07/2022,Indonesia,Johor,84876,45924,38952
1/07/2022,Indonesia,Kedah,1658,661,997
1/07/2022,Indonesia,Kelantan,89,53,36
1/07/2022,Indonesia,Melaka,6231,2663,3568
1/07/2022,Indonesia,Negeri Sembilan,6081,4051,2030
1/07/2022,Indonesia,Pahang,7,6,1
1/07/2022,Indonesia,Perak,127,46,81
1/07/2022,Indonesia,Perlis,140,62,78
1/07/2022,Indonesia,Pulau Pinang,18153,7138,11015
1/07/2022,Indonesia,Sabah,3963,1890,2073
1/07/2022,Indonesia,Sarawak,23710,13814,9896
1/07/2022,Indonesia,Selangor,45541,21372,24169
1/07/2022,Indonesia,Terengganu,0,0,0
1/07/2022,Indonesia,W.P. Labuan,2,2,0
1/07/2022,India,Johor,12385,8784,3601
1/07/2022,India,Kedah,477,271,206
1/07/2022,India,Kelantan,8,6,2
1/07/2022,India,Melaka,0,0,0
1/07/2022,India,Negeri Sembilan,0,0,0
1/07/2022,India,Pahang,0,0,0
1/07/2022,India,Perak,643,542,101
1/07/2022,India,Perlis,117,101,16
1/07/2022,India,Pulau Pinang,659,464,195
1/07/2022,India,Sabah,180,119,61
1/07/2022,India,Sarawak,93,70,23
1/07/2022,India,Selangor,38269,28244,10025
1/07/2022,India,Terengganu,0,0,0
1/07/2022,India,W.P. Labuan,0,0,0
1/07/2022, British Indian Ocean Territory,Pulau Pinang,0,0,0
1/07/2022, British Indian Ocean Territory,Selangor,0,0,0
1/07/2022,Ireland,Johor,253,160,93
1/07/2022,Ireland,Kedah,21,11,10
1/07/2022,Ireland,Kelantan,0,0,0
1/07/2022,Ireland,Negeri Sembilan,0,0,0
1/07/2022,Ireland,Pahang,0,0,0
1/07/2022,Ireland,Perak,7,4,3
1/07/2022,Ireland,Perlis,8,1,7
1/07/2022,Ireland,Pulau Pinang,68,42,26
1/07/2022,Ireland,Sabah,18,8,10
1/07/2022,Ireland,Sarawak,14,8,6
1/07/2022,Ireland,Selangor,973,547,426
1/07/2022,Ireland,Terengganu,0,0,0
1/07/2022,Ireland,W.P. Labuan,0,0,0
1/07/2022,"Iran, Islamic Republic of",Johor,152,88,64
1/07/2022,"Iran, Islamic Republic of",Kedah,3,1,2
1/07/2022,"Iran, Islamic Republic of",Kelantan,0,0,0
1/07/2022,"Iran, Islamic Republic of",Perak,0,0,0
1/07/2022,"Iran, Islamic Republic of",Perlis,1,1,0
1/07/2022,"Iran, Islamic Republic of",Pulau Pinang,3,1,2
1/07/2022,"Iran, Islamic Republic of",Sabah,4,3,1
1/07/2022,"Iran, Islamic Republic of",Sarawak,1,1,0
1/07/2022,"Iran, Islamic Republic of",Selangor,1417,737,680
1/07/2022,"Iran, Islamic Republic of",W.P. Labuan,0,0,0
1/07/2022,Iraq,Johor,17,16,1
1/07/2022,Iraq,Kedah,0,0,0
1/07/2022,Iraq,Kelantan,0,0,0
1/07/2022,Iraq,Melaka,0,0,0
1/07/2022,Iraq,Pahang,0,0,0
1/07/2022,Iraq,Perak,0,0,0
1/07/2022,Iraq,Perlis,0,0,0
1/07/2022,Iraq,Pulau Pinang,0,0,0
1/07/2022,Iraq,Sabah,0,0,0
1/07/2022,Iraq,Sarawak,0,0,0
1/07/2022,Iraq,Selangor,672,393,279
1/07/2022,Iceland,Johor,0,0,0
1/07/2022,Iceland,Kedah,0,0,0
1/07/2022,Iceland,Kelantan,1,0,1
1/07/2022,Iceland,Perak,2,1,1
1/07/2022,Iceland,Perlis,0,0,0
1/07/2022,Iceland,Pulau Pinang,3,1,2
1/07/2022,Iceland,Sabah,0,0,0
1/07/2022,Iceland,Sarawak,4,2,2
1/07/2022,Iceland,Selangor,22,7,15
1/07/2022,Iceland,W.P. Labuan,0,0,0
1/07/2022,Israel,Pulau Pinang,0,0,0
1/07/2022,Italy,Johor,468,305,163
1/07/2022,Italy,Kedah,34,23,11
1/07/2022,Italy,Kelantan,0,0,0
1/07/2022,Italy,Melaka,0,0,0
1/07/2022,Italy,Negeri Sembilan,0,0,0
1/07/2022,Italy,Pahang,0,0,0
1/07/2022,Italy,Perak,2,2,0
1/07/2022,Italy,Perlis,9,4,5
1/07/2022,Italy,Pulau Pinang,81,54,27
1/07/2022,Italy,Sabah,29,15,14
1/07/2022,Italy,Sarawak,27,16,11
1/07/2022,Italy,Selangor,1936,1219,717
1/07/2022,Italy,W.P. Labuan,0,0,0
1/07/2022,Jamaica,Johor,0,0,0
1/07/2022,Jamaica,Kedah,0,0,0
1/07/2022,Jamaica,Perak,0,0,0
1/07/2022,Jamaica,Pulau Pinang,0,0,0
1/07/2022,Jamaica,Sabah,0,0,0
1/07/2022,Jamaica,Sarawak,0,0,0
1/07/2022,Jamaica,Selangor,5,4,1
1/07/2022,Jamaica,W.P. Labuan,0,0,0
1/07/2022,Jordan,Johor,15,10,5
1/07/2022,Jordan,Kedah,1,1,0
1/07/2022,Jordan,Kelantan,0,0,0
1/07/2022,Jordan,Melaka,0,0,0
1/07/2022,Jordan,Perlis,0,0,0
1/07/2022,Jordan,Pulau Pinang,9,5,4
1/07/2022,Jordan,Sabah,1,1,0
1/07/2022,Jordan,Sarawak,1,1,0
1/07/2022,Jordan,Selangor,602,378,224
1/07/2022,Jordan,W.P. Labuan,0,0,0
1/07/2022,Japan,Johor,4233,3059,1174
1/07/2022,Japan,Kedah,99,56,43
1/07/2022,Japan,Kelantan,3,1,2
1/07/2022,Japan,Melaka,1,1,0
1/07/2022,Japan,Negeri Sembilan,2,0,2
1/07/2022,Japan,Pahang,0,0,0
1/07/2022,Japan,Perak,10,6,4
1/07/2022,Japan,Perlis,10,9,1
1/07/2022,Japan,Pulau Pinang,666,457,209
1/07/2022,Japan,Sabah,182,104,78
1/07/2022,Japan,Sarawak,59,34,25
1/07/2022,Japan,Selangor,8192,5378,2814
1/07/2022,Japan,W.P. Labuan,0,0,0
1/07/2022,Kazakhstan,Johor,36,23,13
1/07/2022,Kazakhstan,Kedah,2,0,2
1/07/2022,Kazakhstan,Kelantan,1,1,0
1/07/2022,Kazakhstan,Melaka,0,0,0
1/07/2022,Kazakhstan,Perak,0,0,0
1/07/2022,Kazakhstan,Perlis,0,0,0
1/07/2022,Kazakhstan,Pulau Pinang,0,0,0
1/07/2022,Kazakhstan,Sabah,1,1,0
1/07/2022,Kazakhstan,Sarawak,0,0,0
1/07/2022,Kazakhstan,Selangor,290,129,161
1/07/2022,Kazakhstan,W.P. Labuan,0,0,0
1/07/2022,Kenya,Johor,15,6,9
1/07/2022,Kenya,Kedah,2,1,1
1/07/2022,Kenya,Kelantan,0,0,0
1/07/2022,Kenya,Perak,0,0,0
1/07/2022,Kenya,Perlis,1,1,0
1/07/2022,Kenya,Pulau Pinang,1,1,0
1/07/2022,Kenya,Sabah,0,0,0
1/07/2022,Kenya,Sarawak,0,0,0
1/07/2022,Kenya,Selangor,170,90,80
1/07/2022,Kyrgyzstan,Johor,7,3,4
1/07/2022,Kyrgyzstan,Kedah,0,0,0
1/07/2022,Kyrgyzstan,Kelantan,0,0,0
1/07/2022,Kyrgyzstan,Perak,0,0,0
1/07/2022,Kyrgyzstan,Perlis,0,0,0
1/07/2022,Kyrgyzstan,Pulau Pinang,0,0,0
1/07/2022,Kyrgyzstan,Sabah,0,0,0
1/07/2022,Kyrgyzstan,Sarawak,0,0,0
1/07/2022,Kyrgyzstan,Selangor,136,79,57
1/07/2022,Cambodia,Johor,1025,424,601
1/07/2022,Cambodia,Kedah,997,635,362
1/07/2022,Cambodia,Kelantan,216,124,92
1/07/2022,Cambodia,Melaka,1,0,1
1/07/2022,Cambodia,Negeri Sembilan,0,0,0
1/07/2022,Cambodia,Pahang,0,0,0
1/07/2022,Cambodia,Perak,17,16,1
1/07/2022,Cambodia,Perlis,312,223,89
1/07/2022,Cambodia,Pulau Pinang,39,16,23
1/07/2022,Cambodia,Sabah,2,0,2
1/07/2022,Cambodia,Sarawak,6,5,1
1/07/2022,Cambodia,Selangor,3060,1468,1592
1/07/2022,Cambodia,W.P. Labuan,0,0,0
1/07/2022,Kiribati,Johor,0,0,0
1/07/2022,Kiribati,Sabah,0,0,0
1/07/2022,Kiribati,Selangor,1,1,0
1/07/2022,Saint Kitts and Nevis,Johor,26,20,6
1/07/2022,Saint Kitts and Nevis,Kedah,0,0,0
1/07/2022,Saint Kitts and Nevis,Perlis,0,0,0
1/07/2022,Saint Kitts and Nevis,Pulau Pinang,0,0,0
1/07/2022,Saint Kitts and Nevis,Sabah,0,0,0
1/07/2022,Saint Kitts and Nevis,Selangor,60,38,22
1/07/2022,Saint Kitts and Nevis,W.P. Labuan,0,0,0
1/07/2022,"Korea, Republic of",Johor,8437,4798,3639
1/07/2022,"Korea, Republic of",Kedah,84,45,39
1/07/2022,"Korea, Republic of",Kelantan,0,0,0
1/07/2022,"Korea, Republic of",Melaka,0,0,0
1/07/2022,"Korea, Republic of",Negeri Sembilan,1,1,0
1/07/2022,"Korea, Republic of",Pahang,0,0,0
1/07/2022,"Korea, Republic of",Perak,15,9,6
1/07/2022,"Korea, Republic of",Perlis,29,23,6
1/07/2022,"Korea, Republic of",Pulau Pinang,416,218,198
1/07/2022,"Korea, Republic of",Sabah,8963,3888,5075
1/07/2022,"Korea, Republic of",Sarawak,103,60,43
1/07/2022,"Korea, Republic of",Selangor,8451,4763,3688
1/07/2022,"Korea, Republic of",Terengganu,0,0,0
1/07/2022,"Korea, Republic of",W.P. Labuan,0,0,0
1/07/2022,Kuwait,Johor,72,39,33
1/07/2022,Kuwait,Kedah,46,22,24
1/07/2022,Kuwait,Kelantan,0,0,0
1/07/2022,Kuwait,Perak,0,0,0
1/07/2022,Kuwait,Perlis,3,1,2
1/07/2022,Kuwait,Pulau Pinang,29,13,16
1/07/2022,Kuwait,Sabah,0,0,0
1/07/2022,Kuwait,Sarawak,0,0,0
1/07/2022,Kuwait,Selangor,782,410,372
1/07/2022,Kuwait,W.P. Labuan,0,0,0
1/07/2022, Lao People's Democratic Republic,Johor,55,17,38
1/07/2022, Lao People's Democratic Republic,Kedah,568,83,485
1/07/2022, Lao People's Democratic Republic,Kelantan,42,2,40
1/07/2022, Lao People's Democratic Republic,Melaka,0,0,0
1/07/2022, Lao People's Democratic Republic,Perak,1,1,0
1/07/2022, Lao People's Democratic Republic,Perlis,51,13,38
1/07/2022, Lao People's Democratic Republic,Pulau Pinang,53,32,21
1/07/2022, Lao People's Democratic Republic,Sabah,7,4,3
1/07/2022, Lao People's Democratic Republic,Sarawak,0,0,0
1/07/2022, Lao People's Democratic Republic,Selangor,305,93,212
1/07/2022, Lao People's Democratic Republic,W.P. Labuan,0,0,0
1/07/2022,Lebanon,Johor,8,5,3
1/07/2022,Lebanon,Kedah,0,0,0
1/07/2022,Lebanon,Kelantan,0,0,0
1/07/2022,Lebanon,Pahang,0,0,0
1/07/2022,Lebanon,Perak,0,0,0
1/07/2022,Lebanon,Perlis,0,0,0
1/07/2022,Lebanon,Pulau Pinang,1,1,0
1/07/2022,Lebanon,Sabah,0,0,0
1/07/2022,Lebanon,Sarawak,1,1,0
1/07/2022,Lebanon,Selangor,180,116,64
1/07/2022,Lebanon,W.P. Labuan,0,0,0
1/07/2022,Liberia,Johor,3,3,0
1/07/2022,Liberia,Kedah,0,0,0
1/07/2022,Liberia,Sabah,0,0,0
1/07/2022,Liberia,Sarawak,0,0,0
1/07/2022,Liberia,Selangor,3,3,0
1/07/2022,Libya,Johor,2,2,0
1/07/2022,Libya,Kedah,0,0,0
1/07/2022,Libya,Perlis,0,0,0
1/07/2022,Libya,Pulau Pinang,0,0,0
1/07/2022,Libya,Sabah,0,0,0
1/07/2022,Libya,Sarawak,0,0,0
1/07/2022,Libya,Selangor,138,91,47
1/07/2022,Saint Lucia,Johor,6,5,1
1/07/2022,Saint Lucia,Kedah,0,0,0
1/07/2022,Saint Lucia,Pulau Pinang,0,0,0
1/07/2022,Saint Lucia,Sarawak,0,0,0
1/07/2022,Saint Lucia,Selangor,2,2,0
1/07/2022,Liechtenstein,Johor,2,2,0
1/07/2022,Liechtenstein,Kedah,0,0,0
1/07/2022,Liechtenstein,Perlis,0,0,0
1/07/2022,Liechtenstein,Pulau Pinang,0,0,0
1/07/2022,Liechtenstein,Sabah,0,0,0
1/07/2022,Liechtenstein,Sarawak,0,0,0
1/07/2022,Liechtenstein,Selangor,2,2,0
1/07/2022,LKA,Johor,812,569,243
1/07/2022,LKA,Kedah,10,7,3
1/07/2022,LKA,Kelantan,0,0,0
1/07/2022,LKA,Melaka,0,0,0
1/07/2022,LKA,Pahang,0,0,0
1/07/2022,LKA,Perak,7,5,2
1/07/2022,LKA,Perlis,0,0,0
1/07/2022,LKA,Pulau Pinang,31,17,14
1/07/2022,LKA,Sabah,10,8,2
1/07/2022,LKA,Sarawak,9,6,3
1/07/2022,LKA,Selangor,2154,1314,840
1/07/2022,LKA,W.P. Labuan,0,0,0
1/07/2022,Lesotho,Johor,0,0,0
1/07/2022,Lesotho,Kedah,0,0,0
1/07/2022,Lesotho,Pulau Pinang,0,0,0
1/07/2022,Lesotho,Sarawak,0,0,0
1/07/2022,Lesotho,Selangor,8,4,4
1/07/2022,Lithuania,Johor,20,9,11
1/07/2022,Lithuania,Kedah,1,1,0
1/07/2022,Lithuania,Kelantan,0,0,0
1/07/2022,Lithuania,Pahang,0,0,0
1/07/2022,Lithuania,Perak,0,0,0
1/07/2022,Lithuania,Perlis,1,0,1
1/07/2022,Lithuania,Pulau Pinang,0,0,0
1/07/2022,Lithuania,Sabah,3,2,1
1/07/2022,Lithuania,Sarawak,1,1,0
1/07/2022,Lithuania,Selangor,102,53,49
1/07/2022,Lithuania,W.P. Labuan,0,0,0
1/07/2022,Luxembourg,Johor,13,7,6
1/07/2022,Luxembourg,Kedah,2,2,0
1/07/2022,Luxembourg,Kelantan,0,0,0
1/07/2022,Luxembourg,Perak,0,0,0
1/07/2022,Luxembourg,Perlis,0,0,0
1/07/2022,Luxembourg,Pulau Pinang,1,0,1
1/07/2022,Luxembourg,Sabah,0,0,0
1/07/2022,Luxembourg,Sarawak,1,1,0
1/07/2022,Luxembourg,Selangor,29,17,12
1/07/2022,Latvia,Johor,5,1,4
1/07/2022,Latvia,Kedah,0,0,0
1/07/2022,Latvia,Kelantan,0,0,0
1/07/2022,Latvia,Pahang,0,0,0
1/07/2022,Latvia,Perak,0,0,0
1/07/2022,Latvia,Perlis,0,0,0
1/07/2022,Latvia,Pulau Pinang,0,0,0
1/07/2022,Latvia,Sabah,4,0,4
1/07/2022,Latvia,Sarawak,1,1,0
1/07/2022,Latvia,Selangor,36,15,21
1/07/2022,Latvia,W.P. Labuan,0,0,0
1/07/2022,Macao,Johor,0,0,0
1/07/2022,Macao,Pahang,0,0,0
1/07/2022,Macao,Perak,0,0,0
1/07/2022,Macao,Selangor,0,0,0
1/07/2022,Macao,W.P. Labuan,0,0,0
1/07/2022,Morocco,Johor,58,38,20
1/07/2022,Morocco,Kedah,2,2,0
1/07/2022,Morocco,Kelantan,1,1,0
1/07/2022,Morocco,Melaka,0,0,0
1/07/2022,Morocco,Pahang,0,0,0
1/07/2022,Morocco,Perak,0,0,0
1/07/2022,Morocco,Perlis,2,2,0
1/07/2022,Morocco,Pulau Pinang,2,2,0
1/07/2022,Morocco,Sabah,3,1,2
1/07/2022,Morocco,Sarawak,4,3,1
1/07/2022,Morocco,Selangor,388,204,184
1/07/2022,Morocco,W.P. Labuan,0,0,0
1/07/2022,Monaco,Johor,0,0,0
1/07/2022,Monaco,Kedah,0,0,0
1/07/2022,Monaco,Sabah,0,0,0
1/07/2022,Monaco,Selangor,3,0,3
1/07/2022,"Moldova, Republic of",Johor,0,0,0
1/07/2022,"Moldova, Republic of",Kedah,0,0,0
1/07/2022,"Moldova, Republic of",Kelantan,0,0,0
1/07/2022,"Moldova, Republic of",Negeri Sembilan,0,0,0
1/07/2022,"Moldova, Republic of",Perlis,0,0,0
1/07/2022,"Moldova, Republic of",Pulau Pinang,1,0,1
1/07/2022,"Moldova, Republic of",Sabah,0,0,0
1/07/2022,"Moldova, Republic of",Sarawak,1,0,1
1/07/2022,"Moldova, Republic of",Selangor,6,4,2
1/07/2022,Madagascar,Johor,6,3,3
1/07/2022,Madagascar,Kedah,0,0,0
1/07/2022,Madagascar,Perak,0,0,0
1/07/2022,Madagascar,Perlis,0,0,0
1/07/2022,Madagascar,Pulau Pinang,0,0,0
1/07/2022,Madagascar,Sabah,0,0,0
1/07/2022,Madagascar,Sarawak,0,0,0
1/07/2022,Madagascar,Selangor,7,4,3
1/07/2022,Maldives,Johor,288,143,145
1/07/2022,Maldives,Kedah,1,1,0
1/07/2022,Maldives,Kelantan,1,1,0
1/07/2022,Maldives,Perak,0,0,0
1/07/2022,Maldives,Perlis,2,2,0
1/07/2022,Maldives,Pulau Pinang,11,6,5
1/07/2022,Maldives,Sabah,1,1,0
1/07/2022,Maldives,Sarawak,1,0,1
1/07/2022,Maldives,Selangor,4409,2055,2354
1/07/2022,Mexico,Johor,58,37,21
1/07/2022,Mexico,Kedah,10,6,4
1/07/2022,Mexico,Kelantan,0,0,0
1/07/2022,Mexico,Pahang,0,0,0
1/07/2022,Mexico,Perak,0,0,0
1/07/2022,Mexico,Perlis,0,0,0
1/07/2022,Mexico,Pulau Pinang,33,25,8
1/07/2022,Mexico,Sabah,3,1,2
1/07/2022,Mexico,Sarawak,0,0,0
1/07/2022,Mexico,Selangor,308,170,138
1/07/2022,Mexico,W.P. Labuan,0,0,0
1/07/2022,Marshall Islands,Johor,0,0,0
1/07/2022,Marshall Islands,Kedah,0,0,0
1/07/2022,Marshall Islands,Perak,0,0,0
1/07/2022,Marshall Islands,Pulau Pinang,1,1,0
1/07/2022,Marshall Islands,Sabah,0,0,0
1/07/2022,Marshall Islands,Selangor,1,1,0
1/07/2022,North Macedonia,Johor,4,3,1
1/07/2022,North Macedonia,Kedah,0,0,0
1/07/2022,North Macedonia,Perak,0,0,0
1/07/2022,North Macedonia,Pulau Pinang,0,0,0
1/07/2022,North Macedonia,Sabah,0,0,0
1/07/2022,North Macedonia,Sarawak,0,0,0
1/07/2022,North Macedonia,Selangor,5,2,3
1/07/2022,Mali,Johor,3,3,0
1/07/2022,Mali,Sabah,0,0,0
1/07/2022,Mali,Selangor,1,1,0
1/07/2022,Malta,Johor,5,3,2
1/07/2022,Malta,Kedah,8,4,4
1/07/2022,Malta,Kelantan,0,0,0
1/07/2022,Malta,Perak,0,0,0
1/07/2022,Malta,Perlis,0,0,0
1/07/2022,Malta,Pulau Pinang,3,3,0
1/07/2022,Malta,Sabah,1,1,0
1/07/2022,Malta,Sarawak,0,0,0
1/07/2022,Malta,Selangor,51,25,26
1/07/2022,Malta,W.P. Labuan,0,0,0
1/07/2022,Myanmar,Johor,2999,1040,1959
1/07/2022,Myanmar,Kedah,30,9,21
1/07/2022,Myanmar,Kelantan,1,1,0
1/07/2022,Myanmar,Negeri Sembilan,0,0,0
1/07/2022,Myanmar,Pahang,0,0,0
1/07/2022,Myanmar,Perak,16,6,10
1/07/2022,Myanmar,Perlis,5,2,3
1/07/2022,Myanmar,Pulau Pinang,89,35,54
1/07/2022,Myanmar,Sabah,12,7,5
1/07/2022,Myanmar,Sarawak,10,5,5
1/07/2022,Myanmar,Selangor,4649,2929,1720
1/07/2022,Myanmar,Terengganu,0,0,0
1/07/2022,Myanmar,W.P. Labuan,0,0,0
1/07/2022,Montenegro,Johor,0,0,0
1/07/2022,Montenegro,Kedah,0,0,0
1/07/2022,Montenegro,Pulau Pinang,0,0,0
1/07/2022,Montenegro,Sabah,0,0,0
1/07/2022,Montenegro,Sarawak,0,0,0
1/07/2022,Montenegro,Selangor,5,4,1
1/07/2022,Mongolia,Johor,128,51,77
1/07/2022,Mongolia,Kedah,0,0,0
1/07/2022,Mongolia,Kelantan,0,0,0
1/07/2022,Mongolia,Perak,0,0,0
1/07/2022,Mongolia,Perlis,0,0,0
1/07/2022,Mongolia,Pulau Pinang,11,4,7
1/07/2022,Mongolia,Sabah,6,3,3
1/07/2022,Mongolia,Sarawak,0,0,0
1/07/2022,Mongolia,Selangor,209,93,116
1/07/2022,Northern Mariana Islands,Selangor,0,0,0
1/07/2022,Mozambique,Johor,1,1,0
1/07/2022,Mozambique,Kedah,0,0,0
1/07/2022,Mozambique,Perak,0,0,0
1/07/2022,Mozambique,Pulau Pinang,0,0,0
1/07/2022,Mozambique,Sabah,0,0,0
1/07/2022,Mozambique,Sarawak,0,0,0
1/07/2022,Mozambique,Selangor,6,2,4
1/07/2022,Mauritania,Johor,9,9,0
1/07/2022,Mauritania,Kedah,0,0,0
1/07/2022,Mauritania,Pulau Pinang,0,0,0
1/07/2022,Mauritania,Sabah,0,0,0
1/07/2022,Mauritania,Sarawak,0,0,0
1/07/2022,Mauritania,Selangor,9,7,2
1/07/2022,Mauritius,Johor,69,37,32
1/07/2022,Mauritius,Kedah,0,0,0
1/07/2022,Mauritius,Kelantan,2,1,1
1/07/2022,Mauritius,Pahang,0,0,0
1/07/2022,Mauritius,Perak,0,0,0
1/07/2022,Mauritius,Perlis,1,1,0
1/07/2022,Mauritius,Pulau Pinang,6,4,2
1/07/2022,Mauritius,Sabah,0,0,0
1/07/2022,Mauritius,Sarawak,3,1,2
1/07/2022,Mauritius,Selangor,233,115,118
1/07/2022,Malawi,Johor,1,0,1
1/07/2022,Malawi,Pulau Pinang,0,0,0
1/07/2022,Malawi,Sabah,0,0,0
1/07/2022,Malawi,Sarawak,0,0,0
1/07/2022,Malawi,Selangor,11,9,2
1/07/2022,Mayotte,Selangor,0,0,0
1/07/2022,Namibia,Johor,1,0,1
1/07/2022,Namibia,Kedah,0,0,0
1/07/2022,Namibia,Perak,0,0,0
1/07/2022,Namibia,Perlis,0,0,0
1/07/2022,Namibia,Pulau Pinang,1,0,1
1/07/2022,Namibia,Sabah,0,0,0
1/07/2022,Namibia,Sarawak,0,0,0
1/07/2022,Namibia,Selangor,4,1,3
1/07/2022,New Caledonia,Selangor,0,0,0
1/07/2022,Niger,Johor,0,0,0
1/07/2022,Niger,Sabah,0,0,0
1/07/2022,Niger,Selangor,2,0,2
1/07/2022,Nigeria,Johor,13,11,2
1/07/2022,Nigeria,Kedah,1,1,0
1/07/2022,Nigeria,Perlis,0,0,0
1/07/2022,Nigeria,Pulau Pinang,4,3,1
1/07/2022,Nigeria,Sabah,0,0,0
1/07/2022,Nigeria,Sarawak,5,3,2
1/07/2022,Nigeria,Selangor,265,191,74
1/07/2022,Nicaragua,Johor,1,1,0
1/07/2022,Nicaragua,Kedah,0,0,0
1/07/2022,Nicaragua,Pulau Pinang,0,0,0
1/07/2022,Nicaragua,Sabah,0,0,0
1/07/2022,Nicaragua,Selangor,5,2,3
1/07/2022,Netherlands,Johor,1048,617,431
1/07/2022,Netherlands,Kedah,113,65,48
1/07/2022,Netherlands,Kelantan,5,2,3
1/07/2022,Netherlands,Melaka,0,0,0
1/07/2022,Netherlands,Negeri Sembilan,0,0,0
1/07/2022,Netherlands,Pahang,0,0,0
1/07/2022,Netherlands,Perak,18,8,10
1/07/2022,Netherlands,Perlis,27,16,11
1/07/2022,Netherlands,Pulau Pinang,207,122,85
1/07/2022,Netherlands,Sabah,107,52,55
1/07/2022,Netherlands,Sarawak,121,62,59
1/07/2022,Netherlands,Selangor,4552,2519,2033
1/07/2022,Netherlands,Terengganu,0,0,0
1/07/2022,Netherlands,W.P. Labuan,0,0,0
1/07/2022,Norway,Johor,186,125,61
1/07/2022,Norway,Kedah,28,15,13
1/07/2022,Norway,Kelantan,0,0,0
1/07/2022,Norway,Melaka,0,0,0
1/07/2022,Norway,Pahang,0,0,0
1/07/2022,Norway,Perak,0,0,0
1/07/2022,Norway,Perlis,1,0,1
1/07/2022,Norway,Pulau Pinang,31,17,14
1/07/2022,Norway,Sabah,27,17,10
1/07/2022,Norway,Sarawak,7,3,4
1/07/2022,Norway,Selangor,684,389,295
1/07/2022,Norway,W.P. Labuan,0,0,0
1/07/2022,Nepal,Johor,477,431,46
1/07/2022,Nepal,Kedah,2,1,1
1/07/2022,Nepal,Pahang,0,0,0
1/07/2022,Nepal,Perak,1,1,0
1/07/2022,Nepal,Perlis,1,1,0
1/07/2022,Nepal,Pulau Pinang,10,7,3
1/07/2022,Nepal,Sabah,17,12,5
1/07/2022,Nepal,Sarawak,1,1,0
1/07/2022,Nepal,Selangor,18711,17944,767
1/07/2022,Nepal,W.P. Labuan,0,0,0
1/07/2022,Nauru,Johor,0,0,0
1/07/2022,Nauru,Pulau Pinang,0,0,0
1/07/2022,Nauru,Selangor,1,0,1
1/07/2022,New Zealand,Johor,499,340,159
1/07/2022,New Zealand,Kedah,41,25,16
1/07/2022,New Zealand,Kelantan,1,1,0
1/07/2022,New Zealand,Melaka,0,0,0
1/07/2022,New Zealand,Negeri Sembilan,0,0,0
1/07/2022,New Zealand,Pahang,1,0,1
1/07/2022,New Zealand,Perak,15,13,2
1/07/2022,New Zealand,Perlis,3,2,1
1/07/2022,New Zealand,Pulau Pinang,115,62,53
1/07/2022,New Zealand,Sabah,60,35,25
1/07/2022,New Zealand,Sarawak,48,28,20
1/07/2022,New Zealand,Selangor,1564,905,659
1/07/2022,New Zealand,Terengganu,0,0,0
1/07/2022,New Zealand,W.P. Labuan,0,0,0
1/07/2022,Oman,Johor,204,91,113
1/07/2022,Oman,Kedah,4,1,3
1/07/2022,Oman,Kelantan,0,0,0
1/07/2022,Oman,Melaka,0,0,0
1/07/2022,Oman,Perak,0,0,0
1/07/2022,Oman,Perlis,1,1,0
1/07/2022,Oman,Pulau Pinang,8,5,3
1/07/2022,Oman,Sabah,0,0,0
1/07/2022,Oman,Sarawak,0,0,0
1/07/2022,Oman,Selangor,1212,638,574
1/07/2022,Pakistan,Johor,813,551,262
1/07/2022,Pakistan,Kedah,103,66,37
1/07/2022,Pakistan,Kelantan,12,12,0
1/07/2022,Pakistan,Melaka,1,1,0
1/07/2022,Pakistan,Negeri Sembilan,0,0,0
1/07/2022,Pakistan,Pahang,0,0,0
1/07/2022,Pakistan,Perak,1,1,0
1/07/2022,Pakistan,Perlis,5,5,0
1/07/2022,Pakistan,Pulau Pinang,24,18,6
1/07/2022,Pakistan,Sabah,17,11,6
1/07/2022,Pakistan,Sarawak,5,5,0
1/07/2022,Pakistan,Selangor,8292,6636,1656
1/07/2022,Pakistan,W.P. Labuan,0,0,0
1/07/2022,Panama,Johor,0,0,0
1/07/2022,Panama,Kedah,0,0,0
1/07/2022,Panama,Perak,0,0,0
1/07/2022,Panama,Perlis,0,0,0
1/07/2022,Panama,Pulau Pinang,2,1,1
1/07/2022,Panama,Sabah,0,0,0
1/07/2022,Panama,Sarawak,0,0,0
1/07/2022,Panama,Selangor,6,2,4
1/07/2022,Peru,Johor,27,14,13
1/07/2022,Peru,Kedah,2,2,0
1/07/2022,Peru,Kelantan,0,0,0
1/07/2022,Peru,Pahang,0,0,0
1/07/2022,Peru,Perak,0,0,0
1/07/2022,Peru,Perlis,0,0,0
1/07/2022,Peru,Pulau Pinang,0,0,0
1/07/2022,Peru,Sabah,0,0,0
1/07/2022,Peru,Sarawak,0,0,0
1/07/2022,Peru,Selangor,58,29,29
1/07/2022,Peru,W.P. Labuan,0,0,0
1/07/2022,Philippines,Johor,13058,4163,8895
1/07/2022,Philippines,Kedah,231,92,139
1/07/2022,Philippines,Kelantan,15,5,10
1/07/2022,Philippines,Melaka,2,1,1
1/07/2022,Philippines,Negeri Sembilan,0,0,0
1/07/2022,Philippines,Pahang,7,4,3
1/07/2022,Philippines,Perak,39,13,26
1/07/2022,Philippines,Perlis,122,35,87
1/07/2022,Philippines,Pulau Pinang,652,266,386
1/07/2022,Philippines,Sabah,597,222,375
1/07/2022,Philippines,Sarawak,178,96,82
1/07/2022,Philippines,Selangor,11204,4467,6737
1/07/2022,Philippines,Terengganu,0,0,0
1/07/2022,Philippines,W.P. Labuan,3,3,0
1/07/2022,Palau,Johor,0,0,0
1/07/2022,Palau,Pulau Pinang,0,0,0
1/07/2022,Palau,Selangor,1,1,0
1/07/2022,Papua New Guinea,Johor,10,7,3
1/07/2022,Papua New Guinea,Kedah,1,1,0
1/07/2022,Papua New Guinea,Kelantan,0,0,0
1/07/2022,Papua New Guinea,Perak,0,0,0
1/07/2022,Papua New Guinea,Pulau Pinang,0,0,0
1/07/2022,Papua New Guinea,Sabah,0,0,0
1/07/2022,Papua New Guinea,Sarawak,1,0,1
1/07/2022,Papua New Guinea,Selangor,46,31,15
1/07/2022,Poland,Johor,256,149,107
1/07/2022,Poland,Kedah,13,6,7
1/07/2022,Poland,Kelantan,0,0,0
1/07/2022,Poland,Melaka,0,0,0
1/07/2022,Poland,Negeri Sembilan,0,0,0
1/07/2022,Poland,Pahang,0,0,0
1/07/2022,Poland,Perak,1,0,1
1/07/2022,Poland,Perlis,8,6,2
1/07/2022,Poland,Pulau Pinang,24,11,13
1/07/2022,Poland,Sabah,37,19,18
1/07/2022,Poland,Sarawak,23,11,12
1/07/2022,Poland,Selangor,582,277,305
1/07/2022,Poland,Terengganu,0,0,0
1/07/2022,Poland,W.P. Labuan,0,0,0
1/07/2022,"North Korea, Democratic People's Republic of",Selangor,0,0,0
1/07/2022,Portugal,Johor,92,51,41
1/07/2022,Portugal,Kedah,9,5,4
1/07/2022,Portugal,Kelantan,0,0,0
1/07/2022,Portugal,Melaka,0,0,0
1/07/2022,Portugal,Pahang,0,0,0
1/07/2022,Portugal,Perak,4,3,1
1/07/2022,Portugal,Perlis,4,0,4
1/07/2022,Portugal,Pulau Pinang,22,17,5
1/07/2022,Portugal,Sabah,7,2,5
1/07/2022,Portugal,Sarawak,1,0,1
1/07/2022,Portugal,Selangor,575,305,270
1/07/2022,Portugal,W.P. Labuan,0,0,0
1/07/2022,Paraguay,Johor,4,3,1
1/07/2022,Paraguay,Kedah,0,0,0
1/07/2022,Paraguay,Perak,0,0,0
1/07/2022,Paraguay,Perlis,0,0,0
1/07/2022,Paraguay,Pulau Pinang,0,0,0
1/07/2022,Paraguay,Sabah,0,0,0
1/07/2022,Paraguay,Sarawak,0,0,0
1/07/2022,Paraguay,Selangor,5,3,2
1/07/2022,"Palestine, State of",Johor,3,2,1
1/07/2022,"Palestine, State of",Kedah,5,2,3
1/07/2022,"Palestine, State of",Kelantan,0,0,0
1/07/2022,"Palestine, State of",Melaka,0,0,0
1/07/2022,"Palestine, State of",Perak,0,0,0
1/07/2022,"Palestine, State of",Perlis,0,0,0
1/07/2022,"Palestine, State of",Pulau Pinang,0,0,0
1/07/2022,"Palestine, State of",Sabah,1,1,0
1/07/2022,"Palestine, State of",Sarawak,0,0,0
1/07/2022,"Palestine, State of",Selangor,224,143,81
1/07/2022,Qatar,Johor,75,33,42
1/07/2022,Qatar,Kedah,1,0,1
1/07/2022,Qatar,Perlis,0,0,0
1/07/2022,Qatar,Pulau Pinang,1,1,0
1/07/2022,Qatar,Sabah,0,0,0
1/07/2022,Qatar,Sarawak,0,0,0
1/07/2022,Qatar,Selangor,439,211,228
1/07/2022,Réunion,Johor,0,0,0
1/07/2022,Réunion,Sarawak,0,0,0
1/07/2022,Romania,Johor,107,55,52
1/07/2022,Romania,Kedah,2,1,1
1/07/2022,Romania,Kelantan,1,0,1
1/07/2022,Romania,Negeri Sembilan,0,0,0
1/07/2022,Romania,Pahang,0,0,0
1/07/2022,Romania,Perak,0,0,0
1/07/2022,Romania,Perlis,1,1,0
1/07/2022,Romania,Pulau Pinang,14,9,5
1/07/2022,Romania,Sabah,4,2,2
1/07/2022,Romania,Sarawak,1,0,1
1/07/2022,Romania,Selangor,297,177,120
1/07/2022,Romania,W.P. Labuan,0,0,0
1/07/2022,Russian Federation (Russia),Johor,271,139,132
1/07/2022,Russian Federation (Russia),Kedah,56,27,29
1/07/2022,Russian Federation (Russia),Kelantan,4,2,2
1/07/2022,Russian Federation (Russia),Melaka,1,1,0
1/07/2022,Russian Federation (Russia),Negeri Sembilan,0,0,0
1/07/2022,Russian Federation (Russia),Pahang,0,0,0
1/07/2022,Russian Federation (Russia),Perak,1,1,0
1/07/2022,Russian Federation (Russia),Perlis,6,2,4
1/07/2022,Russian Federation (Russia),Pulau Pinang,37,17,20
1/07/2022,Russian Federation (Russia),Sabah,22,8,14
1/07/2022,Russian Federation (Russia),Sarawak,8,3,5
1/07/2022,Russian Federation (Russia),Selangor,1664,861,803
1/07/2022,Russian Federation (Russia),W.P. Labuan,0,0,0
1/07/2022,Rwanda,Johor,1,1,0
1/07/2022,Rwanda,Kedah,0,0,0
1/07/2022,Rwanda,Pulau Pinang,0,0,0
1/07/2022,Rwanda,Selangor,1,1,0
1/07/2022,Saudi Arabia,Johor,255,145,110
1/07/2022,Saudi Arabia,Kedah,66,35,31
1/07/2022,Saudi Arabia,Kelantan,4,3,1
1/07/2022,Saudi Arabia,Melaka,0,0,0
1/07/2022,Saudi Arabia,Perak,3,2,1
1/07/2022,Saudi Arabia,Perlis,4,3,1
1/07/2022,Saudi Arabia,Pulau Pinang,67,28,39
1/07/2022,Saudi Arabia,Sabah,11,10,1
1/07/2022,Saudi Arabia,Sarawak,5,4,1
1/07/2022,Saudi Arabia,Selangor,9163,4578,4585
1/07/2022,Saudi Arabia,W.P. Labuan,0,0,0
1/07/2022,Sudan,Johor,8,5,3
1/07/2022,Sudan,Kedah,1,1,0
1/07/2022,Sudan,Kelantan,0,0,0
1/07/2022,Sudan,Perlis,0,0,0
1/07/2022,Sudan,Pulau Pinang,0,0,0
1/07/2022,Sudan,Sabah,0,0,0
1/07/2022,Sudan,Sarawak,0,0,0
1/07/2022,Sudan,Selangor,905,458,447
1/07/2022,Sudan,W.P. Labuan,0,0,0
1/07/2022,Senegal,Johor,0,0,0
1/07/2022,Senegal,Kedah,0,0,0
1/07/2022,Senegal,Kelantan,1,1,0
1/07/2022,Senegal,Perak,0,0,0
1/07/2022,Senegal,Perlis,0,0,0
1/07/2022,Senegal,Pulau Pinang,0,0,0
1/07/2022,Senegal,Sabah,0,0,0
1/07/2022,Senegal,Sarawak,1,1,0
1/07/2022,Senegal,Selangor,15,13,2
1/07/2022,Singapore,Johor,931641,555703,375938
1/07/2022,Singapore,Kedah,2168,1165,1003
1/07/2022,Singapore,Kelantan,25,13,12
1/07/2022,Singapore,Melaka,11,4,7
1/07/2022,Singapore,Negeri Sembilan,3,3,0
1/07/2022,Singapore,Pahang,39,31,8
1/07/2022,Singapore,Perak,3645,1723,1922
1/07/2022,Singapore,Perlis,55,36,19
1/07/2022,Singapore,Pulau Pinang,12524,6227,6297
1/07/2022,Singapore,Sabah,1941,1063,878
1/07/2022,Singapore,Sarawak,2439,1466,973
1/07/2022,Singapore,Selangor,25819,13936,11883
1/07/2022,Singapore,Terengganu,0,0,0
1/07/2022,Singapore,W.P. Labuan,0,0,0
1/07/2022,South Georgia and the South Sandwich Islands,Johor,0,0,0
1/07/2022,South Georgia and the South Sandwich Islands,Sabah,0,0,0
1/07/2022,South Georgia and the South Sandwich Islands,Selangor,1,1,0
1/07/2022,Saint Helena,Sarawak,0,0,0
1/07/2022,Solomon Islands,Johor,1,1,0
1/07/2022,Solomon Islands,Perlis,0,0,0
1/07/2022,Solomon Islands,Pulau Pinang,0,0,0
1/07/2022,Solomon Islands,Sabah,0,0,0
1/07/2022,Solomon Islands,Sarawak,0,0,0
1/07/2022,Solomon Islands,Selangor,6,3,3
1/07/2022,Solomon Islands,W.P. Labuan,0,0,0
1/07/2022,Sierra Leone,Johor,1,1,0
1/07/2022,Sierra Leone,Kedah,0,0,0
1/07/2022,Sierra Leone,Perak,0,0,0
1/07/2022,Sierra Leone,Pulau Pinang,1,1,0
1/07/2022,Sierra Leone,Sabah,0,0,0
1/07/2022,Sierra Leone,Selangor,13,11,2
1/07/2022,El Salvador,Johor,0,0,0
1/07/2022,El Salvador,Kedah,0,0,0
1/07/2022,El Salvador,Perak,0,0,0
1/07/2022,El Salvador,Perlis,0,0,0
1/07/2022,El Salvador,Pulau Pinang,1,1,0
1/07/2022,El Salvador,Sabah,0,0,0
1/07/2022,El Salvador,Selangor,0,0,0
1/07/2022,El Salvador,W.P. Labuan,0,0,0
1/07/2022,San Marino,Johor,0,0,0
1/07/2022,San Marino,Selangor,0,0,0
1/07/2022,Somalia,Johor,0,0,0
1/07/2022,Somalia,Kedah,0,0,0
1/07/2022,Somalia,Kelantan,0,0,0
1/07/2022,Somalia,Perlis,0,0,0
1/07/2022,Somalia,Sabah,0,0,0
1/07/2022,Somalia,Sarawak,0,0,0
1/07/2022,Somalia,Selangor,123,60,63
1/07/2022,Serbia,Johor,6,2,4
1/07/2022,Serbia,Kedah,0,0,0
1/07/2022,Serbia,Kelantan,1,1,0
1/07/2022,Serbia,Pahang,0,0,0
1/07/2022,Serbia,Perak,0,0,0
1/07/2022,Serbia,Perlis,0,0,0
1/07/2022,Serbia,Pulau Pinang,0,0,0
1/07/2022,Serbia,Sabah,0,0,0
1/07/2022,Serbia,Sarawak,0,0,0
1/07/2022,Serbia,Selangor,33,23,10
1/07/2022,South Sudan,Johor,0,0,0
1/07/2022,South Sudan,Kedah,0,0,0
1/07/2022,South Sudan,Sarawak,0,0,0
1/07/2022,South Sudan,Selangor,16,13,3
1/07/2022,South Sudan,W.P. Labuan,0,0,0
1/07/2022,Sao Tome and Principe,Selangor,1,0,1
1/07/2022,Suriname,Johor,1,1,0
1/07/2022,Suriname,Kedah,0,0,0
1/07/2022,Suriname,Kelantan,0,0,0
1/07/2022,Suriname,Perak,0,0,0
1/07/2022,Suriname,Perlis,0,0,0
1/07/2022,Suriname,Pulau Pinang,0,0,0
1/07/2022,Suriname,Sabah,0,0,0
1/07/2022,Suriname,Sarawak,0,0,0
1/07/2022,Suriname,Selangor,4,2,2
1/07/2022,Slovakia,Johor,21,11,10
1/07/2022,Slovakia,Kedah,39,20,19
1/07/2022,Slovakia,Kelantan,0,0,0
1/07/2022,Slovakia,Negeri Sembilan,0,0,0
1/07/2022,Slovakia,Pahang,0,0,0
1/07/2022,Slovakia,Perak,0,0,0
1/07/2022,Slovakia,Perlis,0,0,0
1/07/2022,Slovakia,Pulau Pinang,5,4,1
1/07/2022,Slovakia,Sabah,1,0,1
1/07/2022,Slovakia,Sarawak,2,0,2
1/07/2022,Slovakia,Selangor,216,117,99
1/07/2022,Slovakia,W.P. Labuan,0,0,0
1/07/2022,Slovenia,Johor,10,9,1
1/07/2022,Slovenia,Kedah,0,0,0
1/07/2022,Slovenia,Kelantan,1,1,0
1/07/2022,Slovenia,Perak,0,0,0
1/07/2022,Slovenia,Perlis,0,0,0
1/07/2022,Slovenia,Pulau Pinang,1,1,0
1/07/2022,Slovenia,Sabah,6,3,3
1/07/2022,Slovenia,Sarawak,9,6,3
1/07/2022,Slovenia,Selangor,80,50,30
1/07/2022,Slovenia,W.P. Labuan,0,0,0
1/07/2022,Sweden,Johor,166,107,59
1/07/2022,Sweden,Kedah,30,23,7
1/07/2022,Sweden,Kelantan,24,11,13
1/07/2022,Sweden,Melaka,0,0,0
1/07/2022,Sweden,Negeri Sembilan,0,0,0
1/07/2022,Sweden,Pahang,0,0,0
1/07/2022,Sweden,Perak,7,3,4
1/07/2022,Sweden,Perlis,11,8,3
1/07/2022,Sweden,Pulau Pinang,38,23,15
1/07/2022,Sweden,Sabah,33,21,12
1/07/2022,Sweden,Sarawak,8,5,3
1/07/2022,Sweden,Selangor,683,416,267
1/07/2022,Sweden,W.P. Labuan,0,0,0
1/07/2022,Eswatini,Johor,0,0,0
1/07/2022,Eswatini,Kedah,0,0,0
1/07/2022,Eswatini,Pulau Pinang,0,0,0
1/07/2022,Eswatini,Sabah,0,0,0
1/07/2022,Eswatini,Selangor,11,5,6
1/07/2022,Seychelles,Johor,1,0,1
1/07/2022,Seychelles,Kedah,0,0,0
1/07/2022,Seychelles,Pulau Pinang,0,0,0
1/07/2022,Seychelles,Sabah,0,0,0
1/07/2022,Seychelles,Sarawak,2,1,1
1/07/2022,Seychelles,Selangor,41,19,22
1/07/2022,Syrian Arab Republic,Johor,11,5,6
1/07/2022,Syrian Arab Republic,Kedah,0,0,0
1/07/2022,Syrian Arab Republic,Kelantan,0,0,0
1/07/2022,Syrian Arab Republic,Pahang,0,0,0
1/07/2022,Syrian Arab Republic,Perlis,0,0,0
1/07/2022,Syrian Arab Republic,Pulau Pinang,2,2,0
1/07/2022,Syrian Arab Republic,Sabah,0,0,0
1/07/2022,Syrian Arab Republic,Sarawak,4,2,2
1/07/2022,Syrian Arab Republic,Selangor,541,305,236
1/07/2022,Syrian Arab Republic,W.P. Labuan,0,0,0
1/07/2022,Turks and Caicos Islands,Perlis,0,0,0
1/07/2022,TCD,Johor,0,0,0
1/07/2022,TCD,Kedah,0,0,0
1/07/2022,TCD,Perlis,0,0,0
1/07/2022,TCD,Selangor,11,8,3
1/07/2022,Togo,Johor,0,0,0
1/07/2022,Togo,Perak,0,0,0
1/07/2022,Togo,Pulau Pinang,0,0,0
1/07/2022,Togo,Selangor,1,1,0
1/07/2022,Thailand,Johor,3762,904,2858
1/07/2022,Thailand,Kedah,44100,26582,17518
1/07/2022,Thailand,Kelantan,15453,7350,8103
1/07/2022,Thailand,Melaka,1,0,1
1/07/2022,Thailand,Negeri Sembilan,0,0,0
1/07/2022,Thailand,Pahang,9,9,0
1/07/2022,Thailand,Perak,5468,2425,3043
1/07/2022,Thailand,Perlis,49284,30984,18300
1/07/2022,Thailand,Pulau Pinang,1827,815,1012
1/07/2022,Thailand,Sabah,172,67,105
1/07/2022,Thailand,Sarawak,47,25,22
1/07/2022,Thailand,Selangor,8969,3690,5279
1/07/2022,Thailand,Terengganu,0,0,0
1/07/2022,Thailand,W.P. Labuan,0,0,0
1/07/2022,Tajikistan,Johor,0,0,0
1/07/2022,Tajikistan,Kedah,1,1,0
1/07/2022,Tajikistan,Perlis,0,0,0
1/07/2022,Tajikistan,Pulau Pinang,0,0,0
1/07/2022,Tajikistan,Sabah,1,1,0
1/07/2022,Tajikistan,Selangor,77,46,31
1/07/2022,Tokelau,Selangor,0,0,0
1/07/2022,Turkmenistan,Johor,1,1,0
1/07/2022,Turkmenistan,Kedah,0,0,0
1/07/2022,Turkmenistan,Kelantan,0,0,0
1/07/2022,Turkmenistan,Perlis,0,0,0
1/07/2022,Turkmenistan,Pulau Pinang,0,0,0
1/07/2022,Turkmenistan,Sabah,0,0,0
1/07/2022,Turkmenistan,Sarawak,0,0,0
1/07/2022,Turkmenistan,Selangor,71,37,34
1/07/2022,Timor-Leste,Johor,21,20,1
1/07/2022,Timor-Leste,Kedah,0,0,0
1/07/2022,Timor-Leste,Perlis,0,0,0
1/07/2022,Timor-Leste,Pulau Pinang,0,0,0
1/07/2022,Timor-Leste,Sabah,0,0,0
1/07/2022,Timor-Leste,Sarawak,0,0,0
1/07/2022,Timor-Leste,Selangor,457,311,146
1/07/2022,Tonga,Johor,1,0,1
1/07/2022,Tonga,Pulau Pinang,2,0,2
1/07/2022,Tonga,Sarawak,0,0,0
1/07/2022,Tonga,Selangor,6,2,4
1/07/2022,Trinidad and Tobago,Johor,2,0,2
1/07/2022,Trinidad and Tobago,Kedah,0,0,0
1/07/2022,Trinidad and Tobago,Pahang,0,0,0
1/07/2022,Trinidad and Tobago,Pulau Pinang,2,0,2
1/07/2022,Trinidad and Tobago,Sabah,0,0,0
1/07/2022,Trinidad and Tobago,Sarawak,0,0,0
1/07/2022,Trinidad and Tobago,Selangor,17,9,8
1/07/2022,Tunisia,Johor,2,1,1
1/07/2022,Tunisia,Kedah,0,0,0
1/07/2022,Tunisia,Kelantan,5,3,2
1/07/2022,Tunisia,Melaka,0,0,0
1/07/2022,Tunisia,Perak,0,0,0
1/07/2022,Tunisia,Perlis,0,0,0
1/07/2022,Tunisia,Pulau Pinang,0,0,0
1/07/2022,Tunisia,Sabah,2,2,0
1/07/2022,Tunisia,Sarawak,0,0,0
1/07/2022,Tunisia,Selangor,307,148,159
1/07/2022,Tunisia,W.P. Labuan,0,0,0
1/07/2022,Türkiye,Johor,200,130,70
1/07/2022,Türkiye,Kedah,10,6,4
1/07/2022,Türkiye,Kelantan,4,4,0
1/07/2022,Türkiye,Melaka,0,0,0
1/07/2022,Türkiye,Negeri Sembilan,0,0,0
1/07/2022,Türkiye,Pahang,0,0,0
1/07/2022,Türkiye,Perak,1,1,0
1/07/2022,Türkiye,Perlis,1,0,1
1/07/2022,Türkiye,Pulau Pinang,19,13,6
1/07/2022,Türkiye,Sabah,2,1,1
1/07/2022,Türkiye,Sarawak,3,2,1
1/07/2022,Türkiye,Selangor,748,463,285
1/07/2022,Türkiye,W.P. Labuan,0,0,0
1/07/2022,Tuvalu,Selangor,0,0,0
1/07/2022,"Taiwan, Province of China",Johor,2579,1126,1453
1/07/2022,"Taiwan, Province of China",Kedah,54,24,30
1/07/2022,"Taiwan, Province of China",Kelantan,0,0,0
1/07/2022,"Taiwan, Province of China",Melaka,0,0,0
1/07/2022,"Taiwan, Province of China",Negeri Sembilan,2,1,1
1/07/2022,"Taiwan, Province of China",Pahang,1,1,0
1/07/2022,"Taiwan, Province of China",Perak,29,16,13
1/07/2022,"Taiwan, Province of China",Perlis,0,0,0
1/07/2022,"Taiwan, Province of China",Pulau Pinang,493,277,216
1/07/2022,"Taiwan, Province of China",Sabah,39,18,21
1/07/2022,"Taiwan, Province of China",Sarawak,92,39,53
1/07/2022,"Taiwan, Province of China",Selangor,2075,1147,928
1/07/2022,"Taiwan, Province of China",W.P. Labuan,0,0,0
1/07/2022,"Tanzania, United Republic of",Johor,3,1,2
1/07/2022,"Tanzania, United Republic of",Kedah,0,0,0
1/07/2022,"Tanzania, United Republic of",Perak,0,0,0
1/07/2022,"Tanzania, United Republic of",Perlis,0,0,0
1/07/2022,"Tanzania, United Republic of",Pulau Pinang,0,0,0
1/07/2022,"Tanzania, United Republic of",Sabah,0,0,0
1/07/2022,"Tanzania, United Republic of",Sarawak,0,0,0
1/07/2022,"Tanzania, United Republic of",Selangor,75,31,44
1/07/2022,Uganda,Johor,10,6,4
1/07/2022,Uganda,Kedah,0,0,0
1/07/2022,Uganda,Perak,0,0,0
1/07/2022,Uganda,Perlis,0,0,0
1/07/2022,Uganda,Pulau Pinang,0,0,0
1/07/2022,Uganda,Sabah,0,0,0
1/07/2022,Uganda,Sarawak,0,0,0
1/07/2022,Uganda,Selangor,42,15,27
1/07/2022,Ukraine,Johor,89,51,38
1/07/2022,Ukraine,Kedah,7,1,6
1/07/2022,Ukraine,Kelantan,2,1,1
1/07/2022,Ukraine,Melaka,0,0,0
1/07/2022,Ukraine,Negeri Sembilan,0,0,0
1/07/2022,Ukraine,Pahang,0,0,0
1/07/2022,Ukraine,Perak,1,1,0
1/07/2022,Ukraine,Perlis,2,2,0
1/07/2022,Ukraine,Pulau Pinang,8,4,4
1/07/2022,Ukraine,Sabah,10,6,4
1/07/2022,Ukraine,Sarawak,2,0,2
1/07/2022,Ukraine,Selangor,359,182,177
1/07/2022,Ukraine,W.P. Labuan,0,0,0
1/07/2022,Uruguay,Johor,8,2,6
1/07/2022,Uruguay,Kedah,1,1,0
1/07/2022,Uruguay,Kelantan,0,0,0
1/07/2022,Uruguay,Perak,0,0,0
1/07/2022,Uruguay,Perlis,0,0,0
1/07/2022,Uruguay,Pulau Pinang,0,0,0
1/07/2022,Uruguay,Sabah,1,1,0
1/07/2022,Uruguay,Sarawak,0,0,0
1/07/2022,Uruguay,Selangor,23,16,7
1/07/2022,Uruguay,W.P. Labuan,0,0,0
1/07/2022,United States of America,Johor,3361,2020,1341
1/07/2022,United States of America,Kedah,237,138,99
1/07/2022,United States of America,Kelantan,16,12,4
1/07/2022,United States of America,Melaka,7,5,2
1/07/2022,United States of America,Negeri Sembilan,0,0,0
1/07/2022,United States of America,Pahang,0,0,0
1/07/2022,United States of America,Perak,122,65,57
1/07/2022,United States of America,Perlis,34,25,9
1/07/2022,United States of America,Pulau Pinang,1364,833,531
1/07/2022,United States of America,Sabah,308,171,137
1/07/2022,United States of America,Sarawak,173,94,79
1/07/2022,United States of America,Selangor,10431,5972,4459
1/07/2022,United States of America,Terengganu,0,0,0
1/07/2022,United States of America,W.P. Labuan,0,0,0
1/07/2022,Uzbekistan,Johor,25,17,8
1/07/2022,Uzbekistan,Kedah,18,10,8
1/07/2022,Uzbekistan,Kelantan,0,0,0
1/07/2022,Uzbekistan,Perak,0,0,0
1/07/2022,Uzbekistan,Perlis,0,0,0
1/07/2022,Uzbekistan,Pulau Pinang,6,1,5
1/07/2022,Uzbekistan,Sabah,46,45,1
1/07/2022,Uzbekistan,Sarawak,0,0,0
1/07/2022,Uzbekistan,Selangor,514,251,263
1/07/2022,Holy See,Johor,1,1,0
1/07/2022,Holy See,Sarawak,0,0,0
1/07/2022,Holy See,Selangor,0,0,0
1/07/2022,Saint Vincent and the Grenadines,Johor,0,0,0
1/07/2022,Saint Vincent and the Grenadines,Kedah,0,0,0
1/07/2022,Saint Vincent and the Grenadines,Pulau Pinang,0,0,0
1/07/2022,Saint Vincent and the Grenadines,Sarawak,0,0,0
1/07/2022,Saint Vincent and the Grenadines,Selangor,0,0,0
1/07/2022,"Venezuela, Bolivarian Republic of",Johor,4,2,2
1/07/2022,"Venezuela, Bolivarian Republic of",Kedah,0,0,0
1/07/2022,"Venezuela, Bolivarian Republic of",Kelantan,0,0,0
1/07/2022,"Venezuela, Bolivarian Republic of",Melaka,0,0,0
1/07/2022,"Venezuela, Bolivarian Republic of",Perak,0,0,0
1/07/2022,"Venezuela, Bolivarian Republic of",Perlis,0,0,0
1/07/2022,"Venezuela, Bolivarian Republic of",Pulau Pinang,0,0,0
1/07/2022,"Venezuela, Bolivarian Republic of",Sabah,1,1,0
1/07/2022,"Venezuela, Bolivarian Republic of",Sarawak,0,0,0
1/07/2022,"Venezuela, Bolivarian Republic of",Selangor,33,18,15
1/07/2022,"Venezuela, Bolivarian Republic of",W.P. Labuan,0,0,0
1/07/2022,Viet Nam,Johor,15197,5214,9983
1/07/2022,Viet Nam,Kedah,328,43,285
1/07/2022,Viet Nam,Kelantan,3,2,1
1/07/2022,Viet Nam,Melaka,0,0,0
1/07/2022,Viet Nam,Negeri Sembilan,0,0,0
1/07/2022,Viet Nam,Pahang,1,1,0
1/07/2022,Viet Nam,Perak,86,7,79
1/07/2022,Viet Nam,Perlis,19,6,13
1/07/2022,Viet Nam,Pulau Pinang,1102,306,796
1/07/2022,Viet Nam,Sabah,17,3,14
1/07/2022,Viet Nam,Sarawak,35,7,28
1/07/2022,Viet Nam,Selangor,10851,3555,7296
1/07/2022,Viet Nam,Terengganu,0,0,0
1/07/2022,Viet Nam,W.P. Labuan,0,0,0
1/07/2022,Vanuatu,Johor,14,11,3
1/07/2022,Vanuatu,Kedah,0,0,0
1/07/2022,Vanuatu,Pulau Pinang,2,2,0
1/07/2022,Vanuatu,Sabah,0,0,0
1/07/2022,Vanuatu,Sarawak,0,0,0
1/07/2022,Vanuatu,Selangor,19,16,3
1/07/2022, Samoa,Johor,0,0,0
1/07/2022, Samoa,Sarawak,0,0,0
1/07/2022, Samoa,Selangor,1,1,0
1/07/2022,Yemen,Johor,34,22,12
1/07/2022,Yemen,Kedah,7,3,4
1/07/2022,Yemen,Kelantan,1,1,0
1/07/2022,Yemen,Melaka,4,2,2
1/07/2022,Yemen,Pahang,0,0,0
1/07/2022,Yemen,Perak,0,0,0
1/07/2022,Yemen,Perlis,3,3,0
1/07/2022,Yemen,Pulau Pinang,3,2,1
1/07/2022,Yemen,Sabah,1,1,0
1/07/2022,Yemen,Sarawak,0,0,0
1/07/2022,Yemen,Selangor,1148,724,424
1/07/2022,Yemen,W.P. Labuan,0,0,0
1/07/2022,South Africa,Johor,194,100,94
1/07/2022,South Africa,Kedah,20,8,12
1/07/2022,South Africa,Kelantan,1,1,0
1/07/2022,South Africa,Melaka,0,0,0
1/07/2022,South Africa,Pahang,0,0,0
1/07/2022,South Africa,Perak,2,2,0
1/07/2022,South Africa,Perlis,12,10,2
1/07/2022,South Africa,Pulau Pinang,32,16,16
1/07/2022,South Africa,Sabah,18,10,8
1/07/2022,South Africa,Sarawak,38,20,18
1/07/2022,South Africa,Selangor,643,384,259
1/07/2022,South Africa,Terengganu,0,0,0
1/07/2022,South Africa,W.P. Labuan,0,0,0
1/07/2022,ZAR,Selangor,0,0,0
1/07/2022,Zambia,Johor,2,2,0
1/07/2022,Zambia,Kedah,0,0,0
1/07/2022,Zambia,Perak,0,0,0
1/07/2022,Zambia,Perlis,0,0,0
1/07/2022,Zambia,Pulau Pinang,1,0,1
1/07/2022,Zambia,Sabah,0,0,0
1/07/2022,Zambia,Sarawak,0,0,0
1/07/2022,Zambia,Selangor,19,13,6
1/07/2022,Zimbabwe,Johor,10,5,5
1/07/2022,Zimbabwe,Kedah,5,3,2
1/07/2022,Zimbabwe,Kelantan,0,0,0
1/07/2022,Zimbabwe,Perak,0,0,0
1/07/2022,Zimbabwe,Perlis,1,0,1
1/07/2022,Zimbabwe,Pulau Pinang,2,0,2
1/07/2022,Zimbabwe,Sabah,0,0,0
1/07/2022,Zimbabwe,Sarawak,0,0,0
1/07/2022,Zimbabwe,Selangor,94,49,45
1/08/2022,Aruba,Kedah,0,0,0
1/08/2022,Aruba,Pulau Pinang,0,0,0
1/08/2022,Afghanistan,Johor,0,0,0
1/08/2022,Afghanistan,Kedah,0,0,0
1/08/2022,Afghanistan,Perlis,0,0,0
1/08/2022,Afghanistan,Pulau Pinang,0,0,0
1/08/2022,Afghanistan,Sarawak,0,0,0
1/08/2022,Afghanistan,Selangor,74,50,24
1/08/2022,Angola,Johor,0,0,0
1/08/2022,Angola,Kedah,0,0,0
1/08/2022,Angola,Sabah,0,0,0
1/08/2022,Angola,Selangor,0,0,0
1/08/2022,Anguilla,Selangor,0,0,0
1/08/2022,Albania,Johor,17,12,5
1/08/2022,Albania,Kedah,1,1,0
1/08/2022,Albania,Perak,0,0,0
1/08/2022,Albania,Perlis,0,0,0
1/08/2022,Albania,Pulau Pinang,1,0,1
1/08/2022,Albania,Sabah,0,0,0
1/08/2022,Albania,Sarawak,0,0,0
1/08/2022,Albania,Selangor,35,22,13
1/08/2022,Andorra,Johor,1,0,1
1/08/2022,Andorra,Kedah,0,0,0
1/08/2022,Andorra,Perlis,2,0,2
1/08/2022,Andorra,Pulau Pinang,0,0,0
1/08/2022,Andorra,Selangor,2,2,0
1/08/2022,Antigua and Barbuda,Selangor,0,0,0
1/08/2022,United Arab Emirates,Johor,37,23,14
1/08/2022,United Arab Emirates,Kedah,3,3,0
1/08/2022,United Arab Emirates,Kelantan,0,0,0
1/08/2022,United Arab Emirates,Perak,0,0,0
1/08/2022,United Arab Emirates,Perlis,0,0,0
1/08/2022,United Arab Emirates,Pulau Pinang,0,0,0
1/08/2022,United Arab Emirates,Sabah,0,0,0
1/08/2022,United Arab Emirates,Sarawak,0,0,0
1/08/2022,United Arab Emirates,Selangor,605,313,292
1/08/2022,Argentina,Johor,44,23,21
1/08/2022,Argentina,Kedah,13,9,4
1/08/2022,Argentina,Kelantan,2,1,1
1/08/2022,Argentina,Melaka,0,0,0
1/08/2022,Argentina,Perak,0,0,0
1/08/2022,Argentina,Perlis,1,0,1
1/08/2022,Argentina,Pulau Pinang,2,2,0
1/08/2022,Argentina,Sabah,2,2,0
1/08/2022,Argentina,Sarawak,2,1,1
1/08/2022,Argentina,Selangor,193,106,87
1/08/2022,Argentina,W.P. Labuan,0,0,0
1/08/2022,Armenia,Johor,6,3,3
1/08/2022,Armenia,Kedah,1,1,0
1/08/2022,Armenia,Kelantan,0,0,0
1/08/2022,Armenia,Perak,0,0,0
1/08/2022,Armenia,Perlis,0,0,0
1/08/2022,Armenia,Pulau Pinang,0,0,0
1/08/2022,Armenia,Sabah,0,0,0
1/08/2022,Armenia,Sarawak,0,0,0
1/08/2022,Armenia,Selangor,15,8,7
1/08/2022,Antarctica,Selangor,0,0,0
1/08/2022,Antigua and Barbuda,Johor,4,3,1
1/08/2022,Antigua and Barbuda,Kedah,3,0,3
1/08/2022,Antigua and Barbuda,Pulau Pinang,0,0,0
1/08/2022,Antigua and Barbuda,Sarawak,0,0,0
1/08/2022,Antigua and Barbuda,Selangor,13,10,3
1/08/2022,Australia,Johor,3198,1924,1274
1/08/2022,Australia,Kedah,333,194,139
1/08/2022,Australia,Kelantan,7,5,2
1/08/2022,Australia,Melaka,9,6,3
1/08/2022,Australia,Negeri Sembilan,0,0,0
1/08/2022,Australia,Pahang,1,1,0
1/08/2022,Australia,Perak,144,78,66
1/08/2022,Australia,Perlis,30,23,7
1/08/2022,Australia,Pulau Pinang,1286,716,570
1/08/2022,Australia,Sabah,312,164,148
1/08/2022,Australia,Sarawak,450,244,206
1/08/2022,Australia,Selangor,11071,6783,4288
1/08/2022,Australia,Terengganu,0,0,0
1/08/2022,Australia,W.P. Labuan,2,2,0
1/08/2022,Austria,Johor,154,96,58
1/08/2022,Austria,Kedah,37,18,19
1/08/2022,Austria,Kelantan,0,0,0
1/08/2022,Austria,Melaka,3,2,1
1/08/2022,Austria,Negeri Sembilan,0,0,0
1/08/2022,Austria,Pahang,0,0,0
1/08/2022,Austria,Perak,1,0,1
1/08/2022,Austria,Perlis,15,9,6
1/08/2022,Austria,Pulau Pinang,62,45,17
1/08/2022,Austria,Sabah,22,15,7
1/08/2022,Austria,Sarawak,19,13,6
1/08/2022,Austria,Selangor,673,413,260
1/08/2022,Austria,Terengganu,0,0,0
1/08/2022,Austria,W.P. Labuan,0,0,0
1/08/2022,Azerbaijan,Johor,4,3,1
1/08/2022,Azerbaijan,Kedah,5,3,2
1/08/2022,Azerbaijan,Kelantan,0,0,0
1/08/2022,Azerbaijan,Melaka,0,0,0
1/08/2022,Azerbaijan,Perlis,0,0,0
1/08/2022,Azerbaijan,Pulau Pinang,0,0,0
1/08/2022,Azerbaijan,Sabah,1,1,0
1/08/2022,Azerbaijan,Sarawak,0,0,0
1/08/2022,Azerbaijan,Selangor,104,47,57
1/08/2022,Azerbaijan,W.P. Labuan,0,0,0
1/08/2022,Burundi,Pulau Pinang,0,0,0
1/08/2022,Burundi,Sarawak,0,0,0
1/08/2022,Burundi,Selangor,4,2,2
1/08/2022,Belgium,Johor,226,147,79
1/08/2022,Belgium,Kedah,12,7,5
1/08/2022,Belgium,Kelantan,0,0,0
1/08/2022,Belgium,Melaka,0,0,0
1/08/2022,Belgium,Negeri Sembilan,1,1,0
1/08/2022,Belgium,Pahang,6,4,2
1/08/2022,Belgium,Perak,7,2,5
1/08/2022,Belgium,Perlis,9,6,3
1/08/2022,Belgium,Pulau Pinang,68,46,22
1/08/2022,Belgium,Sabah,16,10,6
1/08/2022,Belgium,Sarawak,29,16,13
1/08/2022,Belgium,Selangor,1002,563,439
1/08/2022,Belgium,W.P. Labuan,0,0,0
1/08/2022,Benin,Johor,1,1,0
1/08/2022,Benin,Kedah,0,0,0
1/08/2022,Benin,Perak,0,0,0
1/08/2022,Benin,Pulau Pinang,0,0,0
1/08/2022,Benin,Sabah,0,0,0
1/08/2022,Benin,Sarawak,0,0,0
1/08/2022,Benin,Selangor,5,4,1
1/08/2022,Burkina Faso,Perak,0,0,0
1/08/2022,Burkina Faso,Pulau Pinang,0,0,0
1/08/2022,Burkina Faso,Selangor,1,1,0
1/08/2022,Bangladesh,Johor,1521,1228,293
1/08/2022,Bangladesh,Kedah,33,25,8
1/08/2022,Bangladesh,Kelantan,0,0,0
1/08/2022,Bangladesh,Melaka,0,0,0
1/08/2022,Bangladesh,Negeri Sembilan,0,0,0
1/08/2022,Bangladesh,Pahang,0,0,0
1/08/2022,Bangladesh,Perak,0,0,0
1/08/2022,Bangladesh,Perlis,2,2,0
1/08/2022,Bangladesh,Pulau Pinang,160,150,10
1/08/2022,Bangladesh,Sabah,1,1,0
1/08/2022,Bangladesh,Sarawak,19,12,7
1/08/2022,Bangladesh,Selangor,24441,22429,2012
1/08/2022,Bangladesh,W.P. Labuan,2,2,0
1/08/2022,Bulgaria,Johor,39,20,19
1/08/2022,Bulgaria,Kedah,4,1,3
1/08/2022,Bulgaria,Kelantan,0,0,0
1/08/2022,Bulgaria,Pahang,0,0,0
1/08/2022,Bulgaria,Perak,0,0,0
1/08/2022,Bulgaria,Perlis,0,0,0
1/08/2022,Bulgaria,Pulau Pinang,1,1,0
1/08/2022,Bulgaria,Sabah,0,0,0
1/08/2022,Bulgaria,Sarawak,9,2,7
1/08/2022,Bulgaria,Selangor,146,88,58
1/08/2022,Bulgaria,W.P. Labuan,0,0,0
1/08/2022,Bahrain,Johor,42,23,19
1/08/2022,Bahrain,Kedah,3,1,2
1/08/2022,Bahrain,Kelantan,0,0,0
1/08/2022,Bahrain,Perlis,0,0,0
1/08/2022,Bahrain,Pulau Pinang,0,0,0
1/08/2022,Bahrain,Sabah,1,1,0
1/08/2022,Bahrain,Sarawak,4,4,0
1/08/2022,Bahrain,Selangor,233,101,132
1/08/2022,Bahamas,Johor,8,4,4
1/08/2022,Bahamas,Kedah,0,0,0
1/08/2022,Bahamas,Perak,0,0,0
1/08/2022,Bahamas,Sabah,0,0,0
1/08/2022,Bahamas,Sarawak,1,0,1
1/08/2022,Bahamas,Selangor,4,1,3
1/08/2022,Bosnia and Herzegovina,Johor,21,11,10
1/08/2022,Bosnia and Herzegovina,Kedah,1,1,0
1/08/2022,Bosnia and Herzegovina,Perlis,0,0,0
1/08/2022,Bosnia and Herzegovina,Pulau Pinang,0,0,0
1/08/2022,Bosnia and Herzegovina,Sabah,0,0,0
1/08/2022,Bosnia and Herzegovina,Sarawak,2,2,0
1/08/2022,Bosnia and Herzegovina,Selangor,45,27,18
1/08/2022,Belarus,Johor,5,3,2
1/08/2022,Belarus,Kedah,3,2,1
1/08/2022,Belarus,Kelantan,0,0,0
1/08/2022,Belarus,Pahang,0,0,0
1/08/2022,Belarus,Perak,0,0,0
1/08/2022,Belarus,Perlis,0,0,0
1/08/2022,Belarus,Pulau Pinang,2,0,2
1/08/2022,Belarus,Sabah,1,1,0
1/08/2022,Belarus,Sarawak,0,0,0
1/08/2022,Belarus,Selangor,105,50,55
1/08/2022,Belarus,W.P. Labuan,0,0,0
1/08/2022,Belize,Johor,0,0,0
1/08/2022,Belize,Pulau Pinang,0,0,0
1/08/2022,Belize,Sarawak,3,2,1
1/08/2022,Belize,Selangor,4,3,1
1/08/2022,Bermuda,Selangor,0,0,0
1/08/2022,Bolivia,Johor,2,1,1
1/08/2022,Bolivia,Kedah,0,0,0
1/08/2022,Bolivia,Melaka,0,0,0
1/08/2022,Bolivia,Perak,0,0,0
1/08/2022,Bolivia,Perlis,0,0,0
1/08/2022,Bolivia,Pulau Pinang,0,0,0
1/08/2022,Bolivia,Sabah,0,0,0
1/08/2022,Bolivia,Sarawak,2,0,2
1/08/2022,Bolivia,Selangor,15,9,6
1/08/2022,Brazil,Johor,170,102,68
1/08/2022,Brazil,Kedah,23,11,12
1/08/2022,Brazil,Kelantan,0,0,0
1/08/2022,Brazil,Melaka,0,0,0
1/08/2022,Brazil,Pahang,0,0,0
1/08/2022,Brazil,Perak,2,1,1
1/08/2022,Brazil,Perlis,8,3,5
1/08/2022,Brazil,Pulau Pinang,12,4,8
1/08/2022,Brazil,Sabah,10,4,6
1/08/2022,Brazil,Sarawak,3,2,1
1/08/2022,Brazil,Selangor,662,360,302
1/08/2022,Brazil,W.P. Labuan,0,0,0
1/08/2022,Barbados,Johor,1,0,1
1/08/2022,Barbados,Kedah,0,0,0
1/08/2022,Barbados,Perlis,1,0,1
1/08/2022,Barbados,Pulau Pinang,1,1,0
1/08/2022,Barbados,Selangor,5,4,1
1/08/2022,Brunei Darussalam,Johor,184,100,84
1/08/2022,Brunei Darussalam,Kedah,2,1,1
1/08/2022,Brunei Darussalam,Kelantan,0,0,0
1/08/2022,Brunei Darussalam,Melaka,0,0,0
1/08/2022,Brunei Darussalam,Pahang,0,0,0
1/08/2022,Brunei Darussalam,Perak,1,0,1
1/08/2022,Brunei Darussalam,Perlis,9,6,3
1/08/2022,Brunei Darussalam,Pulau Pinang,20,9,11
1/08/2022,Brunei Darussalam,Sabah,655,307,348
1/08/2022,Brunei Darussalam,Sarawak,32245,17935,14310
1/08/2022,Brunei Darussalam,Selangor,3362,1746,1616
1/08/2022,Brunei Darussalam,W.P. Labuan,475,278,197
1/08/2022,Bhutan,Johor,2,2,0
1/08/2022,Bhutan,Kedah,0,0,0
1/08/2022,Bhutan,Perak,0,0,0
1/08/2022,Bhutan,Perlis,0,0,0
1/08/2022,Bhutan,Pulau Pinang,3,1,2
1/08/2022,Bhutan,Sabah,0,0,0
1/08/2022,Bhutan,Sarawak,0,0,0
1/08/2022,Bhutan,Selangor,38,29,9
1/08/2022,Botswana,Johor,0,0,0
1/08/2022,Botswana,Kedah,1,0,1
1/08/2022,Botswana,Perlis,0,0,0
1/08/2022,Botswana,Pulau Pinang,0,0,0
1/08/2022,Botswana,Sabah,0,0,0
1/08/2022,Botswana,Sarawak,0,0,0
1/08/2022,Botswana,Selangor,10,4,6
1/08/2022,Central African Republic,Kedah,0,0,0
1/08/2022,Central African Republic,Selangor,0,0,0
1/08/2022,Canada,Johor,902,521,381
1/08/2022,Canada,Kedah,84,51,33
1/08/2022,Canada,Kelantan,11,5,6
1/08/2022,Canada,Melaka,0,0,0
1/08/2022,Canada,Negeri Sembilan,0,0,0
1/08/2022,Canada,Pahang,0,0,0
1/08/2022,Canada,Perak,21,14,7
1/08/2022,Canada,Perlis,31,19,12
1/08/2022,Canada,Pulau Pinang,219,123,96
1/08/2022,Canada,Sabah,74,34,40
1/08/2022,Canada,Sarawak,164,100,64
1/08/2022,Canada,Selangor,2708,1575,1133
1/08/2022,Canada,Terengganu,0,0,0
1/08/2022,Canada,W.P. Labuan,0,0,0
1/08/2022,Cocos (Keeling) Islands,Selangor,0,0,0
1/08/2022,Switzerland,Johor,347,221,126
1/08/2022,Switzerland,Kedah,45,24,21
1/08/2022,Switzerland,Kelantan,4,2,2
1/08/2022,Switzerland,Melaka,4,2,2
1/08/2022,Switzerland,Negeri Sembilan,2,1,1
1/08/2022,Switzerland,Pahang,0,0,0
1/08/2022,Switzerland,Perak,5,4,1
1/08/2022,Switzerland,Perlis,28,14,14
1/08/2022,Switzerland,Pulau Pinang,81,55,26
1/08/2022,Switzerland,Sabah,30,16,14
1/08/2022,Switzerland,Sarawak,21,10,11
1/08/2022,Switzerland,Selangor,993,602,391
1/08/2022,Switzerland,W.P. Labuan,0,0,0
1/08/2022,Chile,Johor,26,14,12
1/08/2022,Chile,Kedah,5,1,4
1/08/2022,Chile,Kelantan,0,0,0
1/08/2022,Chile,Melaka,0,0,0
1/08/2022,Chile,Pahang,0,0,0
1/08/2022,Chile,Perak,0,0,0
1/08/2022,Chile,Perlis,14,8,6
1/08/2022,Chile,Pulau Pinang,4,3,1
1/08/2022,Chile,Sabah,2,1,1
1/08/2022,Chile,Sarawak,0,0,0
1/08/2022,Chile,Selangor,101,58,43
1/08/2022,China,Johor,18386,7559,10827
1/08/2022,China,Kedah,290,132,158
1/08/2022,China,Kelantan,6,3,3
1/08/2022,China,Melaka,0,0,0
1/08/2022,China,Pahang,1,1,0
1/08/2022,China,Perak,139,64,75
1/08/2022,China,Perlis,26,13,13
1/08/2022,China,Pulau Pinang,1086,501,585
1/08/2022,China,Sabah,272,104,168
1/08/2022,China,Sarawak,246,113,133
1/08/2022,China,Selangor,11847,7049,4798
1/08/2022,China,Terengganu,0,0,0
1/08/2022,China,W.P. Labuan,2,0,2
1/08/2022,Côte d'Ivoire,Johor,1,0,1
1/08/2022,Côte d'Ivoire,Kedah,2,0,2
1/08/2022,Côte d'Ivoire,Pulau Pinang,0,0,0
1/08/2022,Côte d'Ivoire,Sabah,0,0,0
1/08/2022,Côte d'Ivoire,Sarawak,0,0,0
1/08/2022,Côte d'Ivoire,Selangor,16,10,6
1/08/2022,Cameroon,Johor,1,1,0
1/08/2022,Cameroon,Kedah,0,0,0
1/08/2022,Cameroon,Pulau Pinang,0,0,0
1/08/2022,Cameroon,Sabah,1,1,0
1/08/2022,Cameroon,Sarawak,0,0,0
1/08/2022,Cameroon,Selangor,20,10,10
1/08/2022,Congo,Johor,0,0,0
1/08/2022,Congo,Pulau Pinang,0,0,0
1/08/2022,Congo,Sarawak,0,0,0
1/08/2022,Congo,Selangor,14,10,4
1/08/2022,Congo,Johor,0,0,0
1/08/2022,Congo,Kedah,0,0,0
1/08/2022,Congo,Selangor,0,0,0
1/08/2022,Cook Islands,Selangor,0,0,0
1/08/2022,Colombia,Johor,16,6,10
1/08/2022,Colombia,Kedah,0,0,0
1/08/2022,Colombia,Perak,3,1,2
1/08/2022,Colombia,Pulau Pinang,2,1,1
1/08/2022,Colombia,Sabah,2,1,1
1/08/2022,Colombia,Sarawak,0,0,0
1/08/2022,Colombia,Selangor,92,51,41
1/08/2022,Colombia,W.P. Labuan,0,0,0
1/08/2022,Comoros,Johor,0,0,0
1/08/2022,Comoros,Kedah,1,0,1
1/08/2022,Comoros,Selangor,9,3,6
1/08/2022,Cabo Verde,Johor,0,0,0
1/08/2022,Cabo Verde,Kedah,0,0,0
1/08/2022,Cabo Verde,Pulau Pinang,0,0,0
1/08/2022,Cabo Verde,Sabah,0,0,0
1/08/2022,Cabo Verde,Selangor,5,3,2
1/08/2022,Costa Rica,Johor,0,0,0
1/08/2022,Costa Rica,Kedah,0,0,0
1/08/2022,Costa Rica,Perak,0,0,0
1/08/2022,Costa Rica,Perlis,1,1,0
1/08/2022,Costa Rica,Pulau Pinang,4,2,2
1/08/2022,Costa Rica,Sabah,1,0,1
1/08/2022,Costa Rica,Sarawak,2,1,1
1/08/2022,Costa Rica,Selangor,35,17,18
1/08/2022,Cuba,Johor,0,0,0
1/08/2022,Cuba,Kedah,0,0,0
1/08/2022,Cuba,Perlis,1,1,0
1/08/2022,Cuba,Pulau Pinang,0,0,0
1/08/2022,Cuba,Sabah,0,0,0
1/08/2022,Cuba,Sarawak,0,0,0
1/08/2022,Cuba,Selangor,19,12,7
1/08/2022,Cyprus,Johor,7,6,1
1/08/2022,Cyprus,Kedah,0,0,0
1/08/2022,Cyprus,Perak,0,0,0
1/08/2022,Cyprus,Perlis,0,0,0
1/08/2022,Cyprus,Pulau Pinang,2,2,0
1/08/2022,Cyprus,Sabah,2,1,1
1/08/2022,Cyprus,Sarawak,3,2,1
1/08/2022,Cyprus,Selangor,60,32,28
1/08/2022,Czechia,Johor,109,59,50
1/08/2022,Czechia,Kedah,21,9,12
1/08/2022,Czechia,Kelantan,0,0,0
1/08/2022,Czechia,Melaka,0,0,0
1/08/2022,Czechia,Negeri Sembilan,0,0,0
1/08/2022,Czechia,Perak,0,0,0
1/08/2022,Czechia,Perlis,6,4,2
1/08/2022,Czechia,Pulau Pinang,19,9,10
1/08/2022,Czechia,Sabah,12,7,5
1/08/2022,Czechia,Sarawak,17,7,10
1/08/2022,Czechia,Selangor,312,175,137
1/08/2022,Czechia,W.P. Labuan,0,0,0
1/08/2022,Germany,Johor,1900,1196,704
1/08/2022,Germany,Kedah,244,126,118
1/08/2022,Germany,Kelantan,12,8,4
1/08/2022,Germany,Melaka,1,1,0
1/08/2022,Germany,Negeri Sembilan,0,0,0
1/08/2022,Germany,Pahang,0,0,0
1/08/2022,Germany,Perak,21,13,8
1/08/2022,Germany,Perlis,76,35,41
1/08/2022,Germany,Pulau Pinang,493,340,153
1/08/2022,Germany,Sabah,151,77,74
1/08/2022,Germany,Sarawak,174,102,72
1/08/2022,Germany,Selangor,6483,3742,2741
1/08/2022,Germany,Terengganu,0,0,0
1/08/2022,Germany,W.P. Labuan,0,0,0
1/08/2022,Djibouti,Johor,0,0,0
1/08/2022,Djibouti,Selangor,18,13,5
1/08/2022,Dominica,Johor,1,1,0
1/08/2022,Dominica,Kedah,1,1,0
1/08/2022,Dominica,Pulau Pinang,5,5,0
1/08/2022,Dominica,Sabah,0,0,0
1/08/2022,Dominica,Sarawak,0,0,0
1/08/2022,Dominica,Selangor,31,21,10
1/08/2022,Dominica,W.P. Labuan,0,0,0
1/08/2022,Denmark,Johor,199,132,67
1/08/2022,Denmark,Kedah,44,19,25
1/08/2022,Denmark,Kelantan,1,0,1
1/08/2022,Denmark,Melaka,0,0,0
1/08/2022,Denmark,Negeri Sembilan,0,0,0
1/08/2022,Denmark,Pahang,1,1,0
1/08/2022,Denmark,Perak,2,2,0
1/08/2022,Denmark,Perlis,2,1,1
1/08/2022,Denmark,Pulau Pinang,41,36,5
1/08/2022,Denmark,Sabah,27,14,13
1/08/2022,Denmark,Sarawak,25,11,14
1/08/2022,Denmark,Selangor,670,408,262
1/08/2022,Denmark,W.P. Labuan,0,0,0
1/08/2022,Dominican Republic,Johor,2,0,2
1/08/2022,Dominican Republic,Kedah,0,0,0
1/08/2022,Dominican Republic,Perak,0,0,0
1/08/2022,Dominican Republic,Perlis,0,0,0
1/08/2022,Dominican Republic,Pulau Pinang,0,0,0
1/08/2022,Dominican Republic,Sabah,0,0,0
1/08/2022,Dominican Republic,Sarawak,0,0,0
1/08/2022,Dominican Republic,Selangor,11,7,4
1/08/2022,Algeria,Johor,20,16,4
1/08/2022,Algeria,Kedah,2,2,0
1/08/2022,Algeria,Kelantan,0,0,0
1/08/2022,Algeria,Melaka,0,0,0
1/08/2022,Algeria,Perak,0,0,0
1/08/2022,Algeria,Perlis,0,0,0
1/08/2022,Algeria,Pulau Pinang,1,1,0
1/08/2022,Algeria,Sabah,1,1,0
1/08/2022,Algeria,Sarawak,4,3,1
1/08/2022,Algeria,Selangor,901,467,434
1/08/2022,Algeria,W.P. Labuan,0,0,0
1/08/2022,Ecuador,Johor,6,4,2
1/08/2022,Ecuador,Kedah,1,0,1
1/08/2022,Ecuador,Perak,0,0,0
1/08/2022,Ecuador,Perlis,0,0,0
1/08/2022,Ecuador,Pulau Pinang,3,1,2
1/08/2022,Ecuador,Sabah,1,0,1
1/08/2022,Ecuador,Sarawak,3,1,2
1/08/2022,Ecuador,Selangor,52,22,30
1/08/2022,Egypt,Johor,183,136,47
1/08/2022,Egypt,Kedah,1,1,0
1/08/2022,Egypt,Kelantan,1,1,0
1/08/2022,Egypt,Melaka,0,0,0
1/08/2022,Egypt,Pahang,0,0,0
1/08/2022,Egypt,Perak,0,0,0
1/08/2022,Egypt,Perlis,0,0,0
1/08/2022,Egypt,Pulau Pinang,4,4,0
1/08/2022,Egypt,Sabah,5,4,1
1/08/2022,Egypt,Sarawak,72,44,28
1/08/2022,Egypt,Selangor,1648,1044,604
1/08/2022,Egypt,Terengganu,0,0,0
1/08/2022,Egypt,W.P. Labuan,1,1,0
1/08/2022,Eritrea,Johor,0,0,0
1/08/2022,Eritrea,Pulau Pinang,0,0,0
1/08/2022,Eritrea,Sabah,0,0,0
1/08/2022,Eritrea,Selangor,7,4,3
1/08/2022,Spain,Johor,790,396,394
1/08/2022,Spain,Kedah,83,47,36
1/08/2022,Spain,Kelantan,10,7,3
1/08/2022,Spain,Melaka,0,0,0
1/08/2022,Spain,Negeri Sembilan,0,0,0
1/08/2022,Spain,Pahang,0,0,0
1/08/2022,Spain,Perak,15,8,7
1/08/2022,Spain,Perlis,17,11,6
1/08/2022,Spain,Pulau Pinang,233,112,121
1/08/2022,Spain,Sabah,77,42,35
1/08/2022,Spain,Sarawak,87,49,38
1/08/2022,Spain,Selangor,4946,2559,2387
1/08/2022,Spain,W.P. Labuan,1,1,0
1/08/2022,Estonia,Johor,17,8,9
1/08/2022,Estonia,Kedah,2,1,1
1/08/2022,Estonia,Kelantan,0,0,0
1/08/2022,Estonia,Pahang,0,0,0
1/08/2022,Estonia,Perak,0,0,0
1/08/2022,Estonia,Perlis,1,0,1
1/08/2022,Estonia,Pulau Pinang,2,1,1
1/08/2022,Estonia,Sabah,0,0,0
1/08/2022,Estonia,Sarawak,2,1,1
1/08/2022,Estonia,Selangor,63,26,37
1/08/2022,Estonia,W.P. Labuan,0,0,0
1/08/2022,Ethiopia,Johor,1,1,0
1/08/2022,Ethiopia,Kedah,0,0,0
1/08/2022,Ethiopia,Pulau Pinang,0,0,0
1/08/2022,Ethiopia,Sarawak,0,0,0
1/08/2022,Ethiopia,Selangor,34,19,15
1/08/2022,Finland,Johor,95,59,36
1/08/2022,Finland,Kedah,7,4,3
1/08/2022,Finland,Kelantan,0,0,0
1/08/2022,Finland,Melaka,0,0,0
1/08/2022,Finland,Negeri Sembilan,0,0,0
1/08/2022,Finland,Pahang,0,0,0
1/08/2022,Finland,Perak,1,1,0
1/08/2022,Finland,Perlis,2,1,1
1/08/2022,Finland,Pulau Pinang,11,7,4
1/08/2022,Finland,Sabah,6,1,5
1/08/2022,Finland,Sarawak,3,1,2
1/08/2022,Finland,Selangor,193,121,72
1/08/2022,Finland,W.P. Labuan,0,0,0
1/08/2022,Fiji,Johor,26,14,12
1/08/2022,Fiji,Kedah,0,0,0
1/08/2022,Fiji,Kelantan,0,0,0
1/08/2022,Fiji,Perak,0,0,0
1/08/2022,Fiji,Perlis,1,1,0
1/08/2022,Fiji,Pulau Pinang,0,0,0
1/08/2022,Fiji,Sabah,1,1,0
1/08/2022,Fiji,Sarawak,0,0,0
1/08/2022,Fiji,Selangor,59,30,29
1/08/2022,France,Johor,2203,1303,900
1/08/2022,France,Kedah,194,111,83
1/08/2022,France,Kelantan,4,2,2
1/08/2022,France,Melaka,1,0,1
1/08/2022,France,Negeri Sembilan,1,1,0
1/08/2022,France,Pahang,5,5,0
1/08/2022,France,Perak,23,13,10
1/08/2022,France,Perlis,82,44,38
1/08/2022,France,Pulau Pinang,314,199,115
1/08/2022,France,Sabah,167,94,73
1/08/2022,France,Sarawak,161,88,73
1/08/2022,France,Selangor,10785,5892,4893
1/08/2022,France,Terengganu,0,0,0
1/08/2022,France,W.P. Labuan,9,7,2
1/08/2022,"Micronesia, Federated States of",Johor,0,0,0
1/08/2022,"Micronesia, Federated States of",Pulau Pinang,0,0,0
1/08/2022,"Micronesia, Federated States of",Selangor,1,0,1
1/08/2022,Gabon,Johor,11,6,5
1/08/2022,Gabon,Pulau Pinang,0,0,0
1/08/2022,Gabon,Sarawak,0,0,0
1/08/2022,Gabon,Selangor,6,2,4
1/08/2022,United Kingdom of Great Britain and Northern Ireland,Johor,4151,2630,1521
1/08/2022,United Kingdom of Great Britain and Northern Ireland,Kedah,598,331,267
1/08/2022,United Kingdom of Great Britain and Northern Ireland,Kelantan,9,8,1
1/08/2022,United Kingdom of Great Britain and Northern Ireland,Melaka,2,1,1
1/08/2022,United Kingdom of Great Britain and Northern Ireland,Negeri Sembilan,0,0,0
1/08/2022,United Kingdom of Great Britain and Northern Ireland,Pahang,10,8,2
1/08/2022,United Kingdom of Great Britain and Northern Ireland,Perak,93,51,42
1/08/2022,United Kingdom of Great Britain and Northern Ireland,Perlis,140,93,47
1/08/2022,United Kingdom of Great Britain and Northern Ireland,Pulau Pinang,1067,644,423
1/08/2022,United Kingdom of Great Britain and Northern Ireland,Sabah,552,307,245
1/08/2022,United Kingdom of Great Britain and Northern Ireland,Sarawak,985,609,376
1/08/2022,United Kingdom of Great Britain and Northern Ireland,Selangor,16004,9302,6702
1/08/2022,United Kingdom of Great Britain and Northern Ireland,Terengganu,0,0,0
1/08/2022,United Kingdom of Great Britain and Northern Ireland,W.P. Labuan,16,10,6
1/08/2022,Georgia,Johor,9,8,1
1/08/2022,Georgia,Kedah,0,0,0
1/08/2022,Georgia,Melaka,0,0,0
1/08/2022,Georgia,Perak,0,0,0
1/08/2022,Georgia,Perlis,0,0,0
1/08/2022,Georgia,Pulau Pinang,0,0,0
1/08/2022,Georgia,Sabah,0,0,0
1/08/2022,Georgia,Sarawak,0,0,0
1/08/2022,Georgia,Selangor,41,32,9
1/08/2022,Ghana,Johor,3,3,0
1/08/2022,Ghana,Kedah,0,0,0
1/08/2022,Ghana,Kelantan,0,0,0
1/08/2022,Ghana,Pulau Pinang,0,0,0
1/08/2022,Ghana,Sabah,0,0,0
1/08/2022,Ghana,Sarawak,0,0,0
1/08/2022,Ghana,Selangor,45,30,15
1/08/2022,Gibraltar,Johor,0,0,0
1/08/2022,Gibraltar,Sarawak,0,0,0
1/08/2022,Guinea,Johor,3,1,2
1/08/2022,Guinea,Kedah,0,0,0
1/08/2022,Guinea,Kelantan,0,0,0
1/08/2022,Guinea,Perlis,0,0,0
1/08/2022,Guinea,Pulau Pinang,0,0,0
1/08/2022,Guinea,Sabah,0,0,0
1/08/2022,Guinea,Sarawak,0,0,0
1/08/2022,Guinea,Selangor,38,26,12
1/08/2022,Guadeloupe,Selangor,0,0,0
1/08/2022,Gambia,Johor,4,4,0
1/08/2022,Gambia,Kedah,0,0,0
1/08/2022,Gambia,Kelantan,0,0,0
1/08/2022,Gambia,Pulau Pinang,0,0,0
1/08/2022,Gambia,Sabah,0,0,0
1/08/2022,Gambia,Sarawak,0,0,0
1/08/2022,Gambia,Selangor,21,12,9
1/08/2022,Guinea-Bissau,Johor,0,0,0
1/08/2022,Guinea-Bissau,Selangor,0,0,0
1/08/2022,Equatorial Guinea,Johor,0,0,0
1/08/2022,Equatorial Guinea,Selangor,1,0,1
1/08/2022,Greece,Johor,34,31,3
1/08/2022,Greece,Kedah,6,2,4
1/08/2022,Greece,Kelantan,0,0,0
1/08/2022,Greece,Melaka,0,0,0
1/08/2022,Greece,Negeri Sembilan,0,0,0
1/08/2022,Greece,Pahang,0,0,0
1/08/2022,Greece,Perak,0,0,0
1/08/2022,Greece,Perlis,0,0,0
1/08/2022,Greece,Pulau Pinang,15,10,5
1/08/2022,Greece,Sabah,1,1,0
1/08/2022,Greece,Sarawak,3,1,2
1/08/2022,Greece,Selangor,197,116,81
1/08/2022,Grenada,Johor,9,6,3
1/08/2022,Grenada,Kedah,4,3,1
1/08/2022,Grenada,Pulau Pinang,2,1,1
1/08/2022,Grenada,Sabah,0,0,0
1/08/2022,Grenada,Sarawak,1,1,0
1/08/2022,Grenada,Selangor,9,6,3
1/08/2022,Greenland,Johor,0,0,0
1/08/2022,Greenland,Selangor,0,0,0
1/08/2022,Guatemala,Johor,1,1,0
1/08/2022,Guatemala,Kedah,0,0,0
1/08/2022,Guatemala,Pahang,0,0,0
1/08/2022,Guatemala,Perak,0,0,0
1/08/2022,Guatemala,Pulau Pinang,0,0,0
1/08/2022,Guatemala,Sabah,0,0,0
1/08/2022,Guatemala,Sarawak,0,0,0
1/08/2022,Guatemala,Selangor,11,9,2
1/08/2022,Guatemala,W.P. Labuan,0,0,0
1/08/2022,Guyana,Johor,3,3,0
1/08/2022,Guyana,Kedah,0,0,0
1/08/2022,Guyana,Pulau Pinang,0,0,0
1/08/2022,Guyana,Sarawak,0,0,0
1/08/2022,Guyana,Selangor,3,2,1
1/08/2022,Hong Kong,Johor,3,3,0
1/08/2022,Hong Kong,Kedah,0,0,0
1/08/2022,Hong Kong,Kelantan,0,0,0
1/08/2022,Hong Kong,Pahang,0,0,0
1/08/2022,Hong Kong,Perak,21,9,12
1/08/2022,Hong Kong,Perlis,9,5,4
1/08/2022,Hong Kong,Pulau Pinang,0,0,0
1/08/2022,Hong Kong,Sabah,47,26,21
1/08/2022,Hong Kong,Sarawak,31,20,11
1/08/2022,Hong Kong,Selangor,4,3,1
1/08/2022,Hong Kong,Terengganu,0,0,0
1/08/2022,Heard Island and McDonald Islands,Johor,0,0,0
1/08/2022,Honduras,Johor,1,0,1
1/08/2022,Honduras,Kedah,0,0,0
1/08/2022,Honduras,Perak,0,0,0
1/08/2022,Honduras,Pulau Pinang,1,0,1
1/08/2022,Honduras,Sabah,0,0,0
1/08/2022,Honduras,Sarawak,0,0,0
1/08/2022,Honduras,Selangor,9,5,4
1/08/2022,Croatia,Johor,13,9,4
1/08/2022,Croatia,Kedah,2,0,2
1/08/2022,Croatia,Kelantan,0,0,0
1/08/2022,Croatia,Melaka,0,0,0
1/08/2022,Croatia,Pahang,0,0,0
1/08/2022,Croatia,Perak,0,0,0
1/08/2022,Croatia,Perlis,0,0,0
1/08/2022,Croatia,Pulau Pinang,3,1,2
1/08/2022,Croatia,Sabah,5,5,0
1/08/2022,Croatia,Sarawak,0,0,0
1/08/2022,Croatia,Selangor,127,90,37
1/08/2022,Haiti,Johor,0,0,0
1/08/2022,Haiti,Kedah,0,0,0
1/08/2022,Haiti,Kelantan,0,0,0
1/08/2022,Haiti,Perak,0,0,0
1/08/2022,Haiti,Pulau Pinang,0,0,0
1/08/2022,Haiti,Sabah,0,0,0
1/08/2022,Haiti,Selangor,1,1,0
1/08/2022,Hungary,Johor,81,56,25
1/08/2022,Hungary,Kedah,4,1,3
1/08/2022,Hungary,Kelantan,0,0,0
1/08/2022,Hungary,Pahang,0,0,0
1/08/2022,Hungary,Perak,1,0,1
1/08/2022,Hungary,Perlis,0,0,0
1/08/2022,Hungary,Pulau Pinang,9,7,2
1/08/2022,Hungary,Sabah,5,4,1
1/08/2022,Hungary,Sarawak,2,2,0
1/08/2022,Hungary,Selangor,245,137,108
1/08/2022,Hungary,W.P. Labuan,0,0,0
1/08/2022,Indonesia,Johor,85856,48437,37419
1/08/2022,Indonesia,Kedah,2239,857,1382
1/08/2022,Indonesia,Kelantan,126,63,63
1/08/2022,Indonesia,Melaka,6462,2744,3718
1/08/2022,Indonesia,Negeri Sembilan,7501,5238,2263
1/08/2022,Indonesia,Pahang,28,24,4
1/08/2022,Indonesia,Perak,105,36,69
1/08/2022,Indonesia,Perlis,291,128,163
1/08/2022,Indonesia,Pulau Pinang,20947,7971,12976
1/08/2022,Indonesia,Sabah,3757,1882,1875
1/08/2022,Indonesia,Sarawak,24047,13692,10355
1/08/2022,Indonesia,Selangor,60380,29211,31169
1/08/2022,Indonesia,Terengganu,0,0,0
1/08/2022,Indonesia,W.P. Labuan,11,4,7
1/08/2022,India,Johor,13312,9303,4009
1/08/2022,India,Kedah,514,286,228
1/08/2022,India,Kelantan,5,4,1
1/08/2022,India,Melaka,1,1,0
1/08/2022,India,Negeri Sembilan,0,0,0
1/08/2022,India,Pahang,0,0,0
1/08/2022,India,Perak,865,740,125
1/08/2022,India,Perlis,68,55,13
1/08/2022,India,Pulau Pinang,628,452,176
1/08/2022,India,Sabah,174,116,58
1/08/2022,India,Sarawak,199,160,39
1/08/2022,India,Selangor,40291,29328,10963
1/08/2022,India,Terengganu,0,0,0
1/08/2022,India,W.P. Labuan,4,3,1
1/08/2022, British Indian Ocean Territory,Pulau Pinang,0,0,0
1/08/2022, British Indian Ocean Territory,Selangor,0,0,0
1/08/2022,Ireland,Johor,199,130,69
1/08/2022,Ireland,Kedah,27,14,13
1/08/2022,Ireland,Kelantan,0,0,0
1/08/2022,Ireland,Negeri Sembilan,0,0,0
1/08/2022,Ireland,Pahang,0,0,0
1/08/2022,Ireland,Perak,8,4,4
1/08/2022,Ireland,Perlis,8,5,3
1/08/2022,Ireland,Pulau Pinang,49,32,17
1/08/2022,Ireland,Sabah,28,13,15
1/08/2022,Ireland,Sarawak,28,13,15
1/08/2022,Ireland,Selangor,973,567,406
1/08/2022,Ireland,Terengganu,0,0,0
1/08/2022,Ireland,W.P. Labuan,0,0,0
1/08/2022,"Iran, Islamic Republic of",Johor,62,41,21
1/08/2022,"Iran, Islamic Republic of",Kedah,2,2,0
1/08/2022,"Iran, Islamic Republic of",Kelantan,0,0,0
1/08/2022,"Iran, Islamic Republic of",Perak,0,0,0
1/08/2022,"Iran, Islamic Republic of",Perlis,0,0,0
1/08/2022,"Iran, Islamic Republic of",Pulau Pinang,2,1,1
1/08/2022,"Iran, Islamic Republic of",Sabah,3,2,1
1/08/2022,"Iran, Islamic Republic of",Sarawak,1,0,1
1/08/2022,"Iran, Islamic Republic of",Selangor,1129,600,529
1/08/2022,"Iran, Islamic Republic of",W.P. Labuan,0,0,0
1/08/2022,Iraq,Johor,14,10,4
1/08/2022,Iraq,Kedah,5,2,3
1/08/2022,Iraq,Kelantan,0,0,0
1/08/2022,Iraq,Melaka,4,3,1
1/08/2022,Iraq,Pahang,0,0,0
1/08/2022,Iraq,Perak,0,0,0
1/08/2022,Iraq,Perlis,0,0,0
1/08/2022,Iraq,Pulau Pinang,2,2,0
1/08/2022,Iraq,Sabah,1,1,0
1/08/2022,Iraq,Sarawak,0,0,0
1/08/2022,Iraq,Selangor,872,523,349
1/08/2022,Iceland,Johor,2,2,0
1/08/2022,Iceland,Kedah,2,2,0
1/08/2022,Iceland,Kelantan,0,0,0
1/08/2022,Iceland,Perak,0,0,0
1/08/2022,Iceland,Perlis,0,0,0
1/08/2022,Iceland,Pulau Pinang,1,1,0
1/08/2022,Iceland,Sabah,0,0,0
1/08/2022,Iceland,Sarawak,5,3,2
1/08/2022,Iceland,Selangor,17,12,5
1/08/2022,Iceland,W.P. Labuan,0,0,0
1/08/2022,Israel,Pulau Pinang,0,0,0
1/08/2022,Italy,Johor,923,555,368
1/08/2022,Italy,Kedah,65,38,27
1/08/2022,Italy,Kelantan,7,2,5
1/08/2022,Italy,Melaka,0,0,0
1/08/2022,Italy,Negeri Sembilan,0,0,0
1/08/2022,Italy,Pahang,1,1,0
1/08/2022,Italy,Perak,12,5,7
1/08/2022,Italy,Perlis,21,12,9
1/08/2022,Italy,Pulau Pinang,145,88,57
1/08/2022,Italy,Sabah,90,41,49
1/08/2022,Italy,Sarawak,106,49,57
1/08/2022,Italy,Selangor,4930,2751,2179
1/08/2022,Italy,W.P. Labuan,0,0,0
1/08/2022,Jamaica,Johor,0,0,0
1/08/2022,Jamaica,Kedah,0,0,0
1/08/2022,Jamaica,Perak,0,0,0
1/08/2022,Jamaica,Pulau Pinang,2,1,1
1/08/2022,Jamaica,Sabah,0,0,0
1/08/2022,Jamaica,Sarawak,0,0,0
1/08/2022,Jamaica,Selangor,21,12,9
1/08/2022,Jamaica,W.P. Labuan,0,0,0
1/08/2022,Jordan,Johor,5,4,1
1/08/2022,Jordan,Kedah,1,1,0
1/08/2022,Jordan,Kelantan,0,0,0
1/08/2022,Jordan,Melaka,0,0,0
1/08/2022,Jordan,Perlis,0,0,0
1/08/2022,Jordan,Pulau Pinang,2,1,1
1/08/2022,Jordan,Sabah,0,0,0
1/08/2022,Jordan,Sarawak,0,0,0
1/08/2022,Jordan,Selangor,648,382,266
1/08/2022,Jordan,W.P. Labuan,0,0,0
1/08/2022,Japan,Johor,4695,3275,1420
1/08/2022,Japan,Kedah,142,71,71
1/08/2022,Japan,Kelantan,6,4,2
1/08/2022,Japan,Melaka,0,0,0
1/08/2022,Japan,Negeri Sembilan,0,0,0
1/08/2022,Japan,Pahang,6,4,2
1/08/2022,Japan,Perak,34,20,14
1/08/2022,Japan,Perlis,26,18,8
1/08/2022,Japan,Pulau Pinang,1091,710,381
1/08/2022,Japan,Sabah,240,104,136
1/08/2022,Japan,Sarawak,113,60,53
1/08/2022,Japan,Selangor,11022,6681,4341
1/08/2022,Japan,W.P. Labuan,6,4,2
1/08/2022,Kazakhstan,Johor,31,17,14
1/08/2022,Kazakhstan,Kedah,8,2,6
1/08/2022,Kazakhstan,Kelantan,0,0,0
1/08/2022,Kazakhstan,Melaka,0,0,0
1/08/2022,Kazakhstan,Perak,0,0,0
1/08/2022,Kazakhstan,Perlis,0,0,0
1/08/2022,Kazakhstan,Pulau Pinang,1,1,0
1/08/2022,Kazakhstan,Sabah,5,1,4
1/08/2022,Kazakhstan,Sarawak,2,0,2
1/08/2022,Kazakhstan,Selangor,378,184,194
1/08/2022,Kazakhstan,W.P. Labuan,0,0,0
1/08/2022,Kenya,Johor,35,13,22
1/08/2022,Kenya,Kedah,6,5,1
1/08/2022,Kenya,Kelantan,0,0,0
1/08/2022,Kenya,Perak,0,0,0
1/08/2022,Kenya,Perlis,0,0,0
1/08/2022,Kenya,Pulau Pinang,2,1,1
1/08/2022,Kenya,Sabah,1,1,0
1/08/2022,Kenya,Sarawak,1,0,1
1/08/2022,Kenya,Selangor,219,116,103
1/08/2022,Kyrgyzstan,Johor,20,6,14
1/08/2022,Kyrgyzstan,Kedah,0,0,0
1/08/2022,Kyrgyzstan,Kelantan,1,0,1
1/08/2022,Kyrgyzstan,Perak,0,0,0
1/08/2022,Kyrgyzstan,Perlis,0,0,0
1/08/2022,Kyrgyzstan,Pulau Pinang,0,0,0
1/08/2022,Kyrgyzstan,Sabah,0,0,0
1/08/2022,Kyrgyzstan,Sarawak,0,0,0
1/08/2022,Kyrgyzstan,Selangor,172,90,82
1/08/2022,Cambodia,Johor,1325,588,737
1/08/2022,Cambodia,Kedah,57,44,13
1/08/2022,Cambodia,Kelantan,514,316,198
1/08/2022,Cambodia,Melaka,0,0,0
1/08/2022,Cambodia,Negeri Sembilan,0,0,0
1/08/2022,Cambodia,Pahang,0,0,0
1/08/2022,Cambodia,Perak,20,16,4
1/08/2022,Cambodia,Perlis,1020,647,373
1/08/2022,Cambodia,Pulau Pinang,18,8,10
1/08/2022,Cambodia,Sabah,0,0,0
1/08/2022,Cambodia,Sarawak,2,1,1
1/08/2022,Cambodia,Selangor,3146,1562,1584
1/08/2022,Cambodia,W.P. Labuan,0,0,0
1/08/2022,Kiribati,Johor,0,0,0
1/08/2022,Kiribati,Sabah,0,0,0
1/08/2022,Kiribati,Selangor,0,0,0
1/08/2022,Saint Kitts and Nevis,Johor,19,10,9
1/08/2022,Saint Kitts and Nevis,Kedah,0,0,0
1/08/2022,Saint Kitts and Nevis,Perlis,1,1,0
1/08/2022,Saint Kitts and Nevis,Pulau Pinang,0,0,0
1/08/2022,Saint Kitts and Nevis,Sabah,0,0,0
1/08/2022,Saint Kitts and Nevis,Selangor,33,29,4
1/08/2022,Saint Kitts and Nevis,W.P. Labuan,0,0,0
1/08/2022,"Korea, Republic of",Johor,8356,4576,3780
1/08/2022,"Korea, Republic of",Kedah,125,60,65
1/08/2022,"Korea, Republic of",Kelantan,1,1,0
1/08/2022,"Korea, Republic of",Melaka,4,4,0
1/08/2022,"Korea, Republic of",Negeri Sembilan,0,0,0
1/08/2022,"Korea, Republic of",Pahang,0,0,0
1/08/2022,"Korea, Republic of",Perak,15,10,5
1/08/2022,"Korea, Republic of",Perlis,47,33,14
1/08/2022,"Korea, Republic of",Pulau Pinang,480,270,210
1/08/2022,"Korea, Republic of",Sabah,8892,3946,4946
1/08/2022,"Korea, Republic of",Sarawak,110,69,41
1/08/2022,"Korea, Republic of",Selangor,8249,4679,3570
1/08/2022,"Korea, Republic of",Terengganu,0,0,0
1/08/2022,"Korea, Republic of",W.P. Labuan,1,0,1
1/08/2022,Kuwait,Johor,100,58,42
1/08/2022,Kuwait,Kedah,23,13,10
1/08/2022,Kuwait,Kelantan,0,0,0
1/08/2022,Kuwait,Perak,1,1,0
1/08/2022,Kuwait,Perlis,0,0,0
1/08/2022,Kuwait,Pulau Pinang,13,6,7
1/08/2022,Kuwait,Sabah,0,0,0
1/08/2022,Kuwait,Sarawak,0,0,0
1/08/2022,Kuwait,Selangor,1308,641,667
1/08/2022,Kuwait,W.P. Labuan,0,0,0
1/08/2022, Lao People's Democratic Republic,Johor,48,12,36
1/08/2022, Lao People's Democratic Republic,Kedah,212,32,180
1/08/2022, Lao People's Democratic Republic,Kelantan,82,5,77
1/08/2022, Lao People's Democratic Republic,Melaka,0,0,0
1/08/2022, Lao People's Democratic Republic,Perak,27,3,24
1/08/2022, Lao People's Democratic Republic,Perlis,475,79,396
1/08/2022, Lao People's Democratic Republic,Pulau Pinang,10,1,9
1/08/2022, Lao People's Democratic Republic,Sabah,1,0,1
1/08/2022, Lao People's Democratic Republic,Sarawak,6,4,2
1/08/2022, Lao People's Democratic Republic,Selangor,309,105,204
1/08/2022, Lao People's Democratic Republic,W.P. Labuan,0,0,0
1/08/2022,Lebanon,Johor,13,11,2
1/08/2022,Lebanon,Kedah,1,1,0
1/08/2022,Lebanon,Kelantan,0,0,0
1/08/2022,Lebanon,Pahang,0,0,0
1/08/2022,Lebanon,Perak,0,0,0
1/08/2022,Lebanon,Perlis,0,0,0
1/08/2022,Lebanon,Pulau Pinang,2,1,1
1/08/2022,Lebanon,Sabah,1,0,1
1/08/2022,Lebanon,Sarawak,0,0,0
1/08/2022,Lebanon,Selangor,177,115,62
1/08/2022,Lebanon,W.P. Labuan,1,1,0
1/08/2022,Liberia,Johor,3,3,0
1/08/2022,Liberia,Kedah,0,0,0
1/08/2022,Liberia,Sabah,0,0,0
1/08/2022,Liberia,Sarawak,0,0,0
1/08/2022,Liberia,Selangor,5,2,3
1/08/2022,Libya,Johor,3,3,0
1/08/2022,Libya,Kedah,0,0,0
1/08/2022,Libya,Perlis,0,0,0
1/08/2022,Libya,Pulau Pinang,0,0,0
1/08/2022,Libya,Sabah,0,0,0
1/08/2022,Libya,Sarawak,7,3,4
1/08/2022,Libya,Selangor,258,180,78
1/08/2022,Saint Lucia,Johor,3,3,0
1/08/2022,Saint Lucia,Kedah,0,0,0
1/08/2022,Saint Lucia,Pulau Pinang,0,0,0
1/08/2022,Saint Lucia,Sarawak,0,0,0
1/08/2022,Saint Lucia,Selangor,13,5,8
1/08/2022,Liechtenstein,Johor,1,1,0
1/08/2022,Liechtenstein,Kedah,0,0,0
1/08/2022,Liechtenstein,Perlis,0,0,0
1/08/2022,Liechtenstein,Pulau Pinang,0,0,0
1/08/2022,Liechtenstein,Sabah,0,0,0
1/08/2022,Liechtenstein,Sarawak,0,0,0
1/08/2022,Liechtenstein,Selangor,2,1,1
1/08/2022,LKA,Johor,1010,659,351
1/08/2022,LKA,Kedah,53,30,23
1/08/2022,LKA,Kelantan,0,0,0
1/08/2022,LKA,Melaka,0,0,0
1/08/2022,LKA,Pahang,0,0,0
1/08/2022,LKA,Perak,6,3,3
1/08/2022,LKA,Perlis,2,1,1
1/08/2022,LKA,Pulau Pinang,27,16,11
1/08/2022,LKA,Sabah,2,1,1
1/08/2022,LKA,Sarawak,12,11,1
1/08/2022,LKA,Selangor,2490,1615,875
1/08/2022,LKA,W.P. Labuan,0,0,0
1/08/2022,Lesotho,Johor,0,0,0
1/08/2022,Lesotho,Kedah,0,0,0
1/08/2022,Lesotho,Pulau Pinang,0,0,0
1/08/2022,Lesotho,Sarawak,0,0,0
1/08/2022,Lesotho,Selangor,1,1,0
1/08/2022,Lithuania,Johor,21,6,15
1/08/2022,Lithuania,Kedah,5,1,4
1/08/2022,Lithuania,Kelantan,0,0,0
1/08/2022,Lithuania,Pahang,0,0,0
1/08/2022,Lithuania,Perak,0,0,0
1/08/2022,Lithuania,Perlis,2,2,0
1/08/2022,Lithuania,Pulau Pinang,12,5,7
1/08/2022,Lithuania,Sabah,1,1,0
1/08/2022,Lithuania,Sarawak,2,0,2
1/08/2022,Lithuania,Selangor,128,78,50
1/08/2022,Lithuania,W.P. Labuan,0,0,0
1/08/2022,Luxembourg,Johor,5,0,5
1/08/2022,Luxembourg,Kedah,4,2,2
1/08/2022,Luxembourg,Kelantan,0,0,0
1/08/2022,Luxembourg,Perak,0,0,0
1/08/2022,Luxembourg,Perlis,2,1,1
1/08/2022,Luxembourg,Pulau Pinang,4,3,1
1/08/2022,Luxembourg,Sabah,0,0,0
1/08/2022,Luxembourg,Sarawak,0,0,0
1/08/2022,Luxembourg,Selangor,55,31,24
1/08/2022,Latvia,Johor,6,5,1
1/08/2022,Latvia,Kedah,3,1,2
1/08/2022,Latvia,Kelantan,0,0,0
1/08/2022,Latvia,Pahang,0,0,0
1/08/2022,Latvia,Perak,0,0,0
1/08/2022,Latvia,Perlis,0,0,0
1/08/2022,Latvia,Pulau Pinang,1,0,1
1/08/2022,Latvia,Sabah,0,0,0
1/08/2022,Latvia,Sarawak,4,3,1
1/08/2022,Latvia,Selangor,98,58,40
1/08/2022,Latvia,W.P. Labuan,0,0,0
1/08/2022,Macao,Johor,0,0,0
1/08/2022,Macao,Pahang,0,0,0
1/08/2022,Macao,Perak,0,0,0
1/08/2022,Macao,Selangor,0,0,0
1/08/2022,Macao,W.P. Labuan,0,0,0
1/08/2022,Morocco,Johor,69,49,20
1/08/2022,Morocco,Kedah,9,4,5
1/08/2022,Morocco,Kelantan,1,1,0
1/08/2022,Morocco,Melaka,1,0,1
1/08/2022,Morocco,Pahang,0,0,0
1/08/2022,Morocco,Perak,0,0,0
1/08/2022,Morocco,Perlis,4,2,2
1/08/2022,Morocco,Pulau Pinang,6,3,3
1/08/2022,Morocco,Sabah,1,1,0
1/08/2022,Morocco,Sarawak,2,2,0
1/08/2022,Morocco,Selangor,851,389,462
1/08/2022,Morocco,W.P. Labuan,0,0,0
1/08/2022,Monaco,Johor,0,0,0
1/08/2022,Monaco,Kedah,0,0,0
1/08/2022,Monaco,Sabah,0,0,0
1/08/2022,Monaco,Selangor,0,0,0
1/08/2022,"Moldova, Republic of",Johor,2,1,1
1/08/2022,"Moldova, Republic of",Kedah,0,0,0
1/08/2022,"Moldova, Republic of",Kelantan,0,0,0
1/08/2022,"Moldova, Republic of",Negeri Sembilan,0,0,0
1/08/2022,"Moldova, Republic of",Perlis,0,0,0
1/08/2022,"Moldova, Republic of",Pulau Pinang,0,0,0
1/08/2022,"Moldova, Republic of",Sabah,0,0,0
1/08/2022,"Moldova, Republic of",Sarawak,0,0,0
1/08/2022,"Moldova, Republic of",Selangor,22,11,11
1/08/2022,Madagascar,Johor,5,3,2
1/08/2022,Madagascar,Kedah,0,0,0
1/08/2022,Madagascar,Perak,0,0,0
1/08/2022,Madagascar,Perlis,0,0,0
1/08/2022,Madagascar,Pulau Pinang,0,0,0
1/08/2022,Madagascar,Sabah,0,0,0
1/08/2022,Madagascar,Sarawak,0,0,0
1/08/2022,Madagascar,Selangor,12,4,8
1/08/2022,Maldives,Johor,71,46,25
1/08/2022,Maldives,Kedah,6,3,3
1/08/2022,Maldives,Kelantan,0,0,0
1/08/2022,Maldives,Perak,4,2,2
1/08/2022,Maldives,Perlis,0,0,0
1/08/2022,Maldives,Pulau Pinang,2,1,1
1/08/2022,Maldives,Sabah,0,0,0
1/08/2022,Maldives,Sarawak,3,1,2
1/08/2022,Maldives,Selangor,1763,897,866
1/08/2022,Mexico,Johor,73,41,32
1/08/2022,Mexico,Kedah,2,0,2
1/08/2022,Mexico,Kelantan,0,0,0
1/08/2022,Mexico,Pahang,0,0,0
1/08/2022,Mexico,Perak,0,0,0
1/08/2022,Mexico,Perlis,2,2,0
1/08/2022,Mexico,Pulau Pinang,31,23,8
1/08/2022,Mexico,Sabah,5,2,3
1/08/2022,Mexico,Sarawak,2,1,1
1/08/2022,Mexico,Selangor,306,167,139
1/08/2022,Mexico,W.P. Labuan,0,0,0
1/08/2022,Marshall Islands,Johor,0,0,0
1/08/2022,Marshall Islands,Kedah,0,0,0
1/08/2022,Marshall Islands,Perak,0,0,0
1/08/2022,Marshall Islands,Pulau Pinang,0,0,0
1/08/2022,Marshall Islands,Sabah,0,0,0
1/08/2022,Marshall Islands,Selangor,2,2,0
1/08/2022,North Macedonia,Johor,2,1,1
1/08/2022,North Macedonia,Kedah,0,0,0
1/08/2022,North Macedonia,Perak,0,0,0
1/08/2022,North Macedonia,Pulau Pinang,0,0,0
1/08/2022,North Macedonia,Sabah,0,0,0
1/08/2022,North Macedonia,Sarawak,0,0,0
1/08/2022,North Macedonia,Selangor,20,15,5
1/08/2022,Mali,Johor,5,5,0
1/08/2022,Mali,Sabah,0,0,0
1/08/2022,Mali,Selangor,3,3,0
1/08/2022,Malta,Johor,4,2,2
1/08/2022,Malta,Kedah,0,0,0
1/08/2022,Malta,Kelantan,0,0,0
1/08/2022,Malta,Perak,0,0,0
1/08/2022,Malta,Perlis,0,0,0
1/08/2022,Malta,Pulau Pinang,0,0,0
1/08/2022,Malta,Sabah,0,0,0
1/08/2022,Malta,Sarawak,4,2,2
1/08/2022,Malta,Selangor,55,29,26
1/08/2022,Malta,W.P. Labuan,0,0,0
1/08/2022,Myanmar,Johor,2736,921,1815
1/08/2022,Myanmar,Kedah,21,5,16
1/08/2022,Myanmar,Kelantan,1,0,1
1/08/2022,Myanmar,Negeri Sembilan,0,0,0
1/08/2022,Myanmar,Pahang,0,0,0
1/08/2022,Myanmar,Perak,6,3,3
1/08/2022,Myanmar,Perlis,2,0,2
1/08/2022,Myanmar,Pulau Pinang,104,44,60
1/08/2022,Myanmar,Sabah,15,7,8
1/08/2022,Myanmar,Sarawak,49,25,24
1/08/2022,Myanmar,Selangor,6512,4147,2365
1/08/2022,Myanmar,Terengganu,0,0,0
1/08/2022,Myanmar,W.P. Labuan,0,0,0
1/08/2022,Montenegro,Johor,3,3,0
1/08/2022,Montenegro,Kedah,0,0,0
1/08/2022,Montenegro,Pulau Pinang,0,0,0
1/08/2022,Montenegro,Sabah,0,0,0
1/08/2022,Montenegro,Sarawak,0,0,0
1/08/2022,Montenegro,Selangor,4,4,0
1/08/2022,Mongolia,Johor,114,45,69
1/08/2022,Mongolia,Kedah,0,0,0
1/08/2022,Mongolia,Kelantan,0,0,0
1/08/2022,Mongolia,Perak,0,0,0
1/08/2022,Mongolia,Perlis,0,0,0
1/08/2022,Mongolia,Pulau Pinang,6,3,3
1/08/2022,Mongolia,Sabah,0,0,0
1/08/2022,Mongolia,Sarawak,0,0,0
1/08/2022,Mongolia,Selangor,169,65,104
1/08/2022,Northern Mariana Islands,Selangor,0,0,0
1/08/2022,Mozambique,Johor,0,0,0
1/08/2022,Mozambique,Kedah,0,0,0
1/08/2022,Mozambique,Perak,0,0,0
1/08/2022,Mozambique,Pulau Pinang,0,0,0
1/08/2022,Mozambique,Sabah,0,0,0
1/08/2022,Mozambique,Sarawak,1,1,0
1/08/2022,Mozambique,Selangor,16,10,6
1/08/2022,Mauritania,Johor,4,1,3
1/08/2022,Mauritania,Kedah,1,1,0
1/08/2022,Mauritania,Pulau Pinang,0,0,0
1/08/2022,Mauritania,Sabah,0,0,0
1/08/2022,Mauritania,Sarawak,0,0,0
1/08/2022,Mauritania,Selangor,21,16,5
1/08/2022,Mauritius,Johor,59,32,27
1/08/2022,Mauritius,Kedah,2,0,2
1/08/2022,Mauritius,Kelantan,0,0,0
1/08/2022,Mauritius,Pahang,0,0,0
1/08/2022,Mauritius,Perak,1,0,1
1/08/2022,Mauritius,Perlis,0,0,0
1/08/2022,Mauritius,Pulau Pinang,7,2,5
1/08/2022,Mauritius,Sabah,0,0,0
1/08/2022,Mauritius,Sarawak,0,0,0
1/08/2022,Mauritius,Selangor,266,137,129
1/08/2022,Malawi,Johor,0,0,0
1/08/2022,Malawi,Pulau Pinang,1,0,1
1/08/2022,Malawi,Sabah,0,0,0
1/08/2022,Malawi,Sarawak,0,0,0
1/08/2022,Malawi,Selangor,28,16,12
1/08/2022,Mayotte,Selangor,0,0,0
1/08/2022,Namibia,Johor,1,0,1
1/08/2022,Namibia,Kedah,0,0,0
1/08/2022,Namibia,Perak,0,0,0
1/08/2022,Namibia,Perlis,0,0,0
1/08/2022,Namibia,Pulau Pinang,0,0,0
1/08/2022,Namibia,Sabah,0,0,0
1/08/2022,Namibia,Sarawak,0,0,0
1/08/2022,Namibia,Selangor,19,11,8
1/08/2022,New Caledonia,Selangor,1,1,0
1/08/2022,Niger,Johor,0,0,0
1/08/2022,Niger,Sabah,0,0,0
1/08/2022,Niger,Selangor,1,1,0
1/08/2022,Nigeria,Johor,21,17,4
1/08/2022,Nigeria,Kedah,1,1,0
1/08/2022,Nigeria,Perlis,0,0,0
1/08/2022,Nigeria,Pulau Pinang,3,3,0
1/08/2022,Nigeria,Sabah,1,1,0
1/08/2022,Nigeria,Sarawak,3,3,0
1/08/2022,Nigeria,Selangor,319,252,67
1/08/2022,Nicaragua,Johor,4,2,2
1/08/2022,Nicaragua,Kedah,0,0,0
1/08/2022,Nicaragua,Pulau Pinang,0,0,0
1/08/2022,Nicaragua,Sabah,0,0,0
1/08/2022,Nicaragua,Selangor,3,2,1
1/08/2022,Netherlands,Johor,1040,645,395
1/08/2022,Netherlands,Kedah,142,79,63
1/08/2022,Netherlands,Kelantan,1,1,0
1/08/2022,Netherlands,Melaka,0,0,0
1/08/2022,Netherlands,Negeri Sembilan,1,1,0
1/08/2022,Netherlands,Pahang,0,0,0
1/08/2022,Netherlands,Perak,11,8,3
1/08/2022,Netherlands,Perlis,24,15,9
1/08/2022,Netherlands,Pulau Pinang,207,128,79
1/08/2022,Netherlands,Sabah,93,48,45
1/08/2022,Netherlands,Sarawak,146,87,59
1/08/2022,Netherlands,Selangor,4282,2479,1803
1/08/2022,Netherlands,Terengganu,0,0,0
1/08/2022,Netherlands,W.P. Labuan,3,1,2
1/08/2022,Norway,Johor,101,70,31
1/08/2022,Norway,Kedah,3,3,0
1/08/2022,Norway,Kelantan,3,3,0
1/08/2022,Norway,Melaka,0,0,0
1/08/2022,Norway,Pahang,0,0,0
1/08/2022,Norway,Perak,0,0,0
1/08/2022,Norway,Perlis,3,0,3
1/08/2022,Norway,Pulau Pinang,33,21,12
1/08/2022,Norway,Sabah,16,15,1
1/08/2022,Norway,Sarawak,14,11,3
1/08/2022,Norway,Selangor,422,281,141
1/08/2022,Norway,W.P. Labuan,0,0,0
1/08/2022,Nepal,Johor,432,338,94
1/08/2022,Nepal,Kedah,4,3,1
1/08/2022,Nepal,Pahang,0,0,0
1/08/2022,Nepal,Perak,0,0,0
1/08/2022,Nepal,Perlis,0,0,0
1/08/2022,Nepal,Pulau Pinang,19,16,3
1/08/2022,Nepal,Sabah,9,8,1
1/08/2022,Nepal,Sarawak,73,48,25
1/08/2022,Nepal,Selangor,27956,27201,755
1/08/2022,Nepal,W.P. Labuan,79,72,7
1/08/2022,Nauru,Johor,0,0,0
1/08/2022,Nauru,Pulau Pinang,0,0,0
1/08/2022,Nauru,Selangor,0,0,0
1/08/2022,New Zealand,Johor,473,304,169
1/08/2022,New Zealand,Kedah,46,24,22
1/08/2022,New Zealand,Kelantan,0,0,0
1/08/2022,New Zealand,Melaka,0,0,0
1/08/2022,New Zealand,Negeri Sembilan,0,0,0
1/08/2022,New Zealand,Pahang,1,1,0
1/08/2022,New Zealand,Perak,11,5,6
1/08/2022,New Zealand,Perlis,12,9,3
1/08/2022,New Zealand,Pulau Pinang,136,83,53
1/08/2022,New Zealand,Sabah,32,20,12
1/08/2022,New Zealand,Sarawak,73,42,31
1/08/2022,New Zealand,Selangor,1445,925,520
1/08/2022,New Zealand,Terengganu,0,0,0
1/08/2022,New Zealand,W.P. Labuan,0,0,0
1/08/2022,Oman,Johor,125,75,50
1/08/2022,Oman,Kedah,5,4,1
1/08/2022,Oman,Kelantan,0,0,0
1/08/2022,Oman,Melaka,0,0,0
1/08/2022,Oman,Perak,0,0,0
1/08/2022,Oman,Perlis,0,0,0
1/08/2022,Oman,Pulau Pinang,10,7,3
1/08/2022,Oman,Sabah,0,0,0
1/08/2022,Oman,Sarawak,7,6,1
1/08/2022,Oman,Selangor,1118,603,515
1/08/2022,Pakistan,Johor,664,477,187
1/08/2022,Pakistan,Kedah,93,69,24
1/08/2022,Pakistan,Kelantan,20,20,0
1/08/2022,Pakistan,Melaka,0,0,0
1/08/2022,Pakistan,Negeri Sembilan,1,1,0
1/08/2022,Pakistan,Pahang,0,0,0
1/08/2022,Pakistan,Perak,32,27,5
1/08/2022,Pakistan,Perlis,25,23,2
1/08/2022,Pakistan,Pulau Pinang,50,34,16
1/08/2022,Pakistan,Sabah,6,6,0
1/08/2022,Pakistan,Sarawak,27,26,1
1/08/2022,Pakistan,Selangor,8805,7367,1438
1/08/2022,Pakistan,W.P. Labuan,0,0,0
1/08/2022,Panama,Johor,1,1,0
1/08/2022,Panama,Kedah,0,0,0
1/08/2022,Panama,Perak,0,0,0
1/08/2022,Panama,Perlis,0,0,0
1/08/2022,Panama,Pulau Pinang,2,2,0
1/08/2022,Panama,Sabah,0,0,0
1/08/2022,Panama,Sarawak,0,0,0
1/08/2022,Panama,Selangor,9,3,6
1/08/2022,Peru,Johor,26,19,7
1/08/2022,Peru,Kedah,2,0,2
1/08/2022,Peru,Kelantan,0,0,0
1/08/2022,Peru,Pahang,0,0,0
1/08/2022,Peru,Perak,0,0,0
1/08/2022,Peru,Perlis,0,0,0
1/08/2022,Peru,Pulau Pinang,11,4,7
1/08/2022,Peru,Sabah,1,1,0
1/08/2022,Peru,Sarawak,0,0,0
1/08/2022,Peru,Selangor,105,58,47
1/08/2022,Peru,W.P. Labuan,0,0,0
1/08/2022,Philippines,Johor,12757,4045,8712
1/08/2022,Philippines,Kedah,189,67,122
1/08/2022,Philippines,Kelantan,7,3,4
1/08/2022,Philippines,Melaka,1,0,1
1/08/2022,Philippines,Negeri Sembilan,0,0,0
1/08/2022,Philippines,Pahang,32,27,5
1/08/2022,Philippines,Perak,51,22,29
1/08/2022,Philippines,Perlis,230,77,153
1/08/2022,Philippines,Pulau Pinang,348,144,204
1/08/2022,Philippines,Sabah,634,244,390
1/08/2022,Philippines,Sarawak,543,223,320
1/08/2022,Philippines,Selangor,11100,4475,6625
1/08/2022,Philippines,Terengganu,0,0,0
1/08/2022,Philippines,W.P. Labuan,25,4,21
1/08/2022,Palau,Johor,0,0,0
1/08/2022,Palau,Pulau Pinang,0,0,0
1/08/2022,Palau,Selangor,1,1,0
1/08/2022,Papua New Guinea,Johor,8,7,1
1/08/2022,Papua New Guinea,Kedah,0,0,0
1/08/2022,Papua New Guinea,Kelantan,0,0,0
1/08/2022,Papua New Guinea,Perak,1,1,0
1/08/2022,Papua New Guinea,Pulau Pinang,1,1,0
1/08/2022,Papua New Guinea,Sabah,0,0,0
1/08/2022,Papua New Guinea,Sarawak,4,1,3
1/08/2022,Papua New Guinea,Selangor,38,18,20
1/08/2022,Poland,Johor,320,174,146
1/08/2022,Poland,Kedah,14,6,8
1/08/2022,Poland,Kelantan,3,1,2
1/08/2022,Poland,Melaka,1,1,0
1/08/2022,Poland,Negeri Sembilan,0,0,0
1/08/2022,Poland,Pahang,0,0,0
1/08/2022,Poland,Perak,5,2,3
1/08/2022,Poland,Perlis,5,3,2
1/08/2022,Poland,Pulau Pinang,35,20,15
1/08/2022,Poland,Sabah,19,7,12
1/08/2022,Poland,Sarawak,46,21,25
1/08/2022,Poland,Selangor,863,433,430
1/08/2022,Poland,Terengganu,0,0,0
1/08/2022,Poland,W.P. Labuan,0,0,0
1/08/2022,"North Korea, Democratic People's Republic of",Selangor,0,0,0
1/08/2022,Portugal,Johor,164,89,75
1/08/2022,Portugal,Kedah,17,11,6
1/08/2022,Portugal,Kelantan,0,0,0
1/08/2022,Portugal,Melaka,0,0,0
1/08/2022,Portugal,Pahang,0,0,0
1/08/2022,Portugal,Perak,2,0,2
1/08/2022,Portugal,Perlis,4,2,2
1/08/2022,Portugal,Pulau Pinang,32,15,17
1/08/2022,Portugal,Sabah,9,6,3
1/08/2022,Portugal,Sarawak,7,3,4
1/08/2022,Portugal,Selangor,739,422,317
1/08/2022,Portugal,W.P. Labuan,0,0,0
1/08/2022,Paraguay,Johor,0,0,0
1/08/2022,Paraguay,Kedah,0,0,0
1/08/2022,Paraguay,Perak,0,0,0
1/08/2022,Paraguay,Perlis,0,0,0
1/08/2022,Paraguay,Pulau Pinang,1,0,1
1/08/2022,Paraguay,Sabah,1,0,1
1/08/2022,Paraguay,Sarawak,0,0,0
1/08/2022,Paraguay,Selangor,8,2,6
1/08/2022,"Palestine, State of",Johor,6,4,2
1/08/2022,"Palestine, State of",Kedah,0,0,0
1/08/2022,"Palestine, State of",Kelantan,0,0,0
1/08/2022,"Palestine, State of",Melaka,0,0,0
1/08/2022,"Palestine, State of",Perak,0,0,0
1/08/2022,"Palestine, State of",Perlis,0,0,0
1/08/2022,"Palestine, State of",Pulau Pinang,0,0,0
1/08/2022,"Palestine, State of",Sabah,0,0,0
1/08/2022,"Palestine, State of",Sarawak,2,1,1
1/08/2022,"Palestine, State of",Selangor,283,182,101
1/08/2022,Qatar,Johor,9,5,4
1/08/2022,Qatar,Kedah,0,0,0
1/08/2022,Qatar,Perlis,0,0,0
1/08/2022,Qatar,Pulau Pinang,0,0,0
1/08/2022,Qatar,Sabah,0,0,0
1/08/2022,Qatar,Sarawak,0,0,0
1/08/2022,Qatar,Selangor,155,101,54
1/08/2022,Réunion,Johor,0,0,0
1/08/2022,Réunion,Sarawak,0,0,0
1/08/2022,Romania,Johor,98,46,52
1/08/2022,Romania,Kedah,1,0,1
1/08/2022,Romania,Kelantan,0,0,0
1/08/2022,Romania,Negeri Sembilan,0,0,0
1/08/2022,Romania,Pahang,0,0,0
1/08/2022,Romania,Perak,0,0,0
1/08/2022,Romania,Perlis,0,0,0
1/08/2022,Romania,Pulau Pinang,9,5,4
1/08/2022,Romania,Sabah,9,3,6
1/08/2022,Romania,Sarawak,4,2,2
1/08/2022,Romania,Selangor,374,195,179
1/08/2022,Romania,W.P. Labuan,0,0,0
1/08/2022,Russian Federation (Russia),Johor,236,121,115
1/08/2022,Russian Federation (Russia),Kedah,48,21,27
1/08/2022,Russian Federation (Russia),Kelantan,2,1,1
1/08/2022,Russian Federation (Russia),Melaka,0,0,0
1/08/2022,Russian Federation (Russia),Negeri Sembilan,0,0,0
1/08/2022,Russian Federation (Russia),Pahang,0,0,0
1/08/2022,Russian Federation (Russia),Perak,1,1,0
1/08/2022,Russian Federation (Russia),Perlis,29,10,19
1/08/2022,Russian Federation (Russia),Pulau Pinang,36,21,15
1/08/2022,Russian Federation (Russia),Sabah,12,6,6
1/08/2022,Russian Federation (Russia),Sarawak,30,17,13
1/08/2022,Russian Federation (Russia),Selangor,2323,1164,1159
1/08/2022,Russian Federation (Russia),W.P. Labuan,0,0,0
1/08/2022,Rwanda,Johor,0,0,0
1/08/2022,Rwanda,Kedah,0,0,0
1/08/2022,Rwanda,Pulau Pinang,0,0,0
1/08/2022,Rwanda,Selangor,2,2,0
1/08/2022,Saudi Arabia,Johor,167,80,87
1/08/2022,Saudi Arabia,Kedah,45,34,11
1/08/2022,Saudi Arabia,Kelantan,9,2,7
1/08/2022,Saudi Arabia,Melaka,0,0,0
1/08/2022,Saudi Arabia,Perak,7,1,6
1/08/2022,Saudi Arabia,Perlis,12,6,6
1/08/2022,Saudi Arabia,Pulau Pinang,56,32,24
1/08/2022,Saudi Arabia,Sabah,13,10,3
1/08/2022,Saudi Arabia,Sarawak,14,11,3
1/08/2022,Saudi Arabia,Selangor,6898,3563,3335
1/08/2022,Saudi Arabia,W.P. Labuan,0,0,0
1/08/2022,Sudan,Johor,9,3,6
1/08/2022,Sudan,Kedah,1,1,0
1/08/2022,Sudan,Kelantan,0,0,0
1/08/2022,Sudan,Perlis,0,0,0
1/08/2022,Sudan,Pulau Pinang,0,0,0
1/08/2022,Sudan,Sabah,0,0,0
1/08/2022,Sudan,Sarawak,2,2,0
1/08/2022,Sudan,Selangor,1001,549,452
1/08/2022,Sudan,W.P. Labuan,1,1,0
1/08/2022,Senegal,Johor,1,0,1
1/08/2022,Senegal,Kedah,2,1,1
1/08/2022,Senegal,Kelantan,0,0,0
1/08/2022,Senegal,Perak,0,0,0
1/08/2022,Senegal,Perlis,0,0,0
1/08/2022,Senegal,Pulau Pinang,0,0,0
1/08/2022,Senegal,Sabah,0,0,0
1/08/2022,Senegal,Sarawak,0,0,0
1/08/2022,Senegal,Selangor,25,17,8
1/08/2022,Singapore,Johor,925212,550835,374377
1/08/2022,Singapore,Kedah,2394,1324,1070
1/08/2022,Singapore,Kelantan,61,44,17
1/08/2022,Singapore,Melaka,13,11,2
1/08/2022,Singapore,Negeri Sembilan,0,0,0
1/08/2022,Singapore,Pahang,75,47,28
1/08/2022,Singapore,Perak,3457,1629,1828
1/08/2022,Singapore,Perlis,147,98,49
1/08/2022,Singapore,Pulau Pinang,11206,5832,5374
1/08/2022,Singapore,Sabah,2101,1106,995
1/08/2022,Singapore,Sarawak,2490,1521,969
1/08/2022,Singapore,Selangor,27171,15045,12126
1/08/2022,Singapore,Terengganu,0,0,0
1/08/2022,Singapore,W.P. Labuan,4,4,0
1/08/2022,South Georgia and the South Sandwich Islands,Johor,0,0,0
1/08/2022,South Georgia and the South Sandwich Islands,Sabah,0,0,0
1/08/2022,South Georgia and the South Sandwich Islands,Selangor,1,1,0
1/08/2022,Saint Helena,Sarawak,0,0,0
1/08/2022,Solomon Islands,Johor,0,0,0
1/08/2022,Solomon Islands,Perlis,1,1,0
1/08/2022,Solomon Islands,Pulau Pinang,0,0,0
1/08/2022,Solomon Islands,Sabah,0,0,0
1/08/2022,Solomon Islands,Sarawak,4,2,2
1/08/2022,Solomon Islands,Selangor,9,4,5
1/08/2022,Solomon Islands,W.P. Labuan,0,0,0
1/08/2022,Sierra Leone,Johor,0,0,0
1/08/2022,Sierra Leone,Kedah,0,0,0
1/08/2022,Sierra Leone,Perak,0,0,0
1/08/2022,Sierra Leone,Pulau Pinang,1,1,0
1/08/2022,Sierra Leone,Sabah,0,0,0
1/08/2022,Sierra Leone,Selangor,15,7,8
1/08/2022,El Salvador,Johor,2,1,1
1/08/2022,El Salvador,Kedah,0,0,0
1/08/2022,El Salvador,Perak,0,0,0
1/08/2022,El Salvador,Perlis,0,0,0
1/08/2022,El Salvador,Pulau Pinang,1,0,1
1/08/2022,El Salvador,Sabah,0,0,0
1/08/2022,El Salvador,Selangor,11,7,4
1/08/2022,El Salvador,W.P. Labuan,0,0,0
1/08/2022,San Marino,Johor,0,0,0
1/08/2022,San Marino,Selangor,2,1,1
1/08/2022,Somalia,Johor,0,0,0
1/08/2022,Somalia,Kedah,0,0,0
1/08/2022,Somalia,Kelantan,0,0,0
1/08/2022,Somalia,Perlis,0,0,0
1/08/2022,Somalia,Sabah,0,0,0
1/08/2022,Somalia,Sarawak,0,0,0
1/08/2022,Somalia,Selangor,200,120,80
1/08/2022,Serbia,Johor,9,4,5
1/08/2022,Serbia,Kedah,0,0,0
1/08/2022,Serbia,Kelantan,0,0,0
1/08/2022,Serbia,Pahang,0,0,0
1/08/2022,Serbia,Perak,0,0,0
1/08/2022,Serbia,Perlis,0,0,0
1/08/2022,Serbia,Pulau Pinang,0,0,0
1/08/2022,Serbia,Sabah,1,0,1
1/08/2022,Serbia,Sarawak,0,0,0
1/08/2022,Serbia,Selangor,28,17,11
1/08/2022,South Sudan,Johor,0,0,0
1/08/2022,South Sudan,Kedah,0,0,0
1/08/2022,South Sudan,Sarawak,0,0,0
1/08/2022,South Sudan,Selangor,17,17,0
1/08/2022,South Sudan,W.P. Labuan,0,0,0
1/08/2022,Sao Tome and Principe,Selangor,2,1,1
1/08/2022,Suriname,Johor,2,2,0
1/08/2022,Suriname,Kedah,0,0,0
1/08/2022,Suriname,Kelantan,0,0,0
1/08/2022,Suriname,Perak,0,0,0
1/08/2022,Suriname,Perlis,0,0,0
1/08/2022,Suriname,Pulau Pinang,0,0,0
1/08/2022,Suriname,Sabah,0,0,0
1/08/2022,Suriname,Sarawak,0,0,0
1/08/2022,Suriname,Selangor,6,4,2
1/08/2022,Slovakia,Johor,19,10,9
1/08/2022,Slovakia,Kedah,35,21,14
1/08/2022,Slovakia,Kelantan,1,0,1
1/08/2022,Slovakia,Negeri Sembilan,0,0,0
1/08/2022,Slovakia,Pahang,0,0,0
1/08/2022,Slovakia,Perak,0,0,0
1/08/2022,Slovakia,Perlis,1,0,1
1/08/2022,Slovakia,Pulau Pinang,6,2,4
1/08/2022,Slovakia,Sabah,12,6,6
1/08/2022,Slovakia,Sarawak,2,1,1
1/08/2022,Slovakia,Selangor,214,113,101
1/08/2022,Slovakia,W.P. Labuan,0,0,0
1/08/2022,Slovenia,Johor,8,5,3
1/08/2022,Slovenia,Kedah,1,0,1
1/08/2022,Slovenia,Kelantan,0,0,0
1/08/2022,Slovenia,Perak,0,0,0
1/08/2022,Slovenia,Perlis,0,0,0
1/08/2022,Slovenia,Pulau Pinang,0,0,0
1/08/2022,Slovenia,Sabah,0,0,0
1/08/2022,Slovenia,Sarawak,4,2,2
1/08/2022,Slovenia,Selangor,72,42,30
1/08/2022,Slovenia,W.P. Labuan,0,0,0
1/08/2022,Sweden,Johor,145,98,47
1/08/2022,Sweden,Kedah,6,4,2
1/08/2022,Sweden,Kelantan,10,5,5
1/08/2022,Sweden,Melaka,0,0,0
1/08/2022,Sweden,Negeri Sembilan,0,0,0
1/08/2022,Sweden,Pahang,0,0,0
1/08/2022,Sweden,Perak,1,1,0
1/08/2022,Sweden,Perlis,0,0,0
1/08/2022,Sweden,Pulau Pinang,32,20,12
1/08/2022,Sweden,Sabah,7,4,3
1/08/2022,Sweden,Sarawak,11,7,4
1/08/2022,Sweden,Selangor,569,386,183
1/08/2022,Sweden,W.P. Labuan,1,1,0
1/08/2022,Eswatini,Johor,0,0,0
1/08/2022,Eswatini,Kedah,0,0,0
1/08/2022,Eswatini,Pulau Pinang,0,0,0
1/08/2022,Eswatini,Sabah,0,0,0
1/08/2022,Eswatini,Selangor,12,3,9
1/08/2022,Seychelles,Johor,6,4,2
1/08/2022,Seychelles,Kedah,0,0,0
1/08/2022,Seychelles,Pulau Pinang,0,0,0
1/08/2022,Seychelles,Sabah,0,0,0
1/08/2022,Seychelles,Sarawak,0,0,0
1/08/2022,Seychelles,Selangor,75,30,45
1/08/2022,Syrian Arab Republic,Johor,10,5,5
1/08/2022,Syrian Arab Republic,Kedah,1,1,0
1/08/2022,Syrian Arab Republic,Kelantan,0,0,0
1/08/2022,Syrian Arab Republic,Pahang,0,0,0
1/08/2022,Syrian Arab Republic,Perlis,0,0,0
1/08/2022,Syrian Arab Republic,Pulau Pinang,1,1,0
1/08/2022,Syrian Arab Republic,Sabah,0,0,0
1/08/2022,Syrian Arab Republic,Sarawak,9,6,3
1/08/2022,Syrian Arab Republic,Selangor,681,393,288
1/08/2022,Syrian Arab Republic,W.P. Labuan,0,0,0
1/08/2022,Turks and Caicos Islands,Perlis,0,0,0
1/08/2022,TCD,Johor,2,2,0
1/08/2022,TCD,Kedah,0,0,0
1/08/2022,TCD,Perlis,0,0,0
1/08/2022,TCD,Selangor,13,7,6
1/08/2022,Togo,Johor,2,1,1
1/08/2022,Togo,Perak,0,0,0
1/08/2022,Togo,Pulau Pinang,0,0,0
1/08/2022,Togo,Selangor,0,0,0
1/08/2022,Thailand,Johor,3938,944,2994
1/08/2022,Thailand,Kedah,39784,27359,12425
1/08/2022,Thailand,Kelantan,28591,14183,14408
1/08/2022,Thailand,Melaka,1,0,1
1/08/2022,Thailand,Negeri Sembilan,0,0,0
1/08/2022,Thailand,Pahang,21,17,4
1/08/2022,Thailand,Perak,6861,3018,3843
1/08/2022,Thailand,Perlis,62471,38204,24267
1/08/2022,Thailand,Pulau Pinang,1549,641,908
1/08/2022,Thailand,Sabah,161,48,113
1/08/2022,Thailand,Sarawak,125,44,81
1/08/2022,Thailand,Selangor,8545,3620,4925
1/08/2022,Thailand,Terengganu,0,0,0
1/08/2022,Thailand,W.P. Labuan,3,1,2
1/08/2022,Tajikistan,Johor,0,0,0
1/08/2022,Tajikistan,Kedah,0,0,0
1/08/2022,Tajikistan,Perlis,0,0,0
1/08/2022,Tajikistan,Pulau Pinang,1,0,1
1/08/2022,Tajikistan,Sabah,0,0,0
1/08/2022,Tajikistan,Selangor,79,52,27
1/08/2022,Tokelau,Selangor,0,0,0
1/08/2022,Turkmenistan,Johor,3,1,2
1/08/2022,Turkmenistan,Kedah,1,0,1
1/08/2022,Turkmenistan,Kelantan,0,0,0
1/08/2022,Turkmenistan,Perlis,0,0,0
1/08/2022,Turkmenistan,Pulau Pinang,0,0,0
1/08/2022,Turkmenistan,Sabah,0,0,0
1/08/2022,Turkmenistan,Sarawak,0,0,0
1/08/2022,Turkmenistan,Selangor,74,41,33
1/08/2022,Timor-Leste,Johor,22,20,2
1/08/2022,Timor-Leste,Kedah,3,2,1
1/08/2022,Timor-Leste,Perlis,0,0,0
1/08/2022,Timor-Leste,Pulau Pinang,5,3,2
1/08/2022,Timor-Leste,Sabah,1,1,0
1/08/2022,Timor-Leste,Sarawak,1,0,1
1/08/2022,Timor-Leste,Selangor,362,244,118
1/08/2022,Tonga,Johor,1,0,1
1/08/2022,Tonga,Pulau Pinang,0,0,0
1/08/2022,Tonga,Sarawak,0,0,0
1/08/2022,Tonga,Selangor,5,1,4
1/08/2022,Trinidad and Tobago,Johor,4,1,3
1/08/2022,Trinidad and Tobago,Kedah,0,0,0
1/08/2022,Trinidad and Tobago,Pahang,0,0,0
1/08/2022,Trinidad and Tobago,Pulau Pinang,0,0,0
1/08/2022,Trinidad and Tobago,Sabah,1,0,1
1/08/2022,Trinidad and Tobago,Sarawak,0,0,0
1/08/2022,Trinidad and Tobago,Selangor,40,28,12
1/08/2022,Tunisia,Johor,5,3,2
1/08/2022,Tunisia,Kedah,2,0,2
1/08/2022,Tunisia,Kelantan,0,0,0
1/08/2022,Tunisia,Melaka,0,0,0
1/08/2022,Tunisia,Perak,0,0,0
1/08/2022,Tunisia,Perlis,0,0,0
1/08/2022,Tunisia,Pulau Pinang,4,1,3
1/08/2022,Tunisia,Sabah,1,0,1
1/08/2022,Tunisia,Sarawak,1,0,1
1/08/2022,Tunisia,Selangor,688,308,380
1/08/2022,Tunisia,W.P. Labuan,0,0,0
1/08/2022,Türkiye,Johor,224,165,59
1/08/2022,Türkiye,Kedah,13,9,4
1/08/2022,Türkiye,Kelantan,2,2,0
1/08/2022,Türkiye,Melaka,0,0,0
1/08/2022,Türkiye,Negeri Sembilan,0,0,0
1/08/2022,Türkiye,Pahang,0,0,0
1/08/2022,Türkiye,Perak,1,1,0
1/08/2022,Türkiye,Perlis,9,8,1
1/08/2022,Türkiye,Pulau Pinang,20,15,5
1/08/2022,Türkiye,Sabah,4,3,1
1/08/2022,Türkiye,Sarawak,15,14,1
1/08/2022,Türkiye,Selangor,797,563,234
1/08/2022,Türkiye,W.P. Labuan,0,0,0
1/08/2022,Tuvalu,Selangor,1,0,1
1/08/2022,"Taiwan, Province of China",Johor,2691,1177,1514
1/08/2022,"Taiwan, Province of China",Kedah,64,31,33
1/08/2022,"Taiwan, Province of China",Kelantan,1,1,0
1/08/2022,"Taiwan, Province of China",Melaka,0,0,0
1/08/2022,"Taiwan, Province of China",Negeri Sembilan,0,0,0
1/08/2022,"Taiwan, Province of China",Pahang,0,0,0
1/08/2022,"Taiwan, Province of China",Perak,38,24,14
1/08/2022,"Taiwan, Province of China",Perlis,5,4,1
1/08/2022,"Taiwan, Province of China",Pulau Pinang,515,294,221
1/08/2022,"Taiwan, Province of China",Sabah,70,32,38
1/08/2022,"Taiwan, Province of China",Sarawak,130,55,75
1/08/2022,"Taiwan, Province of China",Selangor,3107,1768,1339
1/08/2022,"Taiwan, Province of China",W.P. Labuan,1,1,0
1/08/2022,"Tanzania, United Republic of",Johor,4,4,0
1/08/2022,"Tanzania, United Republic of",Kedah,0,0,0
1/08/2022,"Tanzania, United Republic of",Perak,0,0,0
1/08/2022,"Tanzania, United Republic of",Perlis,0,0,0
1/08/2022,"Tanzania, United Republic of",Pulau Pinang,0,0,0
1/08/2022,"Tanzania, United Republic of",Sabah,0,0,0
1/08/2022,"Tanzania, United Republic of",Sarawak,0,0,0
1/08/2022,"Tanzania, United Republic of",Selangor,82,41,41
1/08/2022,Uganda,Johor,7,3,4
1/08/2022,Uganda,Kedah,0,0,0
1/08/2022,Uganda,Perak,0,0,0
1/08/2022,Uganda,Perlis,1,0,1
1/08/2022,Uganda,Pulau Pinang,1,0,1
1/08/2022,Uganda,Sabah,4,2,2
1/08/2022,Uganda,Sarawak,0,0,0
1/08/2022,Uganda,Selangor,49,26,23
1/08/2022,Ukraine,Johor,83,59,24
1/08/2022,Ukraine,Kedah,21,10,11
1/08/2022,Ukraine,Kelantan,0,0,0
1/08/2022,Ukraine,Melaka,0,0,0
1/08/2022,Ukraine,Negeri Sembilan,0,0,0
1/08/2022,Ukraine,Pahang,0,0,0
1/08/2022,Ukraine,Perak,0,0,0
1/08/2022,Ukraine,Perlis,7,1,6
1/08/2022,Ukraine,Pulau Pinang,14,6,8
1/08/2022,Ukraine,Sabah,6,2,4
1/08/2022,Ukraine,Sarawak,0,0,0
1/08/2022,Ukraine,Selangor,442,230,212
1/08/2022,Ukraine,W.P. Labuan,0,0,0
1/08/2022,Uruguay,Johor,4,1,3
1/08/2022,Uruguay,Kedah,2,1,1
1/08/2022,Uruguay,Kelantan,0,0,0
1/08/2022,Uruguay,Perak,0,0,0
1/08/2022,Uruguay,Perlis,0,0,0
1/08/2022,Uruguay,Pulau Pinang,0,0,0
1/08/2022,Uruguay,Sabah,0,0,0
1/08/2022,Uruguay,Sarawak,0,0,0
1/08/2022,Uruguay,Selangor,11,6,5
1/08/2022,Uruguay,W.P. Labuan,0,0,0
1/08/2022,United States of America,Johor,2820,1812,1008
1/08/2022,United States of America,Kedah,235,126,109
1/08/2022,United States of America,Kelantan,7,6,1
1/08/2022,United States of America,Melaka,2,2,0
1/08/2022,United States of America,Negeri Sembilan,1,1,0
1/08/2022,United States of America,Pahang,2,0,2
1/08/2022,United States of America,Perak,108,53,55
1/08/2022,United States of America,Perlis,47,32,15
1/08/2022,United States of America,Pulau Pinang,1260,805,455
1/08/2022,United States of America,Sabah,207,116,91
1/08/2022,United States of America,Sarawak,197,108,89
1/08/2022,United States of America,Selangor,9455,5746,3709
1/08/2022,United States of America,Terengganu,0,0,0
1/08/2022,United States of America,W.P. Labuan,0,0,0
1/08/2022,Uzbekistan,Johor,27,18,9
1/08/2022,Uzbekistan,Kedah,6,4,2
1/08/2022,Uzbekistan,Kelantan,0,0,0
1/08/2022,Uzbekistan,Perak,0,0,0
1/08/2022,Uzbekistan,Perlis,1,0,1
1/08/2022,Uzbekistan,Pulau Pinang,8,2,6
1/08/2022,Uzbekistan,Sabah,43,43,0
1/08/2022,Uzbekistan,Sarawak,1,1,0
1/08/2022,Uzbekistan,Selangor,767,433,334
1/08/2022,Holy See,Johor,0,0,0
1/08/2022,Holy See,Sarawak,0,0,0
1/08/2022,Holy See,Selangor,0,0,0
1/08/2022,Saint Vincent and the Grenadines,Johor,0,0,0
1/08/2022,Saint Vincent and the Grenadines,Kedah,0,0,0
1/08/2022,Saint Vincent and the Grenadines,Pulau Pinang,0,0,0
1/08/2022,Saint Vincent and the Grenadines,Sarawak,0,0,0
1/08/2022,Saint Vincent and the Grenadines,Selangor,5,3,2
1/08/2022,"Venezuela, Bolivarian Republic of",Johor,4,3,1
1/08/2022,"Venezuela, Bolivarian Republic of",Kedah,1,0,1
1/08/2022,"Venezuela, Bolivarian Republic of",Kelantan,0,0,0
1/08/2022,"Venezuela, Bolivarian Republic of",Melaka,0,0,0
1/08/2022,"Venezuela, Bolivarian Republic of",Perak,0,0,0
1/08/2022,"Venezuela, Bolivarian Republic of",Perlis,0,0,0
1/08/2022,"Venezuela, Bolivarian Republic of",Pulau Pinang,0,0,0
1/08/2022,"Venezuela, Bolivarian Republic of",Sabah,0,0,0
1/08/2022,"Venezuela, Bolivarian Republic of",Sarawak,4,2,2
1/08/2022,"Venezuela, Bolivarian Republic of",Selangor,54,25,29
1/08/2022,"Venezuela, Bolivarian Republic of",W.P. Labuan,0,0,0
1/08/2022,Viet Nam,Johor,15557,5597,9960
1/08/2022,Viet Nam,Kedah,163,26,137
1/08/2022,Viet Nam,Kelantan,8,8,0
1/08/2022,Viet Nam,Melaka,2,0,2
1/08/2022,Viet Nam,Negeri Sembilan,0,0,0
1/08/2022,Viet Nam,Pahang,0,0,0
1/08/2022,Viet Nam,Perak,105,8,97
1/08/2022,Viet Nam,Perlis,174,23,151
1/08/2022,Viet Nam,Pulau Pinang,1269,398,871
1/08/2022,Viet Nam,Sabah,30,10,20
1/08/2022,Viet Nam,Sarawak,50,7,43
1/08/2022,Viet Nam,Selangor,12326,4480,7846
1/08/2022,Viet Nam,Terengganu,0,0,0
1/08/2022,Viet Nam,W.P. Labuan,4,2,2
1/08/2022,Vanuatu,Johor,23,15,8
1/08/2022,Vanuatu,Kedah,0,0,0
1/08/2022,Vanuatu,Pulau Pinang,2,2,0
1/08/2022,Vanuatu,Sabah,0,0,0
1/08/2022,Vanuatu,Sarawak,0,0,0
1/08/2022,Vanuatu,Selangor,37,27,10
1/08/2022, Samoa,Johor,2,2,0
1/08/2022, Samoa,Sarawak,0,0,0
1/08/2022, Samoa,Selangor,0,0,0
1/08/2022,Yemen,Johor,29,23,6
1/08/2022,Yemen,Kedah,2,2,0
1/08/2022,Yemen,Kelantan,1,1,0
1/08/2022,Yemen,Melaka,0,0,0
1/08/2022,Yemen,Pahang,0,0,0
1/08/2022,Yemen,Perak,0,0,0
1/08/2022,Yemen,Perlis,1,1,0
1/08/2022,Yemen,Pulau Pinang,6,4,2
1/08/2022,Yemen,Sabah,1,1,0
1/08/2022,Yemen,Sarawak,1,1,0
1/08/2022,Yemen,Selangor,1486,941,545
1/08/2022,Yemen,W.P. Labuan,0,0,0
1/08/2022,South Africa,Johor,199,124,75
1/08/2022,South Africa,Kedah,18,12,6
1/08/2022,South Africa,Kelantan,0,0,0
1/08/2022,South Africa,Melaka,0,0,0
1/08/2022,South Africa,Pahang,0,0,0
1/08/2022,South Africa,Perak,6,2,4
1/08/2022,South Africa,Perlis,8,4,4
1/08/2022,South Africa,Pulau Pinang,35,20,15
1/08/2022,South Africa,Sabah,33,18,15
1/08/2022,South Africa,Sarawak,92,39,53
1/08/2022,South Africa,Selangor,610,351,259
1/08/2022,South Africa,Terengganu,0,0,0
1/08/2022,South Africa,W.P. Labuan,0,0,0
1/08/2022,ZAR,Selangor,0,0,0
1/08/2022,Zambia,Johor,5,3,2
1/08/2022,Zambia,Kedah,0,0,0
1/08/2022,Zambia,Perak,0,0,0
1/08/2022,Zambia,Perlis,0,0,0
1/08/2022,Zambia,Pulau Pinang,0,0,0
1/08/2022,Zambia,Sabah,0,0,0
1/08/2022,Zambia,Sarawak,1,0,1
1/08/2022,Zambia,Selangor,37,20,17
1/08/2022,Zimbabwe,Johor,7,3,4
1/08/2022,Zimbabwe,Kedah,1,0,1
1/08/2022,Zimbabwe,Kelantan,1,0,1
1/08/2022,Zimbabwe,Perak,0,0,0
1/08/2022,Zimbabwe,Perlis,0,0,0
1/08/2022,Zimbabwe,Pulau Pinang,0,0,0
1/08/2022,Zimbabwe,Sabah,0,0,0
1/08/2022,Zimbabwe,Sarawak,2,1,1
1/08/2022,Zimbabwe,Selangor,113,43,70
1/09/2022,Aruba,Kedah,0,0,0
1/09/2022,Aruba,Pulau Pinang,0,0,0
1/09/2022,Afghanistan,Johor,0,0,0
1/09/2022,Afghanistan,Kedah,0,0,0
1/09/2022,Afghanistan,Perlis,0,0,0
1/09/2022,Afghanistan,Pulau Pinang,0,0,0
1/09/2022,Afghanistan,Sarawak,0,0,0
1/09/2022,Afghanistan,Selangor,51,45,6
1/09/2022,Angola,Johor,0,0,0
1/09/2022,Angola,Kedah,0,0,0
1/09/2022,Angola,Sabah,0,0,0
1/09/2022,Angola,Selangor,12,5,7
1/09/2022,Anguilla,Selangor,0,0,0
1/09/2022,Albania,Johor,17,10,7
1/09/2022,Albania,Kedah,0,0,0
1/09/2022,Albania,Perak,0,0,0
1/09/2022,Albania,Perlis,0,0,0
1/09/2022,Albania,Pulau Pinang,1,1,0
1/09/2022,Albania,Sabah,1,0,1
1/09/2022,Albania,Sarawak,0,0,0
1/09/2022,Albania,Selangor,23,10,13
1/09/2022,Andorra,Johor,1,1,0
1/09/2022,Andorra,Kedah,0,0,0
1/09/2022,Andorra,Perlis,0,0,0
1/09/2022,Andorra,Pulau Pinang,1,0,1
1/09/2022,Andorra,Selangor,7,4,3
1/09/2022,Antigua and Barbuda,Selangor,0,0,0
1/09/2022,United Arab Emirates,Johor,13,5,8
1/09/2022,United Arab Emirates,Kedah,0,0,0
1/09/2022,United Arab Emirates,Kelantan,0,0,0
1/09/2022,United Arab Emirates,Perak,0,0,0
1/09/2022,United Arab Emirates,Perlis,0,0,0
1/09/2022,United Arab Emirates,Pulau Pinang,0,0,0
1/09/2022,United Arab Emirates,Sabah,0,0,0
1/09/2022,United Arab Emirates,Sarawak,0,0,0
1/09/2022,United Arab Emirates,Selangor,221,170,51
1/09/2022,Argentina,Johor,44,28,16
1/09/2022,Argentina,Kedah,10,6,4
1/09/2022,Argentina,Kelantan,2,1,1
1/09/2022,Argentina,Melaka,0,0,0
1/09/2022,Argentina,Perak,2,1,1
1/09/2022,Argentina,Perlis,7,5,2
1/09/2022,Argentina,Pulau Pinang,6,2,4
1/09/2022,Argentina,Sabah,1,0,1
1/09/2022,Argentina,Sarawak,3,1,2
1/09/2022,Argentina,Selangor,221,127,94
1/09/2022,Argentina,W.P. Labuan,0,0,0
1/09/2022,Armenia,Johor,4,2,2
1/09/2022,Armenia,Kedah,0,0,0
1/09/2022,Armenia,Kelantan,0,0,0
1/09/2022,Armenia,Perak,0,0,0
1/09/2022,Armenia,Perlis,0,0,0
1/09/2022,Armenia,Pulau Pinang,0,0,0
1/09/2022,Armenia,Sabah,0,0,0
1/09/2022,Armenia,Sarawak,0,0,0
1/09/2022,Armenia,Selangor,32,18,14
1/09/2022,Antarctica,Selangor,0,0,0
1/09/2022,Antigua and Barbuda,Johor,9,4,5
1/09/2022,Antigua and Barbuda,Kedah,0,0,0
1/09/2022,Antigua and Barbuda,Pulau Pinang,0,0,0
1/09/2022,Antigua and Barbuda,Sarawak,1,1,0
1/09/2022,Antigua and Barbuda,Selangor,7,5,2
1/09/2022,Australia,Johor,4241,2505,1736
1/09/2022,Australia,Kedah,326,170,156
1/09/2022,Australia,Kelantan,3,3,0
1/09/2022,Australia,Melaka,6,5,1
1/09/2022,Australia,Negeri Sembilan,2,2,0
1/09/2022,Australia,Pahang,8,4,4
1/09/2022,Australia,Perak,187,89,98
1/09/2022,Australia,Perlis,62,43,19
1/09/2022,Australia,Pulau Pinang,1276,698,578
1/09/2022,Australia,Sabah,355,181,174
1/09/2022,Australia,Sarawak,434,235,199
1/09/2022,Australia,Selangor,14837,8813,6024
1/09/2022,Australia,Terengganu,0,0,0
1/09/2022,Australia,W.P. Labuan,7,5,2
1/09/2022,Austria,Johor,133,84,49
1/09/2022,Austria,Kedah,19,8,11
1/09/2022,Austria,Kelantan,0,0,0
1/09/2022,Austria,Melaka,0,0,0
1/09/2022,Austria,Negeri Sembilan,0,0,0
1/09/2022,Austria,Pahang,1,1,0
1/09/2022,Austria,Perak,6,3,3
1/09/2022,Austria,Perlis,7,2,5
1/09/2022,Austria,Pulau Pinang,77,60,17
1/09/2022,Austria,Sabah,10,6,4
1/09/2022,Austria,Sarawak,9,6,3
1/09/2022,Austria,Selangor,569,369,200
1/09/2022,Austria,Terengganu,2,1,1
1/09/2022,Austria,W.P. Labuan,0,0,0
1/09/2022,Azerbaijan,Johor,1,0,1
1/09/2022,Azerbaijan,Kedah,1,1,0
1/09/2022,Azerbaijan,Kelantan,0,0,0
1/09/2022,Azerbaijan,Melaka,0,0,0
1/09/2022,Azerbaijan,Perlis,0,0,0
1/09/2022,Azerbaijan,Pulau Pinang,0,0,0
1/09/2022,Azerbaijan,Sabah,0,0,0
1/09/2022,Azerbaijan,Sarawak,1,0,1
1/09/2022,Azerbaijan,Selangor,65,30,35
1/09/2022,Azerbaijan,W.P. Labuan,0,0,0
1/09/2022,Burundi,Pulau Pinang,0,0,0
1/09/2022,Burundi,Sarawak,0,0,0
1/09/2022,Burundi,Selangor,2,1,1
1/09/2022,Belgium,Johor,228,145,83
1/09/2022,Belgium,Kedah,26,17,9
1/09/2022,Belgium,Kelantan,1,1,0
1/09/2022,Belgium,Melaka,0,0,0
1/09/2022,Belgium,Negeri Sembilan,0,0,0
1/09/2022,Belgium,Pahang,0,0,0
1/09/2022,Belgium,Perak,3,3,0
1/09/2022,Belgium,Perlis,12,8,4
1/09/2022,Belgium,Pulau Pinang,34,22,12
1/09/2022,Belgium,Sabah,30,15,15
1/09/2022,Belgium,Sarawak,8,5,3
1/09/2022,Belgium,Selangor,953,582,371
1/09/2022,Belgium,W.P. Labuan,0,0,0
1/09/2022,Benin,Johor,0,0,0
1/09/2022,Benin,Kedah,0,0,0
1/09/2022,Benin,Perak,0,0,0
1/09/2022,Benin,Pulau Pinang,0,0,0
1/09/2022,Benin,Sabah,0,0,0
1/09/2022,Benin,Sarawak,0,0,0
1/09/2022,Benin,Selangor,9,6,3
1/09/2022,Burkina Faso,Perak,0,0,0
1/09/2022,Burkina Faso,Pulau Pinang,1,1,0
1/09/2022,Burkina Faso,Selangor,10,9,1
1/09/2022,Bangladesh,Johor,1702,1368,334
1/09/2022,Bangladesh,Kedah,35,24,11
1/09/2022,Bangladesh,Kelantan,1,1,0
1/09/2022,Bangladesh,Melaka,0,0,0
1/09/2022,Bangladesh,Negeri Sembilan,1,1,0
1/09/2022,Bangladesh,Pahang,0,0,0
1/09/2022,Bangladesh,Perak,0,0,0
1/09/2022,Bangladesh,Perlis,5,5,0
1/09/2022,Bangladesh,Pulau Pinang,172,164,8
1/09/2022,Bangladesh,Sabah,1,1,0
1/09/2022,Bangladesh,Sarawak,17,16,1
1/09/2022,Bangladesh,Selangor,25148,23571,1577
1/09/2022,Bangladesh,W.P. Labuan,3,3,0
1/09/2022,Bulgaria,Johor,42,21,21
1/09/2022,Bulgaria,Kedah,1,0,1
1/09/2022,Bulgaria,Kelantan,0,0,0
1/09/2022,Bulgaria,Pahang,0,0,0
1/09/2022,Bulgaria,Perak,0,0,0
1/09/2022,Bulgaria,Perlis,0,0,0
1/09/2022,Bulgaria,Pulau Pinang,4,1,3
1/09/2022,Bulgaria,Sabah,1,0,1
1/09/2022,Bulgaria,Sarawak,2,2,0
1/09/2022,Bulgaria,Selangor,107,67,40
1/09/2022,Bulgaria,W.P. Labuan,0,0,0
1/09/2022,Bahrain,Johor,1,1,0
1/09/2022,Bahrain,Kedah,0,0,0
1/09/2022,Bahrain,Kelantan,0,0,0
1/09/2022,Bahrain,Perlis,1,1,0
1/09/2022,Bahrain,Pulau Pinang,3,3,0
1/09/2022,Bahrain,Sabah,0,0,0
1/09/2022,Bahrain,Sarawak,0,0,0
1/09/2022,Bahrain,Selangor,121,78,43
1/09/2022,Bahamas,Johor,0,0,0
1/09/2022,Bahamas,Kedah,0,0,0
1/09/2022,Bahamas,Perak,0,0,0
1/09/2022,Bahamas,Sabah,0,0,0
1/09/2022,Bahamas,Sarawak,0,0,0
1/09/2022,Bahamas,Selangor,3,3,0
1/09/2022,Bosnia and Herzegovina,Johor,1,0,1
1/09/2022,Bosnia and Herzegovina,Kedah,0,0,0
1/09/2022,Bosnia and Herzegovina,Perlis,0,0,0
1/09/2022,Bosnia and Herzegovina,Pulau Pinang,1,1,0
1/09/2022,Bosnia and Herzegovina,Sabah,2,1,1
1/09/2022,Bosnia and Herzegovina,Sarawak,1,1,0
1/09/2022,Bosnia and Herzegovina,Selangor,35,20,15
1/09/2022,Belarus,Johor,12,7,5
1/09/2022,Belarus,Kedah,2,1,1
1/09/2022,Belarus,Kelantan,0,0,0
1/09/2022,Belarus,Pahang,1,0,1
1/09/2022,Belarus,Perak,0,0,0
1/09/2022,Belarus,Perlis,0,0,0
1/09/2022,Belarus,Pulau Pinang,1,1,0
1/09/2022,Belarus,Sabah,0,0,0
1/09/2022,Belarus,Sarawak,3,2,1
1/09/2022,Belarus,Selangor,114,44,70
1/09/2022,Belarus,W.P. Labuan,0,0,0
1/09/2022,Belize,Johor,1,1,0
1/09/2022,Belize,Pulau Pinang,0,0,0
1/09/2022,Belize,Sarawak,0,0,0
1/09/2022,Belize,Selangor,7,4,3
1/09/2022,Bermuda,Selangor,0,0,0
1/09/2022,Bolivia,Johor,2,2,0
1/09/2022,Bolivia,Kedah,0,0,0
1/09/2022,Bolivia,Melaka,0,0,0
1/09/2022,Bolivia,Perak,0,0,0
1/09/2022,Bolivia,Perlis,0,0,0
1/09/2022,Bolivia,Pulau Pinang,4,1,3
1/09/2022,Bolivia,Sabah,0,0,0
1/09/2022,Bolivia,Sarawak,3,2,1
1/09/2022,Bolivia,Selangor,20,7,13
1/09/2022,Brazil,Johor,173,94,79
1/09/2022,Brazil,Kedah,9,2,7
1/09/2022,Brazil,Kelantan,0,0,0
1/09/2022,Brazil,Melaka,0,0,0
1/09/2022,Brazil,Pahang,0,0,0
1/09/2022,Brazil,Perak,5,5,0
1/09/2022,Brazil,Perlis,6,3,3
1/09/2022,Brazil,Pulau Pinang,11,7,4
1/09/2022,Brazil,Sabah,6,5,1
1/09/2022,Brazil,Sarawak,7,3,4
1/09/2022,Brazil,Selangor,656,414,242
1/09/2022,Brazil,W.P. Labuan,0,0,0
1/09/2022,Barbados,Johor,0,0,0
1/09/2022,Barbados,Kedah,0,0,0
1/09/2022,Barbados,Perlis,0,0,0
1/09/2022,Barbados,Pulau Pinang,0,0,0
1/09/2022,Barbados,Selangor,7,3,4
1/09/2022,Brunei Darussalam,Johor,365,207,158
1/09/2022,Brunei Darussalam,Kedah,8,7,1
1/09/2022,Brunei Darussalam,Kelantan,3,2,1
1/09/2022,Brunei Darussalam,Melaka,0,0,0
1/09/2022,Brunei Darussalam,Pahang,0,0,0
1/09/2022,Brunei Darussalam,Perak,3,2,1
1/09/2022,Brunei Darussalam,Perlis,26,14,12
1/09/2022,Brunei Darussalam,Pulau Pinang,12,5,7
1/09/2022,Brunei Darussalam,Sabah,739,349,390
1/09/2022,Brunei Darussalam,Sarawak,56010,30172,25838
1/09/2022,Brunei Darussalam,Selangor,3519,1780,1739
1/09/2022,Brunei Darussalam,W.P. Labuan,647,430,217
1/09/2022,Bhutan,Johor,2,2,0
1/09/2022,Bhutan,Kedah,0,0,0
1/09/2022,Bhutan,Perak,0,0,0
1/09/2022,Bhutan,Perlis,0,0,0
1/09/2022,Bhutan,Pulau Pinang,2,0,2
1/09/2022,Bhutan,Sabah,0,0,0
1/09/2022,Bhutan,Sarawak,0,0,0
1/09/2022,Bhutan,Selangor,63,37,26
1/09/2022,Botswana,Johor,2,0,2
1/09/2022,Botswana,Kedah,0,0,0
1/09/2022,Botswana,Perlis,0,0,0
1/09/2022,Botswana,Pulau Pinang,1,0,1
1/09/2022,Botswana,Sabah,0,0,0
1/09/2022,Botswana,Sarawak,0,0,0
1/09/2022,Botswana,Selangor,3,1,2
1/09/2022,Central African Republic,Kedah,0,0,0
1/09/2022,Central African Republic,Selangor,0,0,0
1/09/2022,Canada,Johor,961,577,384
1/09/2022,Canada,Kedah,53,33,20
1/09/2022,Canada,Kelantan,5,1,4
1/09/2022,Canada,Melaka,0,0,0
1/09/2022,Canada,Negeri Sembilan,0,0,0
1/09/2022,Canada,Pahang,0,0,0
1/09/2022,Canada,Perak,19,10,9
1/09/2022,Canada,Perlis,19,14,5
1/09/2022,Canada,Pulau Pinang,216,132,84
1/09/2022,Canada,Sabah,90,41,49
1/09/2022,Canada,Sarawak,201,114,87
1/09/2022,Canada,Selangor,2608,1656,952
1/09/2022,Canada,Terengganu,0,0,0
1/09/2022,Canada,W.P. Labuan,0,0,0
1/09/2022,Cocos (Keeling) Islands,Selangor,0,0,0
1/09/2022,Switzerland,Johor,255,156,99
1/09/2022,Switzerland,Kedah,28,21,7
1/09/2022,Switzerland,Kelantan,1,1,0
1/09/2022,Switzerland,Melaka,0,0,0
1/09/2022,Switzerland,Negeri Sembilan,0,0,0
1/09/2022,Switzerland,Pahang,0,0,0
1/09/2022,Switzerland,Perak,6,5,1
1/09/2022,Switzerland,Perlis,6,4,2
1/09/2022,Switzerland,Pulau Pinang,92,62,30
1/09/2022,Switzerland,Sabah,29,14,15
1/09/2022,Switzerland,Sarawak,33,13,20
1/09/2022,Switzerland,Selangor,835,528,307
1/09/2022,Switzerland,W.P. Labuan,0,0,0
1/09/2022,Chile,Johor,41,20,21
1/09/2022,Chile,Kedah,3,0,3
1/09/2022,Chile,Kelantan,0,0,0
1/09/2022,Chile,Melaka,0,0,0
1/09/2022,Chile,Pahang,0,0,0
1/09/2022,Chile,Perak,0,0,0
1/09/2022,Chile,Perlis,4,3,1
1/09/2022,Chile,Pulau Pinang,1,1,0
1/09/2022,Chile,Sabah,5,2,3
1/09/2022,Chile,Sarawak,1,0,1
1/09/2022,Chile,Selangor,91,51,40
1/09/2022,China,Johor,20790,8385,12405
1/09/2022,China,Kedah,300,120,180
1/09/2022,China,Kelantan,3,1,2
1/09/2022,China,Melaka,0,0,0
1/09/2022,China,Pahang,3,2,1
1/09/2022,China,Perak,115,43,72
1/09/2022,China,Perlis,45,27,18
1/09/2022,China,Pulau Pinang,1050,528,522
1/09/2022,China,Sabah,347,171,176
1/09/2022,China,Sarawak,288,124,164
1/09/2022,China,Selangor,14957,8875,6082
1/09/2022,China,Terengganu,0,0,0
1/09/2022,China,W.P. Labuan,4,2,2
1/09/2022,Côte d'Ivoire,Johor,0,0,0
1/09/2022,Côte d'Ivoire,Kedah,0,0,0
1/09/2022,Côte d'Ivoire,Pulau Pinang,0,0,0
1/09/2022,Côte d'Ivoire,Sabah,0,0,0
1/09/2022,Côte d'Ivoire,Sarawak,0,0,0
1/09/2022,Côte d'Ivoire,Selangor,32,27,5
1/09/2022,Cameroon,Johor,2,2,0
1/09/2022,Cameroon,Kedah,0,0,0
1/09/2022,Cameroon,Pulau Pinang,0,0,0
1/09/2022,Cameroon,Sabah,0,0,0
1/09/2022,Cameroon,Sarawak,0,0,0
1/09/2022,Cameroon,Selangor,16,13,3
1/09/2022,Congo,Johor,0,0,0
1/09/2022,Congo,Pulau Pinang,0,0,0
1/09/2022,Congo,Sarawak,0,0,0
1/09/2022,Congo,Selangor,15,13,2
1/09/2022,Congo,Johor,0,0,0
1/09/2022,Congo,Kedah,0,0,0
1/09/2022,Congo,Selangor,1,1,0
1/09/2022,Cook Islands,Selangor,0,0,0
1/09/2022,Colombia,Johor,26,14,12
1/09/2022,Colombia,Kedah,5,3,2
1/09/2022,Colombia,Perak,0,0,0
1/09/2022,Colombia,Pulau Pinang,1,1,0
1/09/2022,Colombia,Sabah,0,0,0
1/09/2022,Colombia,Sarawak,0,0,0
1/09/2022,Colombia,Selangor,107,63,44
1/09/2022,Colombia,W.P. Labuan,0,0,0
1/09/2022,Comoros,Johor,0,0,0
1/09/2022,Comoros,Kedah,0,0,0
1/09/2022,Comoros,Selangor,4,4,0
1/09/2022,Cabo Verde,Johor,0,0,0
1/09/2022,Cabo Verde,Kedah,0,0,0
1/09/2022,Cabo Verde,Pulau Pinang,0,0,0
1/09/2022,Cabo Verde,Sabah,0,0,0
1/09/2022,Cabo Verde,Selangor,1,1,0
1/09/2022,Costa Rica,Johor,12,8,4
1/09/2022,Costa Rica,Kedah,0,0,0
1/09/2022,Costa Rica,Perak,0,0,0
1/09/2022,Costa Rica,Perlis,2,2,0
1/09/2022,Costa Rica,Pulau Pinang,3,2,1
1/09/2022,Costa Rica,Sabah,0,0,0
1/09/2022,Costa Rica,Sarawak,0,0,0
1/09/2022,Costa Rica,Selangor,44,23,21
1/09/2022,Cuba,Johor,1,1,0
1/09/2022,Cuba,Kedah,0,0,0
1/09/2022,Cuba,Perlis,0,0,0
1/09/2022,Cuba,Pulau Pinang,0,0,0
1/09/2022,Cuba,Sabah,0,0,0
1/09/2022,Cuba,Sarawak,0,0,0
1/09/2022,Cuba,Selangor,15,3,12
1/09/2022,Cyprus,Johor,12,8,4
1/09/2022,Cyprus,Kedah,1,0,1
1/09/2022,Cyprus,Perak,0,0,0
1/09/2022,Cyprus,Perlis,0,0,0
1/09/2022,Cyprus,Pulau Pinang,3,3,0
1/09/2022,Cyprus,Sabah,0,0,0
1/09/2022,Cyprus,Sarawak,0,0,0
1/09/2022,Cyprus,Selangor,32,25,7
1/09/2022,Czechia,Johor,84,52,32
1/09/2022,Czechia,Kedah,3,1,2
1/09/2022,Czechia,Kelantan,0,0,0
1/09/2022,Czechia,Melaka,0,0,0
1/09/2022,Czechia,Negeri Sembilan,1,1,0
1/09/2022,Czechia,Perak,0,0,0
1/09/2022,Czechia,Perlis,10,7,3
1/09/2022,Czechia,Pulau Pinang,12,9,3
1/09/2022,Czechia,Sabah,6,3,3
1/09/2022,Czechia,Sarawak,1,1,0
1/09/2022,Czechia,Selangor,319,193,126
1/09/2022,Czechia,W.P. Labuan,0,0,0
1/09/2022,Germany,Johor,1858,1162,696
1/09/2022,Germany,Kedah,144,71,73
1/09/2022,Germany,Kelantan,6,4,2
1/09/2022,Germany,Melaka,8,4,4
1/09/2022,Germany,Negeri Sembilan,0,0,0
1/09/2022,Germany,Pahang,3,2,1
1/09/2022,Germany,Perak,11,9,2
1/09/2022,Germany,Perlis,78,46,32
1/09/2022,Germany,Pulau Pinang,470,346,124
1/09/2022,Germany,Sabah,118,76,42
1/09/2022,Germany,Sarawak,152,80,72
1/09/2022,Germany,Selangor,5457,3392,2065
1/09/2022,Germany,Terengganu,1,1,0
1/09/2022,Germany,W.P. Labuan,3,2,1
1/09/2022,Djibouti,Johor,0,0,0
1/09/2022,Djibouti,Selangor,11,7,4
1/09/2022,Dominica,Johor,8,8,0
1/09/2022,Dominica,Kedah,0,0,0
1/09/2022,Dominica,Pulau Pinang,0,0,0
1/09/2022,Dominica,Sabah,0,0,0
1/09/2022,Dominica,Sarawak,4,2,2
1/09/2022,Dominica,Selangor,21,20,1
1/09/2022,Dominica,W.P. Labuan,0,0,0
1/09/2022,Denmark,Johor,217,146,71
1/09/2022,Denmark,Kedah,36,14,22
1/09/2022,Denmark,Kelantan,0,0,0
1/09/2022,Denmark,Melaka,0,0,0
1/09/2022,Denmark,Negeri Sembilan,0,0,0
1/09/2022,Denmark,Pahang,29,12,17
1/09/2022,Denmark,Perak,0,0,0
1/09/2022,Denmark,Perlis,18,10,8
1/09/2022,Denmark,Pulau Pinang,55,40,15
1/09/2022,Denmark,Sabah,25,16,9
1/09/2022,Denmark,Sarawak,17,10,7
1/09/2022,Denmark,Selangor,684,427,257
1/09/2022,Denmark,W.P. Labuan,1,0,1
1/09/2022,Dominican Republic,Johor,0,0,0
1/09/2022,Dominican Republic,Kedah,0,0,0
1/09/2022,Dominican Republic,Perak,0,0,0
1/09/2022,Dominican Republic,Perlis,0,0,0
1/09/2022,Dominican Republic,Pulau Pinang,1,1,0
1/09/2022,Dominican Republic,Sabah,0,0,0
1/09/2022,Dominican Republic,Sarawak,0,0,0
1/09/2022,Dominican Republic,Selangor,8,3,5
1/09/2022,Algeria,Johor,21,16,5
1/09/2022,Algeria,Kedah,0,0,0
1/09/2022,Algeria,Kelantan,0,0,0
1/09/2022,Algeria,Melaka,0,0,0
1/09/2022,Algeria,Perak,0,0,0
1/09/2022,Algeria,Perlis,0,0,0
1/09/2022,Algeria,Pulau Pinang,0,0,0
1/09/2022,Algeria,Sabah,1,1,0
1/09/2022,Algeria,Sarawak,1,1,0
1/09/2022,Algeria,Selangor,478,285,193
1/09/2022,Algeria,W.P. Labuan,0,0,0
1/09/2022,Ecuador,Johor,7,4,3
1/09/2022,Ecuador,Kedah,3,2,1
1/09/2022,Ecuador,Perak,0,0,0
1/09/2022,Ecuador,Perlis,0,0,0
1/09/2022,Ecuador,Pulau Pinang,1,0,1
1/09/2022,Ecuador,Sabah,1,1,0
1/09/2022,Ecuador,Sarawak,2,1,1
1/09/2022,Ecuador,Selangor,43,21,22
1/09/2022,Egypt,Johor,164,137,27
1/09/2022,Egypt,Kedah,2,2,0
1/09/2022,Egypt,Kelantan,2,2,0
1/09/2022,Egypt,Melaka,0,0,0
1/09/2022,Egypt,Pahang,0,0,0
1/09/2022,Egypt,Perak,0,0,0
1/09/2022,Egypt,Perlis,0,0,0
1/09/2022,Egypt,Pulau Pinang,4,4,0
1/09/2022,Egypt,Sabah,0,0,0
1/09/2022,Egypt,Sarawak,119,74,45
1/09/2022,Egypt,Selangor,1708,1135,573
1/09/2022,Egypt,Terengganu,0,0,0
1/09/2022,Egypt,W.P. Labuan,0,0,0
1/09/2022,Eritrea,Johor,0,0,0
1/09/2022,Eritrea,Pulau Pinang,0,0,0
1/09/2022,Eritrea,Sabah,0,0,0
1/09/2022,Eritrea,Selangor,17,9,8
1/09/2022,Spain,Johor,473,264,209
1/09/2022,Spain,Kedah,49,28,21
1/09/2022,Spain,Kelantan,3,1,2
1/09/2022,Spain,Melaka,1,0,1
1/09/2022,Spain,Negeri Sembilan,0,0,0
1/09/2022,Spain,Pahang,0,0,0
1/09/2022,Spain,Perak,1,1,0
1/09/2022,Spain,Perlis,7,6,1
1/09/2022,Spain,Pulau Pinang,79,45,34
1/09/2022,Spain,Sabah,38,18,20
1/09/2022,Spain,Sarawak,64,30,34
1/09/2022,Spain,Selangor,2375,1321,1054
1/09/2022,Spain,W.P. Labuan,0,0,0
1/09/2022,Estonia,Johor,11,8,3
1/09/2022,Estonia,Kedah,1,1,0
1/09/2022,Estonia,Kelantan,0,0,0
1/09/2022,Estonia,Pahang,0,0,0
1/09/2022,Estonia,Perak,0,0,0
1/09/2022,Estonia,Perlis,1,1,0
1/09/2022,Estonia,Pulau Pinang,2,0,2
1/09/2022,Estonia,Sabah,3,1,2
1/09/2022,Estonia,Sarawak,8,6,2
1/09/2022,Estonia,Selangor,73,47,26
1/09/2022,Estonia,W.P. Labuan,0,0,0
1/09/2022,Ethiopia,Johor,2,2,0
1/09/2022,Ethiopia,Kedah,0,0,0
1/09/2022,Ethiopia,Pulau Pinang,1,1,0
1/09/2022,Ethiopia,Sarawak,0,0,0
1/09/2022,Ethiopia,Selangor,23,11,12
1/09/2022,Finland,Johor,113,77,36
1/09/2022,Finland,Kedah,12,8,4
1/09/2022,Finland,Kelantan,0,0,0
1/09/2022,Finland,Melaka,0,0,0
1/09/2022,Finland,Negeri Sembilan,0,0,0
1/09/2022,Finland,Pahang,0,0,0
1/09/2022,Finland,Perak,0,0,0
1/09/2022,Finland,Perlis,0,0,0
1/09/2022,Finland,Pulau Pinang,19,13,6
1/09/2022,Finland,Sabah,7,5,2
1/09/2022,Finland,Sarawak,7,4,3
1/09/2022,Finland,Selangor,269,181,88
1/09/2022,Finland,W.P. Labuan,0,0,0
1/09/2022,Fiji,Johor,56,31,25
1/09/2022,Fiji,Kedah,0,0,0
1/09/2022,Fiji,Kelantan,0,0,0
1/09/2022,Fiji,Perak,0,0,0
1/09/2022,Fiji,Perlis,0,0,0
1/09/2022,Fiji,Pulau Pinang,3,2,1
1/09/2022,Fiji,Sabah,2,1,1
1/09/2022,Fiji,Sarawak,1,0,1
1/09/2022,Fiji,Selangor,72,36,36
1/09/2022,France,Johor,1357,870,487
1/09/2022,France,Kedah,150,100,50
1/09/2022,France,Kelantan,3,3,0
1/09/2022,France,Melaka,2,1,1
1/09/2022,France,Negeri Sembilan,6,3,3
1/09/2022,France,Pahang,4,3,1
1/09/2022,France,Perak,21,12,9
1/09/2022,France,Perlis,49,32,17
1/09/2022,France,Pulau Pinang,246,163,83
1/09/2022,France,Sabah,68,48,20
1/09/2022,France,Sarawak,54,34,20
1/09/2022,France,Selangor,6180,3628,2552
1/09/2022,France,Terengganu,2,1,1
1/09/2022,France,W.P. Labuan,3,3,0
1/09/2022,"Micronesia, Federated States of",Johor,0,0,0
1/09/2022,"Micronesia, Federated States of",Pulau Pinang,0,0,0
1/09/2022,"Micronesia, Federated States of",Selangor,0,0,0
1/09/2022,Gabon,Johor,4,3,1
1/09/2022,Gabon,Pulau Pinang,0,0,0
1/09/2022,Gabon,Sarawak,0,0,0
1/09/2022,Gabon,Selangor,4,3,1
1/09/2022,United Kingdom of Great Britain and Northern Ireland,Johor,3265,2234,1031
1/09/2022,United Kingdom of Great Britain and Northern Ireland,Kedah,331,198,133
1/09/2022,United Kingdom of Great Britain and Northern Ireland,Kelantan,3,3,0
1/09/2022,United Kingdom of Great Britain and Northern Ireland,Melaka,3,1,2
1/09/2022,United Kingdom of Great Britain and Northern Ireland,Negeri Sembilan,2,2,0
1/09/2022,United Kingdom of Great Britain and Northern Ireland,Pahang,8,6,2
1/09/2022,United Kingdom of Great Britain and Northern Ireland,Perak,53,34,19
1/09/2022,United Kingdom of Great Britain and Northern Ireland,Perlis,113,74,39
1/09/2022,United Kingdom of Great Britain and Northern Ireland,Pulau Pinang,879,532,347
1/09/2022,United Kingdom of Great Britain and Northern Ireland,Sabah,318,180,138
1/09/2022,United Kingdom of Great Britain and Northern Ireland,Sarawak,968,632,336
1/09/2022,United Kingdom of Great Britain and Northern Ireland,Selangor,11781,7331,4450
1/09/2022,United Kingdom of Great Britain and Northern Ireland,Terengganu,3,3,0
1/09/2022,United Kingdom of Great Britain and Northern Ireland,W.P. Labuan,44,39,5
1/09/2022,Georgia,Johor,18,12,6
1/09/2022,Georgia,Kedah,1,1,0
1/09/2022,Georgia,Melaka,0,0,0
1/09/2022,Georgia,Perak,0,0,0
1/09/2022,Georgia,Perlis,0,0,0
1/09/2022,Georgia,Pulau Pinang,0,0,0
1/09/2022,Georgia,Sabah,0,0,0
1/09/2022,Georgia,Sarawak,0,0,0
1/09/2022,Georgia,Selangor,47,41,6
1/09/2022,Ghana,Johor,6,6,0
1/09/2022,Ghana,Kedah,0,0,0
1/09/2022,Ghana,Kelantan,0,0,0
1/09/2022,Ghana,Pulau Pinang,0,0,0
1/09/2022,Ghana,Sabah,0,0,0
1/09/2022,Ghana,Sarawak,0,0,0
1/09/2022,Ghana,Selangor,56,43,13
1/09/2022,Gibraltar,Johor,0,0,0
1/09/2022,Gibraltar,Sarawak,0,0,0
1/09/2022,Guinea,Johor,2,2,0
1/09/2022,Guinea,Kedah,0,0,0
1/09/2022,Guinea,Kelantan,1,1,0
1/09/2022,Guinea,Perlis,0,0,0
1/09/2022,Guinea,Pulau Pinang,1,1,0
1/09/2022,Guinea,Sabah,0,0,0
1/09/2022,Guinea,Sarawak,0,0,0
1/09/2022,Guinea,Selangor,25,22,3
1/09/2022,Guadeloupe,Selangor,0,0,0
1/09/2022,Gambia,Johor,0,0,0
1/09/2022,Gambia,Kedah,0,0,0
1/09/2022,Gambia,Kelantan,0,0,0
1/09/2022,Gambia,Pulau Pinang,0,0,0
1/09/2022,Gambia,Sabah,0,0,0
1/09/2022,Gambia,Sarawak,0,0,0
1/09/2022,Gambia,Selangor,13,10,3
1/09/2022,Guinea-Bissau,Johor,0,0,0
1/09/2022,Guinea-Bissau,Selangor,0,0,0
1/09/2022,Equatorial Guinea,Johor,0,0,0
1/09/2022,Equatorial Guinea,Selangor,0,0,0
1/09/2022,Greece,Johor,41,30,11
1/09/2022,Greece,Kedah,0,0,0
1/09/2022,Greece,Kelantan,0,0,0
1/09/2022,Greece,Melaka,0,0,0
1/09/2022,Greece,Negeri Sembilan,0,0,0
1/09/2022,Greece,Pahang,0,0,0
1/09/2022,Greece,Perak,0,0,0
1/09/2022,Greece,Perlis,1,0,1
1/09/2022,Greece,Pulau Pinang,2,2,0
1/09/2022,Greece,Sabah,5,3,2
1/09/2022,Greece,Sarawak,3,2,1
1/09/2022,Greece,Selangor,134,101,33
1/09/2022,Grenada,Johor,6,4,2
1/09/2022,Grenada,Kedah,0,0,0
1/09/2022,Grenada,Pulau Pinang,1,1,0
1/09/2022,Grenada,Sabah,0,0,0
1/09/2022,Grenada,Sarawak,0,0,0
1/09/2022,Grenada,Selangor,11,9,2
1/09/2022,Greenland,Johor,0,0,0
1/09/2022,Greenland,Selangor,0,0,0
1/09/2022,Guatemala,Johor,0,0,0
1/09/2022,Guatemala,Kedah,0,0,0
1/09/2022,Guatemala,Pahang,0,0,0
1/09/2022,Guatemala,Perak,0,0,0
1/09/2022,Guatemala,Pulau Pinang,1,0,1
1/09/2022,Guatemala,Sabah,0,0,0
1/09/2022,Guatemala,Sarawak,0,0,0
1/09/2022,Guatemala,Selangor,10,5,5
1/09/2022,Guatemala,W.P. Labuan,0,0,0
1/09/2022,Guyana,Johor,0,0,0
1/09/2022,Guyana,Kedah,0,0,0
1/09/2022,Guyana,Pulau Pinang,0,0,0
1/09/2022,Guyana,Sarawak,0,0,0
1/09/2022,Guyana,Selangor,2,1,1
1/09/2022,Hong Kong,Johor,1,1,0
1/09/2022,Hong Kong,Kedah,2,1,1
1/09/2022,Hong Kong,Kelantan,0,0,0
1/09/2022,Hong Kong,Pahang,0,0,0
1/09/2022,Hong Kong,Perak,19,11,8
1/09/2022,Hong Kong,Perlis,4,2,2
1/09/2022,Hong Kong,Pulau Pinang,0,0,0
1/09/2022,Hong Kong,Sabah,13,7,6
1/09/2022,Hong Kong,Sarawak,0,0,0
1/09/2022,Hong Kong,Selangor,1,1,0
1/09/2022,Hong Kong,Terengganu,0,0,0
1/09/2022,Heard Island and McDonald Islands,Johor,0,0,0
1/09/2022,Honduras,Johor,2,1,1
1/09/2022,Honduras,Kedah,0,0,0
1/09/2022,Honduras,Perak,0,0,0
1/09/2022,Honduras,Pulau Pinang,0,0,0
1/09/2022,Honduras,Sabah,0,0,0
1/09/2022,Honduras,Sarawak,0,0,0
1/09/2022,Honduras,Selangor,13,4,9
1/09/2022,Croatia,Johor,32,20,12
1/09/2022,Croatia,Kedah,3,1,2
1/09/2022,Croatia,Kelantan,0,0,0
1/09/2022,Croatia,Melaka,0,0,0
1/09/2022,Croatia,Pahang,0,0,0
1/09/2022,Croatia,Perak,3,2,1
1/09/2022,Croatia,Perlis,0,0,0
1/09/2022,Croatia,Pulau Pinang,4,3,1
1/09/2022,Croatia,Sabah,0,0,0
1/09/2022,Croatia,Sarawak,2,2,0
1/09/2022,Croatia,Selangor,116,86,30
1/09/2022,Haiti,Johor,4,3,1
1/09/2022,Haiti,Kedah,0,0,0
1/09/2022,Haiti,Kelantan,0,0,0
1/09/2022,Haiti,Perak,0,0,0
1/09/2022,Haiti,Pulau Pinang,1,0,1
1/09/2022,Haiti,Sabah,0,0,0
1/09/2022,Haiti,Selangor,3,2,1
1/09/2022,Hungary,Johor,66,42,24
1/09/2022,Hungary,Kedah,7,2,5
1/09/2022,Hungary,Kelantan,2,2,0
1/09/2022,Hungary,Pahang,1,1,0
1/09/2022,Hungary,Perak,0,0,0
1/09/2022,Hungary,Perlis,2,1,1
1/09/2022,Hungary,Pulau Pinang,9,5,4
1/09/2022,Hungary,Sabah,3,1,2
1/09/2022,Hungary,Sarawak,2,1,1
1/09/2022,Hungary,Selangor,300,160,140
1/09/2022,Hungary,W.P. Labuan,0,0,0
1/09/2022,Indonesia,Johor,85343,46090,39253
1/09/2022,Indonesia,Kedah,2035,783,1252
1/09/2022,Indonesia,Kelantan,93,59,34
1/09/2022,Indonesia,Melaka,7816,3486,4330
1/09/2022,Indonesia,Negeri Sembilan,6826,4691,2135
1/09/2022,Indonesia,Pahang,8,7,1
1/09/2022,Indonesia,Perak,133,27,106
1/09/2022,Indonesia,Perlis,275,109,166
1/09/2022,Indonesia,Pulau Pinang,23721,8843,14878
1/09/2022,Indonesia,Sabah,3700,1799,1901
1/09/2022,Indonesia,Sarawak,25941,14755,11186
1/09/2022,Indonesia,Selangor,63148,31678,31470
1/09/2022,Indonesia,Terengganu,2,1,1
1/09/2022,Indonesia,W.P. Labuan,28,20,8
1/09/2022,India,Johor,14758,10199,4559
1/09/2022,India,Kedah,591,326,265
1/09/2022,India,Kelantan,5,3,2
1/09/2022,India,Melaka,12,7,5
1/09/2022,India,Negeri Sembilan,0,0,0
1/09/2022,India,Pahang,2,1,1
1/09/2022,India,Perak,1029,912,117
1/09/2022,India,Perlis,61,48,13
1/09/2022,India,Pulau Pinang,506,366,140
1/09/2022,India,Sabah,193,130,63
1/09/2022,India,Sarawak,406,288,118
1/09/2022,India,Selangor,39817,30128,9689
1/09/2022,India,Terengganu,0,0,0
1/09/2022,India,W.P. Labuan,20,13,7
1/09/2022, British Indian Ocean Territory,Pulau Pinang,0,0,0
1/09/2022, British Indian Ocean Territory,Selangor,0,0,0
1/09/2022,Ireland,Johor,224,157,67
1/09/2022,Ireland,Kedah,36,26,10
1/09/2022,Ireland,Kelantan,0,0,0
1/09/2022,Ireland,Negeri Sembilan,0,0,0
1/09/2022,Ireland,Pahang,0,0,0
1/09/2022,Ireland,Perak,14,6,8
1/09/2022,Ireland,Perlis,27,15,12
1/09/2022,Ireland,Pulau Pinang,61,36,25
1/09/2022,Ireland,Sabah,14,9,5
1/09/2022,Ireland,Sarawak,28,14,14
1/09/2022,Ireland,Selangor,949,561,388
1/09/2022,Ireland,Terengganu,0,0,0
1/09/2022,Ireland,W.P. Labuan,0,0,0
1/09/2022,"Iran, Islamic Republic of",Johor,60,45,15
1/09/2022,"Iran, Islamic Republic of",Kedah,4,3,1
1/09/2022,"Iran, Islamic Republic of",Kelantan,0,0,0
1/09/2022,"Iran, Islamic Republic of",Perak,0,0,0
1/09/2022,"Iran, Islamic Republic of",Perlis,3,3,0
1/09/2022,"Iran, Islamic Republic of",Pulau Pinang,4,2,2
1/09/2022,"Iran, Islamic Republic of",Sabah,1,1,0
1/09/2022,"Iran, Islamic Republic of",Sarawak,12,4,8
1/09/2022,"Iran, Islamic Republic of",Selangor,843,451,392
1/09/2022,"Iran, Islamic Republic of",W.P. Labuan,0,0,0
1/09/2022,Iraq,Johor,19,13,6
1/09/2022,Iraq,Kedah,0,0,0
1/09/2022,Iraq,Kelantan,0,0,0
1/09/2022,Iraq,Melaka,0,0,0
1/09/2022,Iraq,Pahang,0,0,0
1/09/2022,Iraq,Perak,0,0,0
1/09/2022,Iraq,Perlis,1,1,0
1/09/2022,Iraq,Pulau Pinang,0,0,0
1/09/2022,Iraq,Sabah,0,0,0
1/09/2022,Iraq,Sarawak,0,0,0
1/09/2022,Iraq,Selangor,770,504,266
1/09/2022,Iceland,Johor,9,8,1
1/09/2022,Iceland,Kedah,0,0,0
1/09/2022,Iceland,Kelantan,0,0,0
1/09/2022,Iceland,Perak,0,0,0
1/09/2022,Iceland,Perlis,1,1,0
1/09/2022,Iceland,Pulau Pinang,1,1,0
1/09/2022,Iceland,Sabah,0,0,0
1/09/2022,Iceland,Sarawak,0,0,0
1/09/2022,Iceland,Selangor,16,12,4
1/09/2022,Iceland,W.P. Labuan,0,0,0
1/09/2022,Israel,Pulau Pinang,2,2,0
1/09/2022,Italy,Johor,473,339,134
1/09/2022,Italy,Kedah,29,18,11
1/09/2022,Italy,Kelantan,2,2,0
1/09/2022,Italy,Melaka,1,0,1
1/09/2022,Italy,Negeri Sembilan,2,1,1
1/09/2022,Italy,Pahang,0,0,0
1/09/2022,Italy,Perak,0,0,0
1/09/2022,Italy,Perlis,15,10,5
1/09/2022,Italy,Pulau Pinang,80,61,19
1/09/2022,Italy,Sabah,34,21,13
1/09/2022,Italy,Sarawak,25,15,10
1/09/2022,Italy,Selangor,1839,1248,591
1/09/2022,Italy,W.P. Labuan,0,0,0
1/09/2022,Jamaica,Johor,0,0,0
1/09/2022,Jamaica,Kedah,0,0,0
1/09/2022,Jamaica,Perak,0,0,0
1/09/2022,Jamaica,Pulau Pinang,1,1,0
1/09/2022,Jamaica,Sabah,1,0,1
1/09/2022,Jamaica,Sarawak,0,0,0
1/09/2022,Jamaica,Selangor,5,1,4
1/09/2022,Jamaica,W.P. Labuan,0,0,0
1/09/2022,Jordan,Johor,17,11,6
1/09/2022,Jordan,Kedah,3,3,0
1/09/2022,Jordan,Kelantan,0,0,0
1/09/2022,Jordan,Melaka,0,0,0
1/09/2022,Jordan,Perlis,1,1,0
1/09/2022,Jordan,Pulau Pinang,8,8,0
1/09/2022,Jordan,Sabah,2,2,0
1/09/2022,Jordan,Sarawak,0,0,0
1/09/2022,Jordan,Selangor,658,400,258
1/09/2022,Jordan,W.P. Labuan,1,1,0
1/09/2022,Japan,Johor,4608,3386,1222
1/09/2022,Japan,Kedah,76,49,27
1/09/2022,Japan,Kelantan,7,7,0
1/09/2022,Japan,Melaka,1,1,0
1/09/2022,Japan,Negeri Sembilan,0,0,0
1/09/2022,Japan,Pahang,0,0,0
1/09/2022,Japan,Perak,36,24,12
1/09/2022,Japan,Perlis,51,42,9
1/09/2022,Japan,Pulau Pinang,817,620,197
1/09/2022,Japan,Sabah,166,91,75
1/09/2022,Japan,Sarawak,97,67,30
1/09/2022,Japan,Selangor,9946,6616,3330
1/09/2022,Japan,W.P. Labuan,4,4,0
1/09/2022,Kazakhstan,Johor,20,5,15
1/09/2022,Kazakhstan,Kedah,8,4,4
1/09/2022,Kazakhstan,Kelantan,0,0,0
1/09/2022,Kazakhstan,Melaka,0,0,0
1/09/2022,Kazakhstan,Perak,0,0,0
1/09/2022,Kazakhstan,Perlis,2,1,1
1/09/2022,Kazakhstan,Pulau Pinang,8,3,5
1/09/2022,Kazakhstan,Sabah,0,0,0
1/09/2022,Kazakhstan,Sarawak,1,1,0
1/09/2022,Kazakhstan,Selangor,382,160,222
1/09/2022,Kazakhstan,W.P. Labuan,0,0,0
1/09/2022,Kenya,Johor,26,12,14
1/09/2022,Kenya,Kedah,4,2,2
1/09/2022,Kenya,Kelantan,0,0,0
1/09/2022,Kenya,Perak,0,0,0
1/09/2022,Kenya,Perlis,0,0,0
1/09/2022,Kenya,Pulau Pinang,1,0,1
1/09/2022,Kenya,Sabah,2,2,0
1/09/2022,Kenya,Sarawak,3,2,1
1/09/2022,Kenya,Selangor,305,162,143
1/09/2022,Kyrgyzstan,Johor,6,2,4
1/09/2022,Kyrgyzstan,Kedah,1,1,0
1/09/2022,Kyrgyzstan,Kelantan,0,0,0
1/09/2022,Kyrgyzstan,Perak,0,0,0
1/09/2022,Kyrgyzstan,Perlis,0,0,0
1/09/2022,Kyrgyzstan,Pulau Pinang,0,0,0
1/09/2022,Kyrgyzstan,Sabah,0,0,0
1/09/2022,Kyrgyzstan,Sarawak,0,0,0
1/09/2022,Kyrgyzstan,Selangor,124,65,59
1/09/2022,Cambodia,Johor,1325,575,750
1/09/2022,Cambodia,Kedah,143,83,60
1/09/2022,Cambodia,Kelantan,601,379,222
1/09/2022,Cambodia,Melaka,0,0,0
1/09/2022,Cambodia,Negeri Sembilan,0,0,0
1/09/2022,Cambodia,Pahang,0,0,0
1/09/2022,Cambodia,Perak,4,1,3
1/09/2022,Cambodia,Perlis,901,626,275
1/09/2022,Cambodia,Pulau Pinang,33,13,20
1/09/2022,Cambodia,Sabah,1,0,1
1/09/2022,Cambodia,Sarawak,0,0,0
1/09/2022,Cambodia,Selangor,3468,1615,1853
1/09/2022,Cambodia,W.P. Labuan,0,0,0
1/09/2022,Kiribati,Johor,0,0,0
1/09/2022,Kiribati,Sabah,0,0,0
1/09/2022,Kiribati,Selangor,0,0,0
1/09/2022,Saint Kitts and Nevis,Johor,24,18,6
1/09/2022,Saint Kitts and Nevis,Kedah,1,1,0
1/09/2022,Saint Kitts and Nevis,Perlis,0,0,0
1/09/2022,Saint Kitts and Nevis,Pulau Pinang,2,2,0
1/09/2022,Saint Kitts and Nevis,Sabah,0,0,0
1/09/2022,Saint Kitts and Nevis,Selangor,37,26,11
1/09/2022,Saint Kitts and Nevis,W.P. Labuan,0,0,0
1/09/2022,"Korea, Republic of",Johor,6829,3972,2857
1/09/2022,"Korea, Republic of",Kedah,72,27,45
1/09/2022,"Korea, Republic of",Kelantan,0,0,0
1/09/2022,"Korea, Republic of",Melaka,3,3,0
1/09/2022,"Korea, Republic of",Negeri Sembilan,0,0,0
1/09/2022,"Korea, Republic of",Pahang,0,0,0
1/09/2022,"Korea, Republic of",Perak,19,11,8
1/09/2022,"Korea, Republic of",Perlis,26,22,4
1/09/2022,"Korea, Republic of",Pulau Pinang,317,191,126
1/09/2022,"Korea, Republic of",Sabah,5550,2474,3076
1/09/2022,"Korea, Republic of",Sarawak,148,78,70
1/09/2022,"Korea, Republic of",Selangor,7541,4517,3024
1/09/2022,"Korea, Republic of",Terengganu,0,0,0
1/09/2022,"Korea, Republic of",W.P. Labuan,3,0,3
1/09/2022,Kuwait,Johor,57,30,27
1/09/2022,Kuwait,Kedah,0,0,0
1/09/2022,Kuwait,Kelantan,0,0,0
1/09/2022,Kuwait,Perak,0,0,0
1/09/2022,Kuwait,Perlis,0,0,0
1/09/2022,Kuwait,Pulau Pinang,8,7,1
1/09/2022,Kuwait,Sabah,0,0,0
1/09/2022,Kuwait,Sarawak,0,0,0
1/09/2022,Kuwait,Selangor,406,220,186
1/09/2022,Kuwait,W.P. Labuan,0,0,0
1/09/2022, Lao People's Democratic Republic,Johor,116,40,76
1/09/2022, Lao People's Democratic Republic,Kedah,657,68,589
1/09/2022, Lao People's Democratic Republic,Kelantan,65,8,57
1/09/2022, Lao People's Democratic Republic,Melaka,1,0,1
1/09/2022, Lao People's Democratic Republic,Perak,16,4,12
1/09/2022, Lao People's Democratic Republic,Perlis,303,97,206
1/09/2022, Lao People's Democratic Republic,Pulau Pinang,17,7,10
1/09/2022, Lao People's Democratic Republic,Sabah,2,0,2
1/09/2022, Lao People's Democratic Republic,Sarawak,4,4,0
1/09/2022, Lao People's Democratic Republic,Selangor,206,67,139
1/09/2022, Lao People's Democratic Republic,W.P. Labuan,0,0,0
1/09/2022,Lebanon,Johor,8,6,2
1/09/2022,Lebanon,Kedah,0,0,0
1/09/2022,Lebanon,Kelantan,0,0,0
1/09/2022,Lebanon,Pahang,0,0,0
1/09/2022,Lebanon,Perak,0,0,0
1/09/2022,Lebanon,Perlis,0,0,0
1/09/2022,Lebanon,Pulau Pinang,2,0,2
1/09/2022,Lebanon,Sabah,2,2,0
1/09/2022,Lebanon,Sarawak,2,0,2
1/09/2022,Lebanon,Selangor,201,130,71
1/09/2022,Lebanon,W.P. Labuan,0,0,0
1/09/2022,Liberia,Johor,1,1,0
1/09/2022,Liberia,Kedah,0,0,0
1/09/2022,Liberia,Sabah,0,0,0
1/09/2022,Liberia,Sarawak,0,0,0
1/09/2022,Liberia,Selangor,5,4,1
1/09/2022,Libya,Johor,8,6,2
1/09/2022,Libya,Kedah,0,0,0
1/09/2022,Libya,Perlis,0,0,0
1/09/2022,Libya,Pulau Pinang,1,1,0
1/09/2022,Libya,Sabah,1,1,0
1/09/2022,Libya,Sarawak,1,1,0
1/09/2022,Libya,Selangor,361,245,116
1/09/2022,Saint Lucia,Johor,6,5,1
1/09/2022,Saint Lucia,Kedah,0,0,0
1/09/2022,Saint Lucia,Pulau Pinang,0,0,0
1/09/2022,Saint Lucia,Sarawak,0,0,0
1/09/2022,Saint Lucia,Selangor,7,7,0
1/09/2022,Liechtenstein,Johor,1,1,0
1/09/2022,Liechtenstein,Kedah,0,0,0
1/09/2022,Liechtenstein,Perlis,0,0,0
1/09/2022,Liechtenstein,Pulau Pinang,2,2,0
1/09/2022,Liechtenstein,Sabah,0,0,0
1/09/2022,Liechtenstein,Sarawak,0,0,0
1/09/2022,Liechtenstein,Selangor,3,3,0
1/09/2022,LKA,Johor,914,581,333
1/09/2022,LKA,Kedah,20,11,9
1/09/2022,LKA,Kelantan,0,0,0
1/09/2022,LKA,Melaka,0,0,0
1/09/2022,LKA,Pahang,0,0,0
1/09/2022,LKA,Perak,1,0,1
1/09/2022,LKA,Perlis,3,1,2
1/09/2022,LKA,Pulau Pinang,26,16,10
1/09/2022,LKA,Sabah,16,10,6
1/09/2022,LKA,Sarawak,10,6,4
1/09/2022,LKA,Selangor,2482,1657,825
1/09/2022,LKA,W.P. Labuan,0,0,0
1/09/2022,Lesotho,Johor,0,0,0
1/09/2022,Lesotho,Kedah,0,0,0
1/09/2022,Lesotho,Pulau Pinang,0,0,0
1/09/2022,Lesotho,Sarawak,0,0,0
1/09/2022,Lesotho,Selangor,6,3,3
1/09/2022,Lithuania,Johor,28,10,18
1/09/2022,Lithuania,Kedah,8,5,3
1/09/2022,Lithuania,Kelantan,0,0,0
1/09/2022,Lithuania,Pahang,0,0,0
1/09/2022,Lithuania,Perak,2,0,2
1/09/2022,Lithuania,Perlis,3,1,2
1/09/2022,Lithuania,Pulau Pinang,3,1,2
1/09/2022,Lithuania,Sabah,5,3,2
1/09/2022,Lithuania,Sarawak,3,1,2
1/09/2022,Lithuania,Selangor,158,90,68
1/09/2022,Lithuania,W.P. Labuan,0,0,0
1/09/2022,Luxembourg,Johor,10,5,5
1/09/2022,Luxembourg,Kedah,0,0,0
1/09/2022,Luxembourg,Kelantan,0,0,0
1/09/2022,Luxembourg,Perak,0,0,0
1/09/2022,Luxembourg,Perlis,0,0,0
1/09/2022,Luxembourg,Pulau Pinang,0,0,0
1/09/2022,Luxembourg,Sabah,0,0,0
1/09/2022,Luxembourg,Sarawak,0,0,0
1/09/2022,Luxembourg,Selangor,34,19,15
1/09/2022,Latvia,Johor,13,5,8
1/09/2022,Latvia,Kedah,0,0,0
1/09/2022,Latvia,Kelantan,0,0,0
1/09/2022,Latvia,Pahang,0,0,0
1/09/2022,Latvia,Perak,0,0,0
1/09/2022,Latvia,Perlis,0,0,0
1/09/2022,Latvia,Pulau Pinang,2,1,1
1/09/2022,Latvia,Sabah,0,0,0
1/09/2022,Latvia,Sarawak,4,2,2
1/09/2022,Latvia,Selangor,53,32,21
1/09/2022,Latvia,W.P. Labuan,0,0,0
1/09/2022,Macao,Johor,0,0,0
1/09/2022,Macao,Pahang,0,0,0
1/09/2022,Macao,Perak,0,0,0
1/09/2022,Macao,Selangor,0,0,0
1/09/2022,Macao,W.P. Labuan,0,0,0
1/09/2022,Morocco,Johor,56,41,15
1/09/2022,Morocco,Kedah,4,3,1
1/09/2022,Morocco,Kelantan,0,0,0
1/09/2022,Morocco,Melaka,0,0,0
1/09/2022,Morocco,Pahang,0,0,0
1/09/2022,Morocco,Perak,0,0,0
1/09/2022,Morocco,Perlis,0,0,0
1/09/2022,Morocco,Pulau Pinang,7,6,1
1/09/2022,Morocco,Sabah,1,0,1
1/09/2022,Morocco,Sarawak,3,3,0
1/09/2022,Morocco,Selangor,643,318,325
1/09/2022,Morocco,W.P. Labuan,0,0,0
1/09/2022,Monaco,Johor,0,0,0
1/09/2022,Monaco,Kedah,0,0,0
1/09/2022,Monaco,Sabah,0,0,0
1/09/2022,Monaco,Selangor,0,0,0
1/09/2022,"Moldova, Republic of",Johor,8,5,3
1/09/2022,"Moldova, Republic of",Kedah,0,0,0
1/09/2022,"Moldova, Republic of",Kelantan,0,0,0
1/09/2022,"Moldova, Republic of",Negeri Sembilan,0,0,0
1/09/2022,"Moldova, Republic of",Perlis,0,0,0
1/09/2022,"Moldova, Republic of",Pulau Pinang,0,0,0
1/09/2022,"Moldova, Republic of",Sabah,1,0,1
1/09/2022,"Moldova, Republic of",Sarawak,3,0,3
1/09/2022,"Moldova, Republic of",Selangor,27,13,14
1/09/2022,Madagascar,Johor,0,0,0
1/09/2022,Madagascar,Kedah,1,1,0
1/09/2022,Madagascar,Perak,0,0,0
1/09/2022,Madagascar,Perlis,0,0,0
1/09/2022,Madagascar,Pulau Pinang,0,0,0
1/09/2022,Madagascar,Sabah,0,0,0
1/09/2022,Madagascar,Sarawak,0,0,0
1/09/2022,Madagascar,Selangor,15,4,11
1/09/2022,Maldives,Johor,90,61,29
1/09/2022,Maldives,Kedah,3,1,2
1/09/2022,Maldives,Kelantan,0,0,0
1/09/2022,Maldives,Perak,0,0,0
1/09/2022,Maldives,Perlis,0,0,0
1/09/2022,Maldives,Pulau Pinang,4,3,1
1/09/2022,Maldives,Sabah,0,0,0
1/09/2022,Maldives,Sarawak,7,5,2
1/09/2022,Maldives,Selangor,1741,997,744
1/09/2022,Mexico,Johor,120,61,59
1/09/2022,Mexico,Kedah,8,4,4
1/09/2022,Mexico,Kelantan,0,0,0
1/09/2022,Mexico,Pahang,0,0,0
1/09/2022,Mexico,Perak,0,0,0
1/09/2022,Mexico,Perlis,1,1,0
1/09/2022,Mexico,Pulau Pinang,15,14,1
1/09/2022,Mexico,Sabah,6,3,3
1/09/2022,Mexico,Sarawak,2,1,1
1/09/2022,Mexico,Selangor,401,218,183
1/09/2022,Mexico,W.P. Labuan,0,0,0
1/09/2022,Marshall Islands,Johor,0,0,0
1/09/2022,Marshall Islands,Kedah,0,0,0
1/09/2022,Marshall Islands,Perak,0,0,0
1/09/2022,Marshall Islands,Pulau Pinang,0,0,0
1/09/2022,Marshall Islands,Sabah,0,0,0
1/09/2022,Marshall Islands,Selangor,1,1,0
1/09/2022,North Macedonia,Johor,5,2,3
1/09/2022,North Macedonia,Kedah,0,0,0
1/09/2022,North Macedonia,Perak,0,0,0
1/09/2022,North Macedonia,Pulau Pinang,5,5,0
1/09/2022,North Macedonia,Sabah,0,0,0
1/09/2022,North Macedonia,Sarawak,4,2,2
1/09/2022,North Macedonia,Selangor,26,15,11
1/09/2022,Mali,Johor,2,2,0
1/09/2022,Mali,Sabah,0,0,0
1/09/2022,Mali,Selangor,5,3,2
1/09/2022,Malta,Johor,3,2,1
1/09/2022,Malta,Kedah,0,0,0
1/09/2022,Malta,Kelantan,0,0,0
1/09/2022,Malta,Perak,2,1,1
1/09/2022,Malta,Perlis,0,0,0
1/09/2022,Malta,Pulau Pinang,1,1,0
1/09/2022,Malta,Sabah,4,2,2
1/09/2022,Malta,Sarawak,0,0,0
1/09/2022,Malta,Selangor,31,21,10
1/09/2022,Malta,W.P. Labuan,0,0,0
1/09/2022,Myanmar,Johor,3275,1037,2238
1/09/2022,Myanmar,Kedah,37,12,25
1/09/2022,Myanmar,Kelantan,3,1,2
1/09/2022,Myanmar,Negeri Sembilan,0,0,0
1/09/2022,Myanmar,Pahang,0,0,0
1/09/2022,Myanmar,Perak,12,5,7
1/09/2022,Myanmar,Perlis,8,0,8
1/09/2022,Myanmar,Pulau Pinang,118,50,68
1/09/2022,Myanmar,Sabah,10,3,7
1/09/2022,Myanmar,Sarawak,33,11,22
1/09/2022,Myanmar,Selangor,6809,4840,1969
1/09/2022,Myanmar,Terengganu,0,0,0
1/09/2022,Myanmar,W.P. Labuan,0,0,0
1/09/2022,Montenegro,Johor,0,0,0
1/09/2022,Montenegro,Kedah,0,0,0
1/09/2022,Montenegro,Pulau Pinang,0,0,0
1/09/2022,Montenegro,Sabah,0,0,0
1/09/2022,Montenegro,Sarawak,2,2,0
1/09/2022,Montenegro,Selangor,6,5,1
1/09/2022,Mongolia,Johor,91,42,49
1/09/2022,Mongolia,Kedah,9,3,6
1/09/2022,Mongolia,Kelantan,0,0,0
1/09/2022,Mongolia,Perak,0,0,0
1/09/2022,Mongolia,Perlis,1,0,1
1/09/2022,Mongolia,Pulau Pinang,11,6,5
1/09/2022,Mongolia,Sabah,1,0,1
1/09/2022,Mongolia,Sarawak,0,0,0
1/09/2022,Mongolia,Selangor,245,111,134
1/09/2022,Northern Mariana Islands,Selangor,0,0,0
1/09/2022,Mozambique,Johor,2,0,2
1/09/2022,Mozambique,Kedah,0,0,0
1/09/2022,Mozambique,Perak,0,0,0
1/09/2022,Mozambique,Pulau Pinang,0,0,0
1/09/2022,Mozambique,Sabah,0,0,0
1/09/2022,Mozambique,Sarawak,0,0,0
1/09/2022,Mozambique,Selangor,23,16,7
1/09/2022,Mauritania,Johor,3,1,2
1/09/2022,Mauritania,Kedah,0,0,0
1/09/2022,Mauritania,Pulau Pinang,0,0,0
1/09/2022,Mauritania,Sabah,0,0,0
1/09/2022,Mauritania,Sarawak,0,0,0
1/09/2022,Mauritania,Selangor,14,10,4
1/09/2022,Mauritius,Johor,73,37,36
1/09/2022,Mauritius,Kedah,4,3,1
1/09/2022,Mauritius,Kelantan,0,0,0
1/09/2022,Mauritius,Pahang,0,0,0
1/09/2022,Mauritius,Perak,0,0,0
1/09/2022,Mauritius,Perlis,1,0,1
1/09/2022,Mauritius,Pulau Pinang,8,3,5
1/09/2022,Mauritius,Sabah,2,1,1
1/09/2022,Mauritius,Sarawak,0,0,0
1/09/2022,Mauritius,Selangor,278,135,143
1/09/2022,Malawi,Johor,0,0,0
1/09/2022,Malawi,Pulau Pinang,0,0,0
1/09/2022,Malawi,Sabah,0,0,0
1/09/2022,Malawi,Sarawak,0,0,0
1/09/2022,Malawi,Selangor,17,10,7
1/09/2022,Mayotte,Selangor,0,0,0
1/09/2022,Namibia,Johor,7,5,2
1/09/2022,Namibia,Kedah,0,0,0
1/09/2022,Namibia,Perak,0,0,0
1/09/2022,Namibia,Perlis,0,0,0
1/09/2022,Namibia,Pulau Pinang,1,0,1
1/09/2022,Namibia,Sabah,0,0,0
1/09/2022,Namibia,Sarawak,0,0,0
1/09/2022,Namibia,Selangor,5,0,5
1/09/2022,New Caledonia,Selangor,0,0,0
1/09/2022,Niger,Johor,0,0,0
1/09/2022,Niger,Sabah,0,0,0
1/09/2022,Niger,Selangor,4,3,1
1/09/2022,Nigeria,Johor,20,18,2
1/09/2022,Nigeria,Kedah,0,0,0
1/09/2022,Nigeria,Perlis,0,0,0
1/09/2022,Nigeria,Pulau Pinang,2,2,0
1/09/2022,Nigeria,Sabah,0,0,0
1/09/2022,Nigeria,Sarawak,1,1,0
1/09/2022,Nigeria,Selangor,329,261,68
1/09/2022,Nicaragua,Johor,2,0,2
1/09/2022,Nicaragua,Kedah,0,0,0
1/09/2022,Nicaragua,Pulau Pinang,0,0,0
1/09/2022,Nicaragua,Sabah,0,0,0
1/09/2022,Nicaragua,Selangor,6,2,4
1/09/2022,Netherlands,Johor,859,543,316
1/09/2022,Netherlands,Kedah,74,45,29
1/09/2022,Netherlands,Kelantan,4,4,0
1/09/2022,Netherlands,Melaka,2,1,1
1/09/2022,Netherlands,Negeri Sembilan,0,0,0
1/09/2022,Netherlands,Pahang,1,1,0
1/09/2022,Netherlands,Perak,3,1,2
1/09/2022,Netherlands,Perlis,24,15,9
1/09/2022,Netherlands,Pulau Pinang,149,93,56
1/09/2022,Netherlands,Sabah,94,51,43
1/09/2022,Netherlands,Sarawak,116,66,50
1/09/2022,Netherlands,Selangor,3121,1894,1227
1/09/2022,Netherlands,Terengganu,0,0,0
1/09/2022,Netherlands,W.P. Labuan,0,0,0
1/09/2022,Norway,Johor,122,82,40
1/09/2022,Norway,Kedah,13,9,4
1/09/2022,Norway,Kelantan,0,0,0
1/09/2022,Norway,Melaka,0,0,0
1/09/2022,Norway,Pahang,0,0,0
1/09/2022,Norway,Perak,2,1,1
1/09/2022,Norway,Perlis,1,1,0
1/09/2022,Norway,Pulau Pinang,11,8,3
1/09/2022,Norway,Sabah,3,3,0
1/09/2022,Norway,Sarawak,16,14,2
1/09/2022,Norway,Selangor,372,240,132
1/09/2022,Norway,W.P. Labuan,1,0,1
1/09/2022,Nepal,Johor,392,327,65
1/09/2022,Nepal,Kedah,1,0,1
1/09/2022,Nepal,Pahang,0,0,0
1/09/2022,Nepal,Perak,0,0,0
1/09/2022,Nepal,Perlis,0,0,0
1/09/2022,Nepal,Pulau Pinang,19,13,6
1/09/2022,Nepal,Sabah,7,4,3
1/09/2022,Nepal,Sarawak,117,73,44
1/09/2022,Nepal,Selangor,33400,32030,1370
1/09/2022,Nepal,W.P. Labuan,91,87,4
1/09/2022,Nauru,Johor,0,0,0
1/09/2022,Nauru,Pulau Pinang,0,0,0
1/09/2022,Nauru,Selangor,0,0,0
1/09/2022,New Zealand,Johor,507,329,178
1/09/2022,New Zealand,Kedah,56,32,24
1/09/2022,New Zealand,Kelantan,1,1,0
1/09/2022,New Zealand,Melaka,0,0,0
1/09/2022,New Zealand,Negeri Sembilan,1,1,0
1/09/2022,New Zealand,Pahang,3,3,0
1/09/2022,New Zealand,Perak,8,6,2
1/09/2022,New Zealand,Perlis,15,10,5
1/09/2022,New Zealand,Pulau Pinang,124,72,52
1/09/2022,New Zealand,Sabah,61,39,22
1/09/2022,New Zealand,Sarawak,97,47,50
1/09/2022,New Zealand,Selangor,1737,1110,627
1/09/2022,New Zealand,Terengganu,0,0,0
1/09/2022,New Zealand,W.P. Labuan,0,0,0
1/09/2022,Oman,Johor,39,24,15
1/09/2022,Oman,Kedah,2,2,0
1/09/2022,Oman,Kelantan,1,1,0
1/09/2022,Oman,Melaka,0,0,0
1/09/2022,Oman,Perak,0,0,0
1/09/2022,Oman,Perlis,0,0,0
1/09/2022,Oman,Pulau Pinang,5,5,0
1/09/2022,Oman,Sabah,0,0,0
1/09/2022,Oman,Sarawak,19,7,12
1/09/2022,Oman,Selangor,567,356,211
1/09/2022,Pakistan,Johor,707,555,152
1/09/2022,Pakistan,Kedah,79,61,18
1/09/2022,Pakistan,Kelantan,20,20,0
1/09/2022,Pakistan,Melaka,0,0,0
1/09/2022,Pakistan,Negeri Sembilan,1,1,0
1/09/2022,Pakistan,Pahang,0,0,0
1/09/2022,Pakistan,Perak,103,103,0
1/09/2022,Pakistan,Perlis,24,24,0
1/09/2022,Pakistan,Pulau Pinang,26,23,3
1/09/2022,Pakistan,Sabah,6,5,1
1/09/2022,Pakistan,Sarawak,63,52,11
1/09/2022,Pakistan,Selangor,9103,7961,1142
1/09/2022,Pakistan,W.P. Labuan,2,2,0
1/09/2022,Panama,Johor,6,3,3
1/09/2022,Panama,Kedah,0,0,0
1/09/2022,Panama,Perak,0,0,0
1/09/2022,Panama,Perlis,1,0,1
1/09/2022,Panama,Pulau Pinang,0,0,0
1/09/2022,Panama,Sabah,0,0,0
1/09/2022,Panama,Sarawak,0,0,0
1/09/2022,Panama,Selangor,15,6,9
1/09/2022,Peru,Johor,36,25,11
1/09/2022,Peru,Kedah,1,0,1
1/09/2022,Peru,Kelantan,0,0,0
1/09/2022,Peru,Pahang,0,0,0
1/09/2022,Peru,Perak,0,0,0
1/09/2022,Peru,Perlis,3,1,2
1/09/2022,Peru,Pulau Pinang,2,1,1
1/09/2022,Peru,Sabah,2,1,1
1/09/2022,Peru,Sarawak,3,2,1
1/09/2022,Peru,Selangor,69,36,33
1/09/2022,Peru,W.P. Labuan,0,0,0
1/09/2022,Philippines,Johor,14117,4207,9910
1/09/2022,Philippines,Kedah,275,105,170
1/09/2022,Philippines,Kelantan,8,6,2
1/09/2022,Philippines,Melaka,0,0,0
1/09/2022,Philippines,Negeri Sembilan,0,0,0
1/09/2022,Philippines,Pahang,9,9,0
1/09/2022,Philippines,Perak,43,15,28
1/09/2022,Philippines,Perlis,133,62,71
1/09/2022,Philippines,Pulau Pinang,320,103,217
1/09/2022,Philippines,Sabah,1072,534,538
1/09/2022,Philippines,Sarawak,758,299,459
1/09/2022,Philippines,Selangor,10486,4141,6345
1/09/2022,Philippines,Terengganu,0,0,0
1/09/2022,Philippines,W.P. Labuan,42,11,31
1/09/2022,Palau,Johor,4,4,0
1/09/2022,Palau,Pulau Pinang,0,0,0
1/09/2022,Palau,Selangor,0,0,0
1/09/2022,Papua New Guinea,Johor,8,3,5
1/09/2022,Papua New Guinea,Kedah,0,0,0
1/09/2022,Papua New Guinea,Kelantan,0,0,0
1/09/2022,Papua New Guinea,Perak,0,0,0
1/09/2022,Papua New Guinea,Pulau Pinang,2,1,1
1/09/2022,Papua New Guinea,Sabah,1,0,1
1/09/2022,Papua New Guinea,Sarawak,3,1,2
1/09/2022,Papua New Guinea,Selangor,36,16,20
1/09/2022,Poland,Johor,189,103,86
1/09/2022,Poland,Kedah,19,10,9
1/09/2022,Poland,Kelantan,2,1,1
1/09/2022,Poland,Melaka,0,0,0
1/09/2022,Poland,Negeri Sembilan,0,0,0
1/09/2022,Poland,Pahang,0,0,0
1/09/2022,Poland,Perak,5,4,1
1/09/2022,Poland,Perlis,13,8,5
1/09/2022,Poland,Pulau Pinang,33,22,11
1/09/2022,Poland,Sabah,48,28,20
1/09/2022,Poland,Sarawak,17,9,8
1/09/2022,Poland,Selangor,896,493,403
1/09/2022,Poland,Terengganu,0,0,0
1/09/2022,Poland,W.P. Labuan,0,0,0
1/09/2022,"North Korea, Democratic People's Republic of",Selangor,0,0,0
1/09/2022,Portugal,Johor,80,47,33
1/09/2022,Portugal,Kedah,12,5,7
1/09/2022,Portugal,Kelantan,0,0,0
1/09/2022,Portugal,Melaka,1,1,0
1/09/2022,Portugal,Pahang,0,0,0
1/09/2022,Portugal,Perak,0,0,0
1/09/2022,Portugal,Perlis,1,1,0
1/09/2022,Portugal,Pulau Pinang,36,19,17
1/09/2022,Portugal,Sabah,9,7,2
1/09/2022,Portugal,Sarawak,4,2,2
1/09/2022,Portugal,Selangor,445,271,174
1/09/2022,Portugal,W.P. Labuan,0,0,0
1/09/2022,Paraguay,Johor,0,0,0
1/09/2022,Paraguay,Kedah,0,0,0
1/09/2022,Paraguay,Perak,0,0,0
1/09/2022,Paraguay,Perlis,0,0,0
1/09/2022,Paraguay,Pulau Pinang,0,0,0
1/09/2022,Paraguay,Sabah,0,0,0
1/09/2022,Paraguay,Sarawak,0,0,0
1/09/2022,Paraguay,Selangor,11,7,4
1/09/2022,"Palestine, State of",Johor,5,3,2
1/09/2022,"Palestine, State of",Kedah,0,0,0
1/09/2022,"Palestine, State of",Kelantan,0,0,0
1/09/2022,"Palestine, State of",Melaka,0,0,0
1/09/2022,"Palestine, State of",Perak,0,0,0
1/09/2022,"Palestine, State of",Perlis,0,0,0
1/09/2022,"Palestine, State of",Pulau Pinang,1,0,1
1/09/2022,"Palestine, State of",Sabah,0,0,0
1/09/2022,"Palestine, State of",Sarawak,1,1,0
1/09/2022,"Palestine, State of",Selangor,302,212,90
1/09/2022,Qatar,Johor,0,0,0
1/09/2022,Qatar,Kedah,0,0,0
1/09/2022,Qatar,Perlis,0,0,0
1/09/2022,Qatar,Pulau Pinang,0,0,0
1/09/2022,Qatar,Sabah,0,0,0
1/09/2022,Qatar,Sarawak,1,1,0
1/09/2022,Qatar,Selangor,40,28,12
1/09/2022,Réunion,Johor,0,0,0
1/09/2022,Réunion,Sarawak,0,0,0
1/09/2022,Romania,Johor,78,48,30
1/09/2022,Romania,Kedah,6,3,3
1/09/2022,Romania,Kelantan,0,0,0
1/09/2022,Romania,Negeri Sembilan,0,0,0
1/09/2022,Romania,Pahang,0,0,0
1/09/2022,Romania,Perak,0,0,0
1/09/2022,Romania,Perlis,0,0,0
1/09/2022,Romania,Pulau Pinang,13,4,9
1/09/2022,Romania,Sabah,3,1,2
1/09/2022,Romania,Sarawak,4,3,1
1/09/2022,Romania,Selangor,386,226,160
1/09/2022,Romania,W.P. Labuan,1,1,0
1/09/2022,Russian Federation (Russia),Johor,265,143,122
1/09/2022,Russian Federation (Russia),Kedah,243,122,121
1/09/2022,Russian Federation (Russia),Kelantan,9,6,3
1/09/2022,Russian Federation (Russia),Melaka,0,0,0
1/09/2022,Russian Federation (Russia),Negeri Sembilan,0,0,0
1/09/2022,Russian Federation (Russia),Pahang,1,0,1
1/09/2022,Russian Federation (Russia),Perak,0,0,0
1/09/2022,Russian Federation (Russia),Perlis,94,53,41
1/09/2022,Russian Federation (Russia),Pulau Pinang,95,59,36
1/09/2022,Russian Federation (Russia),Sabah,10,7,3
1/09/2022,Russian Federation (Russia),Sarawak,35,17,18
1/09/2022,Russian Federation (Russia),Selangor,2592,1315,1277
1/09/2022,Russian Federation (Russia),W.P. Labuan,3,2,1
1/09/2022,Rwanda,Johor,0,0,0
1/09/2022,Rwanda,Kedah,0,0,0
1/09/2022,Rwanda,Pulau Pinang,0,0,0
1/09/2022,Rwanda,Selangor,3,1,2
1/09/2022,Saudi Arabia,Johor,99,73,26
1/09/2022,Saudi Arabia,Kedah,8,5,3
1/09/2022,Saudi Arabia,Kelantan,9,5,4
1/09/2022,Saudi Arabia,Melaka,0,0,0
1/09/2022,Saudi Arabia,Perak,3,1,2
1/09/2022,Saudi Arabia,Perlis,11,9,2
1/09/2022,Saudi Arabia,Pulau Pinang,8,6,2
1/09/2022,Saudi Arabia,Sabah,5,5,0
1/09/2022,Saudi Arabia,Sarawak,19,17,2
1/09/2022,Saudi Arabia,Selangor,2463,1446,1017
1/09/2022,Saudi Arabia,W.P. Labuan,0,0,0
1/09/2022,Sudan,Johor,4,2,2
1/09/2022,Sudan,Kedah,0,0,0
1/09/2022,Sudan,Kelantan,0,0,0
1/09/2022,Sudan,Perlis,0,0,0
1/09/2022,Sudan,Pulau Pinang,0,0,0
1/09/2022,Sudan,Sabah,0,0,0
1/09/2022,Sudan,Sarawak,10,5,5
1/09/2022,Sudan,Selangor,860,522,338
1/09/2022,Sudan,W.P. Labuan,0,0,0
1/09/2022,Senegal,Johor,0,0,0
1/09/2022,Senegal,Kedah,0,0,0
1/09/2022,Senegal,Kelantan,0,0,0
1/09/2022,Senegal,Perak,0,0,0
1/09/2022,Senegal,Perlis,0,0,0
1/09/2022,Senegal,Pulau Pinang,3,0,3
1/09/2022,Senegal,Sabah,0,0,0
1/09/2022,Senegal,Sarawak,0,0,0
1/09/2022,Senegal,Selangor,25,18,7
1/09/2022,Singapore,Johor,1006646,580516,426130
1/09/2022,Singapore,Kedah,3140,1642,1498
1/09/2022,Singapore,Kelantan,90,55,35
1/09/2022,Singapore,Melaka,19,11,8
1/09/2022,Singapore,Negeri Sembilan,1,1,0
1/09/2022,Singapore,Pahang,100,70,30
1/09/2022,Singapore,Perak,4322,1981,2341
1/09/2022,Singapore,Perlis,249,173,76
1/09/2022,Singapore,Pulau Pinang,13498,6674,6824
1/09/2022,Singapore,Sabah,3429,1767,1662
1/09/2022,Singapore,Sarawak,3149,1807,1342
1/09/2022,Singapore,Selangor,32490,17331,15159
1/09/2022,Singapore,Terengganu,2,2,0
1/09/2022,Singapore,W.P. Labuan,2,2,0
1/09/2022,South Georgia and the South Sandwich Islands,Johor,0,0,0
1/09/2022,South Georgia and the South Sandwich Islands,Sabah,0,0,0
1/09/2022,South Georgia and the South Sandwich Islands,Selangor,0,0,0
1/09/2022,Saint Helena,Sarawak,0,0,0
1/09/2022,Solomon Islands,Johor,0,0,0
1/09/2022,Solomon Islands,Perlis,0,0,0
1/09/2022,Solomon Islands,Pulau Pinang,0,0,0
1/09/2022,Solomon Islands,Sabah,0,0,0
1/09/2022,Solomon Islands,Sarawak,0,0,0
1/09/2022,Solomon Islands,Selangor,4,4,0
1/09/2022,Solomon Islands,W.P. Labuan,0,0,0
1/09/2022,Sierra Leone,Johor,0,0,0
1/09/2022,Sierra Leone,Kedah,0,0,0
1/09/2022,Sierra Leone,Perak,0,0,0
1/09/2022,Sierra Leone,Pulau Pinang,0,0,0
1/09/2022,Sierra Leone,Sabah,0,0,0
1/09/2022,Sierra Leone,Selangor,7,5,2
1/09/2022,El Salvador,Johor,1,1,0
1/09/2022,El Salvador,Kedah,0,0,0
1/09/2022,El Salvador,Perak,0,0,0
1/09/2022,El Salvador,Perlis,0,0,0
1/09/2022,El Salvador,Pulau Pinang,0,0,0
1/09/2022,El Salvador,Sabah,0,0,0
1/09/2022,El Salvador,Selangor,6,4,2
1/09/2022,El Salvador,W.P. Labuan,0,0,0
1/09/2022,San Marino,Johor,0,0,0
1/09/2022,San Marino,Selangor,0,0,0
1/09/2022,Somalia,Johor,0,0,0
1/09/2022,Somalia,Kedah,0,0,0
1/09/2022,Somalia,Kelantan,0,0,0
1/09/2022,Somalia,Perlis,0,0,0
1/09/2022,Somalia,Sabah,0,0,0
1/09/2022,Somalia,Sarawak,0,0,0
1/09/2022,Somalia,Selangor,235,148,87
1/09/2022,Serbia,Johor,5,3,2
1/09/2022,Serbia,Kedah,1,1,0
1/09/2022,Serbia,Kelantan,0,0,0
1/09/2022,Serbia,Pahang,0,0,0
1/09/2022,Serbia,Perak,0,0,0
1/09/2022,Serbia,Perlis,0,0,0
1/09/2022,Serbia,Pulau Pinang,13,13,0
1/09/2022,Serbia,Sabah,1,1,0
1/09/2022,Serbia,Sarawak,0,0,0
1/09/2022,Serbia,Selangor,42,25,17
1/09/2022,South Sudan,Johor,0,0,0
1/09/2022,South Sudan,Kedah,0,0,0
1/09/2022,South Sudan,Sarawak,0,0,0
1/09/2022,South Sudan,Selangor,48,35,13
1/09/2022,South Sudan,W.P. Labuan,0,0,0
1/09/2022,Sao Tome and Principe,Selangor,1,1,0
1/09/2022,Suriname,Johor,4,3,1
1/09/2022,Suriname,Kedah,0,0,0
1/09/2022,Suriname,Kelantan,0,0,0
1/09/2022,Suriname,Perak,0,0,0
1/09/2022,Suriname,Perlis,0,0,0
1/09/2022,Suriname,Pulau Pinang,0,0,0
1/09/2022,Suriname,Sabah,0,0,0
1/09/2022,Suriname,Sarawak,0,0,0
1/09/2022,Suriname,Selangor,4,3,1
1/09/2022,Slovakia,Johor,37,21,16
1/09/2022,Slovakia,Kedah,2,1,1
1/09/2022,Slovakia,Kelantan,1,0,1
1/09/2022,Slovakia,Negeri Sembilan,0,0,0
1/09/2022,Slovakia,Pahang,0,0,0
1/09/2022,Slovakia,Perak,0,0,0
1/09/2022,Slovakia,Perlis,0,0,0
1/09/2022,Slovakia,Pulau Pinang,12,7,5
1/09/2022,Slovakia,Sabah,7,5,2
1/09/2022,Slovakia,Sarawak,0,0,0
1/09/2022,Slovakia,Selangor,149,85,64
1/09/2022,Slovakia,W.P. Labuan,0,0,0
1/09/2022,Slovenia,Johor,12,8,4
1/09/2022,Slovenia,Kedah,1,0,1
1/09/2022,Slovenia,Kelantan,0,0,0
1/09/2022,Slovenia,Perak,0,0,0
1/09/2022,Slovenia,Perlis,0,0,0
1/09/2022,Slovenia,Pulau Pinang,2,2,0
1/09/2022,Slovenia,Sabah,0,0,0
1/09/2022,Slovenia,Sarawak,1,0,1
1/09/2022,Slovenia,Selangor,54,31,23
1/09/2022,Slovenia,W.P. Labuan,0,0,0
1/09/2022,Sweden,Johor,249,168,81
1/09/2022,Sweden,Kedah,19,12,7
1/09/2022,Sweden,Kelantan,0,0,0
1/09/2022,Sweden,Melaka,1,1,0
1/09/2022,Sweden,Negeri Sembilan,0,0,0
1/09/2022,Sweden,Pahang,0,0,0
1/09/2022,Sweden,Perak,4,4,0
1/09/2022,Sweden,Perlis,2,1,1
1/09/2022,Sweden,Pulau Pinang,50,43,7
1/09/2022,Sweden,Sabah,17,11,6
1/09/2022,Sweden,Sarawak,7,6,1
1/09/2022,Sweden,Selangor,669,429,240
1/09/2022,Sweden,W.P. Labuan,0,0,0
1/09/2022,Eswatini,Johor,0,0,0
1/09/2022,Eswatini,Kedah,0,0,0
1/09/2022,Eswatini,Pulau Pinang,0,0,0
1/09/2022,Eswatini,Sabah,0,0,0
1/09/2022,Eswatini,Selangor,10,5,5
1/09/2022,Seychelles,Johor,3,1,2
1/09/2022,Seychelles,Kedah,0,0,0
1/09/2022,Seychelles,Pulau Pinang,0,0,0
1/09/2022,Seychelles,Sabah,0,0,0
1/09/2022,Seychelles,Sarawak,1,1,0
1/09/2022,Seychelles,Selangor,62,29,33
1/09/2022,Syrian Arab Republic,Johor,7,1,6
1/09/2022,Syrian Arab Republic,Kedah,0,0,0
1/09/2022,Syrian Arab Republic,Kelantan,0,0,0
1/09/2022,Syrian Arab Republic,Pahang,0,0,0
1/09/2022,Syrian Arab Republic,Perlis,0,0,0
1/09/2022,Syrian Arab Republic,Pulau Pinang,1,1,0
1/09/2022,Syrian Arab Republic,Sabah,0,0,0
1/09/2022,Syrian Arab Republic,Sarawak,2,1,1
1/09/2022,Syrian Arab Republic,Selangor,713,438,275
1/09/2022,Syrian Arab Republic,W.P. Labuan,0,0,0
1/09/2022,Turks and Caicos Islands,Perlis,0,0,0
1/09/2022,TCD,Johor,0,0,0
1/09/2022,TCD,Kedah,0,0,0
1/09/2022,TCD,Perlis,0,0,0
1/09/2022,TCD,Selangor,13,10,3
1/09/2022,Togo,Johor,1,0,1
1/09/2022,Togo,Perak,0,0,0
1/09/2022,Togo,Pulau Pinang,0,0,0
1/09/2022,Togo,Selangor,8,7,1
1/09/2022,Thailand,Johor,4153,947,3206
1/09/2022,Thailand,Kedah,43887,26352,17535
1/09/2022,Thailand,Kelantan,29055,14833,14222
1/09/2022,Thailand,Melaka,2,2,0
1/09/2022,Thailand,Negeri Sembilan,2,1,1
1/09/2022,Thailand,Pahang,38,34,4
1/09/2022,Thailand,Perak,3393,1609,1784
1/09/2022,Thailand,Perlis,45337,27498,17839
1/09/2022,Thailand,Pulau Pinang,1580,675,905
1/09/2022,Thailand,Sabah,135,45,90
1/09/2022,Thailand,Sarawak,161,58,103
1/09/2022,Thailand,Selangor,8635,3579,5056
1/09/2022,Thailand,Terengganu,3,3,0
1/09/2022,Thailand,W.P. Labuan,1,0,1
1/09/2022,Tajikistan,Johor,1,0,1
1/09/2022,Tajikistan,Kedah,1,1,0
1/09/2022,Tajikistan,Perlis,1,1,0
1/09/2022,Tajikistan,Pulau Pinang,0,0,0
1/09/2022,Tajikistan,Sabah,0,0,0
1/09/2022,Tajikistan,Selangor,153,118,35
1/09/2022,Tokelau,Selangor,0,0,0
1/09/2022,Turkmenistan,Johor,3,1,2
1/09/2022,Turkmenistan,Kedah,0,0,0
1/09/2022,Turkmenistan,Kelantan,0,0,0
1/09/2022,Turkmenistan,Perlis,0,0,0
1/09/2022,Turkmenistan,Pulau Pinang,0,0,0
1/09/2022,Turkmenistan,Sabah,0,0,0
1/09/2022,Turkmenistan,Sarawak,0,0,0
1/09/2022,Turkmenistan,Selangor,60,34,26
1/09/2022,Timor-Leste,Johor,26,23,3
1/09/2022,Timor-Leste,Kedah,0,0,0
1/09/2022,Timor-Leste,Perlis,0,0,0
1/09/2022,Timor-Leste,Pulau Pinang,8,6,2
1/09/2022,Timor-Leste,Sabah,0,0,0
1/09/2022,Timor-Leste,Sarawak,0,0,0
1/09/2022,Timor-Leste,Selangor,193,118,75
1/09/2022,Tonga,Johor,0,0,0
1/09/2022,Tonga,Pulau Pinang,1,1,0
1/09/2022,Tonga,Sarawak,0,0,0
1/09/2022,Tonga,Selangor,13,7,6
1/09/2022,Trinidad and Tobago,Johor,1,1,0
1/09/2022,Trinidad and Tobago,Kedah,0,0,0
1/09/2022,Trinidad and Tobago,Pahang,0,0,0
1/09/2022,Trinidad and Tobago,Pulau Pinang,1,1,0
1/09/2022,Trinidad and Tobago,Sabah,0,0,0
1/09/2022,Trinidad and Tobago,Sarawak,1,0,1
1/09/2022,Trinidad and Tobago,Selangor,13,7,6
1/09/2022,Tunisia,Johor,8,4,4
1/09/2022,Tunisia,Kedah,1,1,0
1/09/2022,Tunisia,Kelantan,0,0,0
1/09/2022,Tunisia,Melaka,0,0,0
1/09/2022,Tunisia,Perak,0,0,0
1/09/2022,Tunisia,Perlis,0,0,0
1/09/2022,Tunisia,Pulau Pinang,5,5,0
1/09/2022,Tunisia,Sabah,0,0,0
1/09/2022,Tunisia,Sarawak,1,0,1
1/09/2022,Tunisia,Selangor,530,276,254
1/09/2022,Tunisia,W.P. Labuan,0,0,0
1/09/2022,Türkiye,Johor,159,119,40
1/09/2022,Türkiye,Kedah,16,11,5
1/09/2022,Türkiye,Kelantan,2,2,0
1/09/2022,Türkiye,Melaka,0,0,0
1/09/2022,Türkiye,Negeri Sembilan,2,1,1
1/09/2022,Türkiye,Pahang,0,0,0
1/09/2022,Türkiye,Perak,0,0,0
1/09/2022,Türkiye,Perlis,15,13,2
1/09/2022,Türkiye,Pulau Pinang,22,16,6
1/09/2022,Türkiye,Sabah,3,2,1
1/09/2022,Türkiye,Sarawak,11,8,3
1/09/2022,Türkiye,Selangor,737,517,220
1/09/2022,Türkiye,W.P. Labuan,0,0,0
1/09/2022,Tuvalu,Selangor,0,0,0
1/09/2022,"Taiwan, Province of China",Johor,2649,1117,1532
1/09/2022,"Taiwan, Province of China",Kedah,53,25,28
1/09/2022,"Taiwan, Province of China",Kelantan,0,0,0
1/09/2022,"Taiwan, Province of China",Melaka,0,0,0
1/09/2022,"Taiwan, Province of China",Negeri Sembilan,1,0,1
1/09/2022,"Taiwan, Province of China",Pahang,0,0,0
1/09/2022,"Taiwan, Province of China",Perak,37,19,18
1/09/2022,"Taiwan, Province of China",Perlis,13,7,6
1/09/2022,"Taiwan, Province of China",Pulau Pinang,599,341,258
1/09/2022,"Taiwan, Province of China",Sabah,74,40,34
1/09/2022,"Taiwan, Province of China",Sarawak,123,65,58
1/09/2022,"Taiwan, Province of China",Selangor,5370,2555,2815
1/09/2022,"Taiwan, Province of China",W.P. Labuan,0,0,0
1/09/2022,"Tanzania, United Republic of",Johor,7,2,5
1/09/2022,"Tanzania, United Republic of",Kedah,0,0,0
1/09/2022,"Tanzania, United Republic of",Perak,0,0,0
1/09/2022,"Tanzania, United Republic of",Perlis,0,0,0
1/09/2022,"Tanzania, United Republic of",Pulau Pinang,0,0,0
1/09/2022,"Tanzania, United Republic of",Sabah,0,0,0
1/09/2022,"Tanzania, United Republic of",Sarawak,0,0,0
1/09/2022,"Tanzania, United Republic of",Selangor,143,85,58
1/09/2022,Uganda,Johor,3,1,2
1/09/2022,Uganda,Kedah,0,0,0
1/09/2022,Uganda,Perak,0,0,0
1/09/2022,Uganda,Perlis,0,0,0
1/09/2022,Uganda,Pulau Pinang,1,0,1
1/09/2022,Uganda,Sabah,0,0,0
1/09/2022,Uganda,Sarawak,0,0,0
1/09/2022,Uganda,Selangor,62,33,29
1/09/2022,Ukraine,Johor,71,37,34
1/09/2022,Ukraine,Kedah,27,15,12
1/09/2022,Ukraine,Kelantan,1,0,1
1/09/2022,Ukraine,Melaka,0,0,0
1/09/2022,Ukraine,Negeri Sembilan,0,0,0
1/09/2022,Ukraine,Pahang,2,2,0
1/09/2022,Ukraine,Perak,0,0,0
1/09/2022,Ukraine,Perlis,11,7,4
1/09/2022,Ukraine,Pulau Pinang,30,11,19
1/09/2022,Ukraine,Sabah,2,1,1
1/09/2022,Ukraine,Sarawak,3,3,0
1/09/2022,Ukraine,Selangor,485,260,225
1/09/2022,Ukraine,W.P. Labuan,0,0,0
1/09/2022,Uruguay,Johor,7,3,4
1/09/2022,Uruguay,Kedah,0,0,0
1/09/2022,Uruguay,Kelantan,0,0,0
1/09/2022,Uruguay,Perak,0,0,0
1/09/2022,Uruguay,Perlis,0,0,0
1/09/2022,Uruguay,Pulau Pinang,0,0,0
1/09/2022,Uruguay,Sabah,0,0,0
1/09/2022,Uruguay,Sarawak,0,0,0
1/09/2022,Uruguay,Selangor,13,7,6
1/09/2022,Uruguay,W.P. Labuan,0,0,0
1/09/2022,United States of America,Johor,2801,1763,1038
1/09/2022,United States of America,Kedah,224,122,102
1/09/2022,United States of America,Kelantan,4,1,3
1/09/2022,United States of America,Melaka,3,1,2
1/09/2022,United States of America,Negeri Sembilan,0,0,0
1/09/2022,United States of America,Pahang,8,4,4
1/09/2022,United States of America,Perak,61,37,24
1/09/2022,United States of America,Perlis,55,44,11
1/09/2022,United States of America,Pulau Pinang,1243,814,429
1/09/2022,United States of America,Sabah,253,156,97
1/09/2022,United States of America,Sarawak,229,134,95
1/09/2022,United States of America,Selangor,8891,5502,3389
1/09/2022,United States of America,Terengganu,0,0,0
1/09/2022,United States of America,W.P. Labuan,6,3,3
1/09/2022,Uzbekistan,Johor,63,32,31
1/09/2022,Uzbekistan,Kedah,5,3,2
1/09/2022,Uzbekistan,Kelantan,0,0,0
1/09/2022,Uzbekistan,Perak,0,0,0
1/09/2022,Uzbekistan,Perlis,1,1,0
1/09/2022,Uzbekistan,Pulau Pinang,10,6,4
1/09/2022,Uzbekistan,Sabah,30,28,2
1/09/2022,Uzbekistan,Sarawak,0,0,0
1/09/2022,Uzbekistan,Selangor,700,440,260
1/09/2022,Holy See,Johor,0,0,0
1/09/2022,Holy See,Sarawak,0,0,0
1/09/2022,Holy See,Selangor,2,2,0
1/09/2022,Saint Vincent and the Grenadines,Johor,1,1,0
1/09/2022,Saint Vincent and the Grenadines,Kedah,0,0,0
1/09/2022,Saint Vincent and the Grenadines,Pulau Pinang,0,0,0
1/09/2022,Saint Vincent and the Grenadines,Sarawak,0,0,0
1/09/2022,Saint Vincent and the Grenadines,Selangor,0,0,0
1/09/2022,"Venezuela, Bolivarian Republic of",Johor,8,6,2
1/09/2022,"Venezuela, Bolivarian Republic of",Kedah,1,0,1
1/09/2022,"Venezuela, Bolivarian Republic of",Kelantan,0,0,0
1/09/2022,"Venezuela, Bolivarian Republic of",Melaka,0,0,0
1/09/2022,"Venezuela, Bolivarian Republic of",Perak,0,0,0
1/09/2022,"Venezuela, Bolivarian Republic of",Perlis,0,0,0
1/09/2022,"Venezuela, Bolivarian Republic of",Pulau Pinang,3,2,1
1/09/2022,"Venezuela, Bolivarian Republic of",Sabah,3,1,2
1/09/2022,"Venezuela, Bolivarian Republic of",Sarawak,5,2,3
1/09/2022,"Venezuela, Bolivarian Republic of",Selangor,40,27,13
1/09/2022,"Venezuela, Bolivarian Republic of",W.P. Labuan,0,0,0
1/09/2022,Viet Nam,Johor,12050,3771,8279
1/09/2022,Viet Nam,Kedah,173,24,149
1/09/2022,Viet Nam,Kelantan,7,6,1
1/09/2022,Viet Nam,Melaka,0,0,0
1/09/2022,Viet Nam,Negeri Sembilan,0,0,0
1/09/2022,Viet Nam,Pahang,0,0,0
1/09/2022,Viet Nam,Perak,77,2,75
1/09/2022,Viet Nam,Perlis,190,21,169
1/09/2022,Viet Nam,Pulau Pinang,1174,386,788
1/09/2022,Viet Nam,Sabah,20,6,14
1/09/2022,Viet Nam,Sarawak,90,19,71
1/09/2022,Viet Nam,Selangor,12531,4317,8214
1/09/2022,Viet Nam,Terengganu,1,1,0
1/09/2022,Viet Nam,W.P. Labuan,0,0,0
1/09/2022,Vanuatu,Johor,15,12,3
1/09/2022,Vanuatu,Kedah,0,0,0
1/09/2022,Vanuatu,Pulau Pinang,3,3,0
1/09/2022,Vanuatu,Sabah,1,1,0
1/09/2022,Vanuatu,Sarawak,0,0,0
1/09/2022,Vanuatu,Selangor,46,35,11
1/09/2022, Samoa,Johor,0,0,0
1/09/2022, Samoa,Sarawak,0,0,0
1/09/2022, Samoa,Selangor,7,5,2
1/09/2022,Yemen,Johor,40,28,12
1/09/2022,Yemen,Kedah,4,3,1
1/09/2022,Yemen,Kelantan,0,0,0
1/09/2022,Yemen,Melaka,0,0,0
1/09/2022,Yemen,Pahang,0,0,0
1/09/2022,Yemen,Perak,0,0,0
1/09/2022,Yemen,Perlis,5,4,1
1/09/2022,Yemen,Pulau Pinang,1,1,0
1/09/2022,Yemen,Sabah,1,1,0
1/09/2022,Yemen,Sarawak,7,5,2
1/09/2022,Yemen,Selangor,1251,874,377
1/09/2022,Yemen,W.P. Labuan,0,0,0
1/09/2022,South Africa,Johor,171,116,55
1/09/2022,South Africa,Kedah,14,9,5
1/09/2022,South Africa,Kelantan,0,0,0
1/09/2022,South Africa,Melaka,1,1,0
1/09/2022,South Africa,Pahang,0,0,0
1/09/2022,South Africa,Perak,1,1,0
1/09/2022,South Africa,Perlis,6,4,2
1/09/2022,South Africa,Pulau Pinang,44,24,20
1/09/2022,South Africa,Sabah,17,6,11
1/09/2022,South Africa,Sarawak,80,36,44
1/09/2022,South Africa,Selangor,614,359,255
1/09/2022,South Africa,Terengganu,0,0,0
1/09/2022,South Africa,W.P. Labuan,22,10,12
1/09/2022,ZAR,Selangor,0,0,0
1/09/2022,Zambia,Johor,3,3,0
1/09/2022,Zambia,Kedah,0,0,0
1/09/2022,Zambia,Perak,0,0,0
1/09/2022,Zambia,Perlis,0,0,0
1/09/2022,Zambia,Pulau Pinang,0,0,0
1/09/2022,Zambia,Sabah,0,0,0
1/09/2022,Zambia,Sarawak,0,0,0
1/09/2022,Zambia,Selangor,73,47,26
1/09/2022,Zimbabwe,Johor,6,3,3
1/09/2022,Zimbabwe,Kedah,0,0,0
1/09/2022,Zimbabwe,Kelantan,0,0,0
1/09/2022,Zimbabwe,Perak,0,0,0
1/09/2022,Zimbabwe,Perlis,0,0,0
1/09/2022,Zimbabwe,Pulau Pinang,1,1,0
1/09/2022,Zimbabwe,Sabah,1,0,1
1/09/2022,Zimbabwe,Sarawak,2,0,2
1/09/2022,Zimbabwe,Selangor,87,48,39
1/10/2022,Aruba,Kedah,0,0,0
1/10/2022,Aruba,Pulau Pinang,0,0,0
1/10/2022,Afghanistan,Johor,0,0,0
1/10/2022,Afghanistan,Kedah,0,0,0
1/10/2022,Afghanistan,Perlis,0,0,0
1/10/2022,Afghanistan,Pulau Pinang,0,0,0
1/10/2022,Afghanistan,Sarawak,0,0,0
1/10/2022,Afghanistan,Selangor,48,31,17
1/10/2022,Angola,Johor,0,0,0
1/10/2022,Angola,Kedah,1,0,1
1/10/2022,Angola,Sabah,0,0,0
1/10/2022,Angola,Selangor,5,5,0
1/10/2022,Anguilla,Selangor,0,0,0
1/10/2022,Albania,Johor,24,18,6
1/10/2022,Albania,Kedah,1,1,0
1/10/2022,Albania,Perak,0,0,0
1/10/2022,Albania,Perlis,0,0,0
1/10/2022,Albania,Pulau Pinang,1,0,1
1/10/2022,Albania,Sabah,0,0,0
1/10/2022,Albania,Sarawak,0,0,0
1/10/2022,Albania,Selangor,38,28,10
1/10/2022,Andorra,Johor,0,0,0
1/10/2022,Andorra,Kedah,0,0,0
1/10/2022,Andorra,Perlis,0,0,0
1/10/2022,Andorra,Pulau Pinang,0,0,0
1/10/2022,Andorra,Selangor,6,3,3
1/10/2022,Antigua and Barbuda,Selangor,0,0,0
1/10/2022,United Arab Emirates,Johor,40,28,12
1/10/2022,United Arab Emirates,Kedah,0,0,0
1/10/2022,United Arab Emirates,Kelantan,0,0,0
1/10/2022,United Arab Emirates,Perak,1,0,1
1/10/2022,United Arab Emirates,Perlis,2,2,0
1/10/2022,United Arab Emirates,Pulau Pinang,2,1,1
1/10/2022,United Arab Emirates,Sabah,0,0,0
1/10/2022,United Arab Emirates,Sarawak,0,0,0
1/10/2022,United Arab Emirates,Selangor,311,228,83
1/10/2022,Argentina,Johor,61,32,29
1/10/2022,Argentina,Kedah,17,11,6
1/10/2022,Argentina,Kelantan,0,0,0
1/10/2022,Argentina,Melaka,0,0,0
1/10/2022,Argentina,Perak,2,1,1
1/10/2022,Argentina,Perlis,3,2,1
1/10/2022,Argentina,Pulau Pinang,12,6,6
1/10/2022,Argentina,Sabah,2,1,1
1/10/2022,Argentina,Sarawak,2,1,1
1/10/2022,Argentina,Selangor,282,157,125
1/10/2022,Argentina,W.P. Labuan,0,0,0
1/10/2022,Armenia,Johor,6,5,1
1/10/2022,Armenia,Kedah,6,4,2
1/10/2022,Armenia,Kelantan,0,0,0
1/10/2022,Armenia,Perak,0,0,0
1/10/2022,Armenia,Perlis,0,0,0
1/10/2022,Armenia,Pulau Pinang,3,3,0
1/10/2022,Armenia,Sabah,0,0,0
1/10/2022,Armenia,Sarawak,0,0,0
1/10/2022,Armenia,Selangor,19,9,10
1/10/2022,Antarctica,Selangor,0,0,0
1/10/2022,Antigua and Barbuda,Johor,7,3,4
1/10/2022,Antigua and Barbuda,Kedah,0,0,0
1/10/2022,Antigua and Barbuda,Pulau Pinang,1,0,1
1/10/2022,Antigua and Barbuda,Sarawak,0,0,0
1/10/2022,Antigua and Barbuda,Selangor,23,15,8
1/10/2022,Australia,Johor,4493,2669,1824
1/10/2022,Australia,Kedah,445,244,201
1/10/2022,Australia,Kelantan,2,2,0
1/10/2022,Australia,Melaka,1,1,0
1/10/2022,Australia,Negeri Sembilan,0,0,0
1/10/2022,Australia,Pahang,2,2,0
1/10/2022,Australia,Perak,196,100,96
1/10/2022,Australia,Perlis,51,37,14
1/10/2022,Australia,Pulau Pinang,1343,763,580
1/10/2022,Australia,Sabah,424,233,191
1/10/2022,Australia,Sarawak,470,252,218
1/10/2022,Australia,Selangor,16736,10152,6584
1/10/2022,Australia,Terengganu,0,0,0
1/10/2022,Australia,W.P. Labuan,6,5,1
1/10/2022,Austria,Johor,153,117,36
1/10/2022,Austria,Kedah,13,9,4
1/10/2022,Austria,Kelantan,2,2,0
1/10/2022,Austria,Melaka,0,0,0
1/10/2022,Austria,Negeri Sembilan,0,0,0
1/10/2022,Austria,Pahang,0,0,0
1/10/2022,Austria,Perak,5,2,3
1/10/2022,Austria,Perlis,7,3,4
1/10/2022,Austria,Pulau Pinang,74,59,15
1/10/2022,Austria,Sabah,12,8,4
1/10/2022,Austria,Sarawak,11,7,4
1/10/2022,Austria,Selangor,546,374,172
1/10/2022,Austria,Terengganu,0,0,0
1/10/2022,Austria,W.P. Labuan,2,1,1
1/10/2022,Azerbaijan,Johor,4,3,1
1/10/2022,Azerbaijan,Kedah,5,3,2
1/10/2022,Azerbaijan,Kelantan,0,0,0
1/10/2022,Azerbaijan,Melaka,0,0,0
1/10/2022,Azerbaijan,Perlis,0,0,0
1/10/2022,Azerbaijan,Pulau Pinang,0,0,0
1/10/2022,Azerbaijan,Sabah,1,0,1
1/10/2022,Azerbaijan,Sarawak,1,1,0
1/10/2022,Azerbaijan,Selangor,72,46,26
1/10/2022,Azerbaijan,W.P. Labuan,0,0,0
1/10/2022,Burundi,Pulau Pinang,0,0,0
1/10/2022,Burundi,Sarawak,0,0,0
1/10/2022,Burundi,Selangor,7,5,2
1/10/2022,Belgium,Johor,213,136,77
1/10/2022,Belgium,Kedah,22,11,11
1/10/2022,Belgium,Kelantan,2,2,0
1/10/2022,Belgium,Melaka,0,0,0
1/10/2022,Belgium,Negeri Sembilan,0,0,0
1/10/2022,Belgium,Pahang,0,0,0
1/10/2022,Belgium,Perak,2,1,1
1/10/2022,Belgium,Perlis,7,3,4
1/10/2022,Belgium,Pulau Pinang,33,25,8
1/10/2022,Belgium,Sabah,20,12,8
1/10/2022,Belgium,Sarawak,24,10,14
1/10/2022,Belgium,Selangor,875,558,317
1/10/2022,Belgium,W.P. Labuan,0,0,0
1/10/2022,Benin,Johor,0,0,0
1/10/2022,Benin,Kedah,0,0,0
1/10/2022,Benin,Perak,2,1,1
1/10/2022,Benin,Pulau Pinang,1,1,0
1/10/2022,Benin,Sabah,0,0,0
1/10/2022,Benin,Sarawak,0,0,0
1/10/2022,Benin,Selangor,16,13,3
1/10/2022,Burkina Faso,Perak,1,0,1
1/10/2022,Burkina Faso,Pulau Pinang,0,0,0
1/10/2022,Burkina Faso,Selangor,14,10,4
1/10/2022,Bangladesh,Johor,2043,1687,356
1/10/2022,Bangladesh,Kedah,45,34,11
1/10/2022,Bangladesh,Kelantan,0,0,0
1/10/2022,Bangladesh,Melaka,0,0,0
1/10/2022,Bangladesh,Negeri Sembilan,0,0,0
1/10/2022,Bangladesh,Pahang,0,0,0
1/10/2022,Bangladesh,Perak,0,0,0
1/10/2022,Bangladesh,Perlis,11,8,3
1/10/2022,Bangladesh,Pulau Pinang,238,226,12
1/10/2022,Bangladesh,Sabah,2,1,1
1/10/2022,Bangladesh,Sarawak,26,21,5
1/10/2022,Bangladesh,Selangor,31159,29530,1629
1/10/2022,Bangladesh,W.P. Labuan,0,0,0
1/10/2022,Bulgaria,Johor,62,40,22
1/10/2022,Bulgaria,Kedah,2,0,2
1/10/2022,Bulgaria,Kelantan,0,0,0
1/10/2022,Bulgaria,Pahang,0,0,0
1/10/2022,Bulgaria,Perak,2,0,2
1/10/2022,Bulgaria,Perlis,0,0,0
1/10/2022,Bulgaria,Pulau Pinang,19,6,13
1/10/2022,Bulgaria,Sabah,1,1,0
1/10/2022,Bulgaria,Sarawak,1,0,1
1/10/2022,Bulgaria,Selangor,122,86,36
1/10/2022,Bulgaria,W.P. Labuan,0,0,0
1/10/2022,Bahrain,Johor,2,1,1
1/10/2022,Bahrain,Kedah,0,0,0
1/10/2022,Bahrain,Kelantan,0,0,0
1/10/2022,Bahrain,Perlis,1,1,0
1/10/2022,Bahrain,Pulau Pinang,7,3,4
1/10/2022,Bahrain,Sabah,1,1,0
1/10/2022,Bahrain,Sarawak,0,0,0
1/10/2022,Bahrain,Selangor,132,84,48
1/10/2022,Bahamas,Johor,0,0,0
1/10/2022,Bahamas,Kedah,0,0,0
1/10/2022,Bahamas,Perak,0,0,0
1/10/2022,Bahamas,Sabah,0,0,0
1/10/2022,Bahamas,Sarawak,0,0,0
1/10/2022,Bahamas,Selangor,8,4,4
1/10/2022,Bosnia and Herzegovina,Johor,8,5,3
1/10/2022,Bosnia and Herzegovina,Kedah,0,0,0
1/10/2022,Bosnia and Herzegovina,Perlis,0,0,0
1/10/2022,Bosnia and Herzegovina,Pulau Pinang,1,1,0
1/10/2022,Bosnia and Herzegovina,Sabah,0,0,0
1/10/2022,Bosnia and Herzegovina,Sarawak,2,2,0
1/10/2022,Bosnia and Herzegovina,Selangor,44,25,19
1/10/2022,Belarus,Johor,13,9,4
1/10/2022,Belarus,Kedah,19,8,11
1/10/2022,Belarus,Kelantan,2,1,1
1/10/2022,Belarus,Pahang,0,0,0
1/10/2022,Belarus,Perak,2,0,2
1/10/2022,Belarus,Perlis,0,0,0
1/10/2022,Belarus,Pulau Pinang,4,3,1
1/10/2022,Belarus,Sabah,0,0,0
1/10/2022,Belarus,Sarawak,5,2,3
1/10/2022,Belarus,Selangor,196,89,107
1/10/2022,Belarus,W.P. Labuan,0,0,0
1/10/2022,Belize,Johor,3,1,2
1/10/2022,Belize,Pulau Pinang,0,0,0
1/10/2022,Belize,Sarawak,0,0,0
1/10/2022,Belize,Selangor,2,1,1
1/10/2022,Bermuda,Selangor,0,0,0
1/10/2022,Bolivia,Johor,1,0,1
1/10/2022,Bolivia,Kedah,0,0,0
1/10/2022,Bolivia,Melaka,0,0,0
1/10/2022,Bolivia,Perak,1,1,0
1/10/2022,Bolivia,Perlis,0,0,0
1/10/2022,Bolivia,Pulau Pinang,2,1,1
1/10/2022,Bolivia,Sabah,0,0,0
1/10/2022,Bolivia,Sarawak,4,2,2
1/10/2022,Bolivia,Selangor,16,10,6
1/10/2022,Brazil,Johor,245,130,115
1/10/2022,Brazil,Kedah,22,10,12
1/10/2022,Brazil,Kelantan,0,0,0
1/10/2022,Brazil,Melaka,0,0,0
1/10/2022,Brazil,Pahang,0,0,0
1/10/2022,Brazil,Perak,3,2,1
1/10/2022,Brazil,Perlis,5,2,3
1/10/2022,Brazil,Pulau Pinang,14,9,5
1/10/2022,Brazil,Sabah,1,1,0
1/10/2022,Brazil,Sarawak,13,7,6
1/10/2022,Brazil,Selangor,658,402,256
1/10/2022,Brazil,W.P. Labuan,0,0,0
1/10/2022,Barbados,Johor,1,0,1
1/10/2022,Barbados,Kedah,0,0,0
1/10/2022,Barbados,Perlis,0,0,0
1/10/2022,Barbados,Pulau Pinang,0,0,0
1/10/2022,Barbados,Selangor,10,4,6
1/10/2022,Brunei Darussalam,Johor,294,151,143
1/10/2022,Brunei Darussalam,Kedah,12,7,5
1/10/2022,Brunei Darussalam,Kelantan,0,0,0
1/10/2022,Brunei Darussalam,Melaka,0,0,0
1/10/2022,Brunei Darussalam,Pahang,0,0,0
1/10/2022,Brunei Darussalam,Perak,2,1,1
1/10/2022,Brunei Darussalam,Perlis,6,4,2
1/10/2022,Brunei Darussalam,Pulau Pinang,11,4,7
1/10/2022,Brunei Darussalam,Sabah,638,291,347
1/10/2022,Brunei Darussalam,Sarawak,58681,31932,26749
1/10/2022,Brunei Darussalam,Selangor,3683,1866,1817
1/10/2022,Brunei Darussalam,W.P. Labuan,714,513,201
1/10/2022,Bhutan,Johor,0,0,0
1/10/2022,Bhutan,Kedah,1,1,0
1/10/2022,Bhutan,Perak,0,0,0
1/10/2022,Bhutan,Perlis,0,0,0
1/10/2022,Bhutan,Pulau Pinang,2,2,0
1/10/2022,Bhutan,Sabah,0,0,0
1/10/2022,Bhutan,Sarawak,0,0,0
1/10/2022,Bhutan,Selangor,20,15,5
1/10/2022,Botswana,Johor,5,2,3
1/10/2022,Botswana,Kedah,0,0,0
1/10/2022,Botswana,Perlis,0,0,0
1/10/2022,Botswana,Pulau Pinang,0,0,0
1/10/2022,Botswana,Sabah,0,0,0
1/10/2022,Botswana,Sarawak,1,1,0
1/10/2022,Botswana,Selangor,17,10,7
1/10/2022,Central African Republic,Kedah,0,0,0
1/10/2022,Central African Republic,Selangor,0,0,0
1/10/2022,Canada,Johor,1146,682,464
1/10/2022,Canada,Kedah,111,61,50
1/10/2022,Canada,Kelantan,1,0,1
1/10/2022,Canada,Melaka,0,0,0
1/10/2022,Canada,Negeri Sembilan,0,0,0
1/10/2022,Canada,Pahang,0,0,0
1/10/2022,Canada,Perak,23,12,11
1/10/2022,Canada,Perlis,26,17,9
1/10/2022,Canada,Pulau Pinang,317,200,117
1/10/2022,Canada,Sabah,151,90,61
1/10/2022,Canada,Sarawak,228,125,103
1/10/2022,Canada,Selangor,3401,2047,1354
1/10/2022,Canada,Terengganu,0,0,0
1/10/2022,Canada,W.P. Labuan,5,4,1
1/10/2022,Cocos (Keeling) Islands,Selangor,0,0,0
1/10/2022,Switzerland,Johor,510,309,201
1/10/2022,Switzerland,Kedah,71,41,30
1/10/2022,Switzerland,Kelantan,3,2,1
1/10/2022,Switzerland,Melaka,0,0,0
1/10/2022,Switzerland,Negeri Sembilan,0,0,0
1/10/2022,Switzerland,Pahang,0,0,0
1/10/2022,Switzerland,Perak,6,4,2
1/10/2022,Switzerland,Perlis,13,10,3
1/10/2022,Switzerland,Pulau Pinang,110,67,43
1/10/2022,Switzerland,Sabah,46,27,19
1/10/2022,Switzerland,Sarawak,32,15,17
1/10/2022,Switzerland,Selangor,984,605,379
1/10/2022,Switzerland,W.P. Labuan,3,2,1
1/10/2022,Chile,Johor,33,22,11
1/10/2022,Chile,Kedah,7,3,4
1/10/2022,Chile,Kelantan,0,0,0
1/10/2022,Chile,Melaka,2,1,1
1/10/2022,Chile,Pahang,0,0,0
1/10/2022,Chile,Perak,2,0,2
1/10/2022,Chile,Perlis,6,5,1
1/10/2022,Chile,Pulau Pinang,7,5,2
1/10/2022,Chile,Sabah,2,1,1
1/10/2022,Chile,Sarawak,2,1,1
1/10/2022,Chile,Selangor,125,71,54
1/10/2022,China,Johor,21525,8935,12590
1/10/2022,China,Kedah,473,189,284
1/10/2022,China,Kelantan,9,6,3
1/10/2022,China,Melaka,2,1,1
1/10/2022,China,Pahang,0,0,0
1/10/2022,China,Perak,123,44,79
1/10/2022,China,Perlis,55,33,22
1/10/2022,China,Pulau Pinang,1206,578,628
1/10/2022,China,Sabah,384,170,214
1/10/2022,China,Sarawak,410,213,197
1/10/2022,China,Selangor,16993,9798,7195
1/10/2022,China,Terengganu,0,0,0
1/10/2022,China,W.P. Labuan,7,4,3
1/10/2022,Côte d'Ivoire,Johor,5,3,2
1/10/2022,Côte d'Ivoire,Kedah,0,0,0
1/10/2022,Côte d'Ivoire,Pulau Pinang,1,1,0
1/10/2022,Côte d'Ivoire,Sabah,0,0,0
1/10/2022,Côte d'Ivoire,Sarawak,0,0,0
1/10/2022,Côte d'Ivoire,Selangor,52,38,14
1/10/2022,Cameroon,Johor,1,1,0
1/10/2022,Cameroon,Kedah,0,0,0
1/10/2022,Cameroon,Pulau Pinang,3,2,1
1/10/2022,Cameroon,Sabah,0,0,0
1/10/2022,Cameroon,Sarawak,0,0,0
1/10/2022,Cameroon,Selangor,51,27,24
1/10/2022,Congo,Johor,1,1,0
1/10/2022,Congo,Pulau Pinang,0,0,0
1/10/2022,Congo,Sarawak,0,0,0
1/10/2022,Congo,Selangor,4,4,0
1/10/2022,Congo,Johor,0,0,0
1/10/2022,Congo,Kedah,0,0,0
1/10/2022,Congo,Selangor,1,1,0
1/10/2022,Cook Islands,Selangor,0,0,0
1/10/2022,Colombia,Johor,23,10,13
1/10/2022,Colombia,Kedah,0,0,0
1/10/2022,Colombia,Perak,0,0,0
1/10/2022,Colombia,Pulau Pinang,0,0,0
1/10/2022,Colombia,Sabah,2,1,1
1/10/2022,Colombia,Sarawak,1,0,1
1/10/2022,Colombia,Selangor,218,112,106
1/10/2022,Colombia,W.P. Labuan,0,0,0
1/10/2022,Comoros,Johor,0,0,0
1/10/2022,Comoros,Kedah,0,0,0
1/10/2022,Comoros,Selangor,10,8,2
1/10/2022,Cabo Verde,Johor,0,0,0
1/10/2022,Cabo Verde,Kedah,0,0,0
1/10/2022,Cabo Verde,Pulau Pinang,0,0,0
1/10/2022,Cabo Verde,Sabah,0,0,0
1/10/2022,Cabo Verde,Selangor,5,2,3
1/10/2022,Costa Rica,Johor,9,5,4
1/10/2022,Costa Rica,Kedah,0,0,0
1/10/2022,Costa Rica,Perak,2,1,1
1/10/2022,Costa Rica,Perlis,0,0,0
1/10/2022,Costa Rica,Pulau Pinang,11,7,4
1/10/2022,Costa Rica,Sabah,1,1,0
1/10/2022,Costa Rica,Sarawak,0,0,0
1/10/2022,Costa Rica,Selangor,71,34,37
1/10/2022,Cuba,Johor,7,5,2
1/10/2022,Cuba,Kedah,0,0,0
1/10/2022,Cuba,Perlis,0,0,0
1/10/2022,Cuba,Pulau Pinang,1,1,0
1/10/2022,Cuba,Sabah,0,0,0
1/10/2022,Cuba,Sarawak,0,0,0
1/10/2022,Cuba,Selangor,32,17,15
1/10/2022,Cyprus,Johor,8,5,3
1/10/2022,Cyprus,Kedah,0,0,0
1/10/2022,Cyprus,Perak,0,0,0
1/10/2022,Cyprus,Perlis,0,0,0
1/10/2022,Cyprus,Pulau Pinang,3,2,1
1/10/2022,Cyprus,Sabah,0,0,0
1/10/2022,Cyprus,Sarawak,4,1,3
1/10/2022,Cyprus,Selangor,28,20,8
1/10/2022,Czechia,Johor,63,36,27
1/10/2022,Czechia,Kedah,39,13,26
1/10/2022,Czechia,Kelantan,4,2,2
1/10/2022,Czechia,Melaka,0,0,0
1/10/2022,Czechia,Negeri Sembilan,0,0,0
1/10/2022,Czechia,Perak,0,0,0
1/10/2022,Czechia,Perlis,14,7,7
1/10/2022,Czechia,Pulau Pinang,17,12,5
1/10/2022,Czechia,Sabah,9,4,5
1/10/2022,Czechia,Sarawak,4,2,2
1/10/2022,Czechia,Selangor,346,223,123
1/10/2022,Czechia,W.P. Labuan,0,0,0
1/10/2022,Germany,Johor,2013,1307,706
1/10/2022,Germany,Kedah,349,184,165
1/10/2022,Germany,Kelantan,4,3,1
1/10/2022,Germany,Melaka,1,0,1
1/10/2022,Germany,Negeri Sembilan,0,0,0
1/10/2022,Germany,Pahang,4,3,1
1/10/2022,Germany,Perak,16,10,6
1/10/2022,Germany,Perlis,69,43,26
1/10/2022,Germany,Pulau Pinang,529,391,138
1/10/2022,Germany,Sabah,126,78,48
1/10/2022,Germany,Sarawak,214,129,85
1/10/2022,Germany,Selangor,5474,3458,2016
1/10/2022,Germany,Terengganu,0,0,0
1/10/2022,Germany,W.P. Labuan,12,7,5
1/10/2022,Djibouti,Johor,0,0,0
1/10/2022,Djibouti,Selangor,24,21,3
1/10/2022,Dominica,Johor,5,5,0
1/10/2022,Dominica,Kedah,0,0,0
1/10/2022,Dominica,Pulau Pinang,1,1,0
1/10/2022,Dominica,Sabah,0,0,0
1/10/2022,Dominica,Sarawak,0,0,0
1/10/2022,Dominica,Selangor,30,24,6
1/10/2022,Dominica,W.P. Labuan,0,0,0
1/10/2022,Denmark,Johor,318,216,102
1/10/2022,Denmark,Kedah,37,19,18
1/10/2022,Denmark,Kelantan,0,0,0
1/10/2022,Denmark,Melaka,0,0,0
1/10/2022,Denmark,Negeri Sembilan,0,0,0
1/10/2022,Denmark,Pahang,0,0,0
1/10/2022,Denmark,Perak,6,4,2
1/10/2022,Denmark,Perlis,9,6,3
1/10/2022,Denmark,Pulau Pinang,49,31,18
1/10/2022,Denmark,Sabah,39,24,15
1/10/2022,Denmark,Sarawak,26,12,14
1/10/2022,Denmark,Selangor,735,465,270
1/10/2022,Denmark,W.P. Labuan,0,0,0
1/10/2022,Dominican Republic,Johor,3,2,1
1/10/2022,Dominican Republic,Kedah,0,0,0
1/10/2022,Dominican Republic,Perak,1,0,1
1/10/2022,Dominican Republic,Perlis,1,0,1
1/10/2022,Dominican Republic,Pulau Pinang,0,0,0
1/10/2022,Dominican Republic,Sabah,0,0,0
1/10/2022,Dominican Republic,Sarawak,0,0,0
1/10/2022,Dominican Republic,Selangor,37,18,19
1/10/2022,Algeria,Johor,17,16,1
1/10/2022,Algeria,Kedah,2,1,1
1/10/2022,Algeria,Kelantan,0,0,0
1/10/2022,Algeria,Melaka,0,0,0
1/10/2022,Algeria,Perak,0,0,0
1/10/2022,Algeria,Perlis,0,0,0
1/10/2022,Algeria,Pulau Pinang,4,4,0
1/10/2022,Algeria,Sabah,3,3,0
1/10/2022,Algeria,Sarawak,1,1,0
1/10/2022,Algeria,Selangor,424,288,136
1/10/2022,Algeria,W.P. Labuan,0,0,0
1/10/2022,Ecuador,Johor,19,10,9
1/10/2022,Ecuador,Kedah,0,0,0
1/10/2022,Ecuador,Perak,2,1,1
1/10/2022,Ecuador,Perlis,0,0,0
1/10/2022,Ecuador,Pulau Pinang,1,0,1
1/10/2022,Ecuador,Sabah,1,0,1
1/10/2022,Ecuador,Sarawak,4,2,2
1/10/2022,Ecuador,Selangor,72,44,28
1/10/2022,Egypt,Johor,218,177,41
1/10/2022,Egypt,Kedah,7,5,2
1/10/2022,Egypt,Kelantan,0,0,0
1/10/2022,Egypt,Melaka,0,0,0
1/10/2022,Egypt,Pahang,0,0,0
1/10/2022,Egypt,Perak,1,1,0
1/10/2022,Egypt,Perlis,1,1,0
1/10/2022,Egypt,Pulau Pinang,13,9,4
1/10/2022,Egypt,Sabah,5,5,0
1/10/2022,Egypt,Sarawak,136,95,41
1/10/2022,Egypt,Selangor,1692,1151,541
1/10/2022,Egypt,Terengganu,0,0,0
1/10/2022,Egypt,W.P. Labuan,0,0,0
1/10/2022,Eritrea,Johor,0,0,0
1/10/2022,Eritrea,Pulau Pinang,0,0,0
1/10/2022,Eritrea,Sabah,0,0,0
1/10/2022,Eritrea,Selangor,19,15,4
1/10/2022,Spain,Johor,459,266,193
1/10/2022,Spain,Kedah,80,49,31
1/10/2022,Spain,Kelantan,3,0,3
1/10/2022,Spain,Melaka,0,0,0
1/10/2022,Spain,Negeri Sembilan,0,0,0
1/10/2022,Spain,Pahang,1,1,0
1/10/2022,Spain,Perak,2,0,2
1/10/2022,Spain,Perlis,21,17,4
1/10/2022,Spain,Pulau Pinang,69,45,24
1/10/2022,Spain,Sabah,27,14,13
1/10/2022,Spain,Sarawak,45,27,18
1/10/2022,Spain,Selangor,3003,1913,1090
1/10/2022,Spain,W.P. Labuan,2,1,1
1/10/2022,Estonia,Johor,19,13,6
1/10/2022,Estonia,Kedah,21,15,6
1/10/2022,Estonia,Kelantan,0,0,0
1/10/2022,Estonia,Pahang,0,0,0
1/10/2022,Estonia,Perak,1,1,0
1/10/2022,Estonia,Perlis,0,0,0
1/10/2022,Estonia,Pulau Pinang,6,1,5
1/10/2022,Estonia,Sabah,11,7,4
1/10/2022,Estonia,Sarawak,0,0,0
1/10/2022,Estonia,Selangor,103,53,50
1/10/2022,Estonia,W.P. Labuan,0,0,0
1/10/2022,Ethiopia,Johor,3,3,0
1/10/2022,Ethiopia,Kedah,0,0,0
1/10/2022,Ethiopia,Pulau Pinang,0,0,0
1/10/2022,Ethiopia,Sarawak,3,2,1
1/10/2022,Ethiopia,Selangor,54,47,7
1/10/2022,Finland,Johor,175,96,79
1/10/2022,Finland,Kedah,47,27,20
1/10/2022,Finland,Kelantan,0,0,0
1/10/2022,Finland,Melaka,0,0,0
1/10/2022,Finland,Negeri Sembilan,0,0,0
1/10/2022,Finland,Pahang,0,0,0
1/10/2022,Finland,Perak,1,1,0
1/10/2022,Finland,Perlis,3,3,0
1/10/2022,Finland,Pulau Pinang,48,27,21
1/10/2022,Finland,Sabah,9,6,3
1/10/2022,Finland,Sarawak,9,7,2
1/10/2022,Finland,Selangor,421,248,173
1/10/2022,Finland,W.P. Labuan,2,2,0
1/10/2022,Fiji,Johor,55,22,33
1/10/2022,Fiji,Kedah,0,0,0
1/10/2022,Fiji,Kelantan,0,0,0
1/10/2022,Fiji,Perak,4,3,1
1/10/2022,Fiji,Perlis,0,0,0
1/10/2022,Fiji,Pulau Pinang,6,1,5
1/10/2022,Fiji,Sabah,0,0,0
1/10/2022,Fiji,Sarawak,0,0,0
1/10/2022,Fiji,Selangor,116,73,43
1/10/2022,France,Johor,2074,1292,782
1/10/2022,France,Kedah,283,154,129
1/10/2022,France,Kelantan,14,10,4
1/10/2022,France,Melaka,0,0,0
1/10/2022,France,Negeri Sembilan,1,0,1
1/10/2022,France,Pahang,0,0,0
1/10/2022,France,Perak,32,20,12
1/10/2022,France,Perlis,49,34,15
1/10/2022,France,Pulau Pinang,278,185,93
1/10/2022,France,Sabah,150,87,63
1/10/2022,France,Sarawak,133,76,57
1/10/2022,France,Selangor,6356,3892,2464
1/10/2022,France,Terengganu,2,1,1
1/10/2022,France,W.P. Labuan,1,1,0
1/10/2022,"Micronesia, Federated States of",Johor,0,0,0
1/10/2022,"Micronesia, Federated States of",Pulau Pinang,0,0,0
1/10/2022,"Micronesia, Federated States of",Selangor,1,1,0
1/10/2022,Gabon,Johor,0,0,0
1/10/2022,Gabon,Pulau Pinang,0,0,0
1/10/2022,Gabon,Sarawak,0,0,0
1/10/2022,Gabon,Selangor,14,8,6
1/10/2022,United Kingdom of Great Britain and Northern Ireland,Johor,4645,2909,1736
1/10/2022,United Kingdom of Great Britain and Northern Ireland,Kedah,773,445,328
1/10/2022,United Kingdom of Great Britain and Northern Ireland,Kelantan,10,5,5
1/10/2022,United Kingdom of Great Britain and Northern Ireland,Melaka,1,1,0
1/10/2022,United Kingdom of Great Britain and Northern Ireland,Negeri Sembilan,0,0,0
1/10/2022,United Kingdom of Great Britain and Northern Ireland,Pahang,8,7,1
1/10/2022,United Kingdom of Great Britain and Northern Ireland,Perak,62,34,28
1/10/2022,United Kingdom of Great Britain and Northern Ireland,Perlis,73,47,26
1/10/2022,United Kingdom of Great Britain and Northern Ireland,Pulau Pinang,1199,700,499
1/10/2022,United Kingdom of Great Britain and Northern Ireland,Sabah,552,284,268
1/10/2022,United Kingdom of Great Britain and Northern Ireland,Sarawak,1475,872,603
1/10/2022,United Kingdom of Great Britain and Northern Ireland,Selangor,14629,9069,5560
1/10/2022,United Kingdom of Great Britain and Northern Ireland,Terengganu,0,0,0
1/10/2022,United Kingdom of Great Britain and Northern Ireland,W.P. Labuan,54,42,12
1/10/2022,Georgia,Johor,8,7,1
1/10/2022,Georgia,Kedah,0,0,0
1/10/2022,Georgia,Melaka,0,0,0
1/10/2022,Georgia,Perak,1,0,1
1/10/2022,Georgia,Perlis,1,1,0
1/10/2022,Georgia,Pulau Pinang,0,0,0
1/10/2022,Georgia,Sabah,0,0,0
1/10/2022,Georgia,Sarawak,0,0,0
1/10/2022,Georgia,Selangor,45,28,17
1/10/2022,Ghana,Johor,11,3,8
1/10/2022,Ghana,Kedah,0,0,0
1/10/2022,Ghana,Kelantan,0,0,0
1/10/2022,Ghana,Pulau Pinang,3,2,1
1/10/2022,Ghana,Sabah,0,0,0
1/10/2022,Ghana,Sarawak,1,1,0
1/10/2022,Ghana,Selangor,90,68,22
1/10/2022,Gibraltar,Johor,0,0,0
1/10/2022,Gibraltar,Sarawak,0,0,0
1/10/2022,Guinea,Johor,4,3,1
1/10/2022,Guinea,Kedah,0,0,0
1/10/2022,Guinea,Kelantan,0,0,0
1/10/2022,Guinea,Perlis,5,2,3
1/10/2022,Guinea,Pulau Pinang,0,0,0
1/10/2022,Guinea,Sabah,0,0,0
1/10/2022,Guinea,Sarawak,0,0,0
1/10/2022,Guinea,Selangor,59,42,17
1/10/2022,Guadeloupe,Selangor,0,0,0
1/10/2022,Gambia,Johor,10,6,4
1/10/2022,Gambia,Kedah,0,0,0
1/10/2022,Gambia,Kelantan,0,0,0
1/10/2022,Gambia,Pulau Pinang,1,1,0
1/10/2022,Gambia,Sabah,0,0,0
1/10/2022,Gambia,Sarawak,0,0,0
1/10/2022,Gambia,Selangor,30,29,1
1/10/2022,Guinea-Bissau,Johor,0,0,0
1/10/2022,Guinea-Bissau,Selangor,2,1,1
1/10/2022,Equatorial Guinea,Johor,0,0,0
1/10/2022,Equatorial Guinea,Selangor,0,0,0
1/10/2022,Greece,Johor,60,44,16
1/10/2022,Greece,Kedah,6,3,3
1/10/2022,Greece,Kelantan,0,0,0
1/10/2022,Greece,Melaka,0,0,0
1/10/2022,Greece,Negeri Sembilan,0,0,0
1/10/2022,Greece,Pahang,0,0,0
1/10/2022,Greece,Perak,2,1,1
1/10/2022,Greece,Perlis,1,1,0
1/10/2022,Greece,Pulau Pinang,5,4,1
1/10/2022,Greece,Sabah,0,0,0
1/10/2022,Greece,Sarawak,1,0,1
1/10/2022,Greece,Selangor,139,96,43
1/10/2022,Grenada,Johor,7,4,3
1/10/2022,Grenada,Kedah,0,0,0
1/10/2022,Grenada,Pulau Pinang,0,0,0
1/10/2022,Grenada,Sabah,6,3,3
1/10/2022,Grenada,Sarawak,1,1,0
1/10/2022,Grenada,Selangor,4,3,1
1/10/2022,Greenland,Johor,0,0,0
1/10/2022,Greenland,Selangor,0,0,0
1/10/2022,Guatemala,Johor,1,1,0
1/10/2022,Guatemala,Kedah,0,0,0
1/10/2022,Guatemala,Pahang,0,0,0
1/10/2022,Guatemala,Perak,2,1,1
1/10/2022,Guatemala,Pulau Pinang,1,1,0
1/10/2022,Guatemala,Sabah,0,0,0
1/10/2022,Guatemala,Sarawak,0,0,0
1/10/2022,Guatemala,Selangor,9,3,6
1/10/2022,Guatemala,W.P. Labuan,0,0,0
1/10/2022,Guyana,Johor,1,0,1
1/10/2022,Guyana,Kedah,0,0,0
1/10/2022,Guyana,Pulau Pinang,0,0,0
1/10/2022,Guyana,Sarawak,0,0,0
1/10/2022,Guyana,Selangor,2,1,1
1/10/2022,Hong Kong,Johor,3,1,2
1/10/2022,Hong Kong,Kedah,0,0,0
1/10/2022,Hong Kong,Kelantan,0,0,0
1/10/2022,Hong Kong,Pahang,0,0,0
1/10/2022,Hong Kong,Perak,29,15,14
1/10/2022,Hong Kong,Perlis,0,0,0
1/10/2022,Hong Kong,Pulau Pinang,0,0,0
1/10/2022,Hong Kong,Sabah,8,5,3
1/10/2022,Hong Kong,Sarawak,0,0,0
1/10/2022,Hong Kong,Selangor,74,41,33
1/10/2022,Hong Kong,Terengganu,0,0,0
1/10/2022,Heard Island and McDonald Islands,Johor,0,0,0
1/10/2022,Honduras,Johor,8,3,5
1/10/2022,Honduras,Kedah,1,0,1
1/10/2022,Honduras,Perak,2,1,1
1/10/2022,Honduras,Pulau Pinang,2,1,1
1/10/2022,Honduras,Sabah,1,1,0
1/10/2022,Honduras,Sarawak,0,0,0
1/10/2022,Honduras,Selangor,7,4,3
1/10/2022,Croatia,Johor,28,20,8
1/10/2022,Croatia,Kedah,0,0,0
1/10/2022,Croatia,Kelantan,0,0,0
1/10/2022,Croatia,Melaka,0,0,0
1/10/2022,Croatia,Pahang,0,0,0
1/10/2022,Croatia,Perak,0,0,0
1/10/2022,Croatia,Perlis,0,0,0
1/10/2022,Croatia,Pulau Pinang,6,4,2
1/10/2022,Croatia,Sabah,1,1,0
1/10/2022,Croatia,Sarawak,3,2,1
1/10/2022,Croatia,Selangor,113,89,24
1/10/2022,Haiti,Johor,3,1,2
1/10/2022,Haiti,Kedah,1,0,1
1/10/2022,Haiti,Kelantan,0,0,0
1/10/2022,Haiti,Perak,1,1,0
1/10/2022,Haiti,Pulau Pinang,0,0,0
1/10/2022,Haiti,Sabah,0,0,0
1/10/2022,Haiti,Selangor,0,0,0
1/10/2022,Hungary,Johor,104,72,32
1/10/2022,Hungary,Kedah,8,6,2
1/10/2022,Hungary,Kelantan,0,0,0
1/10/2022,Hungary,Pahang,0,0,0
1/10/2022,Hungary,Perak,1,0,1
1/10/2022,Hungary,Perlis,1,1,0
1/10/2022,Hungary,Pulau Pinang,15,11,4
1/10/2022,Hungary,Sabah,1,1,0
1/10/2022,Hungary,Sarawak,2,1,1
1/10/2022,Hungary,Selangor,335,186,149
1/10/2022,Hungary,W.P. Labuan,0,0,0
1/10/2022,Indonesia,Johor,92684,50940,41744
1/10/2022,Indonesia,Kedah,3570,1231,2339
1/10/2022,Indonesia,Kelantan,151,112,39
1/10/2022,Indonesia,Melaka,6724,3080,3644
1/10/2022,Indonesia,Negeri Sembilan,7349,5041,2308
1/10/2022,Indonesia,Pahang,3,3,0
1/10/2022,Indonesia,Perak,143,44,99
1/10/2022,Indonesia,Perlis,431,158,273
1/10/2022,Indonesia,Pulau Pinang,25298,9479,15819
1/10/2022,Indonesia,Sabah,3405,1685,1720
1/10/2022,Indonesia,Sarawak,27248,15616,11632
1/10/2022,Indonesia,Selangor,81534,41146,40388
1/10/2022,Indonesia,Terengganu,0,0,0
1/10/2022,Indonesia,W.P. Labuan,21,13,8
1/10/2022,India,Johor,16054,10877,5177
1/10/2022,India,Kedah,789,457,332
1/10/2022,India,Kelantan,1,1,0
1/10/2022,India,Melaka,1,1,0
1/10/2022,India,Negeri Sembilan,2,2,0
1/10/2022,India,Pahang,0,0,0
1/10/2022,India,Perak,242,210,32
1/10/2022,India,Perlis,80,71,9
1/10/2022,India,Pulau Pinang,1888,1416,472
1/10/2022,India,Sabah,208,124,84
1/10/2022,India,Sarawak,444,336,108
1/10/2022,India,Selangor,48579,34881,13698
1/10/2022,India,Terengganu,0,0,0
1/10/2022,India,W.P. Labuan,27,21,6
1/10/2022, British Indian Ocean Territory,Pulau Pinang,1,1,0
1/10/2022, British Indian Ocean Territory,Selangor,0,0,0
1/10/2022,Ireland,Johor,291,182,109
1/10/2022,Ireland,Kedah,73,41,32
1/10/2022,Ireland,Kelantan,0,0,0
1/10/2022,Ireland,Negeri Sembilan,0,0,0
1/10/2022,Ireland,Pahang,0,0,0
1/10/2022,Ireland,Perak,7,2,5
1/10/2022,Ireland,Perlis,11,9,2
1/10/2022,Ireland,Pulau Pinang,105,69,36
1/10/2022,Ireland,Sabah,23,13,10
1/10/2022,Ireland,Sarawak,39,20,19
1/10/2022,Ireland,Selangor,1296,757,539
1/10/2022,Ireland,Terengganu,0,0,0
1/10/2022,Ireland,W.P. Labuan,0,0,0
1/10/2022,"Iran, Islamic Republic of",Johor,93,64,29
1/10/2022,"Iran, Islamic Republic of",Kedah,3,1,2
1/10/2022,"Iran, Islamic Republic of",Kelantan,0,0,0
1/10/2022,"Iran, Islamic Republic of",Perak,0,0,0
1/10/2022,"Iran, Islamic Republic of",Perlis,7,6,1
1/10/2022,"Iran, Islamic Republic of",Pulau Pinang,8,6,2
1/10/2022,"Iran, Islamic Republic of",Sabah,1,1,0
1/10/2022,"Iran, Islamic Republic of",Sarawak,1,1,0
1/10/2022,"Iran, Islamic Republic of",Selangor,857,498,359
1/10/2022,"Iran, Islamic Republic of",W.P. Labuan,0,0,0
1/10/2022,Iraq,Johor,12,11,1
1/10/2022,Iraq,Kedah,2,1,1
1/10/2022,Iraq,Kelantan,0,0,0
1/10/2022,Iraq,Melaka,0,0,0
1/10/2022,Iraq,Pahang,0,0,0
1/10/2022,Iraq,Perak,0,0,0
1/10/2022,Iraq,Perlis,0,0,0
1/10/2022,Iraq,Pulau Pinang,2,2,0
1/10/2022,Iraq,Sabah,0,0,0
1/10/2022,Iraq,Sarawak,1,0,1
1/10/2022,Iraq,Selangor,705,498,207
1/10/2022,Iceland,Johor,3,3,0
1/10/2022,Iceland,Kedah,0,0,0
1/10/2022,Iceland,Kelantan,0,0,0
1/10/2022,Iceland,Perak,2,1,1
1/10/2022,Iceland,Perlis,0,0,0
1/10/2022,Iceland,Pulau Pinang,2,2,0
1/10/2022,Iceland,Sabah,8,4,4
1/10/2022,Iceland,Sarawak,0,0,0
1/10/2022,Iceland,Selangor,24,13,11
1/10/2022,Iceland,W.P. Labuan,0,0,0
1/10/2022,Israel,Pulau Pinang,0,0,0
1/10/2022,Italy,Johor,450,324,126
1/10/2022,Italy,Kedah,63,40,23
1/10/2022,Italy,Kelantan,3,1,2
1/10/2022,Italy,Melaka,0,0,0
1/10/2022,Italy,Negeri Sembilan,0,0,0
1/10/2022,Italy,Pahang,1,1,0
1/10/2022,Italy,Perak,2,2,0
1/10/2022,Italy,Perlis,14,9,5
1/10/2022,Italy,Pulau Pinang,78,53,25
1/10/2022,Italy,Sabah,24,14,10
1/10/2022,Italy,Sarawak,19,13,6
1/10/2022,Italy,Selangor,2226,1671,555
1/10/2022,Italy,W.P. Labuan,0,0,0
1/10/2022,Jamaica,Johor,8,1,7
1/10/2022,Jamaica,Kedah,0,0,0
1/10/2022,Jamaica,Perak,1,0,1
1/10/2022,Jamaica,Pulau Pinang,2,1,1
1/10/2022,Jamaica,Sabah,0,0,0
1/10/2022,Jamaica,Sarawak,0,0,0
1/10/2022,Jamaica,Selangor,12,7,5
1/10/2022,Jamaica,W.P. Labuan,0,0,0
1/10/2022,Jordan,Johor,9,8,1
1/10/2022,Jordan,Kedah,10,6,4
1/10/2022,Jordan,Kelantan,0,0,0
1/10/2022,Jordan,Melaka,0,0,0
1/10/2022,Jordan,Perlis,2,2,0
1/10/2022,Jordan,Pulau Pinang,5,3,2
1/10/2022,Jordan,Sabah,1,1,0
1/10/2022,Jordan,Sarawak,4,4,0
1/10/2022,Jordan,Selangor,630,400,230
1/10/2022,Jordan,W.P. Labuan,0,0,0
1/10/2022,Japan,Johor,4801,3430,1371
1/10/2022,Japan,Kedah,148,75,73
1/10/2022,Japan,Kelantan,3,3,0
1/10/2022,Japan,Melaka,1,1,0
1/10/2022,Japan,Negeri Sembilan,0,0,0
1/10/2022,Japan,Pahang,1,0,1
1/10/2022,Japan,Perak,38,26,12
1/10/2022,Japan,Perlis,53,37,16
1/10/2022,Japan,Pulau Pinang,808,617,191
1/10/2022,Japan,Sabah,201,109,92
1/10/2022,Japan,Sarawak,138,86,52
1/10/2022,Japan,Selangor,10744,7300,3444
1/10/2022,Japan,W.P. Labuan,4,3,1
1/10/2022,Kazakhstan,Johor,39,21,18
1/10/2022,Kazakhstan,Kedah,13,6,7
1/10/2022,Kazakhstan,Kelantan,0,0,0
1/10/2022,Kazakhstan,Melaka,0,0,0
1/10/2022,Kazakhstan,Perak,0,0,0
1/10/2022,Kazakhstan,Perlis,3,2,1
1/10/2022,Kazakhstan,Pulau Pinang,6,2,4
1/10/2022,Kazakhstan,Sabah,2,2,0
1/10/2022,Kazakhstan,Sarawak,3,1,2
1/10/2022,Kazakhstan,Selangor,464,164,300
1/10/2022,Kazakhstan,W.P. Labuan,0,0,0
1/10/2022,Kenya,Johor,65,29,36
1/10/2022,Kenya,Kedah,2,1,1
1/10/2022,Kenya,Kelantan,1,0,1
1/10/2022,Kenya,Perak,2,1,1
1/10/2022,Kenya,Perlis,1,1,0
1/10/2022,Kenya,Pulau Pinang,3,1,2
1/10/2022,Kenya,Sabah,1,1,0
1/10/2022,Kenya,Sarawak,0,0,0
1/10/2022,Kenya,Selangor,230,119,111
1/10/2022,Kyrgyzstan,Johor,15,4,11
1/10/2022,Kyrgyzstan,Kedah,1,1,0
1/10/2022,Kyrgyzstan,Kelantan,0,0,0
1/10/2022,Kyrgyzstan,Perak,0,0,0
1/10/2022,Kyrgyzstan,Perlis,0,0,0
1/10/2022,Kyrgyzstan,Pulau Pinang,0,0,0
1/10/2022,Kyrgyzstan,Sabah,0,0,0
1/10/2022,Kyrgyzstan,Sarawak,0,0,0
1/10/2022,Kyrgyzstan,Selangor,89,50,39
1/10/2022,Cambodia,Johor,1402,560,842
1/10/2022,Cambodia,Kedah,195,155,40
1/10/2022,Cambodia,Kelantan,766,443,323
1/10/2022,Cambodia,Melaka,8,4,4
1/10/2022,Cambodia,Negeri Sembilan,0,0,0
1/10/2022,Cambodia,Pahang,0,0,0
1/10/2022,Cambodia,Perak,12,6,6
1/10/2022,Cambodia,Perlis,948,611,337
1/10/2022,Cambodia,Pulau Pinang,33,17,16
1/10/2022,Cambodia,Sabah,1,1,0
1/10/2022,Cambodia,Sarawak,2,1,1
1/10/2022,Cambodia,Selangor,3696,1847,1849
1/10/2022,Cambodia,W.P. Labuan,0,0,0
1/10/2022,Kiribati,Johor,0,0,0
1/10/2022,Kiribati,Sabah,0,0,0
1/10/2022,Kiribati,Selangor,0,0,0
1/10/2022,Saint Kitts and Nevis,Johor,27,16,11
1/10/2022,Saint Kitts and Nevis,Kedah,0,0,0
1/10/2022,Saint Kitts and Nevis,Perlis,0,0,0
1/10/2022,Saint Kitts and Nevis,Pulau Pinang,4,4,0
1/10/2022,Saint Kitts and Nevis,Sabah,0,0,0
1/10/2022,Saint Kitts and Nevis,Selangor,50,40,10
1/10/2022,Saint Kitts and Nevis,W.P. Labuan,0,0,0
1/10/2022,"Korea, Republic of",Johor,8235,4746,3489
1/10/2022,"Korea, Republic of",Kedah,116,53,63
1/10/2022,"Korea, Republic of",Kelantan,0,0,0
1/10/2022,"Korea, Republic of",Melaka,0,0,0
1/10/2022,"Korea, Republic of",Negeri Sembilan,0,0,0
1/10/2022,"Korea, Republic of",Pahang,0,0,0
1/10/2022,"Korea, Republic of",Perak,9,6,3
1/10/2022,"Korea, Republic of",Perlis,57,40,17
1/10/2022,"Korea, Republic of",Pulau Pinang,373,220,153
1/10/2022,"Korea, Republic of",Sabah,6038,2652,3386
1/10/2022,"Korea, Republic of",Sarawak,160,87,73
1/10/2022,"Korea, Republic of",Selangor,8670,5104,3566
1/10/2022,"Korea, Republic of",Terengganu,0,0,0
1/10/2022,"Korea, Republic of",W.P. Labuan,0,0,0
1/10/2022,Kuwait,Johor,12,3,9
1/10/2022,Kuwait,Kedah,3,3,0
1/10/2022,Kuwait,Kelantan,1,1,0
1/10/2022,Kuwait,Perak,0,0,0
1/10/2022,Kuwait,Perlis,0,0,0
1/10/2022,Kuwait,Pulau Pinang,6,3,3
1/10/2022,Kuwait,Sabah,0,0,0
1/10/2022,Kuwait,Sarawak,0,0,0
1/10/2022,Kuwait,Selangor,294,191,103
1/10/2022,Kuwait,W.P. Labuan,0,0,0
1/10/2022, Lao People's Democratic Republic,Johor,89,29,60
1/10/2022, Lao People's Democratic Republic,Kedah,885,93,792
1/10/2022, Lao People's Democratic Republic,Kelantan,85,5,80
1/10/2022, Lao People's Democratic Republic,Melaka,0,0,0
1/10/2022, Lao People's Democratic Republic,Perak,14,1,13
1/10/2022, Lao People's Democratic Republic,Perlis,135,37,98
1/10/2022, Lao People's Democratic Republic,Pulau Pinang,16,1,15
1/10/2022, Lao People's Democratic Republic,Sabah,2,0,2
1/10/2022, Lao People's Democratic Republic,Sarawak,5,5,0
1/10/2022, Lao People's Democratic Republic,Selangor,284,124,160
1/10/2022, Lao People's Democratic Republic,W.P. Labuan,0,0,0
1/10/2022,Lebanon,Johor,16,8,8
1/10/2022,Lebanon,Kedah,5,2,3
1/10/2022,Lebanon,Kelantan,0,0,0
1/10/2022,Lebanon,Pahang,0,0,0
1/10/2022,Lebanon,Perak,0,0,0
1/10/2022,Lebanon,Perlis,0,0,0
1/10/2022,Lebanon,Pulau Pinang,5,5,0
1/10/2022,Lebanon,Sabah,1,1,0
1/10/2022,Lebanon,Sarawak,1,1,0
1/10/2022,Lebanon,Selangor,176,123,53
1/10/2022,Lebanon,W.P. Labuan,0,0,0
1/10/2022,Liberia,Johor,1,1,0
1/10/2022,Liberia,Kedah,0,0,0
1/10/2022,Liberia,Sabah,1,1,0
1/10/2022,Liberia,Sarawak,0,0,0
1/10/2022,Liberia,Selangor,23,17,6
1/10/2022,Libya,Johor,0,0,0
1/10/2022,Libya,Kedah,0,0,0
1/10/2022,Libya,Perlis,0,0,0
1/10/2022,Libya,Pulau Pinang,2,2,0
1/10/2022,Libya,Sabah,1,1,0
1/10/2022,Libya,Sarawak,0,0,0
1/10/2022,Libya,Selangor,318,216,102
1/10/2022,Saint Lucia,Johor,11,7,4
1/10/2022,Saint Lucia,Kedah,0,0,0
1/10/2022,Saint Lucia,Pulau Pinang,0,0,0
1/10/2022,Saint Lucia,Sarawak,0,0,0
1/10/2022,Saint Lucia,Selangor,4,4,0
1/10/2022,Liechtenstein,Johor,3,3,0
1/10/2022,Liechtenstein,Kedah,0,0,0
1/10/2022,Liechtenstein,Perlis,0,0,0
1/10/2022,Liechtenstein,Pulau Pinang,0,0,0
1/10/2022,Liechtenstein,Sabah,0,0,0
1/10/2022,Liechtenstein,Sarawak,0,0,0
1/10/2022,Liechtenstein,Selangor,3,3,0
1/10/2022,LKA,Johor,953,689,264
1/10/2022,LKA,Kedah,27,15,12
1/10/2022,LKA,Kelantan,0,0,0
1/10/2022,LKA,Melaka,0,0,0
1/10/2022,LKA,Pahang,0,0,0
1/10/2022,LKA,Perak,5,3,2
1/10/2022,LKA,Perlis,0,0,0
1/10/2022,LKA,Pulau Pinang,26,17,9
1/10/2022,LKA,Sabah,12,7,5
1/10/2022,LKA,Sarawak,20,13,7
1/10/2022,LKA,Selangor,2950,1946,1004
1/10/2022,LKA,W.P. Labuan,0,0,0
1/10/2022,Lesotho,Johor,0,0,0
1/10/2022,Lesotho,Kedah,0,0,0
1/10/2022,Lesotho,Pulau Pinang,0,0,0
1/10/2022,Lesotho,Sarawak,0,0,0
1/10/2022,Lesotho,Selangor,1,1,0
1/10/2022,Lithuania,Johor,34,11,23
1/10/2022,Lithuania,Kedah,9,4,5
1/10/2022,Lithuania,Kelantan,0,0,0
1/10/2022,Lithuania,Pahang,0,0,0
1/10/2022,Lithuania,Perak,6,2,4
1/10/2022,Lithuania,Perlis,0,0,0
1/10/2022,Lithuania,Pulau Pinang,16,7,9
1/10/2022,Lithuania,Sabah,11,7,4
1/10/2022,Lithuania,Sarawak,5,2,3
1/10/2022,Lithuania,Selangor,148,91,57
1/10/2022,Lithuania,W.P. Labuan,0,0,0
1/10/2022,Luxembourg,Johor,6,2,4
1/10/2022,Luxembourg,Kedah,2,2,0
1/10/2022,Luxembourg,Kelantan,0,0,0
1/10/2022,Luxembourg,Perak,0,0,0
1/10/2022,Luxembourg,Perlis,0,0,0
1/10/2022,Luxembourg,Pulau Pinang,2,1,1
1/10/2022,Luxembourg,Sabah,0,0,0
1/10/2022,Luxembourg,Sarawak,1,1,0
1/10/2022,Luxembourg,Selangor,29,18,11
1/10/2022,Latvia,Johor,48,19,29
1/10/2022,Latvia,Kedah,31,12,19
1/10/2022,Latvia,Kelantan,0,0,0
1/10/2022,Latvia,Pahang,0,0,0
1/10/2022,Latvia,Perak,0,0,0
1/10/2022,Latvia,Perlis,2,1,1
1/10/2022,Latvia,Pulau Pinang,5,1,4
1/10/2022,Latvia,Sabah,5,3,2
1/10/2022,Latvia,Sarawak,8,4,4
1/10/2022,Latvia,Selangor,100,44,56
1/10/2022,Latvia,W.P. Labuan,13,6,7
1/10/2022,Macao,Johor,1,0,1
1/10/2022,Macao,Pahang,0,0,0
1/10/2022,Macao,Perak,0,0,0
1/10/2022,Macao,Selangor,3,0,3
1/10/2022,Macao,W.P. Labuan,0,0,0
1/10/2022,Morocco,Johor,91,57,34
1/10/2022,Morocco,Kedah,2,1,1
1/10/2022,Morocco,Kelantan,2,2,0
1/10/2022,Morocco,Melaka,0,0,0
1/10/2022,Morocco,Pahang,0,0,0
1/10/2022,Morocco,Perak,0,0,0
1/10/2022,Morocco,Perlis,2,2,0
1/10/2022,Morocco,Pulau Pinang,7,6,1
1/10/2022,Morocco,Sabah,4,1,3
1/10/2022,Morocco,Sarawak,4,4,0
1/10/2022,Morocco,Selangor,880,454,426
1/10/2022,Morocco,W.P. Labuan,0,0,0
1/10/2022,Monaco,Johor,0,0,0
1/10/2022,Monaco,Kedah,0,0,0
1/10/2022,Monaco,Sabah,0,0,0
1/10/2022,Monaco,Selangor,2,1,1
1/10/2022,"Moldova, Republic of",Johor,0,0,0
1/10/2022,"Moldova, Republic of",Kedah,0,0,0
1/10/2022,"Moldova, Republic of",Kelantan,0,0,0
1/10/2022,"Moldova, Republic of",Negeri Sembilan,0,0,0
1/10/2022,"Moldova, Republic of",Perlis,0,0,0
1/10/2022,"Moldova, Republic of",Pulau Pinang,1,1,0
1/10/2022,"Moldova, Republic of",Sabah,0,0,0
1/10/2022,"Moldova, Republic of",Sarawak,0,0,0
1/10/2022,"Moldova, Republic of",Selangor,16,13,3
1/10/2022,Madagascar,Johor,5,2,3
1/10/2022,Madagascar,Kedah,0,0,0
1/10/2022,Madagascar,Perak,2,0,2
1/10/2022,Madagascar,Perlis,0,0,0
1/10/2022,Madagascar,Pulau Pinang,0,0,0
1/10/2022,Madagascar,Sabah,0,0,0
1/10/2022,Madagascar,Sarawak,0,0,0
1/10/2022,Madagascar,Selangor,9,3,6
1/10/2022,Maldives,Johor,93,61,32
1/10/2022,Maldives,Kedah,1,1,0
1/10/2022,Maldives,Kelantan,0,0,0
1/10/2022,Maldives,Perak,2,1,1
1/10/2022,Maldives,Perlis,0,0,0
1/10/2022,Maldives,Pulau Pinang,3,3,0
1/10/2022,Maldives,Sabah,0,0,0
1/10/2022,Maldives,Sarawak,2,2,0
1/10/2022,Maldives,Selangor,1838,984,854
1/10/2022,Mexico,Johor,181,77,104
1/10/2022,Mexico,Kedah,6,1,5
1/10/2022,Mexico,Kelantan,0,0,0
1/10/2022,Mexico,Pahang,0,0,0
1/10/2022,Mexico,Perak,1,0,1
1/10/2022,Mexico,Perlis,3,2,1
1/10/2022,Mexico,Pulau Pinang,39,30,9
1/10/2022,Mexico,Sabah,8,5,3
1/10/2022,Mexico,Sarawak,7,3,4
1/10/2022,Mexico,Selangor,550,292,258
1/10/2022,Mexico,W.P. Labuan,0,0,0
1/10/2022,Marshall Islands,Johor,0,0,0
1/10/2022,Marshall Islands,Kedah,1,1,0
1/10/2022,Marshall Islands,Perak,0,0,0
1/10/2022,Marshall Islands,Pulau Pinang,0,0,0
1/10/2022,Marshall Islands,Sabah,0,0,0
1/10/2022,Marshall Islands,Selangor,3,2,1
1/10/2022,North Macedonia,Johor,7,2,5
1/10/2022,North Macedonia,Kedah,0,0,0
1/10/2022,North Macedonia,Perak,2,0,2
1/10/2022,North Macedonia,Pulau Pinang,3,3,0
1/10/2022,North Macedonia,Sabah,0,0,0
1/10/2022,North Macedonia,Sarawak,1,0,1
1/10/2022,North Macedonia,Selangor,30,17,13
1/10/2022,Mali,Johor,0,0,0
1/10/2022,Mali,Sabah,0,0,0
1/10/2022,Mali,Selangor,10,7,3
1/10/2022,Malta,Johor,9,7,2
1/10/2022,Malta,Kedah,2,2,0
1/10/2022,Malta,Kelantan,0,0,0
1/10/2022,Malta,Perak,0,0,0
1/10/2022,Malta,Perlis,1,1,0
1/10/2022,Malta,Pulau Pinang,2,2,0
1/10/2022,Malta,Sabah,0,0,0
1/10/2022,Malta,Sarawak,0,0,0
1/10/2022,Malta,Selangor,26,15,11
1/10/2022,Malta,W.P. Labuan,0,0,0
1/10/2022,Myanmar,Johor,3212,914,2298
1/10/2022,Myanmar,Kedah,46,9,37
1/10/2022,Myanmar,Kelantan,2,0,2
1/10/2022,Myanmar,Negeri Sembilan,0,0,0
1/10/2022,Myanmar,Pahang,0,0,0
1/10/2022,Myanmar,Perak,15,8,7
1/10/2022,Myanmar,Perlis,7,3,4
1/10/2022,Myanmar,Pulau Pinang,112,50,62
1/10/2022,Myanmar,Sabah,10,2,8
1/10/2022,Myanmar,Sarawak,38,17,21
1/10/2022,Myanmar,Selangor,7530,5036,2494
1/10/2022,Myanmar,Terengganu,0,0,0
1/10/2022,Myanmar,W.P. Labuan,0,0,0
1/10/2022,Montenegro,Johor,0,0,0
1/10/2022,Montenegro,Kedah,0,0,0
1/10/2022,Montenegro,Pulau Pinang,0,0,0
1/10/2022,Montenegro,Sabah,0,0,0
1/10/2022,Montenegro,Sarawak,0,0,0
1/10/2022,Montenegro,Selangor,11,9,2
1/10/2022,Mongolia,Johor,87,43,44
1/10/2022,Mongolia,Kedah,2,0,2
1/10/2022,Mongolia,Kelantan,0,0,0
1/10/2022,Mongolia,Perak,0,0,0
1/10/2022,Mongolia,Perlis,0,0,0
1/10/2022,Mongolia,Pulau Pinang,5,1,4
1/10/2022,Mongolia,Sabah,3,2,1
1/10/2022,Mongolia,Sarawak,2,2,0
1/10/2022,Mongolia,Selangor,227,104,123
1/10/2022,Northern Mariana Islands,Selangor,0,0,0
1/10/2022,Mozambique,Johor,6,5,1
1/10/2022,Mozambique,Kedah,0,0,0
1/10/2022,Mozambique,Perak,0,0,0
1/10/2022,Mozambique,Pulau Pinang,0,0,0
1/10/2022,Mozambique,Sabah,0,0,0
1/10/2022,Mozambique,Sarawak,0,0,0
1/10/2022,Mozambique,Selangor,20,13,7
1/10/2022,Mauritania,Johor,0,0,0
1/10/2022,Mauritania,Kedah,0,0,0
1/10/2022,Mauritania,Pulau Pinang,0,0,0
1/10/2022,Mauritania,Sabah,1,1,0
1/10/2022,Mauritania,Sarawak,0,0,0
1/10/2022,Mauritania,Selangor,51,47,4
1/10/2022,Mauritius,Johor,75,42,33
1/10/2022,Mauritius,Kedah,6,3,3
1/10/2022,Mauritius,Kelantan,0,0,0
1/10/2022,Mauritius,Pahang,0,0,0
1/10/2022,Mauritius,Perak,0,0,0
1/10/2022,Mauritius,Perlis,0,0,0
1/10/2022,Mauritius,Pulau Pinang,3,3,0
1/10/2022,Mauritius,Sabah,0,0,0
1/10/2022,Mauritius,Sarawak,0,0,0
1/10/2022,Mauritius,Selangor,266,181,85
1/10/2022,Malawi,Johor,0,0,0
1/10/2022,Malawi,Pulau Pinang,0,0,0
1/10/2022,Malawi,Sabah,0,0,0
1/10/2022,Malawi,Sarawak,1,0,1
1/10/2022,Malawi,Selangor,8,6,2
1/10/2022,Mayotte,Selangor,0,0,0
1/10/2022,Namibia,Johor,0,0,0
1/10/2022,Namibia,Kedah,0,0,0
1/10/2022,Namibia,Perak,2,1,1
1/10/2022,Namibia,Perlis,0,0,0
1/10/2022,Namibia,Pulau Pinang,0,0,0
1/10/2022,Namibia,Sabah,0,0,0
1/10/2022,Namibia,Sarawak,0,0,0
1/10/2022,Namibia,Selangor,18,5,13
1/10/2022,New Caledonia,Selangor,0,0,0
1/10/2022,Niger,Johor,0,0,0
1/10/2022,Niger,Sabah,0,0,0
1/10/2022,Niger,Selangor,1,1,0
1/10/2022,Nigeria,Johor,26,22,4
1/10/2022,Nigeria,Kedah,1,1,0
1/10/2022,Nigeria,Perlis,0,0,0
1/10/2022,Nigeria,Pulau Pinang,4,4,0
1/10/2022,Nigeria,Sabah,0,0,0
1/10/2022,Nigeria,Sarawak,17,10,7
1/10/2022,Nigeria,Selangor,341,272,69
1/10/2022,Nicaragua,Johor,1,1,0
1/10/2022,Nicaragua,Kedah,0,0,0
1/10/2022,Nicaragua,Pulau Pinang,2,1,1
1/10/2022,Nicaragua,Sabah,0,0,0
1/10/2022,Nicaragua,Selangor,6,2,4
1/10/2022,Netherlands,Johor,986,642,344
1/10/2022,Netherlands,Kedah,129,69,60
1/10/2022,Netherlands,Kelantan,1,1,0
1/10/2022,Netherlands,Melaka,3,2,1
1/10/2022,Netherlands,Negeri Sembilan,1,1,0
1/10/2022,Netherlands,Pahang,0,0,0
1/10/2022,Netherlands,Perak,29,19,10
1/10/2022,Netherlands,Perlis,33,19,14
1/10/2022,Netherlands,Pulau Pinang,217,136,81
1/10/2022,Netherlands,Sabah,96,52,44
1/10/2022,Netherlands,Sarawak,165,93,72
1/10/2022,Netherlands,Selangor,2993,1859,1134
1/10/2022,Netherlands,Terengganu,0,0,0
1/10/2022,Netherlands,W.P. Labuan,3,1,2
1/10/2022,Norway,Johor,180,120,60
1/10/2022,Norway,Kedah,25,13,12
1/10/2022,Norway,Kelantan,0,0,0
1/10/2022,Norway,Melaka,0,0,0
1/10/2022,Norway,Pahang,0,0,0
1/10/2022,Norway,Perak,0,0,0
1/10/2022,Norway,Perlis,7,5,2
1/10/2022,Norway,Pulau Pinang,17,11,6
1/10/2022,Norway,Sabah,8,6,2
1/10/2022,Norway,Sarawak,14,11,3
1/10/2022,Norway,Selangor,544,355,189
1/10/2022,Norway,W.P. Labuan,0,0,0
1/10/2022,Nepal,Johor,590,344,246
1/10/2022,Nepal,Kedah,7,7,0
1/10/2022,Nepal,Pahang,0,0,0
1/10/2022,Nepal,Perak,0,0,0
1/10/2022,Nepal,Perlis,1,1,0
1/10/2022,Nepal,Pulau Pinang,27,18,9
1/10/2022,Nepal,Sabah,1,1,0
1/10/2022,Nepal,Sarawak,144,99,45
1/10/2022,Nepal,Selangor,17666,16936,730
1/10/2022,Nepal,W.P. Labuan,54,54,0
1/10/2022,Nauru,Johor,0,0,0
1/10/2022,Nauru,Pulau Pinang,0,0,0
1/10/2022,Nauru,Selangor,2,2,0
1/10/2022,New Zealand,Johor,668,395,273
1/10/2022,New Zealand,Kedah,56,30,26
1/10/2022,New Zealand,Kelantan,1,1,0
1/10/2022,New Zealand,Melaka,1,1,0
1/10/2022,New Zealand,Negeri Sembilan,0,0,0
1/10/2022,New Zealand,Pahang,4,2,2
1/10/2022,New Zealand,Perak,19,8,11
1/10/2022,New Zealand,Perlis,10,6,4
1/10/2022,New Zealand,Pulau Pinang,157,93,64
1/10/2022,New Zealand,Sabah,69,35,34
1/10/2022,New Zealand,Sarawak,105,57,48
1/10/2022,New Zealand,Selangor,1990,1247,743
1/10/2022,New Zealand,Terengganu,0,0,0
1/10/2022,New Zealand,W.P. Labuan,7,4,3
1/10/2022,Oman,Johor,37,17,20
1/10/2022,Oman,Kedah,2,2,0
1/10/2022,Oman,Kelantan,0,0,0
1/10/2022,Oman,Melaka,0,0,0
1/10/2022,Oman,Perak,0,0,0
1/10/2022,Oman,Perlis,0,0,0
1/10/2022,Oman,Pulau Pinang,4,2,2
1/10/2022,Oman,Sabah,2,0,2
1/10/2022,Oman,Sarawak,28,15,13
1/10/2022,Oman,Selangor,852,670,182
1/10/2022,Pakistan,Johor,653,495,158
1/10/2022,Pakistan,Kedah,76,67,9
1/10/2022,Pakistan,Kelantan,12,12,0
1/10/2022,Pakistan,Melaka,0,0,0
1/10/2022,Pakistan,Negeri Sembilan,0,0,0
1/10/2022,Pakistan,Pahang,0,0,0
1/10/2022,Pakistan,Perak,39,37,2
1/10/2022,Pakistan,Perlis,27,23,4
1/10/2022,Pakistan,Pulau Pinang,44,43,1
1/10/2022,Pakistan,Sabah,8,7,1
1/10/2022,Pakistan,Sarawak,94,67,27
1/10/2022,Pakistan,Selangor,9561,8528,1033
1/10/2022,Pakistan,W.P. Labuan,8,6,2
1/10/2022,Panama,Johor,5,3,2
1/10/2022,Panama,Kedah,1,0,1
1/10/2022,Panama,Perak,0,0,0
1/10/2022,Panama,Perlis,0,0,0
1/10/2022,Panama,Pulau Pinang,1,0,1
1/10/2022,Panama,Sabah,0,0,0
1/10/2022,Panama,Sarawak,2,0,2
1/10/2022,Panama,Selangor,18,12,6
1/10/2022,Peru,Johor,45,25,20
1/10/2022,Peru,Kedah,4,1,3
1/10/2022,Peru,Kelantan,0,0,0
1/10/2022,Peru,Pahang,0,0,0
1/10/2022,Peru,Perak,0,0,0
1/10/2022,Peru,Perlis,0,0,0
1/10/2022,Peru,Pulau Pinang,1,1,0
1/10/2022,Peru,Sabah,0,0,0
1/10/2022,Peru,Sarawak,3,1,2
1/10/2022,Peru,Selangor,67,33,34
1/10/2022,Peru,W.P. Labuan,0,0,0
1/10/2022,Philippines,Johor,16343,5190,11153
1/10/2022,Philippines,Kedah,407,162,245
1/10/2022,Philippines,Kelantan,11,6,5
1/10/2022,Philippines,Melaka,0,0,0
1/10/2022,Philippines,Negeri Sembilan,0,0,0
1/10/2022,Philippines,Pahang,4,4,0
1/10/2022,Philippines,Perak,42,18,24
1/10/2022,Philippines,Perlis,169,62,107
1/10/2022,Philippines,Pulau Pinang,376,140,236
1/10/2022,Philippines,Sabah,1117,521,596
1/10/2022,Philippines,Sarawak,1061,406,655
1/10/2022,Philippines,Selangor,15278,6319,8959
1/10/2022,Philippines,Terengganu,0,0,0
1/10/2022,Philippines,W.P. Labuan,38,15,23
1/10/2022,Palau,Johor,0,0,0
1/10/2022,Palau,Pulau Pinang,0,0,0
1/10/2022,Palau,Selangor,3,2,1
1/10/2022,Papua New Guinea,Johor,15,11,4
1/10/2022,Papua New Guinea,Kedah,0,0,0
1/10/2022,Papua New Guinea,Kelantan,0,0,0
1/10/2022,Papua New Guinea,Perak,0,0,0
1/10/2022,Papua New Guinea,Pulau Pinang,1,0,1
1/10/2022,Papua New Guinea,Sabah,0,0,0
1/10/2022,Papua New Guinea,Sarawak,3,2,1
1/10/2022,Papua New Guinea,Selangor,42,25,17
1/10/2022,Poland,Johor,452,262,190
1/10/2022,Poland,Kedah,50,20,30
1/10/2022,Poland,Kelantan,0,0,0
1/10/2022,Poland,Melaka,0,0,0
1/10/2022,Poland,Negeri Sembilan,0,0,0
1/10/2022,Poland,Pahang,0,0,0
1/10/2022,Poland,Perak,1,0,1
1/10/2022,Poland,Perlis,6,4,2
1/10/2022,Poland,Pulau Pinang,46,23,23
1/10/2022,Poland,Sabah,12,6,6
1/10/2022,Poland,Sarawak,20,12,8
1/10/2022,Poland,Selangor,834,482,352
1/10/2022,Poland,Terengganu,0,0,0
1/10/2022,Poland,W.P. Labuan,4,3,1
1/10/2022,"North Korea, Democratic People's Republic of",Selangor,0,0,0
1/10/2022,Portugal,Johor,137,67,70
1/10/2022,Portugal,Kedah,17,10,7
1/10/2022,Portugal,Kelantan,1,1,0
1/10/2022,Portugal,Melaka,0,0,0
1/10/2022,Portugal,Pahang,0,0,0
1/10/2022,Portugal,Perak,2,2,0
1/10/2022,Portugal,Perlis,1,1,0
1/10/2022,Portugal,Pulau Pinang,25,14,11
1/10/2022,Portugal,Sabah,24,13,11
1/10/2022,Portugal,Sarawak,9,6,3
1/10/2022,Portugal,Selangor,564,356,208
1/10/2022,Portugal,W.P. Labuan,2,1,1
1/10/2022,Paraguay,Johor,2,1,1
1/10/2022,Paraguay,Kedah,0,0,0
1/10/2022,Paraguay,Perak,2,1,1
1/10/2022,Paraguay,Perlis,0,0,0
1/10/2022,Paraguay,Pulau Pinang,0,0,0
1/10/2022,Paraguay,Sabah,4,3,1
1/10/2022,Paraguay,Sarawak,0,0,0
1/10/2022,Paraguay,Selangor,4,3,1
1/10/2022,"Palestine, State of",Johor,7,3,4
1/10/2022,"Palestine, State of",Kedah,0,0,0
1/10/2022,"Palestine, State of",Kelantan,0,0,0
1/10/2022,"Palestine, State of",Melaka,0,0,0
1/10/2022,"Palestine, State of",Perak,0,0,0
1/10/2022,"Palestine, State of",Perlis,0,0,0
1/10/2022,"Palestine, State of",Pulau Pinang,1,1,0
1/10/2022,"Palestine, State of",Sabah,0,0,0
1/10/2022,"Palestine, State of",Sarawak,1,1,0
1/10/2022,"Palestine, State of",Selangor,299,212,87
1/10/2022,Qatar,Johor,2,0,2
1/10/2022,Qatar,Kedah,0,0,0
1/10/2022,Qatar,Perlis,0,0,0
1/10/2022,Qatar,Pulau Pinang,0,0,0
1/10/2022,Qatar,Sabah,0,0,0
1/10/2022,Qatar,Sarawak,2,1,1
1/10/2022,Qatar,Selangor,81,66,15
1/10/2022,Réunion,Johor,0,0,0
1/10/2022,Réunion,Sarawak,0,0,0
1/10/2022,Romania,Johor,114,55,59
1/10/2022,Romania,Kedah,10,6,4
1/10/2022,Romania,Kelantan,0,0,0
1/10/2022,Romania,Negeri Sembilan,0,0,0
1/10/2022,Romania,Pahang,0,0,0
1/10/2022,Romania,Perak,6,3,3
1/10/2022,Romania,Perlis,1,1,0
1/10/2022,Romania,Pulau Pinang,13,7,6
1/10/2022,Romania,Sabah,2,1,1
1/10/2022,Romania,Sarawak,4,1,3
1/10/2022,Romania,Selangor,564,304,260
1/10/2022,Romania,W.P. Labuan,0,0,0
1/10/2022,Russian Federation (Russia),Johor,303,168,135
1/10/2022,Russian Federation (Russia),Kedah,537,274,263
1/10/2022,Russian Federation (Russia),Kelantan,38,24,14
1/10/2022,Russian Federation (Russia),Melaka,0,0,0
1/10/2022,Russian Federation (Russia),Negeri Sembilan,0,0,0
1/10/2022,Russian Federation (Russia),Pahang,2,0,2
1/10/2022,Russian Federation (Russia),Perak,3,0,3
1/10/2022,Russian Federation (Russia),Perlis,141,75,66
1/10/2022,Russian Federation (Russia),Pulau Pinang,287,162,125
1/10/2022,Russian Federation (Russia),Sabah,23,11,12
1/10/2022,Russian Federation (Russia),Sarawak,55,28,27
1/10/2022,Russian Federation (Russia),Selangor,4728,2680,2048
1/10/2022,Russian Federation (Russia),W.P. Labuan,0,0,0
1/10/2022,Rwanda,Johor,0,0,0
1/10/2022,Rwanda,Kedah,0,0,0
1/10/2022,Rwanda,Pulau Pinang,0,0,0
1/10/2022,Rwanda,Selangor,13,9,4
1/10/2022,Saudi Arabia,Johor,114,70,44
1/10/2022,Saudi Arabia,Kedah,7,5,2
1/10/2022,Saudi Arabia,Kelantan,10,6,4
1/10/2022,Saudi Arabia,Melaka,2,2,0
1/10/2022,Saudi Arabia,Perak,0,0,0
1/10/2022,Saudi Arabia,Perlis,9,9,0
1/10/2022,Saudi Arabia,Pulau Pinang,16,10,6
1/10/2022,Saudi Arabia,Sabah,1,1,0
1/10/2022,Saudi Arabia,Sarawak,17,14,3
1/10/2022,Saudi Arabia,Selangor,2696,1653,1043
1/10/2022,Saudi Arabia,W.P. Labuan,0,0,0
1/10/2022,Sudan,Johor,6,6,0
1/10/2022,Sudan,Kedah,1,1,0
1/10/2022,Sudan,Kelantan,0,0,0
1/10/2022,Sudan,Perlis,0,0,0
1/10/2022,Sudan,Pulau Pinang,1,1,0
1/10/2022,Sudan,Sabah,0,0,0
1/10/2022,Sudan,Sarawak,2,1,1
1/10/2022,Sudan,Selangor,804,480,324
1/10/2022,Sudan,W.P. Labuan,1,1,0
1/10/2022,Senegal,Johor,2,1,1
1/10/2022,Senegal,Kedah,0,0,0
1/10/2022,Senegal,Kelantan,0,0,0
1/10/2022,Senegal,Perak,1,0,1
1/10/2022,Senegal,Perlis,0,0,0
1/10/2022,Senegal,Pulau Pinang,0,0,0
1/10/2022,Senegal,Sabah,1,1,0
1/10/2022,Senegal,Sarawak,0,0,0
1/10/2022,Senegal,Selangor,40,30,10
1/10/2022,Singapore,Johor,990235,571806,418429
1/10/2022,Singapore,Kedah,3016,1647,1369
1/10/2022,Singapore,Kelantan,43,33,10
1/10/2022,Singapore,Melaka,11,9,2
1/10/2022,Singapore,Negeri Sembilan,66,28,38
1/10/2022,Singapore,Pahang,67,43,24
1/10/2022,Singapore,Perak,4463,2066,2397
1/10/2022,Singapore,Perlis,270,194,76
1/10/2022,Singapore,Pulau Pinang,12616,6245,6371
1/10/2022,Singapore,Sabah,2754,1367,1387
1/10/2022,Singapore,Sarawak,3125,1814,1311
1/10/2022,Singapore,Selangor,47043,23617,23426
1/10/2022,Singapore,Terengganu,0,0,0
1/10/2022,Singapore,W.P. Labuan,17,12,5
1/10/2022,South Georgia and the South Sandwich Islands,Johor,0,0,0
1/10/2022,South Georgia and the South Sandwich Islands,Sabah,0,0,0
1/10/2022,South Georgia and the South Sandwich Islands,Selangor,0,0,0
1/10/2022,Saint Helena,Sarawak,0,0,0
1/10/2022,Solomon Islands,Johor,2,2,0
1/10/2022,Solomon Islands,Perlis,0,0,0
1/10/2022,Solomon Islands,Pulau Pinang,0,0,0
1/10/2022,Solomon Islands,Sabah,2,2,0
1/10/2022,Solomon Islands,Sarawak,1,1,0
1/10/2022,Solomon Islands,Selangor,5,3,2
1/10/2022,Solomon Islands,W.P. Labuan,0,0,0
1/10/2022,Sierra Leone,Johor,2,0,2
1/10/2022,Sierra Leone,Kedah,0,0,0
1/10/2022,Sierra Leone,Perak,1,1,0
1/10/2022,Sierra Leone,Pulau Pinang,1,1,0
1/10/2022,Sierra Leone,Sabah,0,0,0
1/10/2022,Sierra Leone,Selangor,17,12,5
1/10/2022,El Salvador,Johor,3,1,2
1/10/2022,El Salvador,Kedah,0,0,0
1/10/2022,El Salvador,Perak,1,1,0
1/10/2022,El Salvador,Perlis,0,0,0
1/10/2022,El Salvador,Pulau Pinang,1,1,0
1/10/2022,El Salvador,Sabah,0,0,0
1/10/2022,El Salvador,Selangor,7,3,4
1/10/2022,El Salvador,W.P. Labuan,0,0,0
1/10/2022,San Marino,Johor,0,0,0
1/10/2022,San Marino,Selangor,2,2,0
1/10/2022,Somalia,Johor,3,3,0
1/10/2022,Somalia,Kedah,0,0,0
1/10/2022,Somalia,Kelantan,0,0,0
1/10/2022,Somalia,Perlis,0,0,0
1/10/2022,Somalia,Sabah,0,0,0
1/10/2022,Somalia,Sarawak,0,0,0
1/10/2022,Somalia,Selangor,262,171,91
1/10/2022,Serbia,Johor,8,6,2
1/10/2022,Serbia,Kedah,2,1,1
1/10/2022,Serbia,Kelantan,0,0,0
1/10/2022,Serbia,Pahang,0,0,0
1/10/2022,Serbia,Perak,1,0,1
1/10/2022,Serbia,Perlis,0,0,0
1/10/2022,Serbia,Pulau Pinang,2,1,1
1/10/2022,Serbia,Sabah,0,0,0
1/10/2022,Serbia,Sarawak,1,1,0
1/10/2022,Serbia,Selangor,59,28,31
1/10/2022,South Sudan,Johor,0,0,0
1/10/2022,South Sudan,Kedah,0,0,0
1/10/2022,South Sudan,Sarawak,1,1,0
1/10/2022,South Sudan,Selangor,44,36,8
1/10/2022,South Sudan,W.P. Labuan,0,0,0
1/10/2022,Sao Tome and Principe,Selangor,0,0,0
1/10/2022,Suriname,Johor,17,6,11
1/10/2022,Suriname,Kedah,0,0,0
1/10/2022,Suriname,Kelantan,0,0,0
1/10/2022,Suriname,Perak,0,0,0
1/10/2022,Suriname,Perlis,0,0,0
1/10/2022,Suriname,Pulau Pinang,1,1,0
1/10/2022,Suriname,Sabah,0,0,0
1/10/2022,Suriname,Sarawak,0,0,0
1/10/2022,Suriname,Selangor,26,12,14
1/10/2022,Slovakia,Johor,21,11,10
1/10/2022,Slovakia,Kedah,35,18,17
1/10/2022,Slovakia,Kelantan,0,0,0
1/10/2022,Slovakia,Negeri Sembilan,0,0,0
1/10/2022,Slovakia,Pahang,0,0,0
1/10/2022,Slovakia,Perak,0,0,0
1/10/2022,Slovakia,Perlis,2,1,1
1/10/2022,Slovakia,Pulau Pinang,10,8,2
1/10/2022,Slovakia,Sabah,4,2,2
1/10/2022,Slovakia,Sarawak,5,1,4
1/10/2022,Slovakia,Selangor,199,121,78
1/10/2022,Slovakia,W.P. Labuan,0,0,0
1/10/2022,Slovenia,Johor,14,9,5
1/10/2022,Slovenia,Kedah,7,6,1
1/10/2022,Slovenia,Kelantan,0,0,0
1/10/2022,Slovenia,Perak,1,0,1
1/10/2022,Slovenia,Perlis,0,0,0
1/10/2022,Slovenia,Pulau Pinang,7,5,2
1/10/2022,Slovenia,Sabah,4,2,2
1/10/2022,Slovenia,Sarawak,1,0,1
1/10/2022,Slovenia,Selangor,59,37,22
1/10/2022,Slovenia,W.P. Labuan,0,0,0
1/10/2022,Sweden,Johor,225,125,100
1/10/2022,Sweden,Kedah,65,29,36
1/10/2022,Sweden,Kelantan,2,2,0
1/10/2022,Sweden,Melaka,0,0,0
1/10/2022,Sweden,Negeri Sembilan,1,1,0
1/10/2022,Sweden,Pahang,0,0,0
1/10/2022,Sweden,Perak,5,3,2
1/10/2022,Sweden,Perlis,11,6,5
1/10/2022,Sweden,Pulau Pinang,76,54,22
1/10/2022,Sweden,Sabah,13,9,4
1/10/2022,Sweden,Sarawak,21,14,7
1/10/2022,Sweden,Selangor,805,492,313
1/10/2022,Sweden,W.P. Labuan,0,0,0
1/10/2022,Eswatini,Johor,1,1,0
1/10/2022,Eswatini,Kedah,0,0,0
1/10/2022,Eswatini,Pulau Pinang,0,0,0
1/10/2022,Eswatini,Sabah,0,0,0
1/10/2022,Eswatini,Selangor,12,5,7
1/10/2022,Seychelles,Johor,3,2,1
1/10/2022,Seychelles,Kedah,0,0,0
1/10/2022,Seychelles,Pulau Pinang,2,1,1
1/10/2022,Seychelles,Sabah,0,0,0
1/10/2022,Seychelles,Sarawak,2,2,0
1/10/2022,Seychelles,Selangor,32,12,20
1/10/2022,Syrian Arab Republic,Johor,11,6,5
1/10/2022,Syrian Arab Republic,Kedah,4,3,1
1/10/2022,Syrian Arab Republic,Kelantan,0,0,0
1/10/2022,Syrian Arab Republic,Pahang,2,2,0
1/10/2022,Syrian Arab Republic,Perlis,2,1,1
1/10/2022,Syrian Arab Republic,Pulau Pinang,1,1,0
1/10/2022,Syrian Arab Republic,Sabah,0,0,0
1/10/2022,Syrian Arab Republic,Sarawak,9,5,4
1/10/2022,Syrian Arab Republic,Selangor,582,367,215
1/10/2022,Syrian Arab Republic,W.P. Labuan,0,0,0
1/10/2022,Turks and Caicos Islands,Perlis,0,0,0
1/10/2022,TCD,Johor,2,2,0
1/10/2022,TCD,Kedah,0,0,0
1/10/2022,TCD,Perlis,0,0,0
1/10/2022,TCD,Selangor,8,6,2
1/10/2022,Togo,Johor,0,0,0
1/10/2022,Togo,Perak,2,2,0
1/10/2022,Togo,Pulau Pinang,0,0,0
1/10/2022,Togo,Selangor,14,12,2
1/10/2022,Thailand,Johor,7708,2249,5459
1/10/2022,Thailand,Kedah,62507,36255,26252
1/10/2022,Thailand,Kelantan,36906,18909,17997
1/10/2022,Thailand,Melaka,10,4,6
1/10/2022,Thailand,Negeri Sembilan,2,1,1
1/10/2022,Thailand,Pahang,27,21,6
1/10/2022,Thailand,Perak,8355,3861,4494
1/10/2022,Thailand,Perlis,55003,32227,22776
1/10/2022,Thailand,Pulau Pinang,2396,978,1418
1/10/2022,Thailand,Sabah,217,68,149
1/10/2022,Thailand,Sarawak,236,83,153
1/10/2022,Thailand,Selangor,12515,5152,7363
1/10/2022,Thailand,Terengganu,1,0,1
1/10/2022,Thailand,W.P. Labuan,5,4,1
1/10/2022,Tajikistan,Johor,7,7,0
1/10/2022,Tajikistan,Kedah,2,2,0
1/10/2022,Tajikistan,Perlis,0,0,0
1/10/2022,Tajikistan,Pulau Pinang,1,0,1
1/10/2022,Tajikistan,Sabah,0,0,0
1/10/2022,Tajikistan,Selangor,110,88,22
1/10/2022,Tokelau,Selangor,0,0,0
1/10/2022,Turkmenistan,Johor,1,0,1
1/10/2022,Turkmenistan,Kedah,2,1,1
1/10/2022,Turkmenistan,Kelantan,0,0,0
1/10/2022,Turkmenistan,Perlis,0,0,0
1/10/2022,Turkmenistan,Pulau Pinang,0,0,0
1/10/2022,Turkmenistan,Sabah,0,0,0
1/10/2022,Turkmenistan,Sarawak,0,0,0
1/10/2022,Turkmenistan,Selangor,54,32,22
1/10/2022,Timor-Leste,Johor,37,33,4
1/10/2022,Timor-Leste,Kedah,1,1,0
1/10/2022,Timor-Leste,Perlis,0,0,0
1/10/2022,Timor-Leste,Pulau Pinang,3,1,2
1/10/2022,Timor-Leste,Sabah,0,0,0
1/10/2022,Timor-Leste,Sarawak,1,0,1
1/10/2022,Timor-Leste,Selangor,212,132,80
1/10/2022,Tonga,Johor,2,1,1
1/10/2022,Tonga,Pulau Pinang,1,0,1
1/10/2022,Tonga,Sarawak,0,0,0
1/10/2022,Tonga,Selangor,11,6,5
1/10/2022,Trinidad and Tobago,Johor,5,2,3
1/10/2022,Trinidad and Tobago,Kedah,0,0,0
1/10/2022,Trinidad and Tobago,Pahang,0,0,0
1/10/2022,Trinidad and Tobago,Pulau Pinang,0,0,0
1/10/2022,Trinidad and Tobago,Sabah,0,0,0
1/10/2022,Trinidad and Tobago,Sarawak,2,2,0
1/10/2022,Trinidad and Tobago,Selangor,40,32,8
1/10/2022,Tunisia,Johor,9,5,4
1/10/2022,Tunisia,Kedah,2,0,2
1/10/2022,Tunisia,Kelantan,0,0,0
1/10/2022,Tunisia,Melaka,0,0,0
1/10/2022,Tunisia,Perak,0,0,0
1/10/2022,Tunisia,Perlis,2,2,0
1/10/2022,Tunisia,Pulau Pinang,4,3,1
1/10/2022,Tunisia,Sabah,0,0,0
1/10/2022,Tunisia,Sarawak,0,0,0
1/10/2022,Tunisia,Selangor,445,267,178
1/10/2022,Tunisia,W.P. Labuan,0,0,0
1/10/2022,Türkiye,Johor,200,142,58
1/10/2022,Türkiye,Kedah,29,26,3
1/10/2022,Türkiye,Kelantan,4,4,0
1/10/2022,Türkiye,Melaka,1,1,0
1/10/2022,Türkiye,Negeri Sembilan,0,0,0
1/10/2022,Türkiye,Pahang,0,0,0
1/10/2022,Türkiye,Perak,1,0,1
1/10/2022,Türkiye,Perlis,10,5,5
1/10/2022,Türkiye,Pulau Pinang,19,8,11
1/10/2022,Türkiye,Sabah,10,5,5
1/10/2022,Türkiye,Sarawak,17,11,6
1/10/2022,Türkiye,Selangor,1055,735,320
1/10/2022,Türkiye,W.P. Labuan,0,0,0
1/10/2022,Tuvalu,Selangor,0,0,0
1/10/2022,"Taiwan, Province of China",Johor,2694,1166,1528
1/10/2022,"Taiwan, Province of China",Kedah,53,33,20
1/10/2022,"Taiwan, Province of China",Kelantan,1,1,0
1/10/2022,"Taiwan, Province of China",Melaka,2,1,1
1/10/2022,"Taiwan, Province of China",Negeri Sembilan,0,0,0
1/10/2022,"Taiwan, Province of China",Pahang,1,0,1
1/10/2022,"Taiwan, Province of China",Perak,27,9,18
1/10/2022,"Taiwan, Province of China",Perlis,12,9,3
1/10/2022,"Taiwan, Province of China",Pulau Pinang,742,462,280
1/10/2022,"Taiwan, Province of China",Sabah,61,27,34
1/10/2022,"Taiwan, Province of China",Sarawak,152,70,82
1/10/2022,"Taiwan, Province of China",Selangor,4927,2620,2307
1/10/2022,"Taiwan, Province of China",W.P. Labuan,0,0,0
1/10/2022,"Tanzania, United Republic of",Johor,15,11,4
1/10/2022,"Tanzania, United Republic of",Kedah,0,0,0
1/10/2022,"Tanzania, United Republic of",Perak,1,1,0
1/10/2022,"Tanzania, United Republic of",Perlis,0,0,0
1/10/2022,"Tanzania, United Republic of",Pulau Pinang,1,1,0
1/10/2022,"Tanzania, United Republic of",Sabah,0,0,0
1/10/2022,"Tanzania, United Republic of",Sarawak,0,0,0
1/10/2022,"Tanzania, United Republic of",Selangor,173,100,73
1/10/2022,Uganda,Johor,10,7,3
1/10/2022,Uganda,Kedah,3,1,2
1/10/2022,Uganda,Perak,2,1,1
1/10/2022,Uganda,Perlis,3,1,2
1/10/2022,Uganda,Pulau Pinang,1,0,1
1/10/2022,Uganda,Sabah,0,0,0
1/10/2022,Uganda,Sarawak,0,0,0
1/10/2022,Uganda,Selangor,88,45,43
1/10/2022,Ukraine,Johor,96,64,32
1/10/2022,Ukraine,Kedah,30,13,17
1/10/2022,Ukraine,Kelantan,0,0,0
1/10/2022,Ukraine,Melaka,0,0,0
1/10/2022,Ukraine,Negeri Sembilan,0,0,0
1/10/2022,Ukraine,Pahang,1,1,0
1/10/2022,Ukraine,Perak,1,1,0
1/10/2022,Ukraine,Perlis,21,11,10
1/10/2022,Ukraine,Pulau Pinang,19,7,12
1/10/2022,Ukraine,Sabah,1,1,0
1/10/2022,Ukraine,Sarawak,2,1,1
1/10/2022,Ukraine,Selangor,577,296,281
1/10/2022,Ukraine,W.P. Labuan,0,0,0
1/10/2022,Uruguay,Johor,8,3,5
1/10/2022,Uruguay,Kedah,0,0,0
1/10/2022,Uruguay,Kelantan,0,0,0
1/10/2022,Uruguay,Perak,2,1,1
1/10/2022,Uruguay,Perlis,0,0,0
1/10/2022,Uruguay,Pulau Pinang,1,0,1
1/10/2022,Uruguay,Sabah,0,0,0
1/10/2022,Uruguay,Sarawak,2,1,1
1/10/2022,Uruguay,Selangor,47,19,28
1/10/2022,Uruguay,W.P. Labuan,0,0,0
1/10/2022,United States of America,Johor,3458,2136,1322
1/10/2022,United States of America,Kedah,307,193,114
1/10/2022,United States of America,Kelantan,8,5,3
1/10/2022,United States of America,Melaka,5,2,3
1/10/2022,United States of America,Negeri Sembilan,0,0,0
1/10/2022,United States of America,Pahang,3,3,0
1/10/2022,United States of America,Perak,66,42,24
1/10/2022,United States of America,Perlis,79,50,29
1/10/2022,United States of America,Pulau Pinang,1461,891,570
1/10/2022,United States of America,Sabah,372,187,185
1/10/2022,United States of America,Sarawak,309,175,134
1/10/2022,United States of America,Selangor,10799,6652,4147
1/10/2022,United States of America,Terengganu,1,1,0
1/10/2022,United States of America,W.P. Labuan,13,9,4
1/10/2022,Uzbekistan,Johor,54,36,18
1/10/2022,Uzbekistan,Kedah,10,4,6
1/10/2022,Uzbekistan,Kelantan,0,0,0
1/10/2022,Uzbekistan,Perak,0,0,0
1/10/2022,Uzbekistan,Perlis,2,2,0
1/10/2022,Uzbekistan,Pulau Pinang,6,1,5
1/10/2022,Uzbekistan,Sabah,18,17,1
1/10/2022,Uzbekistan,Sarawak,1,1,0
1/10/2022,Uzbekistan,Selangor,529,323,206
1/10/2022,Holy See,Johor,0,0,0
1/10/2022,Holy See,Sarawak,0,0,0
1/10/2022,Holy See,Selangor,0,0,0
1/10/2022,Saint Vincent and the Grenadines,Johor,0,0,0
1/10/2022,Saint Vincent and the Grenadines,Kedah,0,0,0
1/10/2022,Saint Vincent and the Grenadines,Pulau Pinang,0,0,0
1/10/2022,Saint Vincent and the Grenadines,Sarawak,0,0,0
1/10/2022,Saint Vincent and the Grenadines,Selangor,0,0,0
1/10/2022,"Venezuela, Bolivarian Republic of",Johor,8,7,1
1/10/2022,"Venezuela, Bolivarian Republic of",Kedah,1,1,0
1/10/2022,"Venezuela, Bolivarian Republic of",Kelantan,0,0,0
1/10/2022,"Venezuela, Bolivarian Republic of",Melaka,0,0,0
1/10/2022,"Venezuela, Bolivarian Republic of",Perak,0,0,0
1/10/2022,"Venezuela, Bolivarian Republic of",Perlis,0,0,0
1/10/2022,"Venezuela, Bolivarian Republic of",Pulau Pinang,0,0,0
1/10/2022,"Venezuela, Bolivarian Republic of",Sabah,1,1,0
1/10/2022,"Venezuela, Bolivarian Republic of",Sarawak,7,5,2
1/10/2022,"Venezuela, Bolivarian Republic of",Selangor,71,48,23
1/10/2022,"Venezuela, Bolivarian Republic of",W.P. Labuan,0,0,0
1/10/2022,Viet Nam,Johor,11524,3625,7899
1/10/2022,Viet Nam,Kedah,260,53,207
1/10/2022,Viet Nam,Kelantan,20,12,8
1/10/2022,Viet Nam,Melaka,0,0,0
1/10/2022,Viet Nam,Negeri Sembilan,0,0,0
1/10/2022,Viet Nam,Pahang,0,0,0
1/10/2022,Viet Nam,Perak,98,11,87
1/10/2022,Viet Nam,Perlis,241,25,216
1/10/2022,Viet Nam,Pulau Pinang,1774,451,1323
1/10/2022,Viet Nam,Sabah,22,9,13
1/10/2022,Viet Nam,Sarawak,96,14,82
1/10/2022,Viet Nam,Selangor,12642,4646,7996
1/10/2022,Viet Nam,Terengganu,0,0,0
1/10/2022,Viet Nam,W.P. Labuan,1,0,1
1/10/2022,Vanuatu,Johor,28,17,11
1/10/2022,Vanuatu,Kedah,0,0,0
1/10/2022,Vanuatu,Pulau Pinang,0,0,0
1/10/2022,Vanuatu,Sabah,0,0,0
1/10/2022,Vanuatu,Sarawak,0,0,0
1/10/2022,Vanuatu,Selangor,44,35,9
1/10/2022, Samoa,Johor,2,2,0
1/10/2022, Samoa,Sarawak,0,0,0
1/10/2022, Samoa,Selangor,8,3,5
1/10/2022,Yemen,Johor,30,21,9
1/10/2022,Yemen,Kedah,3,2,1
1/10/2022,Yemen,Kelantan,1,1,0
1/10/2022,Yemen,Melaka,0,0,0
1/10/2022,Yemen,Pahang,0,0,0
1/10/2022,Yemen,Perak,4,2,2
1/10/2022,Yemen,Perlis,3,3,0
1/10/2022,Yemen,Pulau Pinang,7,7,0
1/10/2022,Yemen,Sabah,0,0,0
1/10/2022,Yemen,Sarawak,2,2,0
1/10/2022,Yemen,Selangor,1180,894,286
1/10/2022,Yemen,W.P. Labuan,0,0,0
1/10/2022,South Africa,Johor,308,202,106
1/10/2022,South Africa,Kedah,54,29,25
1/10/2022,South Africa,Kelantan,0,0,0
1/10/2022,South Africa,Melaka,2,1,1
1/10/2022,South Africa,Pahang,1,1,0
1/10/2022,South Africa,Perak,4,3,1
1/10/2022,South Africa,Perlis,11,6,5
1/10/2022,South Africa,Pulau Pinang,55,29,26
1/10/2022,South Africa,Sabah,17,11,6
1/10/2022,South Africa,Sarawak,66,37,29
1/10/2022,South Africa,Selangor,892,579,313
1/10/2022,South Africa,Terengganu,0,0,0
1/10/2022,South Africa,W.P. Labuan,0,0,0
1/10/2022,ZAR,Selangor,0,0,0
1/10/2022,Zambia,Johor,2,1,1
1/10/2022,Zambia,Kedah,0,0,0
1/10/2022,Zambia,Perak,2,0,2
1/10/2022,Zambia,Perlis,0,0,0
1/10/2022,Zambia,Pulau Pinang,1,1,0
1/10/2022,Zambia,Sabah,0,0,0
1/10/2022,Zambia,Sarawak,2,2,0
1/10/2022,Zambia,Selangor,37,22,15
1/10/2022,Zimbabwe,Johor,16,3,13
1/10/2022,Zimbabwe,Kedah,0,0,0
1/10/2022,Zimbabwe,Kelantan,0,0,0
1/10/2022,Zimbabwe,Perak,0,0,0
1/10/2022,Zimbabwe,Perlis,0,0,0
1/10/2022,Zimbabwe,Pulau Pinang,0,0,0
1/10/2022,Zimbabwe,Sabah,1,1,0
1/10/2022,Zimbabwe,Sarawak,2,1,1
1/10/2022,Zimbabwe,Selangor,127,57,70
1/11/2022,Aruba,Kedah,0,0,0
1/11/2022,Aruba,Pulau Pinang,0,0,0
1/11/2022,Afghanistan,Johor,1,1,0
1/11/2022,Afghanistan,Kedah,0,0,0
1/11/2022,Afghanistan,Perlis,0,0,0
1/11/2022,Afghanistan,Pulau Pinang,0,0,0
1/11/2022,Afghanistan,Sarawak,1,0,1
1/11/2022,Afghanistan,Selangor,25,20,5
1/11/2022,Angola,Johor,1,1,0
1/11/2022,Angola,Kedah,0,0,0
1/11/2022,Angola,Sabah,0,0,0
1/11/2022,Angola,Selangor,3,3,0
1/11/2022,Anguilla,Selangor,1,1,0
1/11/2022,Albania,Johor,16,14,2
1/11/2022,Albania,Kedah,0,0,0
1/11/2022,Albania,Perak,0,0,0
1/11/2022,Albania,Perlis,0,0,0
1/11/2022,Albania,Pulau Pinang,0,0,0
1/11/2022,Albania,Sabah,0,0,0
1/11/2022,Albania,Sarawak,0,0,0
1/11/2022,Albania,Selangor,25,13,12
1/11/2022,Andorra,Johor,0,0,0
1/11/2022,Andorra,Kedah,0,0,0
1/11/2022,Andorra,Perlis,0,0,0
1/11/2022,Andorra,Pulau Pinang,0,0,0
1/11/2022,Andorra,Selangor,4,1,3
1/11/2022,Antigua and Barbuda,Selangor,0,0,0
1/11/2022,United Arab Emirates,Johor,37,29,8
1/11/2022,United Arab Emirates,Kedah,2,2,0
1/11/2022,United Arab Emirates,Kelantan,0,0,0
1/11/2022,United Arab Emirates,Perak,0,0,0
1/11/2022,United Arab Emirates,Perlis,0,0,0
1/11/2022,United Arab Emirates,Pulau Pinang,2,1,1
1/11/2022,United Arab Emirates,Sabah,0,0,0
1/11/2022,United Arab Emirates,Sarawak,0,0,0
1/11/2022,United Arab Emirates,Selangor,363,246,117
1/11/2022,Argentina,Johor,53,33,20
1/11/2022,Argentina,Kedah,29,17,12
1/11/2022,Argentina,Kelantan,0,0,0
1/11/2022,Argentina,Melaka,0,0,0
1/11/2022,Argentina,Perak,0,0,0
1/11/2022,Argentina,Perlis,1,1,0
1/11/2022,Argentina,Pulau Pinang,7,5,2
1/11/2022,Argentina,Sabah,2,0,2
1/11/2022,Argentina,Sarawak,0,0,0
1/11/2022,Argentina,Selangor,269,164,105
1/11/2022,Argentina,W.P. Labuan,0,0,0
1/11/2022,Armenia,Johor,4,3,1
1/11/2022,Armenia,Kedah,0,0,0
1/11/2022,Armenia,Kelantan,0,0,0
1/11/2022,Armenia,Perak,0,0,0
1/11/2022,Armenia,Perlis,0,0,0
1/11/2022,Armenia,Pulau Pinang,0,0,0
1/11/2022,Armenia,Sabah,0,0,0
1/11/2022,Armenia,Sarawak,0,0,0
1/11/2022,Armenia,Selangor,28,9,19
1/11/2022,Antarctica,Selangor,0,0,0
1/11/2022,Antigua and Barbuda,Johor,4,4,0
1/11/2022,Antigua and Barbuda,Kedah,0,0,0
1/11/2022,Antigua and Barbuda,Pulau Pinang,0,0,0
1/11/2022,Antigua and Barbuda,Sarawak,0,0,0
1/11/2022,Antigua and Barbuda,Selangor,5,5,0
1/11/2022,Australia,Johor,3879,2312,1567
1/11/2022,Australia,Kedah,457,255,202
1/11/2022,Australia,Kelantan,4,3,1
1/11/2022,Australia,Melaka,1,1,0
1/11/2022,Australia,Negeri Sembilan,2,1,1
1/11/2022,Australia,Pahang,0,0,0
1/11/2022,Australia,Perak,143,80,63
1/11/2022,Australia,Perlis,60,40,20
1/11/2022,Australia,Pulau Pinang,1382,748,634
1/11/2022,Australia,Sabah,315,162,153
1/11/2022,Australia,Sarawak,536,296,240
1/11/2022,Australia,Selangor,18721,10988,7733
1/11/2022,Australia,Terengganu,0,0,0
1/11/2022,Australia,W.P. Labuan,21,14,7
1/11/2022,Austria,Johor,147,100,47
1/11/2022,Austria,Kedah,43,20,23
1/11/2022,Austria,Kelantan,0,0,0
1/11/2022,Austria,Melaka,0,0,0
1/11/2022,Austria,Negeri Sembilan,0,0,0
1/11/2022,Austria,Pahang,0,0,0
1/11/2022,Austria,Perak,2,1,1
1/11/2022,Austria,Perlis,17,12,5
1/11/2022,Austria,Pulau Pinang,75,52,23
1/11/2022,Austria,Sabah,15,10,5
1/11/2022,Austria,Sarawak,6,5,1
1/11/2022,Austria,Selangor,679,445,234
1/11/2022,Austria,Terengganu,0,0,0
1/11/2022,Austria,W.P. Labuan,0,0,0
1/11/2022,Azerbaijan,Johor,2,2,0
1/11/2022,Azerbaijan,Kedah,0,0,0
1/11/2022,Azerbaijan,Kelantan,0,0,0
1/11/2022,Azerbaijan,Melaka,0,0,0
1/11/2022,Azerbaijan,Perlis,0,0,0
1/11/2022,Azerbaijan,Pulau Pinang,0,0,0
1/11/2022,Azerbaijan,Sabah,1,1,0
1/11/2022,Azerbaijan,Sarawak,0,0,0
1/11/2022,Azerbaijan,Selangor,74,44,30
1/11/2022,Azerbaijan,W.P. Labuan,0,0,0
1/11/2022,Burundi,Pulau Pinang,0,0,0
1/11/2022,Burundi,Sarawak,0,0,0
1/11/2022,Burundi,Selangor,6,4,2
1/11/2022,Belgium,Johor,210,147,63
1/11/2022,Belgium,Kedah,51,31,20
1/11/2022,Belgium,Kelantan,5,4,1
1/11/2022,Belgium,Melaka,0,0,0
1/11/2022,Belgium,Negeri Sembilan,0,0,0
1/11/2022,Belgium,Pahang,0,0,0
1/11/2022,Belgium,Perak,3,2,1
1/11/2022,Belgium,Perlis,9,8,1
1/11/2022,Belgium,Pulau Pinang,56,43,13
1/11/2022,Belgium,Sabah,15,9,6
1/11/2022,Belgium,Sarawak,24,19,5
1/11/2022,Belgium,Selangor,684,454,230
1/11/2022,Belgium,W.P. Labuan,0,0,0
1/11/2022,Benin,Johor,2,0,2
1/11/2022,Benin,Kedah,0,0,0
1/11/2022,Benin,Perak,0,0,0
1/11/2022,Benin,Pulau Pinang,0,0,0
1/11/2022,Benin,Sabah,0,0,0
1/11/2022,Benin,Sarawak,0,0,0
1/11/2022,Benin,Selangor,6,5,1
1/11/2022,Burkina Faso,Perak,0,0,0
1/11/2022,Burkina Faso,Pulau Pinang,0,0,0
1/11/2022,Burkina Faso,Selangor,2,2,0
1/11/2022,Bangladesh,Johor,1734,1456,278
1/11/2022,Bangladesh,Kedah,38,23,15
1/11/2022,Bangladesh,Kelantan,0,0,0
1/11/2022,Bangladesh,Melaka,0,0,0
1/11/2022,Bangladesh,Negeri Sembilan,0,0,0
1/11/2022,Bangladesh,Pahang,0,0,0
1/11/2022,Bangladesh,Perak,3,3,0
1/11/2022,Bangladesh,Perlis,7,6,1
1/11/2022,Bangladesh,Pulau Pinang,414,402,12
1/11/2022,Bangladesh,Sabah,0,0,0
1/11/2022,Bangladesh,Sarawak,59,53,6
1/11/2022,Bangladesh,Selangor,34670,33433,1237
1/11/2022,Bangladesh,W.P. Labuan,3,3,0
1/11/2022,Bulgaria,Johor,51,25,26
1/11/2022,Bulgaria,Kedah,7,4,3
1/11/2022,Bulgaria,Kelantan,1,0,1
1/11/2022,Bulgaria,Pahang,0,0,0
1/11/2022,Bulgaria,Perak,0,0,0
1/11/2022,Bulgaria,Perlis,1,0,1
1/11/2022,Bulgaria,Pulau Pinang,7,5,2
1/11/2022,Bulgaria,Sabah,1,0,1
1/11/2022,Bulgaria,Sarawak,0,0,0
1/11/2022,Bulgaria,Selangor,163,98,65
1/11/2022,Bulgaria,W.P. Labuan,0,0,0
1/11/2022,Bahrain,Johor,0,0,0
1/11/2022,Bahrain,Kedah,2,2,0
1/11/2022,Bahrain,Kelantan,1,1,0
1/11/2022,Bahrain,Perlis,0,0,0
1/11/2022,Bahrain,Pulau Pinang,3,3,0
1/11/2022,Bahrain,Sabah,0,0,0
1/11/2022,Bahrain,Sarawak,0,0,0
1/11/2022,Bahrain,Selangor,90,55,35
1/11/2022,Bahamas,Johor,0,0,0
1/11/2022,Bahamas,Kedah,0,0,0
1/11/2022,Bahamas,Perak,0,0,0
1/11/2022,Bahamas,Sabah,0,0,0
1/11/2022,Bahamas,Sarawak,0,0,0
1/11/2022,Bahamas,Selangor,6,0,6
1/11/2022,Bosnia and Herzegovina,Johor,3,3,0
1/11/2022,Bosnia and Herzegovina,Kedah,0,0,0
1/11/2022,Bosnia and Herzegovina,Perlis,0,0,0
1/11/2022,Bosnia and Herzegovina,Pulau Pinang,2,1,1
1/11/2022,Bosnia and Herzegovina,Sabah,0,0,0
1/11/2022,Bosnia and Herzegovina,Sarawak,2,2,0
1/11/2022,Bosnia and Herzegovina,Selangor,30,16,14
1/11/2022,Belarus,Johor,7,3,4
1/11/2022,Belarus,Kedah,4,1,3
1/11/2022,Belarus,Kelantan,2,0,2
1/11/2022,Belarus,Pahang,0,0,0
1/11/2022,Belarus,Perak,0,0,0
1/11/2022,Belarus,Perlis,0,0,0
1/11/2022,Belarus,Pulau Pinang,2,1,1
1/11/2022,Belarus,Sabah,1,1,0
1/11/2022,Belarus,Sarawak,2,1,1
1/11/2022,Belarus,Selangor,238,113,125
1/11/2022,Belarus,W.P. Labuan,0,0,0
1/11/2022,Belize,Johor,2,1,1
1/11/2022,Belize,Pulau Pinang,0,0,0
1/11/2022,Belize,Sarawak,1,1,0
1/11/2022,Belize,Selangor,5,1,4
1/11/2022,Bermuda,Selangor,0,0,0
1/11/2022,Bolivia,Johor,6,2,4
1/11/2022,Bolivia,Kedah,0,0,0
1/11/2022,Bolivia,Melaka,0,0,0
1/11/2022,Bolivia,Perak,0,0,0
1/11/2022,Bolivia,Perlis,0,0,0
1/11/2022,Bolivia,Pulau Pinang,0,0,0
1/11/2022,Bolivia,Sabah,0,0,0
1/11/2022,Bolivia,Sarawak,5,3,2
1/11/2022,Bolivia,Selangor,21,13,8
1/11/2022,Brazil,Johor,140,78,62
1/11/2022,Brazil,Kedah,16,8,8
1/11/2022,Brazil,Kelantan,0,0,0
1/11/2022,Brazil,Melaka,0,0,0
1/11/2022,Brazil,Pahang,0,0,0
1/11/2022,Brazil,Perak,2,2,0
1/11/2022,Brazil,Perlis,9,4,5
1/11/2022,Brazil,Pulau Pinang,15,11,4
1/11/2022,Brazil,Sabah,3,2,1
1/11/2022,Brazil,Sarawak,4,2,2
1/11/2022,Brazil,Selangor,676,374,302
1/11/2022,Brazil,W.P. Labuan,1,0,1
1/11/2022,Barbados,Johor,0,0,0
1/11/2022,Barbados,Kedah,0,0,0
1/11/2022,Barbados,Perlis,0,0,0
1/11/2022,Barbados,Pulau Pinang,0,0,0
1/11/2022,Barbados,Selangor,6,5,1
1/11/2022,Brunei Darussalam,Johor,279,144,135
1/11/2022,Brunei Darussalam,Kedah,16,8,8
1/11/2022,Brunei Darussalam,Kelantan,0,0,0
1/11/2022,Brunei Darussalam,Melaka,0,0,0
1/11/2022,Brunei Darussalam,Pahang,0,0,0
1/11/2022,Brunei Darussalam,Perak,1,1,0
1/11/2022,Brunei Darussalam,Perlis,7,4,3
1/11/2022,Brunei Darussalam,Pulau Pinang,15,6,9
1/11/2022,Brunei Darussalam,Sabah,823,393,430
1/11/2022,Brunei Darussalam,Sarawak,59481,32252,27229
1/11/2022,Brunei Darussalam,Selangor,4130,2057,2073
1/11/2022,Brunei Darussalam,W.P. Labuan,788,556,232
1/11/2022,Bhutan,Johor,0,0,0
1/11/2022,Bhutan,Kedah,0,0,0
1/11/2022,Bhutan,Perak,0,0,0
1/11/2022,Bhutan,Perlis,0,0,0
1/11/2022,Bhutan,Pulau Pinang,0,0,0
1/11/2022,Bhutan,Sabah,1,1,0
1/11/2022,Bhutan,Sarawak,0,0,0
1/11/2022,Bhutan,Selangor,23,17,6
1/11/2022,Botswana,Johor,1,0,1
1/11/2022,Botswana,Kedah,1,1,0
1/11/2022,Botswana,Perlis,0,0,0
1/11/2022,Botswana,Pulau Pinang,0,0,0
1/11/2022,Botswana,Sabah,0,0,0
1/11/2022,Botswana,Sarawak,0,0,0
1/11/2022,Botswana,Selangor,3,2,1
1/11/2022,Central African Republic,Kedah,0,0,0
1/11/2022,Central African Republic,Selangor,0,0,0
1/11/2022,Canada,Johor,1233,716,517
1/11/2022,Canada,Kedah,113,63,50
1/11/2022,Canada,Kelantan,0,0,0
1/11/2022,Canada,Melaka,0,0,0
1/11/2022,Canada,Negeri Sembilan,0,0,0
1/11/2022,Canada,Pahang,0,0,0
1/11/2022,Canada,Perak,39,21,18
1/11/2022,Canada,Perlis,50,32,18
1/11/2022,Canada,Pulau Pinang,375,215,160
1/11/2022,Canada,Sabah,110,60,50
1/11/2022,Canada,Sarawak,302,156,146
1/11/2022,Canada,Selangor,3503,2121,1382
1/11/2022,Canada,Terengganu,0,0,0
1/11/2022,Canada,W.P. Labuan,5,4,1
1/11/2022,Cocos (Keeling) Islands,Selangor,1,1,0
1/11/2022,Switzerland,Johor,300,189,111
1/11/2022,Switzerland,Kedah,124,71,53
1/11/2022,Switzerland,Kelantan,2,2,0
1/11/2022,Switzerland,Melaka,0,0,0
1/11/2022,Switzerland,Negeri Sembilan,0,0,0
1/11/2022,Switzerland,Pahang,0,0,0
1/11/2022,Switzerland,Perak,7,5,2
1/11/2022,Switzerland,Perlis,21,15,6
1/11/2022,Switzerland,Pulau Pinang,130,90,40
1/11/2022,Switzerland,Sabah,27,18,9
1/11/2022,Switzerland,Sarawak,28,15,13
1/11/2022,Switzerland,Selangor,987,657,330
1/11/2022,Switzerland,W.P. Labuan,1,1,0
1/11/2022,Chile,Johor,16,10,6
1/11/2022,Chile,Kedah,6,4,2
1/11/2022,Chile,Kelantan,0,0,0
1/11/2022,Chile,Melaka,0,0,0
1/11/2022,Chile,Pahang,0,0,0
1/11/2022,Chile,Perak,0,0,0
1/11/2022,Chile,Perlis,1,1,0
1/11/2022,Chile,Pulau Pinang,0,0,0
1/11/2022,Chile,Sabah,2,2,0
1/11/2022,Chile,Sarawak,0,0,0
1/11/2022,Chile,Selangor,143,87,56
1/11/2022,China,Johor,19263,7672,11591
1/11/2022,China,Kedah,418,178,240
1/11/2022,China,Kelantan,5,2,3
1/11/2022,China,Melaka,5,4,1
1/11/2022,China,Pahang,0,0,0
1/11/2022,China,Perak,145,61,84
1/11/2022,China,Perlis,40,27,13
1/11/2022,China,Pulau Pinang,1465,777,688
1/11/2022,China,Sabah,358,152,206
1/11/2022,China,Sarawak,371,180,191
1/11/2022,China,Selangor,19273,11464,7809
1/11/2022,China,Terengganu,0,0,0
1/11/2022,China,W.P. Labuan,17,10,7
1/11/2022,Côte d'Ivoire,Johor,0,0,0
1/11/2022,Côte d'Ivoire,Kedah,0,0,0
1/11/2022,Côte d'Ivoire,Pulau Pinang,0,0,0
1/11/2022,Côte d'Ivoire,Sabah,0,0,0
1/11/2022,Côte d'Ivoire,Sarawak,0,0,0
1/11/2022,Côte d'Ivoire,Selangor,17,14,3
1/11/2022,Cameroon,Johor,4,4,0
1/11/2022,Cameroon,Kedah,0,0,0
1/11/2022,Cameroon,Pulau Pinang,0,0,0
1/11/2022,Cameroon,Sabah,0,0,0
1/11/2022,Cameroon,Sarawak,0,0,0
1/11/2022,Cameroon,Selangor,16,12,4
1/11/2022,Congo,Johor,0,0,0
1/11/2022,Congo,Pulau Pinang,0,0,0
1/11/2022,Congo,Sarawak,0,0,0
1/11/2022,Congo,Selangor,2,2,0
1/11/2022,Congo,Johor,0,0,0
1/11/2022,Congo,Kedah,0,0,0
1/11/2022,Congo,Selangor,6,3,3
1/11/2022,Cook Islands,Selangor,0,0,0
1/11/2022,Colombia,Johor,19,9,10
1/11/2022,Colombia,Kedah,1,0,1
1/11/2022,Colombia,Perak,0,0,0
1/11/2022,Colombia,Pulau Pinang,3,0,3
1/11/2022,Colombia,Sabah,0,0,0
1/11/2022,Colombia,Sarawak,0,0,0
1/11/2022,Colombia,Selangor,130,76,54
1/11/2022,Colombia,W.P. Labuan,0,0,0
1/11/2022,Comoros,Johor,0,0,0
1/11/2022,Comoros,Kedah,0,0,0
1/11/2022,Comoros,Selangor,16,10,6
1/11/2022,Cabo Verde,Johor,1,1,0
1/11/2022,Cabo Verde,Kedah,0,0,0
1/11/2022,Cabo Verde,Pulau Pinang,1,0,1
1/11/2022,Cabo Verde,Sabah,0,0,0
1/11/2022,Cabo Verde,Selangor,2,1,1
1/11/2022,Costa Rica,Johor,8,7,1
1/11/2022,Costa Rica,Kedah,0,0,0
1/11/2022,Costa Rica,Perak,0,0,0
1/11/2022,Costa Rica,Perlis,0,0,0
1/11/2022,Costa Rica,Pulau Pinang,4,3,1
1/11/2022,Costa Rica,Sabah,0,0,0
1/11/2022,Costa Rica,Sarawak,0,0,0
1/11/2022,Costa Rica,Selangor,41,20,21
1/11/2022,Cuba,Johor,2,1,1
1/11/2022,Cuba,Kedah,1,1,0
1/11/2022,Cuba,Perlis,0,0,0
1/11/2022,Cuba,Pulau Pinang,0,0,0
1/11/2022,Cuba,Sabah,0,0,0
1/11/2022,Cuba,Sarawak,0,0,0
1/11/2022,Cuba,Selangor,25,15,10
1/11/2022,Cyprus,Johor,7,3,4
1/11/2022,Cyprus,Kedah,1,1,0
1/11/2022,Cyprus,Perak,0,0,0
1/11/2022,Cyprus,Perlis,0,0,0
1/11/2022,Cyprus,Pulau Pinang,3,2,1
1/11/2022,Cyprus,Sabah,1,0,1
1/11/2022,Cyprus,Sarawak,1,0,1
1/11/2022,Cyprus,Selangor,50,36,14
1/11/2022,Czechia,Johor,131,77,54
1/11/2022,Czechia,Kedah,76,34,42
1/11/2022,Czechia,Kelantan,1,1,0
1/11/2022,Czechia,Melaka,0,0,0
1/11/2022,Czechia,Negeri Sembilan,0,0,0
1/11/2022,Czechia,Perak,0,0,0
1/11/2022,Czechia,Perlis,15,8,7
1/11/2022,Czechia,Pulau Pinang,22,15,7
1/11/2022,Czechia,Sabah,9,7,2
1/11/2022,Czechia,Sarawak,7,5,2
1/11/2022,Czechia,Selangor,422,272,150
1/11/2022,Czechia,W.P. Labuan,1,0,1
1/11/2022,Germany,Johor,1907,1242,665
1/11/2022,Germany,Kedah,460,234,226
1/11/2022,Germany,Kelantan,11,9,2
1/11/2022,Germany,Melaka,3,2,1
1/11/2022,Germany,Negeri Sembilan,1,1,0
1/11/2022,Germany,Pahang,1,1,0
1/11/2022,Germany,Perak,19,14,5
1/11/2022,Germany,Perlis,95,62,33
1/11/2022,Germany,Pulau Pinang,601,449,152
1/11/2022,Germany,Sabah,87,55,32
1/11/2022,Germany,Sarawak,150,99,51
1/11/2022,Germany,Selangor,5193,3520,1673
1/11/2022,Germany,Terengganu,0,0,0
1/11/2022,Germany,W.P. Labuan,2,1,1
1/11/2022,Djibouti,Johor,0,0,0
1/11/2022,Djibouti,Selangor,7,4,3
1/11/2022,Dominica,Johor,5,4,1
1/11/2022,Dominica,Kedah,0,0,0
1/11/2022,Dominica,Pulau Pinang,0,0,0
1/11/2022,Dominica,Sabah,0,0,0
1/11/2022,Dominica,Sarawak,0,0,0
1/11/2022,Dominica,Selangor,21,18,3
1/11/2022,Dominica,W.P. Labuan,0,0,0
1/11/2022,Denmark,Johor,265,180,85
1/11/2022,Denmark,Kedah,56,28,28
1/11/2022,Denmark,Kelantan,0,0,0
1/11/2022,Denmark,Melaka,0,0,0
1/11/2022,Denmark,Negeri Sembilan,0,0,0
1/11/2022,Denmark,Pahang,0,0,0
1/11/2022,Denmark,Perak,3,3,0
1/11/2022,Denmark,Perlis,10,6,4
1/11/2022,Denmark,Pulau Pinang,62,39,23
1/11/2022,Denmark,Sabah,15,11,4
1/11/2022,Denmark,Sarawak,16,10,6
1/11/2022,Denmark,Selangor,790,527,263
1/11/2022,Denmark,W.P. Labuan,1,1,0
1/11/2022,Dominican Republic,Johor,0,0,0
1/11/2022,Dominican Republic,Kedah,0,0,0
1/11/2022,Dominican Republic,Perak,0,0,0
1/11/2022,Dominican Republic,Perlis,0,0,0
1/11/2022,Dominican Republic,Pulau Pinang,0,0,0
1/11/2022,Dominican Republic,Sabah,0,0,0
1/11/2022,Dominican Republic,Sarawak,0,0,0
1/11/2022,Dominican Republic,Selangor,8,8,0
1/11/2022,Algeria,Johor,54,38,16
1/11/2022,Algeria,Kedah,3,3,0
1/11/2022,Algeria,Kelantan,1,1,0
1/11/2022,Algeria,Melaka,0,0,0
1/11/2022,Algeria,Perak,0,0,0
1/11/2022,Algeria,Perlis,2,2,0
1/11/2022,Algeria,Pulau Pinang,1,1,0
1/11/2022,Algeria,Sabah,1,1,0
1/11/2022,Algeria,Sarawak,1,1,0
1/11/2022,Algeria,Selangor,428,312,116
1/11/2022,Algeria,W.P. Labuan,0,0,0
1/11/2022,Ecuador,Johor,4,4,0
1/11/2022,Ecuador,Kedah,0,0,0
1/11/2022,Ecuador,Perak,0,0,0
1/11/2022,Ecuador,Perlis,0,0,0
1/11/2022,Ecuador,Pulau Pinang,1,0,1
1/11/2022,Ecuador,Sabah,0,0,0
1/11/2022,Ecuador,Sarawak,0,0,0
1/11/2022,Ecuador,Selangor,45,24,21
1/11/2022,Egypt,Johor,143,116,27
1/11/2022,Egypt,Kedah,3,3,0
1/11/2022,Egypt,Kelantan,0,0,0
1/11/2022,Egypt,Melaka,1,0,1
1/11/2022,Egypt,Pahang,0,0,0
1/11/2022,Egypt,Perak,0,0,0
1/11/2022,Egypt,Perlis,0,0,0
1/11/2022,Egypt,Pulau Pinang,9,7,2
1/11/2022,Egypt,Sabah,5,5,0
1/11/2022,Egypt,Sarawak,91,69,22
1/11/2022,Egypt,Selangor,1273,844,429
1/11/2022,Egypt,Terengganu,0,0,0
1/11/2022,Egypt,W.P. Labuan,0,0,0
1/11/2022,Eritrea,Johor,0,0,0
1/11/2022,Eritrea,Pulau Pinang,0,0,0
1/11/2022,Eritrea,Sabah,0,0,0
1/11/2022,Eritrea,Selangor,17,9,8
1/11/2022,Spain,Johor,434,267,167
1/11/2022,Spain,Kedah,191,93,98
1/11/2022,Spain,Kelantan,1,1,0
1/11/2022,Spain,Melaka,0,0,0
1/11/2022,Spain,Negeri Sembilan,0,0,0
1/11/2022,Spain,Pahang,0,0,0
1/11/2022,Spain,Perak,1,0,1
1/11/2022,Spain,Perlis,21,12,9
1/11/2022,Spain,Pulau Pinang,92,52,40
1/11/2022,Spain,Sabah,32,15,17
1/11/2022,Spain,Sarawak,34,25,9
1/11/2022,Spain,Selangor,2000,1184,816
1/11/2022,Spain,W.P. Labuan,2,1,1
1/11/2022,Estonia,Johor,32,16,16
1/11/2022,Estonia,Kedah,9,7,2
1/11/2022,Estonia,Kelantan,0,0,0
1/11/2022,Estonia,Pahang,0,0,0
1/11/2022,Estonia,Perak,0,0,0
1/11/2022,Estonia,Perlis,4,2,2
1/11/2022,Estonia,Pulau Pinang,5,3,2
1/11/2022,Estonia,Sabah,0,0,0
1/11/2022,Estonia,Sarawak,0,0,0
1/11/2022,Estonia,Selangor,122,71,51
1/11/2022,Estonia,W.P. Labuan,0,0,0
1/11/2022,Ethiopia,Johor,0,0,0
1/11/2022,Ethiopia,Kedah,0,0,0
1/11/2022,Ethiopia,Pulau Pinang,0,0,0
1/11/2022,Ethiopia,Sarawak,1,0,1
1/11/2022,Ethiopia,Selangor,34,22,12
1/11/2022,Finland,Johor,166,99,67
1/11/2022,Finland,Kedah,67,26,41
1/11/2022,Finland,Kelantan,0,0,0
1/11/2022,Finland,Melaka,0,0,0
1/11/2022,Finland,Negeri Sembilan,0,0,0
1/11/2022,Finland,Pahang,0,0,0
1/11/2022,Finland,Perak,4,1,3
1/11/2022,Finland,Perlis,5,3,2
1/11/2022,Finland,Pulau Pinang,44,22,22
1/11/2022,Finland,Sabah,10,4,6
1/11/2022,Finland,Sarawak,13,5,8
1/11/2022,Finland,Selangor,597,342,255
1/11/2022,Finland,W.P. Labuan,0,0,0
1/11/2022,Fiji,Johor,29,18,11
1/11/2022,Fiji,Kedah,0,0,0
1/11/2022,Fiji,Kelantan,0,0,0
1/11/2022,Fiji,Perak,1,1,0
1/11/2022,Fiji,Perlis,1,0,1
1/11/2022,Fiji,Pulau Pinang,3,2,1
1/11/2022,Fiji,Sabah,0,0,0
1/11/2022,Fiji,Sarawak,4,3,1
1/11/2022,Fiji,Selangor,71,44,27
1/11/2022,France,Johor,1435,958,477
1/11/2022,France,Kedah,285,167,118
1/11/2022,France,Kelantan,4,3,1
1/11/2022,France,Melaka,3,1,2
1/11/2022,France,Negeri Sembilan,0,0,0
1/11/2022,France,Pahang,3,3,0
1/11/2022,France,Perak,25,16,9
1/11/2022,France,Perlis,67,49,18
1/11/2022,France,Pulau Pinang,264,178,86
1/11/2022,France,Sabah,61,38,23
1/11/2022,France,Sarawak,91,60,31
1/11/2022,France,Selangor,4797,3181,1616
1/11/2022,France,Terengganu,0,0,0
1/11/2022,France,W.P. Labuan,11,9,2
1/11/2022,"Micronesia, Federated States of",Johor,0,0,0
1/11/2022,"Micronesia, Federated States of",Pulau Pinang,0,0,0
1/11/2022,"Micronesia, Federated States of",Selangor,0,0,0
1/11/2022,Gabon,Johor,0,0,0
1/11/2022,Gabon,Pulau Pinang,0,0,0
1/11/2022,Gabon,Sarawak,0,0,0
1/11/2022,Gabon,Selangor,1,1,0
1/11/2022,United Kingdom of Great Britain and Northern Ireland,Johor,3760,2446,1314
1/11/2022,United Kingdom of Great Britain and Northern Ireland,Kedah,791,446,345
1/11/2022,United Kingdom of Great Britain and Northern Ireland,Kelantan,4,3,1
1/11/2022,United Kingdom of Great Britain and Northern Ireland,Melaka,3,3,0
1/11/2022,United Kingdom of Great Britain and Northern Ireland,Negeri Sembilan,2,0,2
1/11/2022,United Kingdom of Great Britain and Northern Ireland,Pahang,2,2,0
1/11/2022,United Kingdom of Great Britain and Northern Ireland,Perak,64,36,28
1/11/2022,United Kingdom of Great Britain and Northern Ireland,Perlis,154,93,61
1/11/2022,United Kingdom of Great Britain and Northern Ireland,Pulau Pinang,1110,690,420
1/11/2022,United Kingdom of Great Britain and Northern Ireland,Sabah,226,141,85
1/11/2022,United Kingdom of Great Britain and Northern Ireland,Sarawak,864,561,303
1/11/2022,United Kingdom of Great Britain and Northern Ireland,Selangor,13386,8520,4866
1/11/2022,United Kingdom of Great Britain and Northern Ireland,Terengganu,1,1,0
1/11/2022,United Kingdom of Great Britain and Northern Ireland,W.P. Labuan,49,34,15
1/11/2022,Georgia,Johor,13,13,0
1/11/2022,Georgia,Kedah,1,1,0
1/11/2022,Georgia,Melaka,0,0,0
1/11/2022,Georgia,Perak,0,0,0
1/11/2022,Georgia,Perlis,2,1,1
1/11/2022,Georgia,Pulau Pinang,0,0,0
1/11/2022,Georgia,Sabah,0,0,0
1/11/2022,Georgia,Sarawak,1,0,1
1/11/2022,Georgia,Selangor,28,17,11
1/11/2022,Ghana,Johor,24,6,18
1/11/2022,Ghana,Kedah,0,0,0
1/11/2022,Ghana,Kelantan,0,0,0
1/11/2022,Ghana,Pulau Pinang,0,0,0
1/11/2022,Ghana,Sabah,1,0,1
1/11/2022,Ghana,Sarawak,0,0,0
1/11/2022,Ghana,Selangor,64,36,28
1/11/2022,Gibraltar,Johor,0,0,0
1/11/2022,Gibraltar,Sarawak,0,0,0
1/11/2022,Guinea,Johor,3,2,1
1/11/2022,Guinea,Kedah,0,0,0
1/11/2022,Guinea,Kelantan,0,0,0
1/11/2022,Guinea,Perlis,2,2,0
1/11/2022,Guinea,Pulau Pinang,0,0,0
1/11/2022,Guinea,Sabah,0,0,0
1/11/2022,Guinea,Sarawak,0,0,0
1/11/2022,Guinea,Selangor,46,35,11
1/11/2022,Guadeloupe,Selangor,0,0,0
1/11/2022,Gambia,Johor,2,2,0
1/11/2022,Gambia,Kedah,0,0,0
1/11/2022,Gambia,Kelantan,0,0,0
1/11/2022,Gambia,Pulau Pinang,0,0,0
1/11/2022,Gambia,Sabah,0,0,0
1/11/2022,Gambia,Sarawak,0,0,0
1/11/2022,Gambia,Selangor,11,5,6
1/11/2022,Guinea-Bissau,Johor,0,0,0
1/11/2022,Guinea-Bissau,Selangor,0,0,0
1/11/2022,Equatorial Guinea,Johor,0,0,0
1/11/2022,Equatorial Guinea,Selangor,1,1,0
1/11/2022,Greece,Johor,45,37,8
1/11/2022,Greece,Kedah,6,4,2
1/11/2022,Greece,Kelantan,0,0,0
1/11/2022,Greece,Melaka,0,0,0
1/11/2022,Greece,Negeri Sembilan,0,0,0
1/11/2022,Greece,Pahang,0,0,0
1/11/2022,Greece,Perak,1,1,0
1/11/2022,Greece,Perlis,1,0,1
1/11/2022,Greece,Pulau Pinang,5,5,0
1/11/2022,Greece,Sabah,2,1,1
1/11/2022,Greece,Sarawak,2,1,1
1/11/2022,Greece,Selangor,221,168,53
1/11/2022,Grenada,Johor,6,4,2
1/11/2022,Grenada,Kedah,0,0,0
1/11/2022,Grenada,Pulau Pinang,1,0,1
1/11/2022,Grenada,Sabah,0,0,0
1/11/2022,Grenada,Sarawak,1,1,0
1/11/2022,Grenada,Selangor,7,7,0
1/11/2022,Greenland,Johor,0,0,0
1/11/2022,Greenland,Selangor,0,0,0
1/11/2022,Guatemala,Johor,0,0,0
1/11/2022,Guatemala,Kedah,0,0,0
1/11/2022,Guatemala,Pahang,0,0,0
1/11/2022,Guatemala,Perak,0,0,0
1/11/2022,Guatemala,Pulau Pinang,0,0,0
1/11/2022,Guatemala,Sabah,0,0,0
1/11/2022,Guatemala,Sarawak,0,0,0
1/11/2022,Guatemala,Selangor,16,10,6
1/11/2022,Guatemala,W.P. Labuan,0,0,0
1/11/2022,Guyana,Johor,0,0,0
1/11/2022,Guyana,Kedah,0,0,0
1/11/2022,Guyana,Pulau Pinang,0,0,0
1/11/2022,Guyana,Sarawak,0,0,0
1/11/2022,Guyana,Selangor,4,3,1
1/11/2022,Hong Kong,Johor,1,0,1
1/11/2022,Hong Kong,Kedah,0,0,0
1/11/2022,Hong Kong,Kelantan,0,0,0
1/11/2022,Hong Kong,Pahang,0,0,0
1/11/2022,Hong Kong,Perak,30,17,13
1/11/2022,Hong Kong,Perlis,2,2,0
1/11/2022,Hong Kong,Pulau Pinang,0,0,0
1/11/2022,Hong Kong,Sabah,1,0,1
1/11/2022,Hong Kong,Sarawak,0,0,0
1/11/2022,Hong Kong,Selangor,24,12,12
1/11/2022,Hong Kong,Terengganu,0,0,0
1/11/2022,Heard Island and McDonald Islands,Johor,0,0,0
1/11/2022,Honduras,Johor,2,2,0
1/11/2022,Honduras,Kedah,0,0,0
1/11/2022,Honduras,Perak,0,0,0
1/11/2022,Honduras,Pulau Pinang,2,1,1
1/11/2022,Honduras,Sabah,0,0,0
1/11/2022,Honduras,Sarawak,0,0,0
1/11/2022,Honduras,Selangor,9,5,4
1/11/2022,Croatia,Johor,24,22,2
1/11/2022,Croatia,Kedah,6,3,3
1/11/2022,Croatia,Kelantan,0,0,0
1/11/2022,Croatia,Melaka,0,0,0
1/11/2022,Croatia,Pahang,0,0,0
1/11/2022,Croatia,Perak,0,0,0
1/11/2022,Croatia,Perlis,0,0,0
1/11/2022,Croatia,Pulau Pinang,2,2,0
1/11/2022,Croatia,Sabah,2,1,1
1/11/2022,Croatia,Sarawak,5,4,1
1/11/2022,Croatia,Selangor,141,96,45
1/11/2022,Haiti,Johor,0,0,0
1/11/2022,Haiti,Kedah,0,0,0
1/11/2022,Haiti,Kelantan,0,0,0
1/11/2022,Haiti,Perak,0,0,0
1/11/2022,Haiti,Pulau Pinang,0,0,0
1/11/2022,Haiti,Sabah,0,0,0
1/11/2022,Haiti,Selangor,6,2,4
1/11/2022,Hungary,Johor,98,58,40
1/11/2022,Hungary,Kedah,9,5,4
1/11/2022,Hungary,Kelantan,0,0,0
1/11/2022,Hungary,Pahang,0,0,0
1/11/2022,Hungary,Perak,0,0,0
1/11/2022,Hungary,Perlis,4,2,2
1/11/2022,Hungary,Pulau Pinang,13,10,3
1/11/2022,Hungary,Sabah,7,5,2
1/11/2022,Hungary,Sarawak,6,4,2
1/11/2022,Hungary,Selangor,372,206,166
1/11/2022,Hungary,W.P. Labuan,0,0,0
1/11/2022,Indonesia,Johor,96592,52990,43602
1/11/2022,Indonesia,Kedah,3884,1470,2414
1/11/2022,Indonesia,Kelantan,181,155,26
1/11/2022,Indonesia,Melaka,5119,2322,2797
1/11/2022,Indonesia,Negeri Sembilan,6786,4580,2206
1/11/2022,Indonesia,Pahang,3,3,0
1/11/2022,Indonesia,Perak,200,100,100
1/11/2022,Indonesia,Perlis,354,175,179
1/11/2022,Indonesia,Pulau Pinang,23905,8712,15193
1/11/2022,Indonesia,Sabah,3585,1822,1763
1/11/2022,Indonesia,Sarawak,28333,15737,12596
1/11/2022,Indonesia,Selangor,83310,41495,41815
1/11/2022,Indonesia,Terengganu,1,1,0
1/11/2022,Indonesia,W.P. Labuan,85,50,35
1/11/2022,India,Johor,14093,9759,4334
1/11/2022,India,Kedah,482,290,192
1/11/2022,India,Kelantan,1,1,0
1/11/2022,India,Melaka,0,0,0
1/11/2022,India,Negeri Sembilan,0,0,0
1/11/2022,India,Pahang,0,0,0
1/11/2022,India,Perak,269,196,73
1/11/2022,India,Perlis,14,11,3
1/11/2022,India,Pulau Pinang,564,437,127
1/11/2022,India,Sabah,161,128,33
1/11/2022,India,Sarawak,646,515,131
1/11/2022,India,Selangor,44374,32516,11858
1/11/2022,India,Terengganu,1,1,0
1/11/2022,India,W.P. Labuan,31,26,5
1/11/2022, British Indian Ocean Territory,Pulau Pinang,0,0,0
1/11/2022, British Indian Ocean Territory,Selangor,1,1,0
1/11/2022,Ireland,Johor,270,182,88
1/11/2022,Ireland,Kedah,66,35,31
1/11/2022,Ireland,Kelantan,0,0,0
1/11/2022,Ireland,Negeri Sembilan,0,0,0
1/11/2022,Ireland,Pahang,1,1,0
1/11/2022,Ireland,Perak,5,4,1
1/11/2022,Ireland,Perlis,18,13,5
1/11/2022,Ireland,Pulau Pinang,91,60,31
1/11/2022,Ireland,Sabah,9,3,6
1/11/2022,Ireland,Sarawak,24,19,5
1/11/2022,Ireland,Selangor,896,543,353
1/11/2022,Ireland,Terengganu,0,0,0
1/11/2022,Ireland,W.P. Labuan,1,1,0
1/11/2022,"Iran, Islamic Republic of",Johor,78,54,24
1/11/2022,"Iran, Islamic Republic of",Kedah,12,9,3
1/11/2022,"Iran, Islamic Republic of",Kelantan,0,0,0
1/11/2022,"Iran, Islamic Republic of",Perak,1,1,0
1/11/2022,"Iran, Islamic Republic of",Perlis,0,0,0
1/11/2022,"Iran, Islamic Republic of",Pulau Pinang,7,3,4
1/11/2022,"Iran, Islamic Republic of",Sabah,1,1,0
1/11/2022,"Iran, Islamic Republic of",Sarawak,6,3,3
1/11/2022,"Iran, Islamic Republic of",Selangor,876,479,397
1/11/2022,"Iran, Islamic Republic of",W.P. Labuan,0,0,0
1/11/2022,Iraq,Johor,25,24,1
1/11/2022,Iraq,Kedah,2,1,1
1/11/2022,Iraq,Kelantan,0,0,0
1/11/2022,Iraq,Melaka,0,0,0
1/11/2022,Iraq,Pahang,0,0,0
1/11/2022,Iraq,Perak,0,0,0
1/11/2022,Iraq,Perlis,1,1,0
1/11/2022,Iraq,Pulau Pinang,0,0,0
1/11/2022,Iraq,Sabah,0,0,0
1/11/2022,Iraq,Sarawak,0,0,0
1/11/2022,Iraq,Selangor,939,732,207
1/11/2022,Iceland,Johor,6,1,5
1/11/2022,Iceland,Kedah,1,1,0
1/11/2022,Iceland,Kelantan,0,0,0
1/11/2022,Iceland,Perak,0,0,0
1/11/2022,Iceland,Perlis,1,1,0
1/11/2022,Iceland,Pulau Pinang,3,1,2
1/11/2022,Iceland,Sabah,0,0,0
1/11/2022,Iceland,Sarawak,1,0,1
1/11/2022,Iceland,Selangor,26,19,7
1/11/2022,Iceland,W.P. Labuan,0,0,0
1/11/2022,Israel,Pulau Pinang,1,1,0
1/11/2022,Italy,Johor,444,346,98
1/11/2022,Italy,Kedah,98,59,39
1/11/2022,Italy,Kelantan,5,4,1
1/11/2022,Italy,Melaka,1,1,0
1/11/2022,Italy,Negeri Sembilan,0,0,0
1/11/2022,Italy,Pahang,0,0,0
1/11/2022,Italy,Perak,3,3,0
1/11/2022,Italy,Perlis,13,10,3
1/11/2022,Italy,Pulau Pinang,73,59,14
1/11/2022,Italy,Sabah,28,21,7
1/11/2022,Italy,Sarawak,120,80,40
1/11/2022,Italy,Selangor,1756,1288,468
1/11/2022,Italy,W.P. Labuan,0,0,0
1/11/2022,Jamaica,Johor,4,3,1
1/11/2022,Jamaica,Kedah,0,0,0
1/11/2022,Jamaica,Perak,0,0,0
1/11/2022,Jamaica,Pulau Pinang,1,1,0
1/11/2022,Jamaica,Sabah,0,0,0
1/11/2022,Jamaica,Sarawak,0,0,0
1/11/2022,Jamaica,Selangor,16,9,7
1/11/2022,Jamaica,W.P. Labuan,0,0,0
1/11/2022,Jordan,Johor,12,8,4
1/11/2022,Jordan,Kedah,0,0,0
1/11/2022,Jordan,Kelantan,0,0,0
1/11/2022,Jordan,Melaka,0,0,0
1/11/2022,Jordan,Perlis,1,1,0
1/11/2022,Jordan,Pulau Pinang,1,1,0
1/11/2022,Jordan,Sabah,0,0,0
1/11/2022,Jordan,Sarawak,3,3,0
1/11/2022,Jordan,Selangor,600,374,226
1/11/2022,Jordan,W.P. Labuan,0,0,0
1/11/2022,Japan,Johor,4561,3295,1266
1/11/2022,Japan,Kedah,200,107,93
1/11/2022,Japan,Kelantan,6,3,3
1/11/2022,Japan,Melaka,1,0,1
1/11/2022,Japan,Negeri Sembilan,0,0,0
1/11/2022,Japan,Pahang,0,0,0
1/11/2022,Japan,Perak,43,31,12
1/11/2022,Japan,Perlis,38,27,11
1/11/2022,Japan,Pulau Pinang,913,726,187
1/11/2022,Japan,Sabah,157,98,59
1/11/2022,Japan,Sarawak,171,108,63
1/11/2022,Japan,Selangor,11128,7760,3368
1/11/2022,Japan,W.P. Labuan,4,3,1
1/11/2022,Kazakhstan,Johor,49,26,23
1/11/2022,Kazakhstan,Kedah,11,7,4
1/11/2022,Kazakhstan,Kelantan,7,3,4
1/11/2022,Kazakhstan,Melaka,0,0,0
1/11/2022,Kazakhstan,Perak,1,1,0
1/11/2022,Kazakhstan,Perlis,9,6,3
1/11/2022,Kazakhstan,Pulau Pinang,5,4,1
1/11/2022,Kazakhstan,Sabah,2,2,0
1/11/2022,Kazakhstan,Sarawak,6,1,5
1/11/2022,Kazakhstan,Selangor,431,177,254
1/11/2022,Kazakhstan,W.P. Labuan,0,0,0
1/11/2022,Kenya,Johor,62,30,32
1/11/2022,Kenya,Kedah,1,1,0
1/11/2022,Kenya,Kelantan,0,0,0
1/11/2022,Kenya,Perak,0,0,0
1/11/2022,Kenya,Perlis,0,0,0
1/11/2022,Kenya,Pulau Pinang,3,1,2
1/11/2022,Kenya,Sabah,1,0,1
1/11/2022,Kenya,Sarawak,1,1,0
1/11/2022,Kenya,Selangor,278,144,134
1/11/2022,Kyrgyzstan,Johor,17,9,8
1/11/2022,Kyrgyzstan,Kedah,0,0,0
1/11/2022,Kyrgyzstan,Kelantan,0,0,0
1/11/2022,Kyrgyzstan,Perak,0,0,0
1/11/2022,Kyrgyzstan,Perlis,0,0,0
1/11/2022,Kyrgyzstan,Pulau Pinang,0,0,0
1/11/2022,Kyrgyzstan,Sabah,0,0,0
1/11/2022,Kyrgyzstan,Sarawak,1,0,1
1/11/2022,Kyrgyzstan,Selangor,127,68,59
1/11/2022,Cambodia,Johor,2587,1117,1470
1/11/2022,Cambodia,Kedah,308,259,49
1/11/2022,Cambodia,Kelantan,428,235,193
1/11/2022,Cambodia,Melaka,0,0,0
1/11/2022,Cambodia,Negeri Sembilan,0,0,0
1/11/2022,Cambodia,Pahang,0,0,0
1/11/2022,Cambodia,Perak,7,6,1
1/11/2022,Cambodia,Perlis,760,513,247
1/11/2022,Cambodia,Pulau Pinang,26,11,15
1/11/2022,Cambodia,Sabah,0,0,0
1/11/2022,Cambodia,Sarawak,8,4,4
1/11/2022,Cambodia,Selangor,4934,2349,2585
1/11/2022,Cambodia,W.P. Labuan,0,0,0
1/11/2022,Kiribati,Johor,0,0,0
1/11/2022,Kiribati,Sabah,1,0,1
1/11/2022,Kiribati,Selangor,3,2,1
1/11/2022,Saint Kitts and Nevis,Johor,16,10,6
1/11/2022,Saint Kitts and Nevis,Kedah,0,0,0
1/11/2022,Saint Kitts and Nevis,Perlis,0,0,0
1/11/2022,Saint Kitts and Nevis,Pulau Pinang,1,1,0
1/11/2022,Saint Kitts and Nevis,Sabah,1,0,1
1/11/2022,Saint Kitts and Nevis,Selangor,39,28,11
1/11/2022,Saint Kitts and Nevis,W.P. Labuan,0,0,0
1/11/2022,"Korea, Republic of",Johor,6743,3831,2912
1/11/2022,"Korea, Republic of",Kedah,141,68,73
1/11/2022,"Korea, Republic of",Kelantan,0,0,0
1/11/2022,"Korea, Republic of",Melaka,4,3,1
1/11/2022,"Korea, Republic of",Negeri Sembilan,0,0,0
1/11/2022,"Korea, Republic of",Pahang,1,1,0
1/11/2022,"Korea, Republic of",Perak,18,10,8
1/11/2022,"Korea, Republic of",Perlis,52,35,17
1/11/2022,"Korea, Republic of",Pulau Pinang,360,233,127
1/11/2022,"Korea, Republic of",Sabah,9595,4219,5376
1/11/2022,"Korea, Republic of",Sarawak,133,83,50
1/11/2022,"Korea, Republic of",Selangor,8143,4862,3281
1/11/2022,"Korea, Republic of",Terengganu,0,0,0
1/11/2022,"Korea, Republic of",W.P. Labuan,2,2,0
1/11/2022,Kuwait,Johor,14,7,7
1/11/2022,Kuwait,Kedah,2,1,1
1/11/2022,Kuwait,Kelantan,0,0,0
1/11/2022,Kuwait,Perak,0,0,0
1/11/2022,Kuwait,Perlis,0,0,0
1/11/2022,Kuwait,Pulau Pinang,0,0,0
1/11/2022,Kuwait,Sabah,1,0,1
1/11/2022,Kuwait,Sarawak,5,3,2
1/11/2022,Kuwait,Selangor,306,203,103
1/11/2022,Kuwait,W.P. Labuan,0,0,0
1/11/2022, Lao People's Democratic Republic,Johor,135,34,101
1/11/2022, Lao People's Democratic Republic,Kedah,747,51,696
1/11/2022, Lao People's Democratic Republic,Kelantan,104,9,95
1/11/2022, Lao People's Democratic Republic,Melaka,0,0,0
1/11/2022, Lao People's Democratic Republic,Perak,6,1,5
1/11/2022, Lao People's Democratic Republic,Perlis,246,74,172
1/11/2022, Lao People's Democratic Republic,Pulau Pinang,18,5,13
1/11/2022, Lao People's Democratic Republic,Sabah,3,1,2
1/11/2022, Lao People's Democratic Republic,Sarawak,3,1,2
1/11/2022, Lao People's Democratic Republic,Selangor,246,90,156
1/11/2022, Lao People's Democratic Republic,W.P. Labuan,0,0,0
1/11/2022,Lebanon,Johor,7,7,0
1/11/2022,Lebanon,Kedah,0,0,0
1/11/2022,Lebanon,Kelantan,0,0,0
1/11/2022,Lebanon,Pahang,0,0,0
1/11/2022,Lebanon,Perak,0,0,0
1/11/2022,Lebanon,Perlis,0,0,0
1/11/2022,Lebanon,Pulau Pinang,2,1,1
1/11/2022,Lebanon,Sabah,0,0,0
1/11/2022,Lebanon,Sarawak,2,2,0
1/11/2022,Lebanon,Selangor,178,125,53
1/11/2022,Lebanon,W.P. Labuan,0,0,0
1/11/2022,Liberia,Johor,0,0,0
1/11/2022,Liberia,Kedah,0,0,0
1/11/2022,Liberia,Sabah,0,0,0
1/11/2022,Liberia,Sarawak,0,0,0
1/11/2022,Liberia,Selangor,4,3,1
1/11/2022,Libya,Johor,2,0,2
1/11/2022,Libya,Kedah,0,0,0
1/11/2022,Libya,Perlis,0,0,0
1/11/2022,Libya,Pulau Pinang,1,1,0
1/11/2022,Libya,Sabah,1,1,0
1/11/2022,Libya,Sarawak,4,2,2
1/11/2022,Libya,Selangor,251,173,78
1/11/2022,Saint Lucia,Johor,6,6,0
1/11/2022,Saint Lucia,Kedah,0,0,0
1/11/2022,Saint Lucia,Pulau Pinang,0,0,0
1/11/2022,Saint Lucia,Sarawak,0,0,0
1/11/2022,Saint Lucia,Selangor,5,4,1
1/11/2022,Liechtenstein,Johor,3,2,1
1/11/2022,Liechtenstein,Kedah,0,0,0
1/11/2022,Liechtenstein,Perlis,0,0,0
1/11/2022,Liechtenstein,Pulau Pinang,3,2,1
1/11/2022,Liechtenstein,Sabah,0,0,0
1/11/2022,Liechtenstein,Sarawak,0,0,0
1/11/2022,Liechtenstein,Selangor,4,3,1
1/11/2022,LKA,Johor,773,509,264
1/11/2022,LKA,Kedah,19,11,8
1/11/2022,LKA,Kelantan,0,0,0
1/11/2022,LKA,Melaka,0,0,0
1/11/2022,LKA,Pahang,0,0,0
1/11/2022,LKA,Perak,1,1,0
1/11/2022,LKA,Perlis,0,0,0
1/11/2022,LKA,Pulau Pinang,9,9,0
1/11/2022,LKA,Sabah,0,0,0
1/11/2022,LKA,Sarawak,17,12,5
1/11/2022,LKA,Selangor,3272,2140,1132
1/11/2022,LKA,W.P. Labuan,0,0,0
1/11/2022,Lesotho,Johor,1,1,0
1/11/2022,Lesotho,Kedah,0,0,0
1/11/2022,Lesotho,Pulau Pinang,0,0,0
1/11/2022,Lesotho,Sarawak,0,0,0
1/11/2022,Lesotho,Selangor,5,2,3
1/11/2022,Lithuania,Johor,44,20,24
1/11/2022,Lithuania,Kedah,6,3,3
1/11/2022,Lithuania,Kelantan,0,0,0
1/11/2022,Lithuania,Pahang,0,0,0
1/11/2022,Lithuania,Perak,0,0,0
1/11/2022,Lithuania,Perlis,5,4,1
1/11/2022,Lithuania,Pulau Pinang,6,4,2
1/11/2022,Lithuania,Sabah,1,1,0
1/11/2022,Lithuania,Sarawak,5,3,2
1/11/2022,Lithuania,Selangor,220,118,102
1/11/2022,Lithuania,W.P. Labuan,0,0,0
1/11/2022,Luxembourg,Johor,11,3,8
1/11/2022,Luxembourg,Kedah,1,1,0
1/11/2022,Luxembourg,Kelantan,0,0,0
1/11/2022,Luxembourg,Perak,0,0,0
1/11/2022,Luxembourg,Perlis,0,0,0
1/11/2022,Luxembourg,Pulau Pinang,2,1,1
1/11/2022,Luxembourg,Sabah,0,0,0
1/11/2022,Luxembourg,Sarawak,1,0,1
1/11/2022,Luxembourg,Selangor,29,16,13
1/11/2022,Latvia,Johor,15,12,3
1/11/2022,Latvia,Kedah,1,0,1
1/11/2022,Latvia,Kelantan,0,0,0
1/11/2022,Latvia,Pahang,0,0,0
1/11/2022,Latvia,Perak,0,0,0
1/11/2022,Latvia,Perlis,0,0,0
1/11/2022,Latvia,Pulau Pinang,1,1,0
1/11/2022,Latvia,Sabah,1,0,1
1/11/2022,Latvia,Sarawak,7,3,4
1/11/2022,Latvia,Selangor,106,51,55
1/11/2022,Latvia,W.P. Labuan,0,0,0
1/11/2022,Macao,Johor,0,0,0
1/11/2022,Macao,Pahang,0,0,0
1/11/2022,Macao,Perak,1,0,1
1/11/2022,Macao,Selangor,0,0,0
1/11/2022,Macao,W.P. Labuan,1,1,0
1/11/2022,Morocco,Johor,64,43,21
1/11/2022,Morocco,Kedah,5,3,2
1/11/2022,Morocco,Kelantan,0,0,0
1/11/2022,Morocco,Melaka,0,0,0
1/11/2022,Morocco,Pahang,0,0,0
1/11/2022,Morocco,Perak,0,0,0
1/11/2022,Morocco,Perlis,1,1,0
1/11/2022,Morocco,Pulau Pinang,13,7,6
1/11/2022,Morocco,Sabah,1,0,1
1/11/2022,Morocco,Sarawak,3,2,1
1/11/2022,Morocco,Selangor,491,284,207
1/11/2022,Morocco,W.P. Labuan,0,0,0
1/11/2022,Monaco,Johor,1,1,0
1/11/2022,Monaco,Kedah,0,0,0
1/11/2022,Monaco,Sabah,0,0,0
1/11/2022,Monaco,Selangor,3,0,3
1/11/2022,"Moldova, Republic of",Johor,1,1,0
1/11/2022,"Moldova, Republic of",Kedah,2,1,1
1/11/2022,"Moldova, Republic of",Kelantan,0,0,0
1/11/2022,"Moldova, Republic of",Negeri Sembilan,0,0,0
1/11/2022,"Moldova, Republic of",Perlis,0,0,0
1/11/2022,"Moldova, Republic of",Pulau Pinang,0,0,0
1/11/2022,"Moldova, Republic of",Sabah,1,0,1
1/11/2022,"Moldova, Republic of",Sarawak,1,0,1
1/11/2022,"Moldova, Republic of",Selangor,41,23,18
1/11/2022,Madagascar,Johor,10,2,8
1/11/2022,Madagascar,Kedah,0,0,0
1/11/2022,Madagascar,Perak,0,0,0
1/11/2022,Madagascar,Perlis,0,0,0
1/11/2022,Madagascar,Pulau Pinang,1,0,1
1/11/2022,Madagascar,Sabah,0,0,0
1/11/2022,Madagascar,Sarawak,0,0,0
1/11/2022,Madagascar,Selangor,43,13,30
1/11/2022,Maldives,Johor,122,67,55
1/11/2022,Maldives,Kedah,2,1,1
1/11/2022,Maldives,Kelantan,0,0,0
1/11/2022,Maldives,Perak,0,0,0
1/11/2022,Maldives,Perlis,3,3,0
1/11/2022,Maldives,Pulau Pinang,8,8,0
1/11/2022,Maldives,Sabah,0,0,0
1/11/2022,Maldives,Sarawak,1,1,0
1/11/2022,Maldives,Selangor,1739,913,826
1/11/2022,Mexico,Johor,95,53,42
1/11/2022,Mexico,Kedah,10,3,7
1/11/2022,Mexico,Kelantan,0,0,0
1/11/2022,Mexico,Pahang,0,0,0
1/11/2022,Mexico,Perak,0,0,0
1/11/2022,Mexico,Perlis,0,0,0
1/11/2022,Mexico,Pulau Pinang,37,26,11
1/11/2022,Mexico,Sabah,1,0,1
1/11/2022,Mexico,Sarawak,2,1,1
1/11/2022,Mexico,Selangor,456,236,220
1/11/2022,Mexico,W.P. Labuan,0,0,0
1/11/2022,Marshall Islands,Johor,0,0,0
1/11/2022,Marshall Islands,Kedah,0,0,0
1/11/2022,Marshall Islands,Perak,0,0,0
1/11/2022,Marshall Islands,Pulau Pinang,0,0,0
1/11/2022,Marshall Islands,Sabah,0,0,0
1/11/2022,Marshall Islands,Selangor,4,3,1
1/11/2022,North Macedonia,Johor,7,4,3
1/11/2022,North Macedonia,Kedah,0,0,0
1/11/2022,North Macedonia,Perak,0,0,0
1/11/2022,North Macedonia,Pulau Pinang,0,0,0
1/11/2022,North Macedonia,Sabah,0,0,0
1/11/2022,North Macedonia,Sarawak,0,0,0
1/11/2022,North Macedonia,Selangor,17,14,3
1/11/2022,Mali,Johor,0,0,0
1/11/2022,Mali,Sabah,0,0,0
1/11/2022,Mali,Selangor,3,3,0
1/11/2022,Malta,Johor,6,2,4
1/11/2022,Malta,Kedah,3,2,1
1/11/2022,Malta,Kelantan,0,0,0
1/11/2022,Malta,Perak,0,0,0
1/11/2022,Malta,Perlis,0,0,0
1/11/2022,Malta,Pulau Pinang,39,22,17
1/11/2022,Malta,Sabah,1,1,0
1/11/2022,Malta,Sarawak,0,0,0
1/11/2022,Malta,Selangor,34,21,13
1/11/2022,Malta,W.P. Labuan,0,0,0
1/11/2022,Myanmar,Johor,3107,895,2212
1/11/2022,Myanmar,Kedah,40,9,31
1/11/2022,Myanmar,Kelantan,1,1,0
1/11/2022,Myanmar,Negeri Sembilan,0,0,0
1/11/2022,Myanmar,Pahang,0,0,0
1/11/2022,Myanmar,Perak,21,4,17
1/11/2022,Myanmar,Perlis,6,0,6
1/11/2022,Myanmar,Pulau Pinang,172,89,83
1/11/2022,Myanmar,Sabah,17,3,14
1/11/2022,Myanmar,Sarawak,74,33,41
1/11/2022,Myanmar,Selangor,8499,6288,2211
1/11/2022,Myanmar,Terengganu,0,0,0
1/11/2022,Myanmar,W.P. Labuan,0,0,0
1/11/2022,Montenegro,Johor,1,1,0
1/11/2022,Montenegro,Kedah,0,0,0
1/11/2022,Montenegro,Pulau Pinang,0,0,0
1/11/2022,Montenegro,Sabah,0,0,0
1/11/2022,Montenegro,Sarawak,0,0,0
1/11/2022,Montenegro,Selangor,10,10,0
1/11/2022,Mongolia,Johor,119,62,57
1/11/2022,Mongolia,Kedah,3,1,2
1/11/2022,Mongolia,Kelantan,0,0,0
1/11/2022,Mongolia,Perak,1,0,1
1/11/2022,Mongolia,Perlis,8,6,2
1/11/2022,Mongolia,Pulau Pinang,1,0,1
1/11/2022,Mongolia,Sabah,3,2,1
1/11/2022,Mongolia,Sarawak,2,2,0
1/11/2022,Mongolia,Selangor,263,115,148
1/11/2022,Northern Mariana Islands,Selangor,0,0,0
1/11/2022,Mozambique,Johor,0,0,0
1/11/2022,Mozambique,Kedah,0,0,0
1/11/2022,Mozambique,Perak,0,0,0
1/11/2022,Mozambique,Pulau Pinang,0,0,0
1/11/2022,Mozambique,Sabah,0,0,0
1/11/2022,Mozambique,Sarawak,0,0,0
1/11/2022,Mozambique,Selangor,14,10,4
1/11/2022,Mauritania,Johor,2,2,0
1/11/2022,Mauritania,Kedah,0,0,0
1/11/2022,Mauritania,Pulau Pinang,0,0,0
1/11/2022,Mauritania,Sabah,0,0,0
1/11/2022,Mauritania,Sarawak,0,0,0
1/11/2022,Mauritania,Selangor,24,22,2
1/11/2022,Mauritius,Johor,175,100,75
1/11/2022,Mauritius,Kedah,3,1,2
1/11/2022,Mauritius,Kelantan,0,0,0
1/11/2022,Mauritius,Pahang,0,0,0
1/11/2022,Mauritius,Perak,3,1,2
1/11/2022,Mauritius,Perlis,0,0,0
1/11/2022,Mauritius,Pulau Pinang,13,9,4
1/11/2022,Mauritius,Sabah,0,0,0
1/11/2022,Mauritius,Sarawak,0,0,0
1/11/2022,Mauritius,Selangor,2044,1015,1029
1/11/2022,Malawi,Johor,0,0,0
1/11/2022,Malawi,Pulau Pinang,0,0,0
1/11/2022,Malawi,Sabah,1,0,1
1/11/2022,Malawi,Sarawak,2,0,2
1/11/2022,Malawi,Selangor,37,19,18
1/11/2022,Mayotte,Selangor,0,0,0
1/11/2022,Namibia,Johor,0,0,0
1/11/2022,Namibia,Kedah,1,0,1
1/11/2022,Namibia,Perak,0,0,0
1/11/2022,Namibia,Perlis,1,0,1
1/11/2022,Namibia,Pulau Pinang,0,0,0
1/11/2022,Namibia,Sabah,0,0,0
1/11/2022,Namibia,Sarawak,0,0,0
1/11/2022,Namibia,Selangor,12,5,7
1/11/2022,New Caledonia,Selangor,0,0,0
1/11/2022,Niger,Johor,0,0,0
1/11/2022,Niger,Sabah,0,0,0
1/11/2022,Niger,Selangor,0,0,0
1/11/2022,Nigeria,Johor,36,30,6
1/11/2022,Nigeria,Kedah,2,2,0
1/11/2022,Nigeria,Perlis,0,0,0
1/11/2022,Nigeria,Pulau Pinang,2,2,0
1/11/2022,Nigeria,Sabah,0,0,0
1/11/2022,Nigeria,Sarawak,4,2,2
1/11/2022,Nigeria,Selangor,469,383,86
1/11/2022,Nicaragua,Johor,0,0,0
1/11/2022,Nicaragua,Kedah,0,0,0
1/11/2022,Nicaragua,Pulau Pinang,1,1,0
1/11/2022,Nicaragua,Sabah,0,0,0
1/11/2022,Nicaragua,Selangor,10,3,7
1/11/2022,Netherlands,Johor,777,537,240
1/11/2022,Netherlands,Kedah,204,101,103
1/11/2022,Netherlands,Kelantan,0,0,0
1/11/2022,Netherlands,Melaka,3,2,1
1/11/2022,Netherlands,Negeri Sembilan,4,3,1
1/11/2022,Netherlands,Pahang,0,0,0
1/11/2022,Netherlands,Perak,10,3,7
1/11/2022,Netherlands,Perlis,31,18,13
1/11/2022,Netherlands,Pulau Pinang,181,124,57
1/11/2022,Netherlands,Sabah,43,25,18
1/11/2022,Netherlands,Sarawak,120,76,44
1/11/2022,Netherlands,Selangor,3078,1885,1193
1/11/2022,Netherlands,Terengganu,0,0,0
1/11/2022,Netherlands,W.P. Labuan,0,0,0
1/11/2022,Norway,Johor,97,64,33
1/11/2022,Norway,Kedah,20,13,7
1/11/2022,Norway,Kelantan,0,0,0
1/11/2022,Norway,Melaka,0,0,0
1/11/2022,Norway,Pahang,0,0,0
1/11/2022,Norway,Perak,0,0,0
1/11/2022,Norway,Perlis,11,7,4
1/11/2022,Norway,Pulau Pinang,16,11,5
1/11/2022,Norway,Sabah,14,9,5
1/11/2022,Norway,Sarawak,9,9,0
1/11/2022,Norway,Selangor,561,375,186
1/11/2022,Norway,W.P. Labuan,0,0,0
1/11/2022,Nepal,Johor,145,113,32
1/11/2022,Nepal,Kedah,3,3,0
1/11/2022,Nepal,Pahang,0,0,0
1/11/2022,Nepal,Perak,0,0,0
1/11/2022,Nepal,Perlis,0,0,0
1/11/2022,Nepal,Pulau Pinang,14,14,0
1/11/2022,Nepal,Sabah,8,3,5
1/11/2022,Nepal,Sarawak,200,136,64
1/11/2022,Nepal,Selangor,29515,28227,1288
1/11/2022,Nepal,W.P. Labuan,59,56,3
1/11/2022,Nauru,Johor,0,0,0
1/11/2022,Nauru,Pulau Pinang,0,0,0
1/11/2022,Nauru,Selangor,5,4,1
1/11/2022,New Zealand,Johor,627,350,277
1/11/2022,New Zealand,Kedah,55,31,24
1/11/2022,New Zealand,Kelantan,0,0,0
1/11/2022,New Zealand,Melaka,0,0,0
1/11/2022,New Zealand,Negeri Sembilan,0,0,0
1/11/2022,New Zealand,Pahang,0,0,0
1/11/2022,New Zealand,Perak,13,9,4
1/11/2022,New Zealand,Perlis,13,10,3
1/11/2022,New Zealand,Pulau Pinang,140,83,57
1/11/2022,New Zealand,Sabah,31,20,11
1/11/2022,New Zealand,Sarawak,86,54,32
1/11/2022,New Zealand,Selangor,2223,1325,898
1/11/2022,New Zealand,Terengganu,0,0,0
1/11/2022,New Zealand,W.P. Labuan,0,0,0
1/11/2022,Oman,Johor,43,28,15
1/11/2022,Oman,Kedah,1,1,0
1/11/2022,Oman,Kelantan,0,0,0
1/11/2022,Oman,Melaka,0,0,0
1/11/2022,Oman,Perak,0,0,0
1/11/2022,Oman,Perlis,0,0,0
1/11/2022,Oman,Pulau Pinang,6,5,1
1/11/2022,Oman,Sabah,2,0,2
1/11/2022,Oman,Sarawak,12,7,5
1/11/2022,Oman,Selangor,591,390,201
1/11/2022,Pakistan,Johor,828,630,198
1/11/2022,Pakistan,Kedah,112,94,18
1/11/2022,Pakistan,Kelantan,8,7,1
1/11/2022,Pakistan,Melaka,0,0,0
1/11/2022,Pakistan,Negeri Sembilan,0,0,0
1/11/2022,Pakistan,Pahang,0,0,0
1/11/2022,Pakistan,Perak,36,36,0
1/11/2022,Pakistan,Perlis,22,21,1
1/11/2022,Pakistan,Pulau Pinang,31,27,4
1/11/2022,Pakistan,Sabah,4,4,0
1/11/2022,Pakistan,Sarawak,91,73,18
1/11/2022,Pakistan,Selangor,9096,7952,1144
1/11/2022,Pakistan,W.P. Labuan,3,3,0
1/11/2022,Panama,Johor,4,1,3
1/11/2022,Panama,Kedah,0,0,0
1/11/2022,Panama,Perak,0,0,0
1/11/2022,Panama,Perlis,0,0,0
1/11/2022,Panama,Pulau Pinang,0,0,0
1/11/2022,Panama,Sabah,0,0,0
1/11/2022,Panama,Sarawak,1,1,0
1/11/2022,Panama,Selangor,20,8,12
1/11/2022,Peru,Johor,20,11,9
1/11/2022,Peru,Kedah,1,1,0
1/11/2022,Peru,Kelantan,0,0,0
1/11/2022,Peru,Pahang,0,0,0
1/11/2022,Peru,Perak,0,0,0
1/11/2022,Peru,Perlis,1,0,1
1/11/2022,Peru,Pulau Pinang,0,0,0
1/11/2022,Peru,Sabah,0,0,0
1/11/2022,Peru,Sarawak,0,0,0
1/11/2022,Peru,Selangor,100,49,51
1/11/2022,Peru,W.P. Labuan,0,0,0
1/11/2022,Philippines,Johor,16889,5358,11531
1/11/2022,Philippines,Kedah,432,165,267
1/11/2022,Philippines,Kelantan,23,10,13
1/11/2022,Philippines,Melaka,1,0,1
1/11/2022,Philippines,Negeri Sembilan,1,1,0
1/11/2022,Philippines,Pahang,1,1,0
1/11/2022,Philippines,Perak,62,23,39
1/11/2022,Philippines,Perlis,103,36,67
1/11/2022,Philippines,Pulau Pinang,383,131,252
1/11/2022,Philippines,Sabah,1243,551,692
1/11/2022,Philippines,Sarawak,1160,451,709
1/11/2022,Philippines,Selangor,15381,5931,9450
1/11/2022,Philippines,Terengganu,1,1,0
1/11/2022,Philippines,W.P. Labuan,86,29,57
1/11/2022,Palau,Johor,1,1,0
1/11/2022,Palau,Pulau Pinang,0,0,0
1/11/2022,Palau,Selangor,0,0,0
1/11/2022,Papua New Guinea,Johor,13,6,7
1/11/2022,Papua New Guinea,Kedah,0,0,0
1/11/2022,Papua New Guinea,Kelantan,0,0,0
1/11/2022,Papua New Guinea,Perak,0,0,0
1/11/2022,Papua New Guinea,Pulau Pinang,0,0,0
1/11/2022,Papua New Guinea,Sabah,0,0,0
1/11/2022,Papua New Guinea,Sarawak,3,1,2
1/11/2022,Papua New Guinea,Selangor,42,25,17
1/11/2022,Poland,Johor,338,176,162
1/11/2022,Poland,Kedah,94,47,47
1/11/2022,Poland,Kelantan,1,1,0
1/11/2022,Poland,Melaka,0,0,0
1/11/2022,Poland,Negeri Sembilan,0,0,0
1/11/2022,Poland,Pahang,0,0,0
1/11/2022,Poland,Perak,5,4,1
1/11/2022,Poland,Perlis,11,7,4
1/11/2022,Poland,Pulau Pinang,128,74,54
1/11/2022,Poland,Sabah,36,23,13
1/11/2022,Poland,Sarawak,53,19,34
1/11/2022,Poland,Selangor,1235,669,566
1/11/2022,Poland,Terengganu,0,0,0
1/11/2022,Poland,W.P. Labuan,8,4,4
1/11/2022,"North Korea, Democratic People's Republic of",Selangor,0,0,0
1/11/2022,Portugal,Johor,129,78,51
1/11/2022,Portugal,Kedah,14,8,6
1/11/2022,Portugal,Kelantan,0,0,0
1/11/2022,Portugal,Melaka,0,0,0
1/11/2022,Portugal,Pahang,0,0,0
1/11/2022,Portugal,Perak,2,2,0
1/11/2022,Portugal,Perlis,4,3,1
1/11/2022,Portugal,Pulau Pinang,25,17,8
1/11/2022,Portugal,Sabah,8,4,4
1/11/2022,Portugal,Sarawak,9,8,1
1/11/2022,Portugal,Selangor,568,344,224
1/11/2022,Portugal,W.P. Labuan,1,0,1
1/11/2022,Paraguay,Johor,0,0,0
1/11/2022,Paraguay,Kedah,0,0,0
1/11/2022,Paraguay,Perak,0,0,0
1/11/2022,Paraguay,Perlis,0,0,0
1/11/2022,Paraguay,Pulau Pinang,0,0,0
1/11/2022,Paraguay,Sabah,0,0,0
1/11/2022,Paraguay,Sarawak,0,0,0
1/11/2022,Paraguay,Selangor,6,4,2
1/11/2022,"Palestine, State of",Johor,2,2,0
1/11/2022,"Palestine, State of",Kedah,1,1,0
1/11/2022,"Palestine, State of",Kelantan,0,0,0
1/11/2022,"Palestine, State of",Melaka,0,0,0
1/11/2022,"Palestine, State of",Perak,0,0,0
1/11/2022,"Palestine, State of",Perlis,2,2,0
1/11/2022,"Palestine, State of",Pulau Pinang,2,2,0
1/11/2022,"Palestine, State of",Sabah,0,0,0
1/11/2022,"Palestine, State of",Sarawak,7,5,2
1/11/2022,"Palestine, State of",Selangor,254,172,82
1/11/2022,Qatar,Johor,18,14,4
1/11/2022,Qatar,Kedah,0,0,0
1/11/2022,Qatar,Perlis,0,0,0
1/11/2022,Qatar,Pulau Pinang,4,3,1
1/11/2022,Qatar,Sabah,0,0,0
1/11/2022,Qatar,Sarawak,5,3,2
1/11/2022,Qatar,Selangor,65,34,31
1/11/2022,Réunion,Johor,0,0,0
1/11/2022,Réunion,Sarawak,0,0,0
1/11/2022,Romania,Johor,93,53,40
1/11/2022,Romania,Kedah,13,6,7
1/11/2022,Romania,Kelantan,0,0,0
1/11/2022,Romania,Negeri Sembilan,0,0,0
1/11/2022,Romania,Pahang,0,0,0
1/11/2022,Romania,Perak,2,0,2
1/11/2022,Romania,Perlis,3,2,1
1/11/2022,Romania,Pulau Pinang,24,15,9
1/11/2022,Romania,Sabah,4,2,2
1/11/2022,Romania,Sarawak,3,2,1
1/11/2022,Romania,Selangor,536,284,252
1/11/2022,Romania,W.P. Labuan,0,0,0
1/11/2022,Russian Federation (Russia),Johor,292,151,141
1/11/2022,Russian Federation (Russia),Kedah,291,169,122
1/11/2022,Russian Federation (Russia),Kelantan,57,34,23
1/11/2022,Russian Federation (Russia),Melaka,0,0,0
1/11/2022,Russian Federation (Russia),Negeri Sembilan,0,0,0
1/11/2022,Russian Federation (Russia),Pahang,0,0,0
1/11/2022,Russian Federation (Russia),Perak,2,0,2
1/11/2022,Russian Federation (Russia),Perlis,517,320,197
1/11/2022,Russian Federation (Russia),Pulau Pinang,321,180,141
1/11/2022,Russian Federation (Russia),Sabah,15,9,6
1/11/2022,Russian Federation (Russia),Sarawak,46,22,24
1/11/2022,Russian Federation (Russia),Selangor,7928,4540,3388
1/11/2022,Russian Federation (Russia),W.P. Labuan,3,1,2
1/11/2022,Rwanda,Johor,2,2,0
1/11/2022,Rwanda,Kedah,0,0,0
1/11/2022,Rwanda,Pulau Pinang,0,0,0
1/11/2022,Rwanda,Selangor,9,3,6
1/11/2022,Saudi Arabia,Johor,101,59,42
1/11/2022,Saudi Arabia,Kedah,11,6,5
1/11/2022,Saudi Arabia,Kelantan,0,0,0
1/11/2022,Saudi Arabia,Melaka,0,0,0
1/11/2022,Saudi Arabia,Perak,0,0,0
1/11/2022,Saudi Arabia,Perlis,6,6,0
1/11/2022,Saudi Arabia,Pulau Pinang,2,2,0
1/11/2022,Saudi Arabia,Sabah,0,0,0
1/11/2022,Saudi Arabia,Sarawak,27,19,8
1/11/2022,Saudi Arabia,Selangor,3877,2132,1745
1/11/2022,Saudi Arabia,W.P. Labuan,0,0,0
1/11/2022,Sudan,Johor,9,5,4
1/11/2022,Sudan,Kedah,0,0,0
1/11/2022,Sudan,Kelantan,0,0,0
1/11/2022,Sudan,Perlis,1,0,1
1/11/2022,Sudan,Pulau Pinang,2,1,1
1/11/2022,Sudan,Sabah,0,0,0
1/11/2022,Sudan,Sarawak,4,4,0
1/11/2022,Sudan,Selangor,784,470,314
1/11/2022,Sudan,W.P. Labuan,1,1,0
1/11/2022,Senegal,Johor,1,1,0
1/11/2022,Senegal,Kedah,0,0,0
1/11/2022,Senegal,Kelantan,0,0,0
1/11/2022,Senegal,Perak,0,0,0
1/11/2022,Senegal,Perlis,0,0,0
1/11/2022,Senegal,Pulau Pinang,0,0,0
1/11/2022,Senegal,Sabah,0,0,0
1/11/2022,Senegal,Sarawak,0,0,0
1/11/2022,Senegal,Selangor,19,13,6
1/11/2022,Singapore,Johor,1005465,577797,427668
1/11/2022,Singapore,Kedah,4114,2177,1937
1/11/2022,Singapore,Kelantan,32,18,14
1/11/2022,Singapore,Melaka,15,14,1
1/11/2022,Singapore,Negeri Sembilan,4,3,1
1/11/2022,Singapore,Pahang,35,12,23
1/11/2022,Singapore,Perak,5710,2658,3052
1/11/2022,Singapore,Perlis,229,136,93
1/11/2022,Singapore,Pulau Pinang,15815,7828,7987
1/11/2022,Singapore,Sabah,3584,1811,1773
1/11/2022,Singapore,Sarawak,3972,2178,1794
1/11/2022,Singapore,Selangor,53185,26212,26973
1/11/2022,Singapore,Terengganu,0,0,0
1/11/2022,Singapore,W.P. Labuan,23,18,5
1/11/2022,South Georgia and the South Sandwich Islands,Johor,0,0,0
1/11/2022,South Georgia and the South Sandwich Islands,Sabah,0,0,0
1/11/2022,South Georgia and the South Sandwich Islands,Selangor,0,0,0
1/11/2022,Saint Helena,Sarawak,0,0,0
1/11/2022,Solomon Islands,Johor,1,1,0
1/11/2022,Solomon Islands,Perlis,0,0,0
1/11/2022,Solomon Islands,Pulau Pinang,0,0,0
1/11/2022,Solomon Islands,Sabah,0,0,0
1/11/2022,Solomon Islands,Sarawak,6,3,3
1/11/2022,Solomon Islands,Selangor,13,6,7
1/11/2022,Solomon Islands,W.P. Labuan,0,0,0
1/11/2022,Sierra Leone,Johor,1,0,1
1/11/2022,Sierra Leone,Kedah,0,0,0
1/11/2022,Sierra Leone,Perak,0,0,0
1/11/2022,Sierra Leone,Pulau Pinang,1,1,0
1/11/2022,Sierra Leone,Sabah,0,0,0
1/11/2022,Sierra Leone,Selangor,23,19,4
1/11/2022,El Salvador,Johor,6,4,2
1/11/2022,El Salvador,Kedah,1,1,0
1/11/2022,El Salvador,Perak,0,0,0
1/11/2022,El Salvador,Perlis,0,0,0
1/11/2022,El Salvador,Pulau Pinang,0,0,0
1/11/2022,El Salvador,Sabah,0,0,0
1/11/2022,El Salvador,Selangor,14,7,7
1/11/2022,El Salvador,W.P. Labuan,0,0,0
1/11/2022,San Marino,Johor,0,0,0
1/11/2022,San Marino,Selangor,0,0,0
1/11/2022,Somalia,Johor,0,0,0
1/11/2022,Somalia,Kedah,0,0,0
1/11/2022,Somalia,Kelantan,0,0,0
1/11/2022,Somalia,Perlis,0,0,0
1/11/2022,Somalia,Sabah,0,0,0
1/11/2022,Somalia,Sarawak,1,1,0
1/11/2022,Somalia,Selangor,247,156,91
1/11/2022,Serbia,Johor,9,9,0
1/11/2022,Serbia,Kedah,0,0,0
1/11/2022,Serbia,Kelantan,0,0,0
1/11/2022,Serbia,Pahang,0,0,0
1/11/2022,Serbia,Perak,0,0,0
1/11/2022,Serbia,Perlis,0,0,0
1/11/2022,Serbia,Pulau Pinang,2,1,1
1/11/2022,Serbia,Sabah,0,0,0
1/11/2022,Serbia,Sarawak,0,0,0
1/11/2022,Serbia,Selangor,54,32,22
1/11/2022,South Sudan,Johor,1,0,1
1/11/2022,South Sudan,Kedah,0,0,0
1/11/2022,South Sudan,Sarawak,0,0,0
1/11/2022,South Sudan,Selangor,30,19,11
1/11/2022,South Sudan,W.P. Labuan,0,0,0
1/11/2022,Sao Tome and Principe,Selangor,2,0,2
1/11/2022,Suriname,Johor,3,1,2
1/11/2022,Suriname,Kedah,1,1,0
1/11/2022,Suriname,Kelantan,0,0,0
1/11/2022,Suriname,Perak,0,0,0
1/11/2022,Suriname,Perlis,0,0,0
1/11/2022,Suriname,Pulau Pinang,1,1,0
1/11/2022,Suriname,Sabah,0,0,0
1/11/2022,Suriname,Sarawak,0,0,0
1/11/2022,Suriname,Selangor,9,6,3
1/11/2022,Slovakia,Johor,25,16,9
1/11/2022,Slovakia,Kedah,56,29,27
1/11/2022,Slovakia,Kelantan,0,0,0
1/11/2022,Slovakia,Negeri Sembilan,0,0,0
1/11/2022,Slovakia,Pahang,0,0,0
1/11/2022,Slovakia,Perak,0,0,0
1/11/2022,Slovakia,Perlis,3,2,1
1/11/2022,Slovakia,Pulau Pinang,12,8,4
1/11/2022,Slovakia,Sabah,4,1,3
1/11/2022,Slovakia,Sarawak,1,1,0
1/11/2022,Slovakia,Selangor,254,141,113
1/11/2022,Slovakia,W.P. Labuan,0,0,0
1/11/2022,Slovenia,Johor,8,5,3
1/11/2022,Slovenia,Kedah,11,5,6
1/11/2022,Slovenia,Kelantan,0,0,0
1/11/2022,Slovenia,Perak,0,0,0
1/11/2022,Slovenia,Perlis,1,0,1
1/11/2022,Slovenia,Pulau Pinang,4,2,2
1/11/2022,Slovenia,Sabah,0,0,0
1/11/2022,Slovenia,Sarawak,0,0,0
1/11/2022,Slovenia,Selangor,70,44,26
1/11/2022,Slovenia,W.P. Labuan,0,0,0
1/11/2022,Sweden,Johor,236,144,92
1/11/2022,Sweden,Kedah,136,66,70
1/11/2022,Sweden,Kelantan,5,1,4
1/11/2022,Sweden,Melaka,0,0,0
1/11/2022,Sweden,Negeri Sembilan,0,0,0
1/11/2022,Sweden,Pahang,1,1,0
1/11/2022,Sweden,Perak,4,2,2
1/11/2022,Sweden,Perlis,9,7,2
1/11/2022,Sweden,Pulau Pinang,69,51,18
1/11/2022,Sweden,Sabah,13,7,6
1/11/2022,Sweden,Sarawak,20,16,4
1/11/2022,Sweden,Selangor,967,601,366
1/11/2022,Sweden,W.P. Labuan,5,5,0
1/11/2022,Eswatini,Johor,0,0,0
1/11/2022,Eswatini,Kedah,0,0,0
1/11/2022,Eswatini,Pulau Pinang,0,0,0
1/11/2022,Eswatini,Sabah,0,0,0
1/11/2022,Eswatini,Selangor,12,5,7
1/11/2022,Seychelles,Johor,1,0,1
1/11/2022,Seychelles,Kedah,0,0,0
1/11/2022,Seychelles,Pulau Pinang,4,2,2
1/11/2022,Seychelles,Sabah,0,0,0
1/11/2022,Seychelles,Sarawak,1,1,0
1/11/2022,Seychelles,Selangor,37,12,25
1/11/2022,Syrian Arab Republic,Johor,5,2,3
1/11/2022,Syrian Arab Republic,Kedah,0,0,0
1/11/2022,Syrian Arab Republic,Kelantan,0,0,0
1/11/2022,Syrian Arab Republic,Pahang,4,4,0
1/11/2022,Syrian Arab Republic,Perlis,0,0,0
1/11/2022,Syrian Arab Republic,Pulau Pinang,1,1,0
1/11/2022,Syrian Arab Republic,Sabah,0,0,0
1/11/2022,Syrian Arab Republic,Sarawak,1,0,1
1/11/2022,Syrian Arab Republic,Selangor,512,332,180
1/11/2022,Syrian Arab Republic,W.P. Labuan,0,0,0
1/11/2022,Turks and Caicos Islands,Perlis,0,0,0
1/11/2022,TCD,Johor,5,5,0
1/11/2022,TCD,Kedah,0,0,0
1/11/2022,TCD,Perlis,0,0,0
1/11/2022,TCD,Selangor,17,16,1
1/11/2022,Togo,Johor,1,0,1
1/11/2022,Togo,Perak,0,0,0
1/11/2022,Togo,Pulau Pinang,0,0,0
1/11/2022,Togo,Selangor,1,1,0
1/11/2022,Thailand,Johor,4704,1275,3429
1/11/2022,Thailand,Kedah,58809,35945,22864
1/11/2022,Thailand,Kelantan,32286,17194,15092
1/11/2022,Thailand,Melaka,32,12,20
1/11/2022,Thailand,Negeri Sembilan,5,1,4
1/11/2022,Thailand,Pahang,2,2,0
1/11/2022,Thailand,Perak,8321,3933,4388
1/11/2022,Thailand,Perlis,51813,32080,19733
1/11/2022,Thailand,Pulau Pinang,1764,730,1034
1/11/2022,Thailand,Sabah,157,35,122
1/11/2022,Thailand,Sarawak,221,86,135
1/11/2022,Thailand,Selangor,10163,4287,5876
1/11/2022,Thailand,Terengganu,0,0,0
1/11/2022,Thailand,W.P. Labuan,5,2,3
1/11/2022,Tajikistan,Johor,0,0,0
1/11/2022,Tajikistan,Kedah,0,0,0
1/11/2022,Tajikistan,Perlis,0,0,0
1/11/2022,Tajikistan,Pulau Pinang,0,0,0
1/11/2022,Tajikistan,Sabah,2,1,1
1/11/2022,Tajikistan,Selangor,103,73,30
1/11/2022,Tokelau,Selangor,0,0,0
1/11/2022,Turkmenistan,Johor,1,0,1
1/11/2022,Turkmenistan,Kedah,0,0,0
1/11/2022,Turkmenistan,Kelantan,0,0,0
1/11/2022,Turkmenistan,Perlis,0,0,0
1/11/2022,Turkmenistan,Pulau Pinang,0,0,0
1/11/2022,Turkmenistan,Sabah,1,1,0
1/11/2022,Turkmenistan,Sarawak,0,0,0
1/11/2022,Turkmenistan,Selangor,48,25,23
1/11/2022,Timor-Leste,Johor,6,6,0
1/11/2022,Timor-Leste,Kedah,0,0,0
1/11/2022,Timor-Leste,Perlis,0,0,0
1/11/2022,Timor-Leste,Pulau Pinang,0,0,0
1/11/2022,Timor-Leste,Sabah,3,2,1
1/11/2022,Timor-Leste,Sarawak,2,0,2
1/11/2022,Timor-Leste,Selangor,143,83,60
1/11/2022,Tonga,Johor,1,1,0
1/11/2022,Tonga,Pulau Pinang,2,0,2
1/11/2022,Tonga,Sarawak,0,0,0
1/11/2022,Tonga,Selangor,8,4,4
1/11/2022,Trinidad and Tobago,Johor,5,2,3
1/11/2022,Trinidad and Tobago,Kedah,2,1,1
1/11/2022,Trinidad and Tobago,Pahang,0,0,0
1/11/2022,Trinidad and Tobago,Pulau Pinang,0,0,0
1/11/2022,Trinidad and Tobago,Sabah,0,0,0
1/11/2022,Trinidad and Tobago,Sarawak,0,0,0
1/11/2022,Trinidad and Tobago,Selangor,36,20,16
1/11/2022,Tunisia,Johor,14,8,6
1/11/2022,Tunisia,Kedah,3,1,2
1/11/2022,Tunisia,Kelantan,0,0,0
1/11/2022,Tunisia,Melaka,1,1,0
1/11/2022,Tunisia,Perak,0,0,0
1/11/2022,Tunisia,Perlis,1,0,1
1/11/2022,Tunisia,Pulau Pinang,1,1,0
1/11/2022,Tunisia,Sabah,0,0,0
1/11/2022,Tunisia,Sarawak,2,0,2
1/11/2022,Tunisia,Selangor,320,174,146
1/11/2022,Tunisia,W.P. Labuan,0,0,0
1/11/2022,Türkiye,Johor,275,186,89
1/11/2022,Türkiye,Kedah,13,10,3
1/11/2022,Türkiye,Kelantan,2,2,0
1/11/2022,Türkiye,Melaka,0,0,0
1/11/2022,Türkiye,Negeri Sembilan,0,0,0
1/11/2022,Türkiye,Pahang,0,0,0
1/11/2022,Türkiye,Perak,1,1,0
1/11/2022,Türkiye,Perlis,12,11,1
1/11/2022,Türkiye,Pulau Pinang,15,12,3
1/11/2022,Türkiye,Sabah,7,5,2
1/11/2022,Türkiye,Sarawak,16,9,7
1/11/2022,Türkiye,Selangor,883,649,234
1/11/2022,Türkiye,W.P. Labuan,0,0,0
1/11/2022,Tuvalu,Selangor,0,0,0
1/11/2022,"Taiwan, Province of China",Johor,2713,1231,1482
1/11/2022,"Taiwan, Province of China",Kedah,72,42,30
1/11/2022,"Taiwan, Province of China",Kelantan,1,1,0
1/11/2022,"Taiwan, Province of China",Melaka,1,1,0
1/11/2022,"Taiwan, Province of China",Negeri Sembilan,0,0,0
1/11/2022,"Taiwan, Province of China",Pahang,0,0,0
1/11/2022,"Taiwan, Province of China",Perak,28,12,16
1/11/2022,"Taiwan, Province of China",Perlis,8,3,5
1/11/2022,"Taiwan, Province of China",Pulau Pinang,769,466,303
1/11/2022,"Taiwan, Province of China",Sabah,74,28,46
1/11/2022,"Taiwan, Province of China",Sarawak,191,83,108
1/11/2022,"Taiwan, Province of China",Selangor,5291,2922,2369
1/11/2022,"Taiwan, Province of China",W.P. Labuan,3,3,0
1/11/2022,"Tanzania, United Republic of",Johor,6,3,3
1/11/2022,"Tanzania, United Republic of",Kedah,0,0,0
1/11/2022,"Tanzania, United Republic of",Perak,0,0,0
1/11/2022,"Tanzania, United Republic of",Perlis,0,0,0
1/11/2022,"Tanzania, United Republic of",Pulau Pinang,0,0,0
1/11/2022,"Tanzania, United Republic of",Sabah,0,0,0
1/11/2022,"Tanzania, United Republic of",Sarawak,1,1,0
1/11/2022,"Tanzania, United Republic of",Selangor,143,64,79
1/11/2022,Uganda,Johor,25,15,10
1/11/2022,Uganda,Kedah,0,0,0
1/11/2022,Uganda,Perak,0,0,0
1/11/2022,Uganda,Perlis,3,3,0
1/11/2022,Uganda,Pulau Pinang,0,0,0
1/11/2022,Uganda,Sabah,0,0,0
1/11/2022,Uganda,Sarawak,0,0,0
1/11/2022,Uganda,Selangor,68,40,28
1/11/2022,Ukraine,Johor,80,39,41
1/11/2022,Ukraine,Kedah,23,9,14
1/11/2022,Ukraine,Kelantan,3,2,1
1/11/2022,Ukraine,Melaka,5,5,0
1/11/2022,Ukraine,Negeri Sembilan,0,0,0
1/11/2022,Ukraine,Pahang,0,0,0
1/11/2022,Ukraine,Perak,0,0,0
1/11/2022,Ukraine,Perlis,22,9,13
1/11/2022,Ukraine,Pulau Pinang,37,17,20
1/11/2022,Ukraine,Sabah,7,6,1
1/11/2022,Ukraine,Sarawak,1,0,1
1/11/2022,Ukraine,Selangor,736,369,367
1/11/2022,Ukraine,W.P. Labuan,1,0,1
1/11/2022,Uruguay,Johor,8,2,6
1/11/2022,Uruguay,Kedah,0,0,0
1/11/2022,Uruguay,Kelantan,0,0,0
1/11/2022,Uruguay,Perak,0,0,0
1/11/2022,Uruguay,Perlis,0,0,0
1/11/2022,Uruguay,Pulau Pinang,1,0,1
1/11/2022,Uruguay,Sabah,1,1,0
1/11/2022,Uruguay,Sarawak,0,0,0
1/11/2022,Uruguay,Selangor,40,17,23
1/11/2022,Uruguay,W.P. Labuan,0,0,0
1/11/2022,United States of America,Johor,3279,1972,1307
1/11/2022,United States of America,Kedah,358,219,139
1/11/2022,United States of America,Kelantan,6,5,1
1/11/2022,United States of America,Melaka,3,2,1
1/11/2022,United States of America,Negeri Sembilan,0,0,0
1/11/2022,United States of America,Pahang,3,3,0
1/11/2022,United States of America,Perak,101,51,50
1/11/2022,United States of America,Perlis,113,75,38
1/11/2022,United States of America,Pulau Pinang,1480,906,574
1/11/2022,United States of America,Sabah,265,153,112
1/11/2022,United States of America,Sarawak,225,126,99
1/11/2022,United States of America,Selangor,11399,6830,4569
1/11/2022,United States of America,Terengganu,0,0,0
1/11/2022,United States of America,W.P. Labuan,7,7,0
1/11/2022,Uzbekistan,Johor,68,50,18
1/11/2022,Uzbekistan,Kedah,4,2,2
1/11/2022,Uzbekistan,Kelantan,0,0,0
1/11/2022,Uzbekistan,Perak,1,1,0
1/11/2022,Uzbekistan,Perlis,6,3,3
1/11/2022,Uzbekistan,Pulau Pinang,1,1,0
1/11/2022,Uzbekistan,Sabah,54,52,2
1/11/2022,Uzbekistan,Sarawak,0,0,0
1/11/2022,Uzbekistan,Selangor,968,617,351
1/11/2022,Holy See,Johor,1,1,0
1/11/2022,Holy See,Sarawak,0,0,0
1/11/2022,Holy See,Selangor,1,1,0
1/11/2022,Saint Vincent and the Grenadines,Johor,0,0,0
1/11/2022,Saint Vincent and the Grenadines,Kedah,0,0,0
1/11/2022,Saint Vincent and the Grenadines,Pulau Pinang,0,0,0
1/11/2022,Saint Vincent and the Grenadines,Sarawak,0,0,0
1/11/2022,Saint Vincent and the Grenadines,Selangor,1,0,1
1/11/2022,"Venezuela, Bolivarian Republic of",Johor,11,4,7
1/11/2022,"Venezuela, Bolivarian Republic of",Kedah,0,0,0
1/11/2022,"Venezuela, Bolivarian Republic of",Kelantan,0,0,0
1/11/2022,"Venezuela, Bolivarian Republic of",Melaka,0,0,0
1/11/2022,"Venezuela, Bolivarian Republic of",Perak,0,0,0
1/11/2022,"Venezuela, Bolivarian Republic of",Perlis,0,0,0
1/11/2022,"Venezuela, Bolivarian Republic of",Pulau Pinang,0,0,0
1/11/2022,"Venezuela, Bolivarian Republic of",Sabah,0,0,0
1/11/2022,"Venezuela, Bolivarian Republic of",Sarawak,0,0,0
1/11/2022,"Venezuela, Bolivarian Republic of",Selangor,45,27,18
1/11/2022,"Venezuela, Bolivarian Republic of",W.P. Labuan,0,0,0
1/11/2022,Viet Nam,Johor,10491,3145,7346
1/11/2022,Viet Nam,Kedah,221,40,181
1/11/2022,Viet Nam,Kelantan,9,6,3
1/11/2022,Viet Nam,Melaka,0,0,0
1/11/2022,Viet Nam,Negeri Sembilan,0,0,0
1/11/2022,Viet Nam,Pahang,2,2,0
1/11/2022,Viet Nam,Perak,110,9,101
1/11/2022,Viet Nam,Perlis,206,21,185
1/11/2022,Viet Nam,Pulau Pinang,1158,335,823
1/11/2022,Viet Nam,Sabah,15,6,9
1/11/2022,Viet Nam,Sarawak,135,19,116
1/11/2022,Viet Nam,Selangor,11063,3967,7096
1/11/2022,Viet Nam,Terengganu,0,0,0
1/11/2022,Viet Nam,W.P. Labuan,1,0,1
1/11/2022,Vanuatu,Johor,19,14,5
1/11/2022,Vanuatu,Kedah,0,0,0
1/11/2022,Vanuatu,Pulau Pinang,1,1,0
1/11/2022,Vanuatu,Sabah,1,1,0
1/11/2022,Vanuatu,Sarawak,0,0,0
1/11/2022,Vanuatu,Selangor,46,41,5
1/11/2022, Samoa,Johor,0,0,0
1/11/2022, Samoa,Sarawak,0,0,0
1/11/2022, Samoa,Selangor,8,6,2
1/11/2022,Yemen,Johor,34,25,9
1/11/2022,Yemen,Kedah,0,0,0
1/11/2022,Yemen,Kelantan,2,2,0
1/11/2022,Yemen,Melaka,0,0,0
1/11/2022,Yemen,Pahang,0,0,0
1/11/2022,Yemen,Perak,0,0,0
1/11/2022,Yemen,Perlis,0,0,0
1/11/2022,Yemen,Pulau Pinang,3,3,0
1/11/2022,Yemen,Sabah,0,0,0
1/11/2022,Yemen,Sarawak,2,2,0
1/11/2022,Yemen,Selangor,1254,866,388
1/11/2022,Yemen,W.P. Labuan,1,1,0
1/11/2022,South Africa,Johor,221,133,88
1/11/2022,South Africa,Kedah,25,13,12
1/11/2022,South Africa,Kelantan,0,0,0
1/11/2022,South Africa,Melaka,0,0,0
1/11/2022,South Africa,Pahang,0,0,0
1/11/2022,South Africa,Perak,2,1,1
1/11/2022,South Africa,Perlis,7,5,2
1/11/2022,South Africa,Pulau Pinang,47,35,12
1/11/2022,South Africa,Sabah,12,8,4
1/11/2022,South Africa,Sarawak,85,51,34
1/11/2022,South Africa,Selangor,689,420,269
1/11/2022,South Africa,Terengganu,0,0,0
1/11/2022,South Africa,W.P. Labuan,0,0,0
1/11/2022,ZAR,Selangor,0,0,0
1/11/2022,Zambia,Johor,1,1,0
1/11/2022,Zambia,Kedah,0,0,0
1/11/2022,Zambia,Perak,0,0,0
1/11/2022,Zambia,Perlis,0,0,0
1/11/2022,Zambia,Pulau Pinang,1,0,1
1/11/2022,Zambia,Sabah,0,0,0
1/11/2022,Zambia,Sarawak,0,0,0
1/11/2022,Zambia,Selangor,41,21,20
1/11/2022,Zimbabwe,Johor,4,1,3
1/11/2022,Zimbabwe,Kedah,0,0,0
1/11/2022,Zimbabwe,Kelantan,0,0,0
1/11/2022,Zimbabwe,Perak,0,0,0
1/11/2022,Zimbabwe,Perlis,0,0,0
1/11/2022,Zimbabwe,Pulau Pinang,1,0,1
1/11/2022,Zimbabwe,Sabah,1,0,1
1/11/2022,Zimbabwe,Sarawak,0,0,0
1/11/2022,Zimbabwe,Selangor,93,36,57
1/12/2022,Aruba,Kedah,0,0,0
1/12/2022,Aruba,Pulau Pinang,0,0,0
1/12/2022,Afghanistan,Johor,1,1,0
1/12/2022,Afghanistan,Kedah,0,0,0
1/12/2022,Afghanistan,Perlis,0,0,0
1/12/2022,Afghanistan,Pulau Pinang,0,0,0
1/12/2022,Afghanistan,Sarawak,1,1,0
1/12/2022,Afghanistan,Selangor,33,27,6
1/12/2022,Angola,Johor,1,1,0
1/12/2022,Angola,Kedah,0,0,0
1/12/2022,Angola,Sabah,1,1,0
1/12/2022,Angola,Selangor,1,1,0
1/12/2022,Anguilla,Selangor,0,0,0
1/12/2022,Albania,Johor,7,7,0
1/12/2022,Albania,Kedah,0,0,0
1/12/2022,Albania,Perak,0,0,0
1/12/2022,Albania,Perlis,0,0,0
1/12/2022,Albania,Pulau Pinang,4,3,1
1/12/2022,Albania,Sabah,0,0,0
1/12/2022,Albania,Sarawak,0,0,0
1/12/2022,Albania,Selangor,42,22,20
1/12/2022,Andorra,Johor,0,0,0
1/12/2022,Andorra,Kedah,0,0,0
1/12/2022,Andorra,Perlis,0,0,0
1/12/2022,Andorra,Pulau Pinang,0,0,0
1/12/2022,Andorra,Selangor,0,0,0
1/12/2022,Antigua and Barbuda,Selangor,0,0,0
1/12/2022,United Arab Emirates,Johor,55,29,26
1/12/2022,United Arab Emirates,Kedah,5,2,3
1/12/2022,United Arab Emirates,Kelantan,0,0,0
1/12/2022,United Arab Emirates,Perak,0,0,0
1/12/2022,United Arab Emirates,Perlis,0,0,0
1/12/2022,United Arab Emirates,Pulau Pinang,1,1,0
1/12/2022,United Arab Emirates,Sabah,0,0,0
1/12/2022,United Arab Emirates,Sarawak,0,0,0
1/12/2022,United Arab Emirates,Selangor,673,345,328
1/12/2022,Argentina,Johor,29,17,12
1/12/2022,Argentina,Kedah,32,16,16
1/12/2022,Argentina,Kelantan,1,1,0
1/12/2022,Argentina,Melaka,0,0,0
1/12/2022,Argentina,Perak,1,1,0
1/12/2022,Argentina,Perlis,5,2,3
1/12/2022,Argentina,Pulau Pinang,10,6,4
1/12/2022,Argentina,Sabah,0,0,0
1/12/2022,Argentina,Sarawak,4,2,2
1/12/2022,Argentina,Selangor,229,119,110
1/12/2022,Argentina,W.P. Labuan,0,0,0
1/12/2022,Armenia,Johor,11,6,5
1/12/2022,Armenia,Kedah,1,0,1
1/12/2022,Armenia,Kelantan,0,0,0
1/12/2022,Armenia,Perak,0,0,0
1/12/2022,Armenia,Perlis,0,0,0
1/12/2022,Armenia,Pulau Pinang,1,1,0
1/12/2022,Armenia,Sabah,3,1,2
1/12/2022,Armenia,Sarawak,0,0,0
1/12/2022,Armenia,Selangor,39,18,21
1/12/2022,Antarctica,Selangor,0,0,0
1/12/2022,Antigua and Barbuda,Johor,3,1,2
1/12/2022,Antigua and Barbuda,Kedah,0,0,0
1/12/2022,Antigua and Barbuda,Pulau Pinang,1,1,0
1/12/2022,Antigua and Barbuda,Sarawak,0,0,0
1/12/2022,Antigua and Barbuda,Selangor,12,5,7
1/12/2022,Australia,Johor,5212,2921,2291
1/12/2022,Australia,Kedah,538,302,236
1/12/2022,Australia,Kelantan,3,3,0
1/12/2022,Australia,Melaka,5,3,2
1/12/2022,Australia,Negeri Sembilan,0,0,0
1/12/2022,Australia,Pahang,21,9,12
1/12/2022,Australia,Perak,190,95,95
1/12/2022,Australia,Perlis,53,36,17
1/12/2022,Australia,Pulau Pinang,1929,1010,919
1/12/2022,Australia,Sabah,479,245,234
1/12/2022,Australia,Sarawak,706,391,315
1/12/2022,Australia,Selangor,30838,16944,13894
1/12/2022,Australia,Terengganu,0,0,0
1/12/2022,Australia,W.P. Labuan,28,14,14
1/12/2022,Austria,Johor,113,74,39
1/12/2022,Austria,Kedah,61,34,27
1/12/2022,Austria,Kelantan,0,0,0
1/12/2022,Austria,Melaka,0,0,0
1/12/2022,Austria,Negeri Sembilan,0,0,0
1/12/2022,Austria,Pahang,0,0,0
1/12/2022,Austria,Perak,3,2,1
1/12/2022,Austria,Perlis,12,7,5
1/12/2022,Austria,Pulau Pinang,67,43,24
1/12/2022,Austria,Sabah,6,3,3
1/12/2022,Austria,Sarawak,18,15,3
1/12/2022,Austria,Selangor,767,457,310
1/12/2022,Austria,Terengganu,0,0,0
1/12/2022,Austria,W.P. Labuan,0,0,0
1/12/2022,Azerbaijan,Johor,10,6,4
1/12/2022,Azerbaijan,Kedah,3,3,0
1/12/2022,Azerbaijan,Kelantan,0,0,0
1/12/2022,Azerbaijan,Melaka,0,0,0
1/12/2022,Azerbaijan,Perlis,0,0,0
1/12/2022,Azerbaijan,Pulau Pinang,1,0,1
1/12/2022,Azerbaijan,Sabah,1,0,1
1/12/2022,Azerbaijan,Sarawak,0,0,0
1/12/2022,Azerbaijan,Selangor,103,57,46
1/12/2022,Azerbaijan,W.P. Labuan,0,0,0
1/12/2022,Burundi,Pulau Pinang,0,0,0
1/12/2022,Burundi,Sarawak,0,0,0
1/12/2022,Burundi,Selangor,1,0,1
1/12/2022,Belgium,Johor,166,111,55
1/12/2022,Belgium,Kedah,60,35,25
1/12/2022,Belgium,Kelantan,1,1,0
1/12/2022,Belgium,Melaka,0,0,0
1/12/2022,Belgium,Negeri Sembilan,0,0,0
1/12/2022,Belgium,Pahang,0,0,0
1/12/2022,Belgium,Perak,0,0,0
1/12/2022,Belgium,Perlis,5,4,1
1/12/2022,Belgium,Pulau Pinang,50,30,20
1/12/2022,Belgium,Sabah,10,7,3
1/12/2022,Belgium,Sarawak,18,8,10
1/12/2022,Belgium,Selangor,612,408,204
1/12/2022,Belgium,W.P. Labuan,3,2,1
1/12/2022,Benin,Johor,0,0,0
1/12/2022,Benin,Kedah,0,0,0
1/12/2022,Benin,Perak,0,0,0
1/12/2022,Benin,Pulau Pinang,0,0,0
1/12/2022,Benin,Sabah,1,1,0
1/12/2022,Benin,Sarawak,0,0,0
1/12/2022,Benin,Selangor,10,6,4
1/12/2022,Burkina Faso,Perak,0,0,0
1/12/2022,Burkina Faso,Pulau Pinang,1,1,0
1/12/2022,Burkina Faso,Selangor,2,2,0
1/12/2022,Bangladesh,Johor,2184,1774,410
1/12/2022,Bangladesh,Kedah,45,29,16
1/12/2022,Bangladesh,Kelantan,2,2,0
1/12/2022,Bangladesh,Melaka,0,0,0
1/12/2022,Bangladesh,Negeri Sembilan,0,0,0
1/12/2022,Bangladesh,Pahang,0,0,0
1/12/2022,Bangladesh,Perak,0,0,0
1/12/2022,Bangladesh,Perlis,2,2,0
1/12/2022,Bangladesh,Pulau Pinang,317,306,11
1/12/2022,Bangladesh,Sabah,6,4,2
1/12/2022,Bangladesh,Sarawak,64,53,11
1/12/2022,Bangladesh,Selangor,37198,35338,1860
1/12/2022,Bangladesh,W.P. Labuan,2,2,0
1/12/2022,Bulgaria,Johor,46,31,15
1/12/2022,Bulgaria,Kedah,12,5,7
1/12/2022,Bulgaria,Kelantan,0,0,0
1/12/2022,Bulgaria,Pahang,2,2,0
1/12/2022,Bulgaria,Perak,0,0,0
1/12/2022,Bulgaria,Perlis,3,1,2
1/12/2022,Bulgaria,Pulau Pinang,4,3,1
1/12/2022,Bulgaria,Sabah,4,3,1
1/12/2022,Bulgaria,Sarawak,0,0,0
1/12/2022,Bulgaria,Selangor,201,105,96
1/12/2022,Bulgaria,W.P. Labuan,0,0,0
1/12/2022,Bahrain,Johor,14,7,7
1/12/2022,Bahrain,Kedah,0,0,0
1/12/2022,Bahrain,Kelantan,0,0,0
1/12/2022,Bahrain,Perlis,2,2,0
1/12/2022,Bahrain,Pulau Pinang,0,0,0
1/12/2022,Bahrain,Sabah,0,0,0
1/12/2022,Bahrain,Sarawak,1,1,0
1/12/2022,Bahrain,Selangor,102,57,45
1/12/2022,Bahamas,Johor,2,2,0
1/12/2022,Bahamas,Kedah,0,0,0
1/12/2022,Bahamas,Perak,0,0,0
1/12/2022,Bahamas,Sabah,0,0,0
1/12/2022,Bahamas,Sarawak,0,0,0
1/12/2022,Bahamas,Selangor,2,0,2
1/12/2022,Bosnia and Herzegovina,Johor,3,2,1
1/12/2022,Bosnia and Herzegovina,Kedah,0,0,0
1/12/2022,Bosnia and Herzegovina,Perlis,0,0,0
1/12/2022,Bosnia and Herzegovina,Pulau Pinang,2,1,1
1/12/2022,Bosnia and Herzegovina,Sabah,0,0,0
1/12/2022,Bosnia and Herzegovina,Sarawak,1,1,0
1/12/2022,Bosnia and Herzegovina,Selangor,35,24,11
1/12/2022,Belarus,Johor,17,8,9
1/12/2022,Belarus,Kedah,5,1,4
1/12/2022,Belarus,Kelantan,0,0,0
1/12/2022,Belarus,Pahang,0,0,0
1/12/2022,Belarus,Perak,0,0,0
1/12/2022,Belarus,Perlis,0,0,0
1/12/2022,Belarus,Pulau Pinang,10,5,5
1/12/2022,Belarus,Sabah,0,0,0
1/12/2022,Belarus,Sarawak,8,3,5
1/12/2022,Belarus,Selangor,245,121,124
1/12/2022,Belarus,W.P. Labuan,0,0,0
1/12/2022,Belize,Johor,5,1,4
1/12/2022,Belize,Pulau Pinang,0,0,0
1/12/2022,Belize,Sarawak,0,0,0
1/12/2022,Belize,Selangor,7,4,3
1/12/2022,Bermuda,Selangor,0,0,0
1/12/2022,Bolivia,Johor,1,1,0
1/12/2022,Bolivia,Kedah,0,0,0
1/12/2022,Bolivia,Melaka,0,0,0
1/12/2022,Bolivia,Perak,0,0,0
1/12/2022,Bolivia,Perlis,0,0,0
1/12/2022,Bolivia,Pulau Pinang,0,0,0
1/12/2022,Bolivia,Sabah,0,0,0
1/12/2022,Bolivia,Sarawak,0,0,0
1/12/2022,Bolivia,Selangor,20,15,5
1/12/2022,Brazil,Johor,147,85,62
1/12/2022,Brazil,Kedah,56,31,25
1/12/2022,Brazil,Kelantan,0,0,0
1/12/2022,Brazil,Melaka,0,0,0
1/12/2022,Brazil,Pahang,0,0,0
1/12/2022,Brazil,Perak,1,1,0
1/12/2022,Brazil,Perlis,13,8,5
1/12/2022,Brazil,Pulau Pinang,16,10,6
1/12/2022,Brazil,Sabah,9,5,4
1/12/2022,Brazil,Sarawak,6,4,2
1/12/2022,Brazil,Selangor,669,377,292
1/12/2022,Brazil,W.P. Labuan,0,0,0
1/12/2022,Barbados,Johor,0,0,0
1/12/2022,Barbados,Kedah,0,0,0
1/12/2022,Barbados,Perlis,0,0,0
1/12/2022,Barbados,Pulau Pinang,0,0,0
1/12/2022,Barbados,Selangor,7,4,3
1/12/2022,Brunei Darussalam,Johor,1033,497,536
1/12/2022,Brunei Darussalam,Kedah,45,21,24
1/12/2022,Brunei Darussalam,Kelantan,13,13,0
1/12/2022,Brunei Darussalam,Melaka,0,0,0
1/12/2022,Brunei Darussalam,Pahang,0,0,0
1/12/2022,Brunei Darussalam,Perak,9,2,7
1/12/2022,Brunei Darussalam,Perlis,57,30,27
1/12/2022,Brunei Darussalam,Pulau Pinang,11,7,4
1/12/2022,Brunei Darussalam,Sabah,1587,706,881
1/12/2022,Brunei Darussalam,Sarawak,137530,71458,66072
1/12/2022,Brunei Darussalam,Selangor,7873,3867,4006
1/12/2022,Brunei Darussalam,W.P. Labuan,1769,1033,736
1/12/2022,Bhutan,Johor,4,3,1
1/12/2022,Bhutan,Kedah,1,0,1
1/12/2022,Bhutan,Perak,0,0,0
1/12/2022,Bhutan,Perlis,0,0,0
1/12/2022,Bhutan,Pulau Pinang,17,8,9
1/12/2022,Bhutan,Sabah,0,0,0
1/12/2022,Bhutan,Sarawak,0,0,0
1/12/2022,Bhutan,Selangor,36,17,19
1/12/2022,Botswana,Johor,1,1,0
1/12/2022,Botswana,Kedah,1,1,0
1/12/2022,Botswana,Perlis,0,0,0
1/12/2022,Botswana,Pulau Pinang,2,2,0
1/12/2022,Botswana,Sabah,1,1,0
1/12/2022,Botswana,Sarawak,0,0,0
1/12/2022,Botswana,Selangor,15,5,10
1/12/2022,Central African Republic,Kedah,0,0,0
1/12/2022,Central African Republic,Selangor,0,0,0
1/12/2022,Canada,Johor,1219,728,491
1/12/2022,Canada,Kedah,142,84,58
1/12/2022,Canada,Kelantan,4,2,2
1/12/2022,Canada,Melaka,2,2,0
1/12/2022,Canada,Negeri Sembilan,0,0,0
1/12/2022,Canada,Pahang,3,2,1
1/12/2022,Canada,Perak,25,18,7
1/12/2022,Canada,Perlis,31,22,9
1/12/2022,Canada,Pulau Pinang,407,217,190
1/12/2022,Canada,Sabah,111,66,45
1/12/2022,Canada,Sarawak,303,148,155
1/12/2022,Canada,Selangor,3657,2089,1568
1/12/2022,Canada,Terengganu,0,0,0
1/12/2022,Canada,W.P. Labuan,4,3,1
1/12/2022,Cocos (Keeling) Islands,Selangor,1,1,0
1/12/2022,Switzerland,Johor,256,152,104
1/12/2022,Switzerland,Kedah,112,67,45
1/12/2022,Switzerland,Kelantan,2,1,1
1/12/2022,Switzerland,Melaka,2,1,1
1/12/2022,Switzerland,Negeri Sembilan,0,0,0
1/12/2022,Switzerland,Pahang,0,0,0
1/12/2022,Switzerland,Perak,1,1,0
1/12/2022,Switzerland,Perlis,22,15,7
1/12/2022,Switzerland,Pulau Pinang,55,35,20
1/12/2022,Switzerland,Sabah,29,16,13
1/12/2022,Switzerland,Sarawak,27,12,15
1/12/2022,Switzerland,Selangor,1086,673,413
1/12/2022,Switzerland,W.P. Labuan,1,1,0
1/12/2022,Chile,Johor,20,9,11
1/12/2022,Chile,Kedah,11,4,7
1/12/2022,Chile,Kelantan,0,0,0
1/12/2022,Chile,Melaka,0,0,0
1/12/2022,Chile,Pahang,0,0,0
1/12/2022,Chile,Perak,0,0,0
1/12/2022,Chile,Perlis,3,2,1
1/12/2022,Chile,Pulau Pinang,5,0,5
1/12/2022,Chile,Sabah,0,0,0
1/12/2022,Chile,Sarawak,0,0,0
1/12/2022,Chile,Selangor,113,67,46
1/12/2022,China,Johor,26433,10442,15991
1/12/2022,China,Kedah,607,236,371
1/12/2022,China,Kelantan,5,4,1
1/12/2022,China,Melaka,2,0,2
1/12/2022,China,Pahang,20,10,10
1/12/2022,China,Perak,206,86,120
1/12/2022,China,Perlis,59,19,40
1/12/2022,China,Pulau Pinang,2723,1364,1359
1/12/2022,China,Sabah,590,264,326
1/12/2022,China,Sarawak,653,272,381
1/12/2022,China,Selangor,22674,12268,10406
1/12/2022,China,Terengganu,0,0,0
1/12/2022,China,W.P. Labuan,26,22,4
1/12/2022,Côte d'Ivoire,Johor,0,0,0
1/12/2022,Côte d'Ivoire,Kedah,0,0,0
1/12/2022,Côte d'Ivoire,Pulau Pinang,0,0,0
1/12/2022,Côte d'Ivoire,Sabah,0,0,0
1/12/2022,Côte d'Ivoire,Sarawak,0,0,0
1/12/2022,Côte d'Ivoire,Selangor,11,9,2
1/12/2022,Cameroon,Johor,6,6,0
1/12/2022,Cameroon,Kedah,0,0,0
1/12/2022,Cameroon,Pulau Pinang,0,0,0
1/12/2022,Cameroon,Sabah,0,0,0
1/12/2022,Cameroon,Sarawak,0,0,0
1/12/2022,Cameroon,Selangor,10,8,2
1/12/2022,Congo,Johor,0,0,0
1/12/2022,Congo,Pulau Pinang,0,0,0
1/12/2022,Congo,Sarawak,0,0,0
1/12/2022,Congo,Selangor,4,3,1
1/12/2022,Congo,Johor,0,0,0
1/12/2022,Congo,Kedah,0,0,0
1/12/2022,Congo,Selangor,5,5,0
1/12/2022,Cook Islands,Selangor,0,0,0
1/12/2022,Colombia,Johor,26,12,14
1/12/2022,Colombia,Kedah,4,1,3
1/12/2022,Colombia,Perak,0,0,0
1/12/2022,Colombia,Pulau Pinang,1,0,1
1/12/2022,Colombia,Sabah,1,0,1
1/12/2022,Colombia,Sarawak,0,0,0
1/12/2022,Colombia,Selangor,120,65,55
1/12/2022,Colombia,W.P. Labuan,0,0,0
1/12/2022,Comoros,Johor,1,0,1
1/12/2022,Comoros,Kedah,0,0,0
1/12/2022,Comoros,Selangor,17,11,6
1/12/2022,Cabo Verde,Johor,0,0,0
1/12/2022,Cabo Verde,Kedah,0,0,0
1/12/2022,Cabo Verde,Pulau Pinang,0,0,0
1/12/2022,Cabo Verde,Sabah,0,0,0
1/12/2022,Cabo Verde,Selangor,1,0,1
1/12/2022,Costa Rica,Johor,6,3,3
1/12/2022,Costa Rica,Kedah,1,0,1
1/12/2022,Costa Rica,Perak,0,0,0
1/12/2022,Costa Rica,Perlis,0,0,0
1/12/2022,Costa Rica,Pulau Pinang,3,0,3
1/12/2022,Costa Rica,Sabah,0,0,0
1/12/2022,Costa Rica,Sarawak,0,0,0
1/12/2022,Costa Rica,Selangor,33,19,14
1/12/2022,Cuba,Johor,14,12,2
1/12/2022,Cuba,Kedah,2,1,1
1/12/2022,Cuba,Perlis,0,0,0
1/12/2022,Cuba,Pulau Pinang,1,0,1
1/12/2022,Cuba,Sabah,0,0,0
1/12/2022,Cuba,Sarawak,0,0,0
1/12/2022,Cuba,Selangor,38,23,15
1/12/2022,Cyprus,Johor,9,5,4
1/12/2022,Cyprus,Kedah,0,0,0
1/12/2022,Cyprus,Perak,0,0,0
1/12/2022,Cyprus,Perlis,0,0,0
1/12/2022,Cyprus,Pulau Pinang,1,1,0
1/12/2022,Cyprus,Sabah,0,0,0
1/12/2022,Cyprus,Sarawak,0,0,0
1/12/2022,Cyprus,Selangor,70,40,30
1/12/2022,Czechia,Johor,60,36,24
1/12/2022,Czechia,Kedah,62,33,29
1/12/2022,Czechia,Kelantan,1,1,0
1/12/2022,Czechia,Melaka,0,0,0
1/12/2022,Czechia,Negeri Sembilan,0,0,0
1/12/2022,Czechia,Perak,1,0,1
1/12/2022,Czechia,Perlis,15,9,6
1/12/2022,Czechia,Pulau Pinang,17,7,10
1/12/2022,Czechia,Sabah,5,3,2
1/12/2022,Czechia,Sarawak,7,3,4
1/12/2022,Czechia,Selangor,401,238,163
1/12/2022,Czechia,W.P. Labuan,1,0,1
1/12/2022,Germany,Johor,1413,930,483
1/12/2022,Germany,Kedah,540,302,238
1/12/2022,Germany,Kelantan,6,4,2
1/12/2022,Germany,Melaka,2,1,1
1/12/2022,Germany,Negeri Sembilan,0,0,0
1/12/2022,Germany,Pahang,0,0,0
1/12/2022,Germany,Perak,23,17,6
1/12/2022,Germany,Perlis,102,68,34
1/12/2022,Germany,Pulau Pinang,424,301,123
1/12/2022,Germany,Sabah,96,61,35
1/12/2022,Germany,Sarawak,180,119,61
1/12/2022,Germany,Selangor,8908,5055,3853
1/12/2022,Germany,Terengganu,0,0,0
1/12/2022,Germany,W.P. Labuan,5,4,1
1/12/2022,Djibouti,Johor,0,0,0
1/12/2022,Djibouti,Selangor,25,12,13
1/12/2022,Dominica,Johor,9,8,1
1/12/2022,Dominica,Kedah,0,0,0
1/12/2022,Dominica,Pulau Pinang,1,0,1
1/12/2022,Dominica,Sabah,0,0,0
1/12/2022,Dominica,Sarawak,2,1,1
1/12/2022,Dominica,Selangor,12,11,1
1/12/2022,Dominica,W.P. Labuan,0,0,0
1/12/2022,Denmark,Johor,225,156,69
1/12/2022,Denmark,Kedah,96,52,44
1/12/2022,Denmark,Kelantan,0,0,0
1/12/2022,Denmark,Melaka,0,0,0
1/12/2022,Denmark,Negeri Sembilan,0,0,0
1/12/2022,Denmark,Pahang,0,0,0
1/12/2022,Denmark,Perak,3,2,1
1/12/2022,Denmark,Perlis,8,7,1
1/12/2022,Denmark,Pulau Pinang,49,30,19
1/12/2022,Denmark,Sabah,29,18,11
1/12/2022,Denmark,Sarawak,10,7,3
1/12/2022,Denmark,Selangor,666,385,281
1/12/2022,Denmark,W.P. Labuan,0,0,0
1/12/2022,Dominican Republic,Johor,2,1,1
1/12/2022,Dominican Republic,Kedah,0,0,0
1/12/2022,Dominican Republic,Perak,0,0,0
1/12/2022,Dominican Republic,Perlis,0,0,0
1/12/2022,Dominican Republic,Pulau Pinang,0,0,0
1/12/2022,Dominican Republic,Sabah,0,0,0
1/12/2022,Dominican Republic,Sarawak,0,0,0
1/12/2022,Dominican Republic,Selangor,12,5,7
1/12/2022,Algeria,Johor,45,36,9
1/12/2022,Algeria,Kedah,3,3,0
1/12/2022,Algeria,Kelantan,2,2,0
1/12/2022,Algeria,Melaka,0,0,0
1/12/2022,Algeria,Perak,0,0,0
1/12/2022,Algeria,Perlis,3,2,1
1/12/2022,Algeria,Pulau Pinang,0,0,0
1/12/2022,Algeria,Sabah,6,4,2
1/12/2022,Algeria,Sarawak,1,1,0
1/12/2022,Algeria,Selangor,262,171,91
1/12/2022,Algeria,W.P. Labuan,0,0,0
1/12/2022,Ecuador,Johor,6,3,3
1/12/2022,Ecuador,Kedah,1,0,1
1/12/2022,Ecuador,Perak,0,0,0
1/12/2022,Ecuador,Perlis,0,0,0
1/12/2022,Ecuador,Pulau Pinang,1,1,0
1/12/2022,Ecuador,Sabah,0,0,0
1/12/2022,Ecuador,Sarawak,0,0,0
1/12/2022,Ecuador,Selangor,43,18,25
1/12/2022,Egypt,Johor,223,164,59
1/12/2022,Egypt,Kedah,1,0,1
1/12/2022,Egypt,Kelantan,0,0,0
1/12/2022,Egypt,Melaka,0,0,0
1/12/2022,Egypt,Pahang,0,0,0
1/12/2022,Egypt,Perak,0,0,0
1/12/2022,Egypt,Perlis,2,2,0
1/12/2022,Egypt,Pulau Pinang,7,6,1
1/12/2022,Egypt,Sabah,5,2,3
1/12/2022,Egypt,Sarawak,189,126,63
1/12/2022,Egypt,Selangor,1207,730,477
1/12/2022,Egypt,Terengganu,0,0,0
1/12/2022,Egypt,W.P. Labuan,0,0,0
1/12/2022,Eritrea,Johor,1,0,1
1/12/2022,Eritrea,Pulau Pinang,0,0,0
1/12/2022,Eritrea,Sabah,0,0,0
1/12/2022,Eritrea,Selangor,12,6,6
1/12/2022,Spain,Johor,254,150,104
1/12/2022,Spain,Kedah,156,86,70
1/12/2022,Spain,Kelantan,2,1,1
1/12/2022,Spain,Melaka,0,0,0
1/12/2022,Spain,Negeri Sembilan,0,0,0
1/12/2022,Spain,Pahang,0,0,0
1/12/2022,Spain,Perak,1,1,0
1/12/2022,Spain,Perlis,16,8,8
1/12/2022,Spain,Pulau Pinang,60,35,25
1/12/2022,Spain,Sabah,19,16,3
1/12/2022,Spain,Sarawak,27,19,8
1/12/2022,Spain,Selangor,1458,830,628
1/12/2022,Spain,W.P. Labuan,0,0,0
1/12/2022,Estonia,Johor,22,12,10
1/12/2022,Estonia,Kedah,43,16,27
1/12/2022,Estonia,Kelantan,0,0,0
1/12/2022,Estonia,Pahang,0,0,0
1/12/2022,Estonia,Perak,1,0,1
1/12/2022,Estonia,Perlis,4,4,0
1/12/2022,Estonia,Pulau Pinang,4,0,4
1/12/2022,Estonia,Sabah,3,1,2
1/12/2022,Estonia,Sarawak,0,0,0
1/12/2022,Estonia,Selangor,228,100,128
1/12/2022,Estonia,W.P. Labuan,0,0,0
1/12/2022,Ethiopia,Johor,1,0,1
1/12/2022,Ethiopia,Kedah,0,0,0
1/12/2022,Ethiopia,Pulau Pinang,1,1,0
1/12/2022,Ethiopia,Sarawak,0,0,0
1/12/2022,Ethiopia,Selangor,18,12,6
1/12/2022,Finland,Johor,167,108,59
1/12/2022,Finland,Kedah,73,38,35
1/12/2022,Finland,Kelantan,0,0,0
1/12/2022,Finland,Melaka,0,0,0
1/12/2022,Finland,Negeri Sembilan,0,0,0
1/12/2022,Finland,Pahang,0,0,0
1/12/2022,Finland,Perak,2,1,1
1/12/2022,Finland,Perlis,3,2,1
1/12/2022,Finland,Pulau Pinang,32,19,13
1/12/2022,Finland,Sabah,13,10,3
1/12/2022,Finland,Sarawak,15,5,10
1/12/2022,Finland,Selangor,576,311,265
1/12/2022,Finland,W.P. Labuan,0,0,0
1/12/2022,Fiji,Johor,41,21,20
1/12/2022,Fiji,Kedah,2,2,0
1/12/2022,Fiji,Kelantan,0,0,0
1/12/2022,Fiji,Perak,0,0,0
1/12/2022,Fiji,Perlis,0,0,0
1/12/2022,Fiji,Pulau Pinang,1,0,1
1/12/2022,Fiji,Sabah,2,2,0
1/12/2022,Fiji,Sarawak,6,5,1
1/12/2022,Fiji,Selangor,115,63,52
1/12/2022,France,Johor,1417,914,503
1/12/2022,France,Kedah,492,270,222
1/12/2022,France,Kelantan,9,6,3
1/12/2022,France,Melaka,2,1,1
1/12/2022,France,Negeri Sembilan,1,0,1
1/12/2022,France,Pahang,11,3,8
1/12/2022,France,Perak,24,17,7
1/12/2022,France,Perlis,58,38,20
1/12/2022,France,Pulau Pinang,297,193,104
1/12/2022,France,Sabah,94,54,40
1/12/2022,France,Sarawak,66,55,11
1/12/2022,France,Selangor,4793,2871,1922
1/12/2022,France,Terengganu,0,0,0
1/12/2022,France,W.P. Labuan,3,1,2
1/12/2022,"Micronesia, Federated States of",Johor,0,0,0
1/12/2022,"Micronesia, Federated States of",Pulau Pinang,0,0,0
1/12/2022,"Micronesia, Federated States of",Selangor,0,0,0
1/12/2022,Gabon,Johor,0,0,0
1/12/2022,Gabon,Pulau Pinang,0,0,0
1/12/2022,Gabon,Sarawak,0,0,0
1/12/2022,Gabon,Selangor,6,0,6
1/12/2022,United Kingdom of Great Britain and Northern Ireland,Johor,3852,2420,1432
1/12/2022,United Kingdom of Great Britain and Northern Ireland,Kedah,1113,628,485
1/12/2022,United Kingdom of Great Britain and Northern Ireland,Kelantan,8,6,2
1/12/2022,United Kingdom of Great Britain and Northern Ireland,Melaka,2,1,1
1/12/2022,United Kingdom of Great Britain and Northern Ireland,Negeri Sembilan,0,0,0
1/12/2022,United Kingdom of Great Britain and Northern Ireland,Pahang,11,6,5
1/12/2022,United Kingdom of Great Britain and Northern Ireland,Perak,99,62,37
1/12/2022,United Kingdom of Great Britain and Northern Ireland,Perlis,108,67,41
1/12/2022,United Kingdom of Great Britain and Northern Ireland,Pulau Pinang,1292,739,553
1/12/2022,United Kingdom of Great Britain and Northern Ireland,Sabah,383,223,160
1/12/2022,United Kingdom of Great Britain and Northern Ireland,Sarawak,1526,900,626
1/12/2022,United Kingdom of Great Britain and Northern Ireland,Selangor,13980,8282,5698
1/12/2022,United Kingdom of Great Britain and Northern Ireland,Terengganu,0,0,0
1/12/2022,United Kingdom of Great Britain and Northern Ireland,W.P. Labuan,29,13,16
1/12/2022,Georgia,Johor,6,5,1
1/12/2022,Georgia,Kedah,0,0,0
1/12/2022,Georgia,Melaka,0,0,0
1/12/2022,Georgia,Perak,0,0,0
1/12/2022,Georgia,Perlis,2,2,0
1/12/2022,Georgia,Pulau Pinang,1,0,1
1/12/2022,Georgia,Sabah,0,0,0
1/12/2022,Georgia,Sarawak,0,0,0
1/12/2022,Georgia,Selangor,48,26,22
1/12/2022,Ghana,Johor,7,3,4
1/12/2022,Ghana,Kedah,0,0,0
1/12/2022,Ghana,Kelantan,0,0,0
1/12/2022,Ghana,Pulau Pinang,1,0,1
1/12/2022,Ghana,Sabah,0,0,0
1/12/2022,Ghana,Sarawak,1,1,0
1/12/2022,Ghana,Selangor,64,41,23
1/12/2022,Gibraltar,Johor,0,0,0
1/12/2022,Gibraltar,Sarawak,0,0,0
1/12/2022,Guinea,Johor,4,2,2
1/12/2022,Guinea,Kedah,0,0,0
1/12/2022,Guinea,Kelantan,1,1,0
1/12/2022,Guinea,Perlis,0,0,0
1/12/2022,Guinea,Pulau Pinang,0,0,0
1/12/2022,Guinea,Sabah,0,0,0
1/12/2022,Guinea,Sarawak,0,0,0
1/12/2022,Guinea,Selangor,36,24,12
1/12/2022,Guadeloupe,Selangor,0,0,0
1/12/2022,Gambia,Johor,0,0,0
1/12/2022,Gambia,Kedah,0,0,0
1/12/2022,Gambia,Kelantan,0,0,0
1/12/2022,Gambia,Pulau Pinang,0,0,0
1/12/2022,Gambia,Sabah,0,0,0
1/12/2022,Gambia,Sarawak,0,0,0
1/12/2022,Gambia,Selangor,16,10,6
1/12/2022,Guinea-Bissau,Johor,0,0,0
1/12/2022,Guinea-Bissau,Selangor,0,0,0
1/12/2022,Equatorial Guinea,Johor,0,0,0
1/12/2022,Equatorial Guinea,Selangor,0,0,0
1/12/2022,Greece,Johor,39,26,13
1/12/2022,Greece,Kedah,20,11,9
1/12/2022,Greece,Kelantan,0,0,0
1/12/2022,Greece,Melaka,0,0,0
1/12/2022,Greece,Negeri Sembilan,0,0,0
1/12/2022,Greece,Pahang,0,0,0
1/12/2022,Greece,Perak,0,0,0
1/12/2022,Greece,Perlis,4,3,1
1/12/2022,Greece,Pulau Pinang,5,4,1
1/12/2022,Greece,Sabah,2,2,0
1/12/2022,Greece,Sarawak,1,1,0
1/12/2022,Greece,Selangor,159,106,53
1/12/2022,Grenada,Johor,9,7,2
1/12/2022,Grenada,Kedah,1,1,0
1/12/2022,Grenada,Pulau Pinang,1,1,0
1/12/2022,Grenada,Sabah,0,0,0
1/12/2022,Grenada,Sarawak,1,0,1
1/12/2022,Grenada,Selangor,3,3,0
1/12/2022,Greenland,Johor,0,0,0
1/12/2022,Greenland,Selangor,0,0,0
1/12/2022,Guatemala,Johor,1,1,0
1/12/2022,Guatemala,Kedah,0,0,0
1/12/2022,Guatemala,Pahang,0,0,0
1/12/2022,Guatemala,Perak,0,0,0
1/12/2022,Guatemala,Pulau Pinang,1,1,0
1/12/2022,Guatemala,Sabah,0,0,0
1/12/2022,Guatemala,Sarawak,0,0,0
1/12/2022,Guatemala,Selangor,14,8,6
1/12/2022,Guatemala,W.P. Labuan,0,0,0
1/12/2022,Guyana,Johor,0,0,0
1/12/2022,Guyana,Kedah,0,0,0
1/12/2022,Guyana,Pulau Pinang,0,0,0
1/12/2022,Guyana,Sarawak,0,0,0
1/12/2022,Guyana,Selangor,6,4,2
1/12/2022,Hong Kong,Johor,5,3,2
1/12/2022,Hong Kong,Kedah,3,3,0
1/12/2022,Hong Kong,Kelantan,0,0,0
1/12/2022,Hong Kong,Pahang,9,6,3
1/12/2022,Hong Kong,Perak,45,22,23
1/12/2022,Hong Kong,Perlis,3,1,2
1/12/2022,Hong Kong,Pulau Pinang,0,0,0
1/12/2022,Hong Kong,Sabah,4,2,2
1/12/2022,Hong Kong,Sarawak,2,1,1
1/12/2022,Hong Kong,Selangor,53,30,23
1/12/2022,Hong Kong,Terengganu,0,0,0
1/12/2022,Heard Island and McDonald Islands,Johor,0,0,0
1/12/2022,Honduras,Johor,4,3,1
1/12/2022,Honduras,Kedah,0,0,0
1/12/2022,Honduras,Perak,0,0,0
1/12/2022,Honduras,Pulau Pinang,1,1,0
1/12/2022,Honduras,Sabah,0,0,0
1/12/2022,Honduras,Sarawak,0,0,0
1/12/2022,Honduras,Selangor,8,2,6
1/12/2022,Croatia,Johor,36,32,4
1/12/2022,Croatia,Kedah,4,1,3
1/12/2022,Croatia,Kelantan,0,0,0
1/12/2022,Croatia,Melaka,0,0,0
1/12/2022,Croatia,Pahang,0,0,0
1/12/2022,Croatia,Perak,0,0,0
1/12/2022,Croatia,Perlis,0,0,0
1/12/2022,Croatia,Pulau Pinang,3,2,1
1/12/2022,Croatia,Sabah,0,0,0
1/12/2022,Croatia,Sarawak,2,1,1
1/12/2022,Croatia,Selangor,133,77,56
1/12/2022,Haiti,Johor,0,0,0
1/12/2022,Haiti,Kedah,0,0,0
1/12/2022,Haiti,Kelantan,0,0,0
1/12/2022,Haiti,Perak,0,0,0
1/12/2022,Haiti,Pulau Pinang,0,0,0
1/12/2022,Haiti,Sabah,0,0,0
1/12/2022,Haiti,Selangor,4,3,1
1/12/2022,Hungary,Johor,108,66,42
1/12/2022,Hungary,Kedah,42,19,23
1/12/2022,Hungary,Kelantan,1,1,0
1/12/2022,Hungary,Pahang,3,2,1
1/12/2022,Hungary,Perak,0,0,0
1/12/2022,Hungary,Perlis,6,4,2
1/12/2022,Hungary,Pulau Pinang,42,19,23
1/12/2022,Hungary,Sabah,59,29,30
1/12/2022,Hungary,Sarawak,6,5,1
1/12/2022,Hungary,Selangor,427,213,214
1/12/2022,Hungary,W.P. Labuan,0,0,0
1/12/2022,Indonesia,Johor,109403,54653,54750
1/12/2022,Indonesia,Kedah,3686,1512,2174
1/12/2022,Indonesia,Kelantan,101,69,32
1/12/2022,Indonesia,Melaka,7953,3512,4441
1/12/2022,Indonesia,Negeri Sembilan,7001,4507,2494
1/12/2022,Indonesia,Pahang,14,3,11
1/12/2022,Indonesia,Perak,186,57,129
1/12/2022,Indonesia,Perlis,435,161,274
1/12/2022,Indonesia,Pulau Pinang,27822,11043,16779
1/12/2022,Indonesia,Sabah,5497,2483,3014
1/12/2022,Indonesia,Sarawak,39388,18824,20564
1/12/2022,Indonesia,Selangor,95045,45009,50036
1/12/2022,Indonesia,Terengganu,0,0,0
1/12/2022,Indonesia,W.P. Labuan,82,46,36
1/12/2022,India,Johor,17995,11880,6115
1/12/2022,India,Kedah,459,249,210
1/12/2022,India,Kelantan,3,3,0
1/12/2022,India,Melaka,3,2,1
1/12/2022,India,Negeri Sembilan,0,0,0
1/12/2022,India,Pahang,9,5,4
1/12/2022,India,Perak,214,159,55
1/12/2022,India,Perlis,42,35,7
1/12/2022,India,Pulau Pinang,633,414,219
1/12/2022,India,Sabah,199,131,68
1/12/2022,India,Sarawak,1235,954,281
1/12/2022,India,Selangor,41083,27944,13139
1/12/2022,India,Terengganu,0,0,0
1/12/2022,India,W.P. Labuan,72,58,14
1/12/2022, British Indian Ocean Territory,Pulau Pinang,0,0,0
1/12/2022, British Indian Ocean Territory,Selangor,0,0,0
1/12/2022,Ireland,Johor,206,130,76
1/12/2022,Ireland,Kedah,86,45,41
1/12/2022,Ireland,Kelantan,0,0,0
1/12/2022,Ireland,Negeri Sembilan,0,0,0
1/12/2022,Ireland,Pahang,1,0,1
1/12/2022,Ireland,Perak,3,1,2
1/12/2022,Ireland,Perlis,7,5,2
1/12/2022,Ireland,Pulau Pinang,55,35,20
1/12/2022,Ireland,Sabah,21,13,8
1/12/2022,Ireland,Sarawak,31,20,11
1/12/2022,Ireland,Selangor,920,542,378
1/12/2022,Ireland,Terengganu,0,0,0
1/12/2022,Ireland,W.P. Labuan,0,0,0
1/12/2022,"Iran, Islamic Republic of",Johor,62,46,16
1/12/2022,"Iran, Islamic Republic of",Kedah,6,4,2
1/12/2022,"Iran, Islamic Republic of",Kelantan,0,0,0
1/12/2022,"Iran, Islamic Republic of",Perak,0,0,0
1/12/2022,"Iran, Islamic Republic of",Perlis,0,0,0
1/12/2022,"Iran, Islamic Republic of",Pulau Pinang,13,8,5
1/12/2022,"Iran, Islamic Republic of",Sabah,5,4,1
1/12/2022,"Iran, Islamic Republic of",Sarawak,5,3,2
1/12/2022,"Iran, Islamic Republic of",Selangor,854,474,380
1/12/2022,"Iran, Islamic Republic of",W.P. Labuan,0,0,0
1/12/2022,Iraq,Johor,15,9,6
1/12/2022,Iraq,Kedah,3,1,2
1/12/2022,Iraq,Kelantan,0,0,0
1/12/2022,Iraq,Melaka,0,0,0
1/12/2022,Iraq,Pahang,0,0,0
1/12/2022,Iraq,Perak,0,0,0
1/12/2022,Iraq,Perlis,0,0,0
1/12/2022,Iraq,Pulau Pinang,3,3,0
1/12/2022,Iraq,Sabah,0,0,0
1/12/2022,Iraq,Sarawak,0,0,0
1/12/2022,Iraq,Selangor,728,502,226
1/12/2022,Iceland,Johor,12,8,4
1/12/2022,Iceland,Kedah,1,1,0
1/12/2022,Iceland,Kelantan,0,0,0
1/12/2022,Iceland,Perak,0,0,0
1/12/2022,Iceland,Perlis,0,0,0
1/12/2022,Iceland,Pulau Pinang,2,1,1
1/12/2022,Iceland,Sabah,12,7,5
1/12/2022,Iceland,Sarawak,0,0,0
1/12/2022,Iceland,Selangor,7,3,4
1/12/2022,Iceland,W.P. Labuan,0,0,0
1/12/2022,Israel,Pulau Pinang,0,0,0
1/12/2022,Italy,Johor,352,260,92
1/12/2022,Italy,Kedah,170,105,65
1/12/2022,Italy,Kelantan,0,0,0
1/12/2022,Italy,Melaka,0,0,0
1/12/2022,Italy,Negeri Sembilan,0,0,0
1/12/2022,Italy,Pahang,3,2,1
1/12/2022,Italy,Perak,12,10,2
1/12/2022,Italy,Perlis,23,12,11
1/12/2022,Italy,Pulau Pinang,83,55,28
1/12/2022,Italy,Sabah,24,16,8
1/12/2022,Italy,Sarawak,39,28,11
1/12/2022,Italy,Selangor,1657,1051,606
1/12/2022,Italy,W.P. Labuan,2,1,1
1/12/2022,Jamaica,Johor,1,0,1
1/12/2022,Jamaica,Kedah,2,0,2
1/12/2022,Jamaica,Perak,0,0,0
1/12/2022,Jamaica,Pulau Pinang,0,0,0
1/12/2022,Jamaica,Sabah,6,4,2
1/12/2022,Jamaica,Sarawak,0,0,0
1/12/2022,Jamaica,Selangor,14,11,3
1/12/2022,Jamaica,W.P. Labuan,0,0,0
1/12/2022,Jordan,Johor,23,10,13
1/12/2022,Jordan,Kedah,2,2,0
1/12/2022,Jordan,Kelantan,0,0,0
1/12/2022,Jordan,Melaka,0,0,0
1/12/2022,Jordan,Perlis,0,0,0
1/12/2022,Jordan,Pulau Pinang,2,2,0
1/12/2022,Jordan,Sabah,0,0,0
1/12/2022,Jordan,Sarawak,0,0,0
1/12/2022,Jordan,Selangor,496,300,196
1/12/2022,Jordan,W.P. Labuan,0,0,0
1/12/2022,Japan,Johor,4606,3182,1424
1/12/2022,Japan,Kedah,380,199,181
1/12/2022,Japan,Kelantan,2,2,0
1/12/2022,Japan,Melaka,1,1,0
1/12/2022,Japan,Negeri Sembilan,0,0,0
1/12/2022,Japan,Pahang,10,5,5
1/12/2022,Japan,Perak,52,30,22
1/12/2022,Japan,Perlis,54,39,15
1/12/2022,Japan,Pulau Pinang,1076,711,365
1/12/2022,Japan,Sabah,449,239,210
1/12/2022,Japan,Sarawak,178,94,84
1/12/2022,Japan,Selangor,12123,7561,4562
1/12/2022,Japan,W.P. Labuan,7,5,2
1/12/2022,Kazakhstan,Johor,44,16,28
1/12/2022,Kazakhstan,Kedah,11,7,4
1/12/2022,Kazakhstan,Kelantan,1,0,1
1/12/2022,Kazakhstan,Melaka,0,0,0
1/12/2022,Kazakhstan,Perak,0,0,0
1/12/2022,Kazakhstan,Perlis,17,8,9
1/12/2022,Kazakhstan,Pulau Pinang,14,7,7
1/12/2022,Kazakhstan,Sabah,2,1,1
1/12/2022,Kazakhstan,Sarawak,7,0,7
1/12/2022,Kazakhstan,Selangor,460,188,272
1/12/2022,Kazakhstan,W.P. Labuan,0,0,0
1/12/2022,Kenya,Johor,68,33,35
1/12/2022,Kenya,Kedah,8,4,4
1/12/2022,Kenya,Kelantan,0,0,0
1/12/2022,Kenya,Perak,0,0,0
1/12/2022,Kenya,Perlis,0,0,0
1/12/2022,Kenya,Pulau Pinang,2,1,1
1/12/2022,Kenya,Sabah,4,2,2
1/12/2022,Kenya,Sarawak,2,0,2
1/12/2022,Kenya,Selangor,363,187,176
1/12/2022,Kyrgyzstan,Johor,21,7,14
1/12/2022,Kyrgyzstan,Kedah,1,1,0
1/12/2022,Kyrgyzstan,Kelantan,0,0,0
1/12/2022,Kyrgyzstan,Perak,0,0,0
1/12/2022,Kyrgyzstan,Perlis,0,0,0
1/12/2022,Kyrgyzstan,Pulau Pinang,1,1,0
1/12/2022,Kyrgyzstan,Sabah,0,0,0
1/12/2022,Kyrgyzstan,Sarawak,0,0,0
1/12/2022,Kyrgyzstan,Selangor,156,68,88
1/12/2022,Cambodia,Johor,2035,824,1211
1/12/2022,Cambodia,Kedah,179,134,45
1/12/2022,Cambodia,Kelantan,495,280,215
1/12/2022,Cambodia,Melaka,0,0,0
1/12/2022,Cambodia,Negeri Sembilan,0,0,0
1/12/2022,Cambodia,Pahang,0,0,0
1/12/2022,Cambodia,Perak,13,7,6
1/12/2022,Cambodia,Perlis,513,285,228
1/12/2022,Cambodia,Pulau Pinang,12,4,8
1/12/2022,Cambodia,Sabah,2,1,1
1/12/2022,Cambodia,Sarawak,4,1,3
1/12/2022,Cambodia,Selangor,3427,1557,1870
1/12/2022,Cambodia,W.P. Labuan,0,0,0
1/12/2022,Kiribati,Johor,0,0,0
1/12/2022,Kiribati,Sabah,0,0,0
1/12/2022,Kiribati,Selangor,0,0,0
1/12/2022,Saint Kitts and Nevis,Johor,9,6,3
1/12/2022,Saint Kitts and Nevis,Kedah,5,2,3
1/12/2022,Saint Kitts and Nevis,Perlis,0,0,0
1/12/2022,Saint Kitts and Nevis,Pulau Pinang,9,8,1
1/12/2022,Saint Kitts and Nevis,Sabah,1,1,0
1/12/2022,Saint Kitts and Nevis,Selangor,58,37,21
1/12/2022,Saint Kitts and Nevis,W.P. Labuan,0,0,0
1/12/2022,"Korea, Republic of",Johor,9911,5334,4577
1/12/2022,"Korea, Republic of",Kedah,243,114,129
1/12/2022,"Korea, Republic of",Kelantan,0,0,0
1/12/2022,"Korea, Republic of",Melaka,0,0,0
1/12/2022,"Korea, Republic of",Negeri Sembilan,0,0,0
1/12/2022,"Korea, Republic of",Pahang,10,3,7
1/12/2022,"Korea, Republic of",Perak,10,2,8
1/12/2022,"Korea, Republic of",Perlis,85,65,20
1/12/2022,"Korea, Republic of",Pulau Pinang,387,215,172
1/12/2022,"Korea, Republic of",Sabah,12363,5398,6965
1/12/2022,"Korea, Republic of",Sarawak,230,132,98
1/12/2022,"Korea, Republic of",Selangor,11169,6041,5128
1/12/2022,"Korea, Republic of",Terengganu,0,0,0
1/12/2022,"Korea, Republic of",W.P. Labuan,7,6,1
1/12/2022,Kuwait,Johor,9,6,3
1/12/2022,Kuwait,Kedah,1,0,1
1/12/2022,Kuwait,Kelantan,0,0,0
1/12/2022,Kuwait,Perak,0,0,0
1/12/2022,Kuwait,Perlis,0,0,0
1/12/2022,Kuwait,Pulau Pinang,1,1,0
1/12/2022,Kuwait,Sabah,0,0,0
1/12/2022,Kuwait,Sarawak,4,2,2
1/12/2022,Kuwait,Selangor,444,270,174
1/12/2022,Kuwait,W.P. Labuan,0,0,0
1/12/2022, Lao People's Democratic Republic,Johor,158,46,112
1/12/2022, Lao People's Democratic Republic,Kedah,749,73,676
1/12/2022, Lao People's Democratic Republic,Kelantan,121,12,109
1/12/2022, Lao People's Democratic Republic,Melaka,0,0,0
1/12/2022, Lao People's Democratic Republic,Perak,17,4,13
1/12/2022, Lao People's Democratic Republic,Perlis,217,76,141
1/12/2022, Lao People's Democratic Republic,Pulau Pinang,11,0,11
1/12/2022, Lao People's Democratic Republic,Sabah,1,0,1
1/12/2022, Lao People's Democratic Republic,Sarawak,11,2,9
1/12/2022, Lao People's Democratic Republic,Selangor,211,84,127
1/12/2022, Lao People's Democratic Republic,W.P. Labuan,0,0,0
1/12/2022,Lebanon,Johor,23,12,11
1/12/2022,Lebanon,Kedah,1,0,1
1/12/2022,Lebanon,Kelantan,0,0,0
1/12/2022,Lebanon,Pahang,0,0,0
1/12/2022,Lebanon,Perak,0,0,0
1/12/2022,Lebanon,Perlis,1,1,0
1/12/2022,Lebanon,Pulau Pinang,4,4,0
1/12/2022,Lebanon,Sabah,0,0,0
1/12/2022,Lebanon,Sarawak,1,1,0
1/12/2022,Lebanon,Selangor,233,137,96
1/12/2022,Lebanon,W.P. Labuan,0,0,0
1/12/2022,Liberia,Johor,1,1,0
1/12/2022,Liberia,Kedah,0,0,0
1/12/2022,Liberia,Sabah,0,0,0
1/12/2022,Liberia,Sarawak,0,0,0
1/12/2022,Liberia,Selangor,12,11,1
1/12/2022,Libya,Johor,0,0,0
1/12/2022,Libya,Kedah,1,1,0
1/12/2022,Libya,Perlis,0,0,0
1/12/2022,Libya,Pulau Pinang,1,1,0
1/12/2022,Libya,Sabah,0,0,0
1/12/2022,Libya,Sarawak,1,1,0
1/12/2022,Libya,Selangor,200,138,62
1/12/2022,Saint Lucia,Johor,2,2,0
1/12/2022,Saint Lucia,Kedah,0,0,0
1/12/2022,Saint Lucia,Pulau Pinang,1,0,1
1/12/2022,Saint Lucia,Sarawak,6,3,3
1/12/2022,Saint Lucia,Selangor,9,7,2
1/12/2022,Liechtenstein,Johor,1,1,0
1/12/2022,Liechtenstein,Kedah,5,3,2
1/12/2022,Liechtenstein,Perlis,0,0,0
1/12/2022,Liechtenstein,Pulau Pinang,0,0,0
1/12/2022,Liechtenstein,Sabah,0,0,0
1/12/2022,Liechtenstein,Sarawak,0,0,0
1/12/2022,Liechtenstein,Selangor,5,3,2
1/12/2022,LKA,Johor,1116,675,441
1/12/2022,LKA,Kedah,11,5,6
1/12/2022,LKA,Kelantan,0,0,0
1/12/2022,LKA,Melaka,0,0,0
1/12/2022,LKA,Pahang,0,0,0
1/12/2022,LKA,Perak,10,4,6
1/12/2022,LKA,Perlis,1,1,0
1/12/2022,LKA,Pulau Pinang,15,13,2
1/12/2022,LKA,Sabah,12,7,5
1/12/2022,LKA,Sarawak,29,17,12
1/12/2022,LKA,Selangor,3681,2244,1437
1/12/2022,LKA,W.P. Labuan,2,2,0
1/12/2022,Lesotho,Johor,0,0,0
1/12/2022,Lesotho,Kedah,0,0,0
1/12/2022,Lesotho,Pulau Pinang,0,0,0
1/12/2022,Lesotho,Sarawak,0,0,0
1/12/2022,Lesotho,Selangor,6,3,3
1/12/2022,Lithuania,Johor,37,18,19
1/12/2022,Lithuania,Kedah,25,9,16
1/12/2022,Lithuania,Kelantan,0,0,0
1/12/2022,Lithuania,Pahang,0,0,0
1/12/2022,Lithuania,Perak,0,0,0
1/12/2022,Lithuania,Perlis,9,4,5
1/12/2022,Lithuania,Pulau Pinang,6,6,0
1/12/2022,Lithuania,Sabah,5,4,1
1/12/2022,Lithuania,Sarawak,7,4,3
1/12/2022,Lithuania,Selangor,205,101,104
1/12/2022,Lithuania,W.P. Labuan,0,0,0
1/12/2022,Luxembourg,Johor,2,1,1
1/12/2022,Luxembourg,Kedah,4,2,2
1/12/2022,Luxembourg,Kelantan,0,0,0
1/12/2022,Luxembourg,Perak,0,0,0
1/12/2022,Luxembourg,Perlis,0,0,0
1/12/2022,Luxembourg,Pulau Pinang,3,1,2
1/12/2022,Luxembourg,Sabah,2,1,1
1/12/2022,Luxembourg,Sarawak,0,0,0
1/12/2022,Luxembourg,Selangor,39,19,20
1/12/2022,Latvia,Johor,19,12,7
1/12/2022,Latvia,Kedah,10,4,6
1/12/2022,Latvia,Kelantan,0,0,0
1/12/2022,Latvia,Pahang,0,0,0
1/12/2022,Latvia,Perak,1,1,0
1/12/2022,Latvia,Perlis,6,3,3
1/12/2022,Latvia,Pulau Pinang,3,2,1
1/12/2022,Latvia,Sabah,0,0,0
1/12/2022,Latvia,Sarawak,8,3,5
1/12/2022,Latvia,Selangor,120,65,55
1/12/2022,Latvia,W.P. Labuan,0,0,0
1/12/2022,Macao,Johor,0,0,0
1/12/2022,Macao,Pahang,0,0,0
1/12/2022,Macao,Perak,3,2,1
1/12/2022,Macao,Selangor,6,2,4
1/12/2022,Macao,W.P. Labuan,0,0,0
1/12/2022,Morocco,Johor,60,29,31
1/12/2022,Morocco,Kedah,5,3,2
1/12/2022,Morocco,Kelantan,0,0,0
1/12/2022,Morocco,Melaka,1,0,1
1/12/2022,Morocco,Pahang,0,0,0
1/12/2022,Morocco,Perak,0,0,0
1/12/2022,Morocco,Perlis,1,0,1
1/12/2022,Morocco,Pulau Pinang,15,14,1
1/12/2022,Morocco,Sabah,3,3,0
1/12/2022,Morocco,Sarawak,10,7,3
1/12/2022,Morocco,Selangor,386,211,175
1/12/2022,Morocco,W.P. Labuan,1,1,0
1/12/2022,Monaco,Johor,1,1,0
1/12/2022,Monaco,Kedah,0,0,0
1/12/2022,Monaco,Sabah,0,0,0
1/12/2022,Monaco,Selangor,0,0,0
1/12/2022,"Moldova, Republic of",Johor,8,3,5
1/12/2022,"Moldova, Republic of",Kedah,0,0,0
1/12/2022,"Moldova, Republic of",Kelantan,0,0,0
1/12/2022,"Moldova, Republic of",Negeri Sembilan,0,0,0
1/12/2022,"Moldova, Republic of",Perlis,0,0,0
1/12/2022,"Moldova, Republic of",Pulau Pinang,3,3,0
1/12/2022,"Moldova, Republic of",Sabah,0,0,0
1/12/2022,"Moldova, Republic of",Sarawak,0,0,0
1/12/2022,"Moldova, Republic of",Selangor,13,8,5
1/12/2022,Madagascar,Johor,3,1,2
1/12/2022,Madagascar,Kedah,0,0,0
1/12/2022,Madagascar,Perak,0,0,0
1/12/2022,Madagascar,Perlis,0,0,0
1/12/2022,Madagascar,Pulau Pinang,1,0,1
1/12/2022,Madagascar,Sabah,0,0,0
1/12/2022,Madagascar,Sarawak,0,0,0
1/12/2022,Madagascar,Selangor,32,14,18
1/12/2022,Maldives,Johor,174,86,88
1/12/2022,Maldives,Kedah,0,0,0
1/12/2022,Maldives,Kelantan,0,0,0
1/12/2022,Maldives,Perak,2,1,1
1/12/2022,Maldives,Perlis,5,2,3
1/12/2022,Maldives,Pulau Pinang,2,1,1
1/12/2022,Maldives,Sabah,0,0,0
1/12/2022,Maldives,Sarawak,1,0,1
1/12/2022,Maldives,Selangor,2847,1392,1455
1/12/2022,Mexico,Johor,101,47,54
1/12/2022,Mexico,Kedah,7,4,3
1/12/2022,Mexico,Kelantan,0,0,0
1/12/2022,Mexico,Pahang,0,0,0
1/12/2022,Mexico,Perak,3,2,1
1/12/2022,Mexico,Perlis,1,0,1
1/12/2022,Mexico,Pulau Pinang,22,17,5
1/12/2022,Mexico,Sabah,7,4,3
1/12/2022,Mexico,Sarawak,3,2,1
1/12/2022,Mexico,Selangor,338,185,153
1/12/2022,Mexico,W.P. Labuan,0,0,0
1/12/2022,Marshall Islands,Johor,0,0,0
1/12/2022,Marshall Islands,Kedah,0,0,0
1/12/2022,Marshall Islands,Perak,0,0,0
1/12/2022,Marshall Islands,Pulau Pinang,0,0,0
1/12/2022,Marshall Islands,Sabah,0,0,0
1/12/2022,Marshall Islands,Selangor,0,0,0
1/12/2022,North Macedonia,Johor,5,2,3
1/12/2022,North Macedonia,Kedah,1,1,0
1/12/2022,North Macedonia,Perak,0,0,0
1/12/2022,North Macedonia,Pulau Pinang,0,0,0
1/12/2022,North Macedonia,Sabah,0,0,0
1/12/2022,North Macedonia,Sarawak,1,0,1
1/12/2022,North Macedonia,Selangor,21,9,12
1/12/2022,Mali,Johor,5,5,0
1/12/2022,Mali,Sabah,0,0,0
1/12/2022,Mali,Selangor,3,3,0
1/12/2022,Malta,Johor,6,5,1
1/12/2022,Malta,Kedah,7,4,3
1/12/2022,Malta,Kelantan,0,0,0
1/12/2022,Malta,Perak,0,0,0
1/12/2022,Malta,Perlis,0,0,0
1/12/2022,Malta,Pulau Pinang,2,1,1
1/12/2022,Malta,Sabah,0,0,0
1/12/2022,Malta,Sarawak,1,1,0
1/12/2022,Malta,Selangor,39,25,14
1/12/2022,Malta,W.P. Labuan,0,0,0
1/12/2022,Myanmar,Johor,4608,1237,3371
1/12/2022,Myanmar,Kedah,72,8,64
1/12/2022,Myanmar,Kelantan,2,1,1
1/12/2022,Myanmar,Negeri Sembilan,0,0,0
1/12/2022,Myanmar,Pahang,0,0,0
1/12/2022,Myanmar,Perak,32,5,27
1/12/2022,Myanmar,Perlis,14,2,12
1/12/2022,Myanmar,Pulau Pinang,176,61,115
1/12/2022,Myanmar,Sabah,21,4,17
1/12/2022,Myanmar,Sarawak,108,37,71
1/12/2022,Myanmar,Selangor,8288,5817,2471
1/12/2022,Myanmar,Terengganu,0,0,0
1/12/2022,Myanmar,W.P. Labuan,1,1,0
1/12/2022,Montenegro,Johor,1,1,0
1/12/2022,Montenegro,Kedah,0,0,0
1/12/2022,Montenegro,Pulau Pinang,0,0,0
1/12/2022,Montenegro,Sabah,0,0,0
1/12/2022,Montenegro,Sarawak,0,0,0
1/12/2022,Montenegro,Selangor,6,6,0
1/12/2022,Mongolia,Johor,264,121,143
1/12/2022,Mongolia,Kedah,10,3,7
1/12/2022,Mongolia,Kelantan,0,0,0
1/12/2022,Mongolia,Perak,0,0,0
1/12/2022,Mongolia,Perlis,7,5,2
1/12/2022,Mongolia,Pulau Pinang,19,10,9
1/12/2022,Mongolia,Sabah,30,14,16
1/12/2022,Mongolia,Sarawak,0,0,0
1/12/2022,Mongolia,Selangor,350,128,222
1/12/2022,Northern Mariana Islands,Selangor,0,0,0
1/12/2022,Mozambique,Johor,2,1,1
1/12/2022,Mozambique,Kedah,11,7,4
1/12/2022,Mozambique,Perak,0,0,0
1/12/2022,Mozambique,Pulau Pinang,0,0,0
1/12/2022,Mozambique,Sabah,0,0,0
1/12/2022,Mozambique,Sarawak,0,0,0
1/12/2022,Mozambique,Selangor,9,2,7
1/12/2022,Mauritania,Johor,3,3,0
1/12/2022,Mauritania,Kedah,0,0,0
1/12/2022,Mauritania,Pulau Pinang,0,0,0
1/12/2022,Mauritania,Sabah,0,0,0
1/12/2022,Mauritania,Sarawak,0,0,0
1/12/2022,Mauritania,Selangor,12,8,4
1/12/2022,Mauritius,Johor,266,142,124
1/12/2022,Mauritius,Kedah,1,0,1
1/12/2022,Mauritius,Kelantan,0,0,0
1/12/2022,Mauritius,Pahang,0,0,0
1/12/2022,Mauritius,Perak,4,1,3
1/12/2022,Mauritius,Perlis,5,3,2
1/12/2022,Mauritius,Pulau Pinang,17,7,10
1/12/2022,Mauritius,Sabah,1,1,0
1/12/2022,Mauritius,Sarawak,1,1,0
1/12/2022,Mauritius,Selangor,1985,932,1053
1/12/2022,Malawi,Johor,10,4,6
1/12/2022,Malawi,Pulau Pinang,1,1,0
1/12/2022,Malawi,Sabah,0,0,0
1/12/2022,Malawi,Sarawak,0,0,0
1/12/2022,Malawi,Selangor,10,4,6
1/12/2022,Mayotte,Selangor,0,0,0
1/12/2022,Namibia,Johor,1,0,1
1/12/2022,Namibia,Kedah,0,0,0
1/12/2022,Namibia,Perak,0,0,0
1/12/2022,Namibia,Perlis,0,0,0
1/12/2022,Namibia,Pulau Pinang,0,0,0
1/12/2022,Namibia,Sabah,0,0,0
1/12/2022,Namibia,Sarawak,0,0,0
1/12/2022,Namibia,Selangor,16,6,10
1/12/2022,New Caledonia,Selangor,0,0,0
1/12/2022,Niger,Johor,0,0,0
1/12/2022,Niger,Sabah,0,0,0
1/12/2022,Niger,Selangor,3,1,2
1/12/2022,Nigeria,Johor,30,26,4
1/12/2022,Nigeria,Kedah,4,4,0
1/12/2022,Nigeria,Perlis,0,0,0
1/12/2022,Nigeria,Pulau Pinang,2,1,1
1/12/2022,Nigeria,Sabah,0,0,0
1/12/2022,Nigeria,Sarawak,13,8,5
1/12/2022,Nigeria,Selangor,242,178,64
1/12/2022,Nicaragua,Johor,1,1,0
1/12/2022,Nicaragua,Kedah,0,0,0
1/12/2022,Nicaragua,Pulau Pinang,0,0,0
1/12/2022,Nicaragua,Sabah,0,0,0
1/12/2022,Nicaragua,Selangor,5,2,3
1/12/2022,Netherlands,Johor,788,541,247
1/12/2022,Netherlands,Kedah,240,124,116
1/12/2022,Netherlands,Kelantan,2,2,0
1/12/2022,Netherlands,Melaka,0,0,0
1/12/2022,Netherlands,Negeri Sembilan,2,1,1
1/12/2022,Netherlands,Pahang,6,5,1
1/12/2022,Netherlands,Perak,12,9,3
1/12/2022,Netherlands,Perlis,24,17,7
1/12/2022,Netherlands,Pulau Pinang,167,100,67
1/12/2022,Netherlands,Sabah,33,20,13
1/12/2022,Netherlands,Sarawak,132,82,50
1/12/2022,Netherlands,Selangor,2656,1615,1041
1/12/2022,Netherlands,Terengganu,0,0,0
1/12/2022,Netherlands,W.P. Labuan,1,1,0
1/12/2022,Norway,Johor,147,94,53
1/12/2022,Norway,Kedah,40,24,16
1/12/2022,Norway,Kelantan,0,0,0
1/12/2022,Norway,Melaka,0,0,0
1/12/2022,Norway,Pahang,0,0,0
1/12/2022,Norway,Perak,0,0,0
1/12/2022,Norway,Perlis,10,7,3
1/12/2022,Norway,Pulau Pinang,16,12,4
1/12/2022,Norway,Sabah,5,4,1
1/12/2022,Norway,Sarawak,19,12,7
1/12/2022,Norway,Selangor,562,348,214
1/12/2022,Norway,W.P. Labuan,1,1,0
1/12/2022,Nepal,Johor,486,404,82
1/12/2022,Nepal,Kedah,18,11,7
1/12/2022,Nepal,Pahang,0,0,0
1/12/2022,Nepal,Perak,0,0,0
1/12/2022,Nepal,Perlis,2,2,0
1/12/2022,Nepal,Pulau Pinang,25,24,1
1/12/2022,Nepal,Sabah,6,4,2
1/12/2022,Nepal,Sarawak,457,318,139
1/12/2022,Nepal,Selangor,25621,24929,692
1/12/2022,Nepal,W.P. Labuan,77,75,2
1/12/2022,Nauru,Johor,0,0,0
1/12/2022,Nauru,Pulau Pinang,0,0,0
1/12/2022,Nauru,Selangor,1,1,0
1/12/2022,New Zealand,Johor,773,437,336
1/12/2022,New Zealand,Kedah,75,39,36
1/12/2022,New Zealand,Kelantan,3,0,3
1/12/2022,New Zealand,Melaka,0,0,0
1/12/2022,New Zealand,Negeri Sembilan,0,0,0
1/12/2022,New Zealand,Pahang,0,0,0
1/12/2022,New Zealand,Perak,32,20,12
1/12/2022,New Zealand,Perlis,10,4,6
1/12/2022,New Zealand,Pulau Pinang,222,124,98
1/12/2022,New Zealand,Sabah,64,27,37
1/12/2022,New Zealand,Sarawak,157,83,74
1/12/2022,New Zealand,Selangor,3309,1852,1457
1/12/2022,New Zealand,Terengganu,0,0,0
1/12/2022,New Zealand,W.P. Labuan,2,2,0
1/12/2022,Oman,Johor,31,22,9
1/12/2022,Oman,Kedah,1,1,0
1/12/2022,Oman,Kelantan,2,1,1
1/12/2022,Oman,Melaka,0,0,0
1/12/2022,Oman,Perak,0,0,0
1/12/2022,Oman,Perlis,0,0,0
1/12/2022,Oman,Pulau Pinang,5,3,2
1/12/2022,Oman,Sabah,3,3,0
1/12/2022,Oman,Sarawak,6,3,3
1/12/2022,Oman,Selangor,533,325,208
1/12/2022,Pakistan,Johor,779,554,225
1/12/2022,Pakistan,Kedah,123,86,37
1/12/2022,Pakistan,Kelantan,4,4,0
1/12/2022,Pakistan,Melaka,0,0,0
1/12/2022,Pakistan,Negeri Sembilan,1,1,0
1/12/2022,Pakistan,Pahang,5,2,3
1/12/2022,Pakistan,Perak,41,41,0
1/12/2022,Pakistan,Perlis,30,28,2
1/12/2022,Pakistan,Pulau Pinang,49,46,3
1/12/2022,Pakistan,Sabah,34,31,3
1/12/2022,Pakistan,Sarawak,204,160,44
1/12/2022,Pakistan,Selangor,10196,8776,1420
1/12/2022,Pakistan,W.P. Labuan,8,6,2
1/12/2022,Panama,Johor,5,1,4
1/12/2022,Panama,Kedah,0,0,0
1/12/2022,Panama,Perak,0,0,0
1/12/2022,Panama,Perlis,0,0,0
1/12/2022,Panama,Pulau Pinang,0,0,0
1/12/2022,Panama,Sabah,1,1,0
1/12/2022,Panama,Sarawak,0,0,0
1/12/2022,Panama,Selangor,16,9,7
1/12/2022,Peru,Johor,26,15,11
1/12/2022,Peru,Kedah,1,0,1
1/12/2022,Peru,Kelantan,0,0,0
1/12/2022,Peru,Pahang,0,0,0
1/12/2022,Peru,Perak,0,0,0
1/12/2022,Peru,Perlis,3,0,3
1/12/2022,Peru,Pulau Pinang,3,2,1
1/12/2022,Peru,Sabah,0,0,0
1/12/2022,Peru,Sarawak,0,0,0
1/12/2022,Peru,Selangor,89,46,43
1/12/2022,Peru,W.P. Labuan,0,0,0
1/12/2022,Philippines,Johor,19506,6147,13359
1/12/2022,Philippines,Kedah,426,141,285
1/12/2022,Philippines,Kelantan,19,13,6
1/12/2022,Philippines,Melaka,0,0,0
1/12/2022,Philippines,Negeri Sembilan,0,0,0
1/12/2022,Philippines,Pahang,5,2,3
1/12/2022,Philippines,Perak,100,31,69
1/12/2022,Philippines,Perlis,88,29,59
1/12/2022,Philippines,Pulau Pinang,399,114,285
1/12/2022,Philippines,Sabah,1705,695,1010
1/12/2022,Philippines,Sarawak,2342,847,1495
1/12/2022,Philippines,Selangor,15026,5792,9234
1/12/2022,Philippines,Terengganu,0,0,0
1/12/2022,Philippines,W.P. Labuan,140,49,91
1/12/2022,Palau,Johor,3,3,0
1/12/2022,Palau,Pulau Pinang,0,0,0
1/12/2022,Palau,Selangor,0,0,0
1/12/2022,Papua New Guinea,Johor,13,7,6
1/12/2022,Papua New Guinea,Kedah,0,0,0
1/12/2022,Papua New Guinea,Kelantan,0,0,0
1/12/2022,Papua New Guinea,Perak,0,0,0
1/12/2022,Papua New Guinea,Pulau Pinang,0,0,0
1/12/2022,Papua New Guinea,Sabah,1,0,1
1/12/2022,Papua New Guinea,Sarawak,7,3,4
1/12/2022,Papua New Guinea,Selangor,33,17,16
1/12/2022,Poland,Johor,272,159,113
1/12/2022,Poland,Kedah,98,44,54
1/12/2022,Poland,Kelantan,2,1,1
1/12/2022,Poland,Melaka,0,0,0
1/12/2022,Poland,Negeri Sembilan,0,0,0
1/12/2022,Poland,Pahang,0,0,0
1/12/2022,Poland,Perak,1,1,0
1/12/2022,Poland,Perlis,22,14,8
1/12/2022,Poland,Pulau Pinang,55,27,28
1/12/2022,Poland,Sabah,22,13,9
1/12/2022,Poland,Sarawak,28,14,14
1/12/2022,Poland,Selangor,668,357,311
1/12/2022,Poland,Terengganu,0,0,0
1/12/2022,Poland,W.P. Labuan,2,1,1
1/12/2022,"North Korea, Democratic People's Republic of",Selangor,0,0,0
1/12/2022,Portugal,Johor,128,72,56
1/12/2022,Portugal,Kedah,40,21,19
1/12/2022,Portugal,Kelantan,0,0,0
1/12/2022,Portugal,Melaka,0,0,0
1/12/2022,Portugal,Pahang,0,0,0
1/12/2022,Portugal,Perak,6,2,4
1/12/2022,Portugal,Perlis,0,0,0
1/12/2022,Portugal,Pulau Pinang,13,6,7
1/12/2022,Portugal,Sabah,3,2,1
1/12/2022,Portugal,Sarawak,5,1,4
1/12/2022,Portugal,Selangor,456,261,195
1/12/2022,Portugal,W.P. Labuan,0,0,0
1/12/2022,Paraguay,Johor,1,1,0
1/12/2022,Paraguay,Kedah,0,0,0
1/12/2022,Paraguay,Perak,0,0,0
1/12/2022,Paraguay,Perlis,0,0,0
1/12/2022,Paraguay,Pulau Pinang,6,6,0
1/12/2022,Paraguay,Sabah,0,0,0
1/12/2022,Paraguay,Sarawak,0,0,0
1/12/2022,Paraguay,Selangor,5,3,2
1/12/2022,"Palestine, State of",Johor,6,5,1
1/12/2022,"Palestine, State of",Kedah,0,0,0
1/12/2022,"Palestine, State of",Kelantan,3,2,1
1/12/2022,"Palestine, State of",Melaka,0,0,0
1/12/2022,"Palestine, State of",Perak,0,0,0
1/12/2022,"Palestine, State of",Perlis,0,0,0
1/12/2022,"Palestine, State of",Pulau Pinang,2,1,1
1/12/2022,"Palestine, State of",Sabah,0,0,0
1/12/2022,"Palestine, State of",Sarawak,1,1,0
1/12/2022,"Palestine, State of",Selangor,207,137,70
1/12/2022,Qatar,Johor,12,4,8
1/12/2022,Qatar,Kedah,0,0,0
1/12/2022,Qatar,Perlis,0,0,0
1/12/2022,Qatar,Pulau Pinang,0,0,0
1/12/2022,Qatar,Sabah,0,0,0
1/12/2022,Qatar,Sarawak,0,0,0
1/12/2022,Qatar,Selangor,54,32,22
1/12/2022,Réunion,Johor,0,0,0
1/12/2022,Réunion,Sarawak,0,0,0
1/12/2022,Romania,Johor,141,77,64
1/12/2022,Romania,Kedah,34,21,13
1/12/2022,Romania,Kelantan,0,0,0
1/12/2022,Romania,Negeri Sembilan,0,0,0
1/12/2022,Romania,Pahang,0,0,0
1/12/2022,Romania,Perak,4,3,1
1/12/2022,Romania,Perlis,4,3,1
1/12/2022,Romania,Pulau Pinang,20,9,11
1/12/2022,Romania,Sabah,5,2,3
1/12/2022,Romania,Sarawak,22,13,9
1/12/2022,Romania,Selangor,553,290,263
1/12/2022,Romania,W.P. Labuan,0,0,0
1/12/2022,Russian Federation (Russia),Johor,448,221,227
1/12/2022,Russian Federation (Russia),Kedah,569,312,257
1/12/2022,Russian Federation (Russia),Kelantan,39,26,13
1/12/2022,Russian Federation (Russia),Melaka,2,1,1
1/12/2022,Russian Federation (Russia),Negeri Sembilan,0,0,0
1/12/2022,Russian Federation (Russia),Pahang,0,0,0
1/12/2022,Russian Federation (Russia),Perak,10,5,5
1/12/2022,Russian Federation (Russia),Perlis,552,320,232
1/12/2022,Russian Federation (Russia),Pulau Pinang,329,173,156
1/12/2022,Russian Federation (Russia),Sabah,53,27,26
1/12/2022,Russian Federation (Russia),Sarawak,69,35,34
1/12/2022,Russian Federation (Russia),Selangor,10820,5835,4985
1/12/2022,Russian Federation (Russia),W.P. Labuan,0,0,0
1/12/2022,Rwanda,Johor,1,0,1
1/12/2022,Rwanda,Kedah,0,0,0
1/12/2022,Rwanda,Pulau Pinang,0,0,0
1/12/2022,Rwanda,Selangor,5,2,3
1/12/2022,Saudi Arabia,Johor,73,53,20
1/12/2022,Saudi Arabia,Kedah,15,7,8
1/12/2022,Saudi Arabia,Kelantan,0,0,0
1/12/2022,Saudi Arabia,Melaka,0,0,0
1/12/2022,Saudi Arabia,Perak,0,0,0
1/12/2022,Saudi Arabia,Perlis,7,4,3
1/12/2022,Saudi Arabia,Pulau Pinang,4,3,1
1/12/2022,Saudi Arabia,Sabah,5,3,2
1/12/2022,Saudi Arabia,Sarawak,15,9,6
1/12/2022,Saudi Arabia,Selangor,2309,1305,1004
1/12/2022,Saudi Arabia,W.P. Labuan,1,1,0
1/12/2022,Sudan,Johor,8,2,6
1/12/2022,Sudan,Kedah,1,1,0
1/12/2022,Sudan,Kelantan,0,0,0
1/12/2022,Sudan,Perlis,0,0,0
1/12/2022,Sudan,Pulau Pinang,1,0,1
1/12/2022,Sudan,Sabah,0,0,0
1/12/2022,Sudan,Sarawak,5,4,1
1/12/2022,Sudan,Selangor,835,468,367
1/12/2022,Sudan,W.P. Labuan,0,0,0
1/12/2022,Senegal,Johor,3,1,2
1/12/2022,Senegal,Kedah,0,0,0
1/12/2022,Senegal,Kelantan,0,0,0
1/12/2022,Senegal,Perak,0,0,0
1/12/2022,Senegal,Perlis,0,0,0
1/12/2022,Senegal,Pulau Pinang,0,0,0
1/12/2022,Senegal,Sabah,0,0,0
1/12/2022,Senegal,Sarawak,0,0,0
1/12/2022,Senegal,Selangor,12,9,3
1/12/2022,Singapore,Johor,1151986,631496,520490
1/12/2022,Singapore,Kedah,6597,3389,3208
1/12/2022,Singapore,Kelantan,46,28,18
1/12/2022,Singapore,Melaka,16,14,2
1/12/2022,Singapore,Negeri Sembilan,1,1,0
1/12/2022,Singapore,Pahang,564,281,283
1/12/2022,Singapore,Perak,7950,3875,4075
1/12/2022,Singapore,Perlis,571,279,292
1/12/2022,Singapore,Pulau Pinang,20185,9923,10262
1/12/2022,Singapore,Sabah,4405,2210,2195
1/12/2022,Singapore,Sarawak,6115,3114,3001
1/12/2022,Singapore,Selangor,68868,33621,35247
1/12/2022,Singapore,Terengganu,0,0,0
1/12/2022,Singapore,W.P. Labuan,18,15,3
1/12/2022,South Georgia and the South Sandwich Islands,Johor,0,0,0
1/12/2022,South Georgia and the South Sandwich Islands,Sabah,0,0,0
1/12/2022,South Georgia and the South Sandwich Islands,Selangor,0,0,0
1/12/2022,Saint Helena,Sarawak,0,0,0
1/12/2022,Solomon Islands,Johor,0,0,0
1/12/2022,Solomon Islands,Perlis,0,0,0
1/12/2022,Solomon Islands,Pulau Pinang,0,0,0
1/12/2022,Solomon Islands,Sabah,0,0,0
1/12/2022,Solomon Islands,Sarawak,3,3,0
1/12/2022,Solomon Islands,Selangor,6,4,2
1/12/2022,Solomon Islands,W.P. Labuan,0,0,0
1/12/2022,Sierra Leone,Johor,1,1,0
1/12/2022,Sierra Leone,Kedah,0,0,0
1/12/2022,Sierra Leone,Perak,0,0,0
1/12/2022,Sierra Leone,Pulau Pinang,0,0,0
1/12/2022,Sierra Leone,Sabah,0,0,0
1/12/2022,Sierra Leone,Selangor,12,10,2
1/12/2022,El Salvador,Johor,0,0,0
1/12/2022,El Salvador,Kedah,1,1,0
1/12/2022,El Salvador,Perak,0,0,0
1/12/2022,El Salvador,Perlis,0,0,0
1/12/2022,El Salvador,Pulau Pinang,2,2,0
1/12/2022,El Salvador,Sabah,0,0,0
1/12/2022,El Salvador,Selangor,11,7,4
1/12/2022,El Salvador,W.P. Labuan,0,0,0
1/12/2022,San Marino,Johor,0,0,0
1/12/2022,San Marino,Selangor,0,0,0
1/12/2022,Somalia,Johor,0,0,0
1/12/2022,Somalia,Kedah,0,0,0
1/12/2022,Somalia,Kelantan,0,0,0
1/12/2022,Somalia,Perlis,0,0,0
1/12/2022,Somalia,Sabah,0,0,0
1/12/2022,Somalia,Sarawak,0,0,0
1/12/2022,Somalia,Selangor,174,117,57
1/12/2022,Serbia,Johor,10,5,5
1/12/2022,Serbia,Kedah,0,0,0
1/12/2022,Serbia,Kelantan,0,0,0
1/12/2022,Serbia,Pahang,0,0,0
1/12/2022,Serbia,Perak,0,0,0
1/12/2022,Serbia,Perlis,0,0,0
1/12/2022,Serbia,Pulau Pinang,0,0,0
1/12/2022,Serbia,Sabah,1,1,0
1/12/2022,Serbia,Sarawak,0,0,0
1/12/2022,Serbia,Selangor,69,41,28
1/12/2022,South Sudan,Johor,0,0,0
1/12/2022,South Sudan,Kedah,0,0,0
1/12/2022,South Sudan,Sarawak,1,1,0
1/12/2022,South Sudan,Selangor,31,28,3
1/12/2022,South Sudan,W.P. Labuan,0,0,0
1/12/2022,Sao Tome and Principe,Selangor,1,1,0
1/12/2022,Suriname,Johor,1,1,0
1/12/2022,Suriname,Kedah,0,0,0
1/12/2022,Suriname,Kelantan,0,0,0
1/12/2022,Suriname,Perak,0,0,0
1/12/2022,Suriname,Perlis,0,0,0
1/12/2022,Suriname,Pulau Pinang,0,0,0
1/12/2022,Suriname,Sabah,0,0,0
1/12/2022,Suriname,Sarawak,0,0,0
1/12/2022,Suriname,Selangor,19,8,11
1/12/2022,Slovakia,Johor,30,15,15
1/12/2022,Slovakia,Kedah,55,28,27
1/12/2022,Slovakia,Kelantan,1,0,1
1/12/2022,Slovakia,Negeri Sembilan,0,0,0
1/12/2022,Slovakia,Pahang,0,0,0
1/12/2022,Slovakia,Perak,0,0,0
1/12/2022,Slovakia,Perlis,1,0,1
1/12/2022,Slovakia,Pulau Pinang,8,8,0
1/12/2022,Slovakia,Sabah,9,5,4
1/12/2022,Slovakia,Sarawak,7,3,4
1/12/2022,Slovakia,Selangor,232,115,117
1/12/2022,Slovakia,W.P. Labuan,0,0,0
1/12/2022,Slovenia,Johor,7,2,5
1/12/2022,Slovenia,Kedah,13,7,6
1/12/2022,Slovenia,Kelantan,0,0,0
1/12/2022,Slovenia,Perak,0,0,0
1/12/2022,Slovenia,Perlis,2,2,0
1/12/2022,Slovenia,Pulau Pinang,0,0,0
1/12/2022,Slovenia,Sabah,0,0,0
1/12/2022,Slovenia,Sarawak,1,0,1
1/12/2022,Slovenia,Selangor,67,40,27
1/12/2022,Slovenia,W.P. Labuan,0,0,0
1/12/2022,Sweden,Johor,256,139,117
1/12/2022,Sweden,Kedah,189,99,90
1/12/2022,Sweden,Kelantan,0,0,0
1/12/2022,Sweden,Melaka,0,0,0
1/12/2022,Sweden,Negeri Sembilan,0,0,0
1/12/2022,Sweden,Pahang,0,0,0
1/12/2022,Sweden,Perak,7,3,4
1/12/2022,Sweden,Perlis,26,18,8
1/12/2022,Sweden,Pulau Pinang,72,43,29
1/12/2022,Sweden,Sabah,39,21,18
1/12/2022,Sweden,Sarawak,32,23,9
1/12/2022,Sweden,Selangor,1159,663,496
1/12/2022,Sweden,W.P. Labuan,0,0,0
1/12/2022,Eswatini,Johor,1,1,0
1/12/2022,Eswatini,Kedah,0,0,0
1/12/2022,Eswatini,Pulau Pinang,0,0,0
1/12/2022,Eswatini,Sabah,0,0,0
1/12/2022,Eswatini,Selangor,22,14,8
1/12/2022,Seychelles,Johor,3,3,0
1/12/2022,Seychelles,Kedah,0,0,0
1/12/2022,Seychelles,Pulau Pinang,0,0,0
1/12/2022,Seychelles,Sabah,0,0,0
1/12/2022,Seychelles,Sarawak,0,0,0
1/12/2022,Seychelles,Selangor,71,24,47
1/12/2022,Syrian Arab Republic,Johor,23,8,15
1/12/2022,Syrian Arab Republic,Kedah,0,0,0
1/12/2022,Syrian Arab Republic,Kelantan,0,0,0
1/12/2022,Syrian Arab Republic,Pahang,0,0,0
1/12/2022,Syrian Arab Republic,Perlis,0,0,0
1/12/2022,Syrian Arab Republic,Pulau Pinang,1,1,0
1/12/2022,Syrian Arab Republic,Sabah,0,0,0
1/12/2022,Syrian Arab Republic,Sarawak,14,10,4
1/12/2022,Syrian Arab Republic,Selangor,439,284,155
1/12/2022,Syrian Arab Republic,W.P. Labuan,2,2,0
1/12/2022,Turks and Caicos Islands,Perlis,0,0,0
1/12/2022,TCD,Johor,1,1,0
1/12/2022,TCD,Kedah,0,0,0
1/12/2022,TCD,Perlis,0,0,0
1/12/2022,TCD,Selangor,18,10,8
1/12/2022,Togo,Johor,2,1,1
1/12/2022,Togo,Perak,0,0,0
1/12/2022,Togo,Pulau Pinang,0,0,0
1/12/2022,Togo,Selangor,3,3,0
1/12/2022,Thailand,Johor,5450,1568,3882
1/12/2022,Thailand,Kedah,57007,33206,23801
1/12/2022,Thailand,Kelantan,25530,12900,12630
1/12/2022,Thailand,Melaka,2,0,2
1/12/2022,Thailand,Negeri Sembilan,2,1,1
1/12/2022,Thailand,Pahang,0,0,0
1/12/2022,Thailand,Perak,8624,4023,4601
1/12/2022,Thailand,Perlis,50271,30816,19455
1/12/2022,Thailand,Pulau Pinang,1651,647,1004
1/12/2022,Thailand,Sabah,113,26,87
1/12/2022,Thailand,Sarawak,345,127,218
1/12/2022,Thailand,Selangor,10889,4288,6601
1/12/2022,Thailand,Terengganu,0,0,0
1/12/2022,Thailand,W.P. Labuan,2,2,0
1/12/2022,Tajikistan,Johor,1,1,0
1/12/2022,Tajikistan,Kedah,1,0,1
1/12/2022,Tajikistan,Perlis,0,0,0
1/12/2022,Tajikistan,Pulau Pinang,0,0,0
1/12/2022,Tajikistan,Sabah,0,0,0
1/12/2022,Tajikistan,Selangor,98,66,32
1/12/2022,Tokelau,Selangor,0,0,0
1/12/2022,Turkmenistan,Johor,1,1,0
1/12/2022,Turkmenistan,Kedah,0,0,0
1/12/2022,Turkmenistan,Kelantan,0,0,0
1/12/2022,Turkmenistan,Perlis,0,0,0
1/12/2022,Turkmenistan,Pulau Pinang,0,0,0
1/12/2022,Turkmenistan,Sabah,0,0,0
1/12/2022,Turkmenistan,Sarawak,0,0,0
1/12/2022,Turkmenistan,Selangor,56,38,18
1/12/2022,Timor-Leste,Johor,12,7,5
1/12/2022,Timor-Leste,Kedah,0,0,0
1/12/2022,Timor-Leste,Perlis,0,0,0
1/12/2022,Timor-Leste,Pulau Pinang,6,3,3
1/12/2022,Timor-Leste,Sabah,1,0,1
1/12/2022,Timor-Leste,Sarawak,2,0,2
1/12/2022,Timor-Leste,Selangor,219,112,107
1/12/2022,Tonga,Johor,0,0,0
1/12/2022,Tonga,Pulau Pinang,1,0,1
1/12/2022,Tonga,Sarawak,0,0,0
1/12/2022,Tonga,Selangor,6,6,0
1/12/2022,Trinidad and Tobago,Johor,1,1,0
1/12/2022,Trinidad and Tobago,Kedah,0,0,0
1/12/2022,Trinidad and Tobago,Pahang,0,0,0
1/12/2022,Trinidad and Tobago,Pulau Pinang,0,0,0
1/12/2022,Trinidad and Tobago,Sabah,0,0,0
1/12/2022,Trinidad and Tobago,Sarawak,5,4,1
1/12/2022,Trinidad and Tobago,Selangor,27,15,12
1/12/2022,Tunisia,Johor,32,16,16
1/12/2022,Tunisia,Kedah,2,1,1
1/12/2022,Tunisia,Kelantan,0,0,0
1/12/2022,Tunisia,Melaka,0,0,0
1/12/2022,Tunisia,Perak,0,0,0
1/12/2022,Tunisia,Perlis,0,0,0
1/12/2022,Tunisia,Pulau Pinang,4,3,1
1/12/2022,Tunisia,Sabah,1,1,0
1/12/2022,Tunisia,Sarawak,1,1,0
1/12/2022,Tunisia,Selangor,286,148,138
1/12/2022,Tunisia,W.P. Labuan,0,0,0
1/12/2022,Türkiye,Johor,198,124,74
1/12/2022,Türkiye,Kedah,27,17,10
1/12/2022,Türkiye,Kelantan,2,1,1
1/12/2022,Türkiye,Melaka,0,0,0
1/12/2022,Türkiye,Negeri Sembilan,0,0,0
1/12/2022,Türkiye,Pahang,0,0,0
1/12/2022,Türkiye,Perak,1,1,0
1/12/2022,Türkiye,Perlis,10,8,2
1/12/2022,Türkiye,Pulau Pinang,30,18,12
1/12/2022,Türkiye,Sabah,5,4,1
1/12/2022,Türkiye,Sarawak,35,22,13
1/12/2022,Türkiye,Selangor,888,625,263
1/12/2022,Türkiye,W.P. Labuan,0,0,0
1/12/2022,Tuvalu,Selangor,0,0,0
1/12/2022,"Taiwan, Province of China",Johor,2844,1176,1668
1/12/2022,"Taiwan, Province of China",Kedah,73,37,36
1/12/2022,"Taiwan, Province of China",Kelantan,1,0,1
1/12/2022,"Taiwan, Province of China",Melaka,0,0,0
1/12/2022,"Taiwan, Province of China",Negeri Sembilan,0,0,0
1/12/2022,"Taiwan, Province of China",Pahang,4,2,2
1/12/2022,"Taiwan, Province of China",Perak,35,18,17
1/12/2022,"Taiwan, Province of China",Perlis,12,6,6
1/12/2022,"Taiwan, Province of China",Pulau Pinang,1388,789,599
1/12/2022,"Taiwan, Province of China",Sabah,429,216,213
1/12/2022,"Taiwan, Province of China",Sarawak,233,105,128
1/12/2022,"Taiwan, Province of China",Selangor,5564,3004,2560
1/12/2022,"Taiwan, Province of China",W.P. Labuan,3,1,2
1/12/2022,"Tanzania, United Republic of",Johor,42,22,20
1/12/2022,"Tanzania, United Republic of",Kedah,0,0,0
1/12/2022,"Tanzania, United Republic of",Perak,0,0,0
1/12/2022,"Tanzania, United Republic of",Perlis,0,0,0
1/12/2022,"Tanzania, United Republic of",Pulau Pinang,0,0,0
1/12/2022,"Tanzania, United Republic of",Sabah,3,2,1
1/12/2022,"Tanzania, United Republic of",Sarawak,3,3,0
1/12/2022,"Tanzania, United Republic of",Selangor,154,67,87
1/12/2022,Uganda,Johor,13,7,6
1/12/2022,Uganda,Kedah,7,3,4
1/12/2022,Uganda,Perak,0,0,0
1/12/2022,Uganda,Perlis,1,1,0
1/12/2022,Uganda,Pulau Pinang,0,0,0
1/12/2022,Uganda,Sabah,2,1,1
1/12/2022,Uganda,Sarawak,0,0,0
1/12/2022,Uganda,Selangor,114,52,62
1/12/2022,Ukraine,Johor,100,49,51
1/12/2022,Ukraine,Kedah,35,15,20
1/12/2022,Ukraine,Kelantan,6,2,4
1/12/2022,Ukraine,Melaka,6,6,0
1/12/2022,Ukraine,Negeri Sembilan,0,0,0
1/12/2022,Ukraine,Pahang,3,0,3
1/12/2022,Ukraine,Perak,1,0,1
1/12/2022,Ukraine,Perlis,32,10,22
1/12/2022,Ukraine,Pulau Pinang,26,9,17
1/12/2022,Ukraine,Sabah,3,2,1
1/12/2022,Ukraine,Sarawak,6,3,3
1/12/2022,Ukraine,Selangor,728,371,357
1/12/2022,Ukraine,W.P. Labuan,1,0,1
1/12/2022,Uruguay,Johor,5,2,3
1/12/2022,Uruguay,Kedah,6,3,3
1/12/2022,Uruguay,Kelantan,0,0,0
1/12/2022,Uruguay,Perak,0,0,0
1/12/2022,Uruguay,Perlis,0,0,0
1/12/2022,Uruguay,Pulau Pinang,0,0,0
1/12/2022,Uruguay,Sabah,1,1,0
1/12/2022,Uruguay,Sarawak,0,0,0
1/12/2022,Uruguay,Selangor,37,20,17
1/12/2022,Uruguay,W.P. Labuan,0,0,0
1/12/2022,United States of America,Johor,3784,2252,1532
1/12/2022,United States of America,Kedah,430,238,192
1/12/2022,United States of America,Kelantan,5,4,1
1/12/2022,United States of America,Melaka,2,2,0
1/12/2022,United States of America,Negeri Sembilan,1,1,0
1/12/2022,United States of America,Pahang,5,3,2
1/12/2022,United States of America,Perak,140,79,61
1/12/2022,United States of America,Perlis,78,48,30
1/12/2022,United States of America,Pulau Pinang,1698,991,707
1/12/2022,United States of America,Sabah,348,203,145
1/12/2022,United States of America,Sarawak,326,177,149
1/12/2022,United States of America,Selangor,12311,7090,5221
1/12/2022,United States of America,Terengganu,0,0,0
1/12/2022,United States of America,W.P. Labuan,9,8,1
1/12/2022,Uzbekistan,Johor,95,75,20
1/12/2022,Uzbekistan,Kedah,39,18,21
1/12/2022,Uzbekistan,Kelantan,0,0,0
1/12/2022,Uzbekistan,Perak,0,0,0
1/12/2022,Uzbekistan,Perlis,5,3,2
1/12/2022,Uzbekistan,Pulau Pinang,15,5,10
1/12/2022,Uzbekistan,Sabah,13,7,6
1/12/2022,Uzbekistan,Sarawak,1,0,1
1/12/2022,Uzbekistan,Selangor,1492,873,619
1/12/2022,Holy See,Johor,1,1,0
1/12/2022,Holy See,Sarawak,1,1,0
1/12/2022,Holy See,Selangor,0,0,0
1/12/2022,Saint Vincent and the Grenadines,Johor,0,0,0
1/12/2022,Saint Vincent and the Grenadines,Kedah,0,0,0
1/12/2022,Saint Vincent and the Grenadines,Pulau Pinang,0,0,0
1/12/2022,Saint Vincent and the Grenadines,Sarawak,0,0,0
1/12/2022,Saint Vincent and the Grenadines,Selangor,1,1,0
1/12/2022,"Venezuela, Bolivarian Republic of",Johor,16,8,8
1/12/2022,"Venezuela, Bolivarian Republic of",Kedah,1,0,1
1/12/2022,"Venezuela, Bolivarian Republic of",Kelantan,0,0,0
1/12/2022,"Venezuela, Bolivarian Republic of",Melaka,0,0,0
1/12/2022,"Venezuela, Bolivarian Republic of",Perak,0,0,0
1/12/2022,"Venezuela, Bolivarian Republic of",Perlis,0,0,0
1/12/2022,"Venezuela, Bolivarian Republic of",Pulau Pinang,0,0,0
1/12/2022,"Venezuela, Bolivarian Republic of",Sabah,0,0,0
1/12/2022,"Venezuela, Bolivarian Republic of",Sarawak,11,6,5
1/12/2022,"Venezuela, Bolivarian Republic of",Selangor,44,21,23
1/12/2022,"Venezuela, Bolivarian Republic of",W.P. Labuan,0,0,0
1/12/2022,Viet Nam,Johor,9714,2706,7008
1/12/2022,Viet Nam,Kedah,216,21,195
1/12/2022,Viet Nam,Kelantan,6,4,2
1/12/2022,Viet Nam,Melaka,1,0,1
1/12/2022,Viet Nam,Negeri Sembilan,0,0,0
1/12/2022,Viet Nam,Pahang,1,1,0
1/12/2022,Viet Nam,Perak,100,10,90
1/12/2022,Viet Nam,Perlis,208,10,198
1/12/2022,Viet Nam,Pulau Pinang,998,235,763
1/12/2022,Viet Nam,Sabah,13,3,10
1/12/2022,Viet Nam,Sarawak,180,35,145
1/12/2022,Viet Nam,Selangor,10936,3507,7429
1/12/2022,Viet Nam,Terengganu,0,0,0
1/12/2022,Viet Nam,W.P. Labuan,2,1,1
1/12/2022,Vanuatu,Johor,23,13,10
1/12/2022,Vanuatu,Kedah,0,0,0
1/12/2022,Vanuatu,Pulau Pinang,5,2,3
1/12/2022,Vanuatu,Sabah,3,2,1
1/12/2022,Vanuatu,Sarawak,0,0,0
1/12/2022,Vanuatu,Selangor,50,40,10
1/12/2022, Samoa,Johor,0,0,0
1/12/2022, Samoa,Sarawak,0,0,0
1/12/2022, Samoa,Selangor,2,0,2
1/12/2022,Yemen,Johor,33,25,8
1/12/2022,Yemen,Kedah,1,1,0
1/12/2022,Yemen,Kelantan,0,0,0
1/12/2022,Yemen,Melaka,2,2,0
1/12/2022,Yemen,Pahang,1,1,0
1/12/2022,Yemen,Perak,0,0,0
1/12/2022,Yemen,Perlis,3,3,0
1/12/2022,Yemen,Pulau Pinang,1,1,0
1/12/2022,Yemen,Sabah,2,2,0
1/12/2022,Yemen,Sarawak,3,2,1
1/12/2022,Yemen,Selangor,878,609,269
1/12/2022,Yemen,W.P. Labuan,0,0,0
1/12/2022,South Africa,Johor,394,230,164
1/12/2022,South Africa,Kedah,41,22,19
1/12/2022,South Africa,Kelantan,0,0,0
1/12/2022,South Africa,Melaka,1,1,0
1/12/2022,South Africa,Pahang,0,0,0
1/12/2022,South Africa,Perak,1,1,0
1/12/2022,South Africa,Perlis,15,8,7
1/12/2022,South Africa,Pulau Pinang,61,31,30
1/12/2022,South Africa,Sabah,19,7,12
1/12/2022,South Africa,Sarawak,172,69,103
1/12/2022,South Africa,Selangor,1913,986,927
1/12/2022,South Africa,Terengganu,0,0,0
1/12/2022,South Africa,W.P. Labuan,1,0,1
1/12/2022,ZAR,Selangor,1,0,1
1/12/2022,Zambia,Johor,1,0,1
1/12/2022,Zambia,Kedah,1,0,1
1/12/2022,Zambia,Perak,0,0,0
1/12/2022,Zambia,Perlis,0,0,0
1/12/2022,Zambia,Pulau Pinang,1,1,0
1/12/2022,Zambia,Sabah,1,1,0
1/12/2022,Zambia,Sarawak,0,0,0
1/12/2022,Zambia,Selangor,59,32,27
1/12/2022,Zimbabwe,Johor,30,13,17
1/12/2022,Zimbabwe,Kedah,0,0,0
1/12/2022,Zimbabwe,Kelantan,0,0,0
1/12/2022,Zimbabwe,Perak,0,0,0
1/12/2022,Zimbabwe,Perlis,0,0,0
1/12/2022,Zimbabwe,Pulau Pinang,5,3,2
1/12/2022,Zimbabwe,Sabah,0,0,0
1/12/2022,Zimbabwe,Sarawak,1,1,0
1/12/2022,Zimbabwe,Selangor,135,49,86
1/01/2023,Aruba,Kedah,0,0,0
1/01/2023,Aruba,Pulau Pinang,0,0,0
1/01/2023,Afghanistan,Johor,3,3,0
1/01/2023,Afghanistan,Kedah,0,0,0
1/01/2023,Afghanistan,Perlis,0,0,0
1/01/2023,Afghanistan,Pulau Pinang,0,0,0
1/01/2023,Afghanistan,Sarawak,0,0,0
1/01/2023,Afghanistan,Selangor,57,46,11
1/01/2023,Angola,Johor,0,0,0
1/01/2023,Angola,Kedah,0,0,0
1/01/2023,Angola,Sabah,0,0,0
1/01/2023,Angola,Selangor,1,1,0
1/01/2023,Anguilla,Selangor,0,0,0
1/01/2023,Albania,Johor,21,13,8
1/01/2023,Albania,Kedah,2,2,0
1/01/2023,Albania,Perak,0,0,0
1/01/2023,Albania,Perlis,0,0,0
1/01/2023,Albania,Pulau Pinang,1,0,1
1/01/2023,Albania,Sabah,0,0,0
1/01/2023,Albania,Sarawak,1,1,0
1/01/2023,Albania,Selangor,30,18,12
1/01/2023,Andorra,Johor,0,0,0
1/01/2023,Andorra,Kedah,1,0,1
1/01/2023,Andorra,Perlis,0,0,0
1/01/2023,Andorra,Pulau Pinang,0,0,0
1/01/2023,Andorra,Selangor,2,1,1
1/01/2023,Antigua and Barbuda,Selangor,0,0,0
1/01/2023,United Arab Emirates,Johor,10,8,2
1/01/2023,United Arab Emirates,Kedah,0,0,0
1/01/2023,United Arab Emirates,Kelantan,0,0,0
1/01/2023,United Arab Emirates,Perak,0,0,0
1/01/2023,United Arab Emirates,Perlis,0,0,0
1/01/2023,United Arab Emirates,Pulau Pinang,1,1,0
1/01/2023,United Arab Emirates,Sabah,0,0,0
1/01/2023,United Arab Emirates,Sarawak,0,0,0
1/01/2023,United Arab Emirates,Selangor,275,168,107
1/01/2023,Argentina,Johor,90,54,36
1/01/2023,Argentina,Kedah,163,82,81
1/01/2023,Argentina,Kelantan,2,0,2
1/01/2023,Argentina,Melaka,0,0,0
1/01/2023,Argentina,Perak,0,0,0
1/01/2023,Argentina,Perlis,1,0,1
1/01/2023,Argentina,Pulau Pinang,10,6,4
1/01/2023,Argentina,Sabah,0,0,0
1/01/2023,Argentina,Sarawak,1,1,0
1/01/2023,Argentina,Selangor,443,236,207
1/01/2023,Argentina,W.P. Labuan,0,0,0
1/01/2023,Armenia,Johor,6,3,3
1/01/2023,Armenia,Kedah,0,0,0
1/01/2023,Armenia,Kelantan,0,0,0
1/01/2023,Armenia,Perak,0,0,0
1/01/2023,Armenia,Perlis,0,0,0
1/01/2023,Armenia,Pulau Pinang,1,0,1
1/01/2023,Armenia,Sabah,0,0,0
1/01/2023,Armenia,Sarawak,0,0,0
1/01/2023,Armenia,Selangor,49,24,25
1/01/2023,Antarctica,Selangor,0,0,0
1/01/2023,Antigua and Barbuda,Johor,9,5,4
1/01/2023,Antigua and Barbuda,Kedah,0,0,0
1/01/2023,Antigua and Barbuda,Pulau Pinang,0,0,0
1/01/2023,Antigua and Barbuda,Sarawak,0,0,0
1/01/2023,Antigua and Barbuda,Selangor,13,7,6
1/01/2023,Australia,Johor,6459,3580,2879
1/01/2023,Australia,Kedah,814,438,376
1/01/2023,Australia,Kelantan,5,5,0
1/01/2023,Australia,Melaka,0,0,0
1/01/2023,Australia,Negeri Sembilan,0,0,0
1/01/2023,Australia,Pahang,26,13,13
1/01/2023,Australia,Perak,348,173,175
1/01/2023,Australia,Perlis,122,75,47
1/01/2023,Australia,Pulau Pinang,2518,1325,1193
1/01/2023,Australia,Sabah,626,315,311
1/01/2023,Australia,Sarawak,900,464,436
1/01/2023,Australia,Selangor,31592,17342,14250
1/01/2023,Australia,Terengganu,0,0,0
1/01/2023,Australia,W.P. Labuan,11,11,0
1/01/2023,Austria,Johor,142,86,56
1/01/2023,Austria,Kedah,131,64,67
1/01/2023,Austria,Kelantan,3,3,0
1/01/2023,Austria,Melaka,0,0,0
1/01/2023,Austria,Negeri Sembilan,0,0,0
1/01/2023,Austria,Pahang,0,0,0
1/01/2023,Austria,Perak,0,0,0
1/01/2023,Austria,Perlis,19,14,5
1/01/2023,Austria,Pulau Pinang,92,60,32
1/01/2023,Austria,Sabah,9,7,2
1/01/2023,Austria,Sarawak,10,7,3
1/01/2023,Austria,Selangor,823,497,326
1/01/2023,Austria,Terengganu,0,0,0
1/01/2023,Austria,W.P. Labuan,1,1,0
1/01/2023,Azerbaijan,Johor,4,2,2
1/01/2023,Azerbaijan,Kedah,3,3,0
1/01/2023,Azerbaijan,Kelantan,0,0,0
1/01/2023,Azerbaijan,Melaka,0,0,0
1/01/2023,Azerbaijan,Perlis,0,0,0
1/01/2023,Azerbaijan,Pulau Pinang,0,0,0
1/01/2023,Azerbaijan,Sabah,0,0,0
1/01/2023,Azerbaijan,Sarawak,0,0,0
1/01/2023,Azerbaijan,Selangor,79,43,36
1/01/2023,Azerbaijan,W.P. Labuan,0,0,0
1/01/2023,Burundi,Pulau Pinang,0,0,0
1/01/2023,Burundi,Sarawak,1,1,0
1/01/2023,Burundi,Selangor,9,4,5
1/01/2023,Belgium,Johor,181,120,61
1/01/2023,Belgium,Kedah,88,51,37
1/01/2023,Belgium,Kelantan,0,0,0
1/01/2023,Belgium,Melaka,0,0,0
1/01/2023,Belgium,Negeri Sembilan,0,0,0
1/01/2023,Belgium,Pahang,0,0,0
1/01/2023,Belgium,Perak,6,4,2
1/01/2023,Belgium,Perlis,32,18,14
1/01/2023,Belgium,Pulau Pinang,42,29,13
1/01/2023,Belgium,Sabah,12,7,5
1/01/2023,Belgium,Sarawak,18,11,7
1/01/2023,Belgium,Selangor,751,490,261
1/01/2023,Belgium,W.P. Labuan,0,0,0
1/01/2023,Benin,Johor,0,0,0
1/01/2023,Benin,Kedah,0,0,0
1/01/2023,Benin,Perak,0,0,0
1/01/2023,Benin,Pulau Pinang,0,0,0
1/01/2023,Benin,Sabah,0,0,0
1/01/2023,Benin,Sarawak,0,0,0
1/01/2023,Benin,Selangor,10,6,4
1/01/2023,Burkina Faso,Perak,0,0,0
1/01/2023,Burkina Faso,Pulau Pinang,1,1,0
1/01/2023,Burkina Faso,Selangor,6,5,1
1/01/2023,Bangladesh,Johor,5102,4614,488
1/01/2023,Bangladesh,Kedah,64,38,26
1/01/2023,Bangladesh,Kelantan,1,1,0
1/01/2023,Bangladesh,Melaka,0,0,0
1/01/2023,Bangladesh,Negeri Sembilan,0,0,0
1/01/2023,Bangladesh,Pahang,1,1,0
1/01/2023,Bangladesh,Perak,0,0,0
1/01/2023,Bangladesh,Perlis,1,1,0
1/01/2023,Bangladesh,Pulau Pinang,831,820,11
1/01/2023,Bangladesh,Sabah,3,2,1
1/01/2023,Bangladesh,Sarawak,35,31,4
1/01/2023,Bangladesh,Selangor,45792,43860,1932
1/01/2023,Bangladesh,W.P. Labuan,8,5,3
1/01/2023,Bulgaria,Johor,41,25,16
1/01/2023,Bulgaria,Kedah,12,7,5
1/01/2023,Bulgaria,Kelantan,0,0,0
1/01/2023,Bulgaria,Pahang,0,0,0
1/01/2023,Bulgaria,Perak,1,1,0
1/01/2023,Bulgaria,Perlis,4,3,1
1/01/2023,Bulgaria,Pulau Pinang,13,10,3
1/01/2023,Bulgaria,Sabah,9,4,5
1/01/2023,Bulgaria,Sarawak,4,3,1
1/01/2023,Bulgaria,Selangor,204,120,84
1/01/2023,Bulgaria,W.P. Labuan,0,0,0
1/01/2023,Bahrain,Johor,40,23,17
1/01/2023,Bahrain,Kedah,1,0,1
1/01/2023,Bahrain,Kelantan,2,1,1
1/01/2023,Bahrain,Perlis,1,1,0
1/01/2023,Bahrain,Pulau Pinang,2,1,1
1/01/2023,Bahrain,Sabah,0,0,0
1/01/2023,Bahrain,Sarawak,0,0,0
1/01/2023,Bahrain,Selangor,193,116,77
1/01/2023,Bahamas,Johor,2,2,0
1/01/2023,Bahamas,Kedah,2,2,0
1/01/2023,Bahamas,Perak,0,0,0
1/01/2023,Bahamas,Sabah,0,0,0
1/01/2023,Bahamas,Sarawak,0,0,0
1/01/2023,Bahamas,Selangor,18,6,12
1/01/2023,Bosnia and Herzegovina,Johor,3,2,1
1/01/2023,Bosnia and Herzegovina,Kedah,2,2,0
1/01/2023,Bosnia and Herzegovina,Perlis,0,0,0
1/01/2023,Bosnia and Herzegovina,Pulau Pinang,3,2,1
1/01/2023,Bosnia and Herzegovina,Sabah,0,0,0
1/01/2023,Bosnia and Herzegovina,Sarawak,0,0,0
1/01/2023,Bosnia and Herzegovina,Selangor,70,39,31
1/01/2023,Belarus,Johor,20,6,14
1/01/2023,Belarus,Kedah,23,13,10
1/01/2023,Belarus,Kelantan,4,2,2
1/01/2023,Belarus,Pahang,0,0,0
1/01/2023,Belarus,Perak,0,0,0
1/01/2023,Belarus,Perlis,1,0,1
1/01/2023,Belarus,Pulau Pinang,7,4,3
1/01/2023,Belarus,Sabah,4,1,3
1/01/2023,Belarus,Sarawak,10,4,6
1/01/2023,Belarus,Selangor,487,226,261
1/01/2023,Belarus,W.P. Labuan,0,0,0
1/01/2023,Belize,Johor,2,0,2
1/01/2023,Belize,Pulau Pinang,0,0,0
1/01/2023,Belize,Sarawak,0,0,0
1/01/2023,Belize,Selangor,19,10,9
1/01/2023,Bermuda,Selangor,0,0,0
1/01/2023,Bolivia,Johor,6,4,2
1/01/2023,Bolivia,Kedah,0,0,0
1/01/2023,Bolivia,Melaka,1,1,0
1/01/2023,Bolivia,Perak,0,0,0
1/01/2023,Bolivia,Perlis,1,1,0
1/01/2023,Bolivia,Pulau Pinang,1,1,0
1/01/2023,Bolivia,Sabah,0,0,0
1/01/2023,Bolivia,Sarawak,1,0,1
1/01/2023,Bolivia,Selangor,39,23,16
1/01/2023,Brazil,Johor,260,147,113
1/01/2023,Brazil,Kedah,102,53,49
1/01/2023,Brazil,Kelantan,0,0,0
1/01/2023,Brazil,Melaka,0,0,0
1/01/2023,Brazil,Pahang,0,0,0
1/01/2023,Brazil,Perak,0,0,0
1/01/2023,Brazil,Perlis,12,7,5
1/01/2023,Brazil,Pulau Pinang,26,16,10
1/01/2023,Brazil,Sabah,3,3,0
1/01/2023,Brazil,Sarawak,4,3,1
1/01/2023,Brazil,Selangor,848,456,392
1/01/2023,Brazil,W.P. Labuan,0,0,0
1/01/2023,Barbados,Johor,0,0,0
1/01/2023,Barbados,Kedah,1,1,0
1/01/2023,Barbados,Perlis,0,0,0
1/01/2023,Barbados,Pulau Pinang,0,0,0
1/01/2023,Barbados,Selangor,10,4,6
1/01/2023,Brunei Darussalam,Johor,308,160,148
1/01/2023,Brunei Darussalam,Kedah,17,8,9
1/01/2023,Brunei Darussalam,Kelantan,1,1,0
1/01/2023,Brunei Darussalam,Melaka,6,3,3
1/01/2023,Brunei Darussalam,Pahang,0,0,0
1/01/2023,Brunei Darussalam,Perak,2,1,1
1/01/2023,Brunei Darussalam,Perlis,19,13,6
1/01/2023,Brunei Darussalam,Pulau Pinang,10,2,8
1/01/2023,Brunei Darussalam,Sabah,686,308,378
1/01/2023,Brunei Darussalam,Sarawak,86761,47354,39407
1/01/2023,Brunei Darussalam,Selangor,4105,2054,2051
1/01/2023,Brunei Darussalam,W.P. Labuan,1210,846,364
1/01/2023,Bhutan,Johor,10,5,5
1/01/2023,Bhutan,Kedah,0,0,0
1/01/2023,Bhutan,Perak,0,0,0
1/01/2023,Bhutan,Perlis,2,1,1
1/01/2023,Bhutan,Pulau Pinang,2,2,0
1/01/2023,Bhutan,Sabah,0,0,0
1/01/2023,Bhutan,Sarawak,0,0,0
1/01/2023,Bhutan,Selangor,17,11,6
1/01/2023,Botswana,Johor,1,0,1
1/01/2023,Botswana,Kedah,0,0,0
1/01/2023,Botswana,Perlis,0,0,0
1/01/2023,Botswana,Pulau Pinang,0,0,0
1/01/2023,Botswana,Sabah,0,0,0
1/01/2023,Botswana,Sarawak,0,0,0
1/01/2023,Botswana,Selangor,17,8,9
1/01/2023,Central African Republic,Kedah,0,0,0
1/01/2023,Central African Republic,Selangor,0,0,0
1/01/2023,Canada,Johor,1444,814,630
1/01/2023,Canada,Kedah,292,152,140
1/01/2023,Canada,Kelantan,3,1,2
1/01/2023,Canada,Melaka,1,1,0
1/01/2023,Canada,Negeri Sembilan,0,0,0
1/01/2023,Canada,Pahang,2,2,0
1/01/2023,Canada,Perak,34,18,16
1/01/2023,Canada,Perlis,78,48,30
1/01/2023,Canada,Pulau Pinang,554,312,242
1/01/2023,Canada,Sabah,169,76,93
1/01/2023,Canada,Sarawak,396,223,173
1/01/2023,Canada,Selangor,4335,2501,1834
1/01/2023,Canada,Terengganu,0,0,0
1/01/2023,Canada,W.P. Labuan,6,5,1
1/01/2023,Cocos (Keeling) Islands,Selangor,0,0,0
1/01/2023,Switzerland,Johor,322,200,122
1/01/2023,Switzerland,Kedah,215,117,98
1/01/2023,Switzerland,Kelantan,2,1,1
1/01/2023,Switzerland,Melaka,0,0,0
1/01/2023,Switzerland,Negeri Sembilan,0,0,0
1/01/2023,Switzerland,Pahang,4,3,1
1/01/2023,Switzerland,Perak,3,3,0
1/01/2023,Switzerland,Perlis,45,29,16
1/01/2023,Switzerland,Pulau Pinang,154,89,65
1/01/2023,Switzerland,Sabah,19,11,8
1/01/2023,Switzerland,Sarawak,20,11,9
1/01/2023,Switzerland,Selangor,1109,651,458
1/01/2023,Switzerland,W.P. Labuan,0,0,0
1/01/2023,Chile,Johor,31,15,16
1/01/2023,Chile,Kedah,30,17,13
1/01/2023,Chile,Kelantan,0,0,0
1/01/2023,Chile,Melaka,0,0,0
1/01/2023,Chile,Pahang,0,0,0
1/01/2023,Chile,Perak,0,0,0
1/01/2023,Chile,Perlis,6,4,2
1/01/2023,Chile,Pulau Pinang,7,6,1
1/01/2023,Chile,Sabah,1,1,0
1/01/2023,Chile,Sarawak,0,0,0
1/01/2023,Chile,Selangor,167,83,84
1/01/2023,China,Johor,22538,9459,13079
1/01/2023,China,Kedah,549,243,306
1/01/2023,China,Kelantan,17,7,10
1/01/2023,China,Melaka,1,1,0
1/01/2023,China,Pahang,17,8,9
1/01/2023,China,Perak,109,40,69
1/01/2023,China,Perlis,88,37,51
1/01/2023,China,Pulau Pinang,2863,1375,1488
1/01/2023,China,Sabah,1694,814,880
1/01/2023,China,Sarawak,614,274,340
1/01/2023,China,Selangor,28763,14551,14212
1/01/2023,China,Terengganu,0,0,0
1/01/2023,China,W.P. Labuan,37,34,3
1/01/2023,Côte d'Ivoire,Johor,0,0,0
1/01/2023,Côte d'Ivoire,Kedah,0,0,0
1/01/2023,Côte d'Ivoire,Pulau Pinang,0,0,0
1/01/2023,Côte d'Ivoire,Sabah,0,0,0
1/01/2023,Côte d'Ivoire,Sarawak,0,0,0
1/01/2023,Côte d'Ivoire,Selangor,8,6,2
1/01/2023,Cameroon,Johor,4,4,0
1/01/2023,Cameroon,Kedah,0,0,0
1/01/2023,Cameroon,Pulau Pinang,0,0,0
1/01/2023,Cameroon,Sabah,0,0,0
1/01/2023,Cameroon,Sarawak,0,0,0
1/01/2023,Cameroon,Selangor,19,14,5
1/01/2023,Congo,Johor,0,0,0
1/01/2023,Congo,Pulau Pinang,0,0,0
1/01/2023,Congo,Sarawak,2,1,1
1/01/2023,Congo,Selangor,12,8,4
1/01/2023,Congo,Johor,0,0,0
1/01/2023,Congo,Kedah,0,0,0
1/01/2023,Congo,Selangor,0,0,0
1/01/2023,Cook Islands,Selangor,0,0,0
1/01/2023,Colombia,Johor,35,14,21
1/01/2023,Colombia,Kedah,0,0,0
1/01/2023,Colombia,Perak,1,1,0
1/01/2023,Colombia,Pulau Pinang,1,1,0
1/01/2023,Colombia,Sabah,0,0,0
1/01/2023,Colombia,Sarawak,1,1,0
1/01/2023,Colombia,Selangor,186,99,87
1/01/2023,Colombia,W.P. Labuan,0,0,0
1/01/2023,Comoros,Johor,1,0,1
1/01/2023,Comoros,Kedah,0,0,0
1/01/2023,Comoros,Selangor,15,11,4
1/01/2023,Cabo Verde,Johor,0,0,0
1/01/2023,Cabo Verde,Kedah,2,2,0
1/01/2023,Cabo Verde,Pulau Pinang,0,0,0
1/01/2023,Cabo Verde,Sabah,0,0,0
1/01/2023,Cabo Verde,Selangor,3,0,3
1/01/2023,Costa Rica,Johor,15,9,6
1/01/2023,Costa Rica,Kedah,1,0,1
1/01/2023,Costa Rica,Perak,0,0,0
1/01/2023,Costa Rica,Perlis,0,0,0
1/01/2023,Costa Rica,Pulau Pinang,9,4,5
1/01/2023,Costa Rica,Sabah,0,0,0
1/01/2023,Costa Rica,Sarawak,0,0,0
1/01/2023,Costa Rica,Selangor,48,26,22
1/01/2023,Cuba,Johor,3,2,1
1/01/2023,Cuba,Kedah,1,0,1
1/01/2023,Cuba,Perlis,0,0,0
1/01/2023,Cuba,Pulau Pinang,0,0,0
1/01/2023,Cuba,Sabah,0,0,0
1/01/2023,Cuba,Sarawak,0,0,0
1/01/2023,Cuba,Selangor,19,5,14
1/01/2023,Cyprus,Johor,10,5,5
1/01/2023,Cyprus,Kedah,5,1,4
1/01/2023,Cyprus,Perak,0,0,0
1/01/2023,Cyprus,Perlis,0,0,0
1/01/2023,Cyprus,Pulau Pinang,4,3,1
1/01/2023,Cyprus,Sabah,0,0,0
1/01/2023,Cyprus,Sarawak,6,0,6
1/01/2023,Cyprus,Selangor,47,33,14
1/01/2023,Czechia,Johor,93,53,40
1/01/2023,Czechia,Kedah,112,68,44
1/01/2023,Czechia,Kelantan,0,0,0
1/01/2023,Czechia,Melaka,0,0,0
1/01/2023,Czechia,Negeri Sembilan,0,0,0
1/01/2023,Czechia,Perak,0,0,0
1/01/2023,Czechia,Perlis,16,9,7
1/01/2023,Czechia,Pulau Pinang,35,19,16
1/01/2023,Czechia,Sabah,13,9,4
1/01/2023,Czechia,Sarawak,6,4,2
1/01/2023,Czechia,Selangor,515,285,230
1/01/2023,Czechia,W.P. Labuan,0,0,0
1/01/2023,Germany,Johor,2128,1312,816
1/01/2023,Germany,Kedah,1174,630,544
1/01/2023,Germany,Kelantan,7,6,1
1/01/2023,Germany,Melaka,5,3,2
1/01/2023,Germany,Negeri Sembilan,0,0,0
1/01/2023,Germany,Pahang,3,2,1
1/01/2023,Germany,Perak,26,16,10
1/01/2023,Germany,Perlis,241,154,87
1/01/2023,Germany,Pulau Pinang,699,447,252
1/01/2023,Germany,Sabah,115,73,42
1/01/2023,Germany,Sarawak,188,114,74
1/01/2023,Germany,Selangor,7921,4583,3338
1/01/2023,Germany,Terengganu,0,0,0
1/01/2023,Germany,W.P. Labuan,5,3,2
1/01/2023,Djibouti,Johor,0,0,0
1/01/2023,Djibouti,Selangor,15,8,7
1/01/2023,Dominica,Johor,3,3,0
1/01/2023,Dominica,Kedah,1,1,0
1/01/2023,Dominica,Pulau Pinang,0,0,0
1/01/2023,Dominica,Sabah,0,0,0
1/01/2023,Dominica,Sarawak,0,0,0
1/01/2023,Dominica,Selangor,35,25,10
1/01/2023,Dominica,W.P. Labuan,0,0,0
1/01/2023,Denmark,Johor,278,187,91
1/01/2023,Denmark,Kedah,231,119,112
1/01/2023,Denmark,Kelantan,5,4,1
1/01/2023,Denmark,Melaka,0,0,0
1/01/2023,Denmark,Negeri Sembilan,0,0,0
1/01/2023,Denmark,Pahang,0,0,0
1/01/2023,Denmark,Perak,1,1,0
1/01/2023,Denmark,Perlis,33,26,7
1/01/2023,Denmark,Pulau Pinang,85,56,29
1/01/2023,Denmark,Sabah,52,21,31
1/01/2023,Denmark,Sarawak,13,8,5
1/01/2023,Denmark,Selangor,1016,562,454
1/01/2023,Denmark,W.P. Labuan,0,0,0
1/01/2023,Dominican Republic,Johor,2,1,1
1/01/2023,Dominican Republic,Kedah,0,0,0
1/01/2023,Dominican Republic,Perak,0,0,0
1/01/2023,Dominican Republic,Perlis,0,0,0
1/01/2023,Dominican Republic,Pulau Pinang,0,0,0
1/01/2023,Dominican Republic,Sabah,0,0,0
1/01/2023,Dominican Republic,Sarawak,0,0,0
1/01/2023,Dominican Republic,Selangor,12,8,4
1/01/2023,Algeria,Johor,13,12,1
1/01/2023,Algeria,Kedah,3,3,0
1/01/2023,Algeria,Kelantan,0,0,0
1/01/2023,Algeria,Melaka,0,0,0
1/01/2023,Algeria,Perak,0,0,0
1/01/2023,Algeria,Perlis,1,1,0
1/01/2023,Algeria,Pulau Pinang,2,2,0
1/01/2023,Algeria,Sabah,0,0,0
1/01/2023,Algeria,Sarawak,12,10,2
1/01/2023,Algeria,Selangor,469,308,161
1/01/2023,Algeria,W.P. Labuan,0,0,0
1/01/2023,Ecuador,Johor,6,1,5
1/01/2023,Ecuador,Kedah,0,0,0
1/01/2023,Ecuador,Perak,0,0,0
1/01/2023,Ecuador,Perlis,0,0,0
1/01/2023,Ecuador,Pulau Pinang,1,1,0
1/01/2023,Ecuador,Sabah,1,0,1
1/01/2023,Ecuador,Sarawak,0,0,0
1/01/2023,Ecuador,Selangor,30,14,16
1/01/2023,Egypt,Johor,168,133,35
1/01/2023,Egypt,Kedah,3,3,0
1/01/2023,Egypt,Kelantan,0,0,0
1/01/2023,Egypt,Melaka,1,1,0
1/01/2023,Egypt,Pahang,0,0,0
1/01/2023,Egypt,Perak,0,0,0
1/01/2023,Egypt,Perlis,2,1,1
1/01/2023,Egypt,Pulau Pinang,10,8,2
1/01/2023,Egypt,Sabah,6,6,0
1/01/2023,Egypt,Sarawak,134,89,45
1/01/2023,Egypt,Selangor,1345,903,442
1/01/2023,Egypt,Terengganu,0,0,0
1/01/2023,Egypt,W.P. Labuan,0,0,0
1/01/2023,Eritrea,Johor,0,0,0
1/01/2023,Eritrea,Pulau Pinang,0,0,0
1/01/2023,Eritrea,Sabah,0,0,0
1/01/2023,Eritrea,Selangor,12,7,5
1/01/2023,Spain,Johor,396,240,156
1/01/2023,Spain,Kedah,300,158,142
1/01/2023,Spain,Kelantan,5,2,3
1/01/2023,Spain,Melaka,0,0,0
1/01/2023,Spain,Negeri Sembilan,1,1,0
1/01/2023,Spain,Pahang,0,0,0
1/01/2023,Spain,Perak,1,1,0
1/01/2023,Spain,Perlis,43,33,10
1/01/2023,Spain,Pulau Pinang,60,40,20
1/01/2023,Spain,Sabah,35,21,14
1/01/2023,Spain,Sarawak,22,14,8
1/01/2023,Spain,Selangor,1744,1026,718
1/01/2023,Spain,W.P. Labuan,0,0,0
1/01/2023,Estonia,Johor,42,23,19
1/01/2023,Estonia,Kedah,54,26,28
1/01/2023,Estonia,Kelantan,0,0,0
1/01/2023,Estonia,Pahang,0,0,0
1/01/2023,Estonia,Perak,0,0,0
1/01/2023,Estonia,Perlis,5,3,2
1/01/2023,Estonia,Pulau Pinang,26,12,14
1/01/2023,Estonia,Sabah,9,4,5
1/01/2023,Estonia,Sarawak,2,1,1
1/01/2023,Estonia,Selangor,205,108,97
1/01/2023,Estonia,W.P. Labuan,0,0,0
1/01/2023,Ethiopia,Johor,2,2,0
1/01/2023,Ethiopia,Kedah,0,0,0
1/01/2023,Ethiopia,Pulau Pinang,0,0,0
1/01/2023,Ethiopia,Sarawak,0,0,0
1/01/2023,Ethiopia,Selangor,34,21,13
1/01/2023,Finland,Johor,222,140,82
1/01/2023,Finland,Kedah,158,85,73
1/01/2023,Finland,Kelantan,2,0,2
1/01/2023,Finland,Melaka,0,0,0
1/01/2023,Finland,Negeri Sembilan,0,0,0
1/01/2023,Finland,Pahang,0,0,0
1/01/2023,Finland,Perak,3,2,1
1/01/2023,Finland,Perlis,16,13,3
1/01/2023,Finland,Pulau Pinang,61,38,23
1/01/2023,Finland,Sabah,24,13,11
1/01/2023,Finland,Sarawak,12,5,7
1/01/2023,Finland,Selangor,747,428,319
1/01/2023,Finland,W.P. Labuan,0,0,0
1/01/2023,Fiji,Johor,41,16,25
1/01/2023,Fiji,Kedah,0,0,0
1/01/2023,Fiji,Kelantan,0,0,0
1/01/2023,Fiji,Perak,1,1,0
1/01/2023,Fiji,Perlis,1,0,1
1/01/2023,Fiji,Pulau Pinang,3,2,1
1/01/2023,Fiji,Sabah,2,2,0
1/01/2023,Fiji,Sarawak,0,0,0
1/01/2023,Fiji,Selangor,91,41,50
1/01/2023,France,Johor,1595,988,607
1/01/2023,France,Kedah,707,381,326
1/01/2023,France,Kelantan,11,7,4
1/01/2023,France,Melaka,4,2,2
1/01/2023,France,Negeri Sembilan,0,0,0
1/01/2023,France,Pahang,10,7,3
1/01/2023,France,Perak,15,10,5
1/01/2023,France,Perlis,145,93,52
1/01/2023,France,Pulau Pinang,324,216,108
1/01/2023,France,Sabah,109,59,50
1/01/2023,France,Sarawak,49,35,14
1/01/2023,France,Selangor,6034,3593,2441
1/01/2023,France,Terengganu,0,0,0
1/01/2023,France,W.P. Labuan,1,1,0
1/01/2023,"Micronesia, Federated States of",Johor,0,0,0
1/01/2023,"Micronesia, Federated States of",Pulau Pinang,0,0,0
1/01/2023,"Micronesia, Federated States of",Selangor,0,0,0
1/01/2023,Gabon,Johor,1,1,0
1/01/2023,Gabon,Pulau Pinang,0,0,0
1/01/2023,Gabon,Sarawak,0,0,0
1/01/2023,Gabon,Selangor,10,6,4
1/01/2023,United Kingdom of Great Britain and Northern Ireland,Johor,3944,2471,1473
1/01/2023,United Kingdom of Great Britain and Northern Ireland,Kedah,1689,931,758
1/01/2023,United Kingdom of Great Britain and Northern Ireland,Kelantan,10,7,3
1/01/2023,United Kingdom of Great Britain and Northern Ireland,Melaka,8,6,2
1/01/2023,United Kingdom of Great Britain and Northern Ireland,Negeri Sembilan,1,1,0
1/01/2023,United Kingdom of Great Britain and Northern Ireland,Pahang,5,5,0
1/01/2023,United Kingdom of Great Britain and Northern Ireland,Perak,73,44,29
1/01/2023,United Kingdom of Great Britain and Northern Ireland,Perlis,244,158,86
1/01/2023,United Kingdom of Great Britain and Northern Ireland,Pulau Pinang,1568,919,649
1/01/2023,United Kingdom of Great Britain and Northern Ireland,Sabah,476,278,198
1/01/2023,United Kingdom of Great Britain and Northern Ireland,Sarawak,1028,646,382
1/01/2023,United Kingdom of Great Britain and Northern Ireland,Selangor,15954,9588,6366
1/01/2023,United Kingdom of Great Britain and Northern Ireland,Terengganu,0,0,0
1/01/2023,United Kingdom of Great Britain and Northern Ireland,W.P. Labuan,40,32,8
1/01/2023,Georgia,Johor,6,6,0
1/01/2023,Georgia,Kedah,1,1,0
1/01/2023,Georgia,Melaka,0,0,0
1/01/2023,Georgia,Perak,0,0,0
1/01/2023,Georgia,Perlis,0,0,0
1/01/2023,Georgia,Pulau Pinang,1,0,1
1/01/2023,Georgia,Sabah,0,0,0
1/01/2023,Georgia,Sarawak,0,0,0
1/01/2023,Georgia,Selangor,49,27,22
1/01/2023,Ghana,Johor,4,4,0
1/01/2023,Ghana,Kedah,0,0,0
1/01/2023,Ghana,Kelantan,0,0,0
1/01/2023,Ghana,Pulau Pinang,2,1,1
1/01/2023,Ghana,Sabah,0,0,0
1/01/2023,Ghana,Sarawak,2,1,1
1/01/2023,Ghana,Selangor,53,45,8
1/01/2023,Gibraltar,Johor,0,0,0
1/01/2023,Gibraltar,Sarawak,0,0,0
1/01/2023,Guinea,Johor,4,3,1
1/01/2023,Guinea,Kedah,1,1,0
1/01/2023,Guinea,Kelantan,0,0,0
1/01/2023,Guinea,Perlis,0,0,0
1/01/2023,Guinea,Pulau Pinang,0,0,0
1/01/2023,Guinea,Sabah,0,0,0
1/01/2023,Guinea,Sarawak,0,0,0
1/01/2023,Guinea,Selangor,49,35,14
1/01/2023,Guadeloupe,Selangor,0,0,0
1/01/2023,Gambia,Johor,0,0,0
1/01/2023,Gambia,Kedah,0,0,0
1/01/2023,Gambia,Kelantan,0,0,0
1/01/2023,Gambia,Pulau Pinang,1,1,0
1/01/2023,Gambia,Sabah,0,0,0
1/01/2023,Gambia,Sarawak,0,0,0
1/01/2023,Gambia,Selangor,11,8,3
1/01/2023,Guinea-Bissau,Johor,0,0,0
1/01/2023,Guinea-Bissau,Selangor,0,0,0
1/01/2023,Equatorial Guinea,Johor,0,0,0
1/01/2023,Equatorial Guinea,Selangor,4,1,3
1/01/2023,Greece,Johor,60,41,19
1/01/2023,Greece,Kedah,19,10,9
1/01/2023,Greece,Kelantan,0,0,0
1/01/2023,Greece,Melaka,0,0,0
1/01/2023,Greece,Negeri Sembilan,1,1,0
1/01/2023,Greece,Pahang,0,0,0
1/01/2023,Greece,Perak,0,0,0
1/01/2023,Greece,Perlis,1,1,0
1/01/2023,Greece,Pulau Pinang,6,5,1
1/01/2023,Greece,Sabah,2,2,0
1/01/2023,Greece,Sarawak,1,0,1
1/01/2023,Greece,Selangor,219,161,58
1/01/2023,Grenada,Johor,15,8,7
1/01/2023,Grenada,Kedah,0,0,0
1/01/2023,Grenada,Pulau Pinang,0,0,0
1/01/2023,Grenada,Sabah,0,0,0
1/01/2023,Grenada,Sarawak,0,0,0
1/01/2023,Grenada,Selangor,17,10,7
1/01/2023,Greenland,Johor,0,0,0
1/01/2023,Greenland,Selangor,0,0,0
1/01/2023,Guatemala,Johor,1,1,0
1/01/2023,Guatemala,Kedah,1,0,1
1/01/2023,Guatemala,Pahang,0,0,0
1/01/2023,Guatemala,Perak,0,0,0
1/01/2023,Guatemala,Pulau Pinang,3,2,1
1/01/2023,Guatemala,Sabah,0,0,0
1/01/2023,Guatemala,Sarawak,0,0,0
1/01/2023,Guatemala,Selangor,15,8,7
1/01/2023,Guatemala,W.P. Labuan,0,0,0
1/01/2023,Guyana,Johor,0,0,0
1/01/2023,Guyana,Kedah,0,0,0
1/01/2023,Guyana,Pulau Pinang,0,0,0
1/01/2023,Guyana,Sarawak,0,0,0
1/01/2023,Guyana,Selangor,0,0,0
1/01/2023,Hong Kong,Johor,5,2,3
1/01/2023,Hong Kong,Kedah,2,1,1
1/01/2023,Hong Kong,Kelantan,0,0,0
1/01/2023,Hong Kong,Pahang,1,0,1
1/01/2023,Hong Kong,Perak,37,17,20
1/01/2023,Hong Kong,Perlis,5,2,3
1/01/2023,Hong Kong,Pulau Pinang,0,0,0
1/01/2023,Hong Kong,Sabah,0,0,0
1/01/2023,Hong Kong,Sarawak,0,0,0
1/01/2023,Hong Kong,Selangor,14,10,4
1/01/2023,Hong Kong,Terengganu,0,0,0
1/01/2023,Heard Island and McDonald Islands,Johor,0,0,0
1/01/2023,Honduras,Johor,4,1,3
1/01/2023,Honduras,Kedah,0,0,0
1/01/2023,Honduras,Perak,0,0,0
1/01/2023,Honduras,Pulau Pinang,3,1,2
1/01/2023,Honduras,Sabah,0,0,0
1/01/2023,Honduras,Sarawak,0,0,0
1/01/2023,Honduras,Selangor,21,10,11
1/01/2023,Croatia,Johor,36,26,10
1/01/2023,Croatia,Kedah,11,5,6
1/01/2023,Croatia,Kelantan,0,0,0
1/01/2023,Croatia,Melaka,0,0,0
1/01/2023,Croatia,Pahang,0,0,0
1/01/2023,Croatia,Perak,0,0,0
1/01/2023,Croatia,Perlis,0,0,0
1/01/2023,Croatia,Pulau Pinang,10,7,3
1/01/2023,Croatia,Sabah,2,0,2
1/01/2023,Croatia,Sarawak,3,3,0
1/01/2023,Croatia,Selangor,175,107,68
1/01/2023,Haiti,Johor,0,0,0
1/01/2023,Haiti,Kedah,0,0,0
1/01/2023,Haiti,Kelantan,0,0,0
1/01/2023,Haiti,Perak,0,0,0
1/01/2023,Haiti,Pulau Pinang,0,0,0
1/01/2023,Haiti,Sabah,0,0,0
1/01/2023,Haiti,Selangor,6,4,2
1/01/2023,Hungary,Johor,90,63,27
1/01/2023,Hungary,Kedah,49,22,27
1/01/2023,Hungary,Kelantan,0,0,0
1/01/2023,Hungary,Pahang,0,0,0
1/01/2023,Hungary,Perak,0,0,0
1/01/2023,Hungary,Perlis,5,3,2
1/01/2023,Hungary,Pulau Pinang,31,17,14
1/01/2023,Hungary,Sabah,1,1,0
1/01/2023,Hungary,Sarawak,6,5,1
1/01/2023,Hungary,Selangor,460,244,216
1/01/2023,Hungary,W.P. Labuan,0,0,0
1/01/2023,Indonesia,Johor,105128,55208,49920
1/01/2023,Indonesia,Kedah,4720,1849,2871
1/01/2023,Indonesia,Kelantan,120,79,41
1/01/2023,Indonesia,Melaka,5322,2392,2930
1/01/2023,Indonesia,Negeri Sembilan,8075,5572,2503
1/01/2023,Indonesia,Pahang,7,2,5
1/01/2023,Indonesia,Perak,171,44,127
1/01/2023,Indonesia,Perlis,620,224,396
1/01/2023,Indonesia,Pulau Pinang,33065,11879,21186
1/01/2023,Indonesia,Sabah,5351,2675,2676
1/01/2023,Indonesia,Sarawak,40632,21623,19009
1/01/2023,Indonesia,Selangor,97722,46409,51313
1/01/2023,Indonesia,Terengganu,0,0,0
1/01/2023,Indonesia,W.P. Labuan,44,28,16
1/01/2023,India,Johor,15320,10961,4359
1/01/2023,India,Kedah,509,314,195
1/01/2023,India,Kelantan,1,1,0
1/01/2023,India,Melaka,0,0,0
1/01/2023,India,Negeri Sembilan,0,0,0
1/01/2023,India,Pahang,9,8,1
1/01/2023,India,Perak,259,206,53
1/01/2023,India,Perlis,61,55,6
1/01/2023,India,Pulau Pinang,552,405,147
1/01/2023,India,Sabah,201,149,52
1/01/2023,India,Sarawak,903,722,181
1/01/2023,India,Selangor,38155,26397,11758
1/01/2023,India,Terengganu,0,0,0
1/01/2023,India,W.P. Labuan,38,30,8
1/01/2023, British Indian Ocean Territory,Pulau Pinang,1,0,1
1/01/2023, British Indian Ocean Territory,Selangor,0,0,0
1/01/2023,Ireland,Johor,249,163,86
1/01/2023,Ireland,Kedah,120,68,52
1/01/2023,Ireland,Kelantan,0,0,0
1/01/2023,Ireland,Negeri Sembilan,0,0,0
1/01/2023,Ireland,Pahang,0,0,0
1/01/2023,Ireland,Perak,5,3,2
1/01/2023,Ireland,Perlis,16,8,8
1/01/2023,Ireland,Pulau Pinang,79,50,29
1/01/2023,Ireland,Sabah,26,16,10
1/01/2023,Ireland,Sarawak,28,14,14
1/01/2023,Ireland,Selangor,1211,727,484
1/01/2023,Ireland,Terengganu,0,0,0
1/01/2023,Ireland,W.P. Labuan,0,0,0
1/01/2023,"Iran, Islamic Republic of",Johor,81,62,19
1/01/2023,"Iran, Islamic Republic of",Kedah,5,3,2
1/01/2023,"Iran, Islamic Republic of",Kelantan,0,0,0
1/01/2023,"Iran, Islamic Republic of",Perak,1,1,0
1/01/2023,"Iran, Islamic Republic of",Perlis,3,3,0
1/01/2023,"Iran, Islamic Republic of",Pulau Pinang,5,1,4
1/01/2023,"Iran, Islamic Republic of",Sabah,3,1,2
1/01/2023,"Iran, Islamic Republic of",Sarawak,7,3,4
1/01/2023,"Iran, Islamic Republic of",Selangor,879,499,380
1/01/2023,"Iran, Islamic Republic of",W.P. Labuan,0,0,0
1/01/2023,Iraq,Johor,23,20,3
1/01/2023,Iraq,Kedah,5,2,3
1/01/2023,Iraq,Kelantan,0,0,0
1/01/2023,Iraq,Melaka,0,0,0
1/01/2023,Iraq,Pahang,0,0,0
1/01/2023,Iraq,Perak,1,0,1
1/01/2023,Iraq,Perlis,0,0,0
1/01/2023,Iraq,Pulau Pinang,2,2,0
1/01/2023,Iraq,Sabah,0,0,0
1/01/2023,Iraq,Sarawak,0,0,0
1/01/2023,Iraq,Selangor,631,431,200
1/01/2023,Iceland,Johor,3,3,0
1/01/2023,Iceland,Kedah,0,0,0
1/01/2023,Iceland,Kelantan,0,0,0
1/01/2023,Iceland,Perak,2,1,1
1/01/2023,Iceland,Perlis,0,0,0
1/01/2023,Iceland,Pulau Pinang,2,0,2
1/01/2023,Iceland,Sabah,1,1,0
1/01/2023,Iceland,Sarawak,0,0,0
1/01/2023,Iceland,Selangor,25,13,12
1/01/2023,Iceland,W.P. Labuan,0,0,0
1/01/2023,Israel,Pulau Pinang,0,0,0
1/01/2023,Italy,Johor,538,360,178
1/01/2023,Italy,Kedah,617,345,272
1/01/2023,Italy,Kelantan,3,2,1
1/01/2023,Italy,Melaka,0,0,0
1/01/2023,Italy,Negeri Sembilan,0,0,0
1/01/2023,Italy,Pahang,0,0,0
1/01/2023,Italy,Perak,5,5,0
1/01/2023,Italy,Perlis,48,38,10
1/01/2023,Italy,Pulau Pinang,103,72,31
1/01/2023,Italy,Sabah,31,19,12
1/01/2023,Italy,Sarawak,33,26,7
1/01/2023,Italy,Selangor,2387,1555,832
1/01/2023,Italy,W.P. Labuan,1,1,0
1/01/2023,Jamaica,Johor,0,0,0
1/01/2023,Jamaica,Kedah,2,1,1
1/01/2023,Jamaica,Perak,0,0,0
1/01/2023,Jamaica,Pulau Pinang,1,0,1
1/01/2023,Jamaica,Sabah,0,0,0
1/01/2023,Jamaica,Sarawak,0,0,0
1/01/2023,Jamaica,Selangor,12,4,8
1/01/2023,Jamaica,W.P. Labuan,0,0,0
1/01/2023,Jordan,Johor,6,3,3
1/01/2023,Jordan,Kedah,1,1,0
1/01/2023,Jordan,Kelantan,0,0,0
1/01/2023,Jordan,Melaka,0,0,0
1/01/2023,Jordan,Perlis,1,1,0
1/01/2023,Jordan,Pulau Pinang,2,2,0
1/01/2023,Jordan,Sabah,1,1,0
1/01/2023,Jordan,Sarawak,0,0,0
1/01/2023,Jordan,Selangor,776,469,307
1/01/2023,Jordan,W.P. Labuan,0,0,0
1/01/2023,Japan,Johor,4873,3230,1643
1/01/2023,Japan,Kedah,569,283,286
1/01/2023,Japan,Kelantan,15,14,1
1/01/2023,Japan,Melaka,1,1,0
1/01/2023,Japan,Negeri Sembilan,0,0,0
1/01/2023,Japan,Pahang,32,19,13
1/01/2023,Japan,Perak,49,28,21
1/01/2023,Japan,Perlis,68,46,22
1/01/2023,Japan,Pulau Pinang,1145,765,380
1/01/2023,Japan,Sabah,371,189,182
1/01/2023,Japan,Sarawak,131,79,52
1/01/2023,Japan,Selangor,12107,7473,4634
1/01/2023,Japan,W.P. Labuan,11,5,6
1/01/2023,Kazakhstan,Johor,35,19,16
1/01/2023,Kazakhstan,Kedah,40,23,17
1/01/2023,Kazakhstan,Kelantan,2,0,2
1/01/2023,Kazakhstan,Melaka,0,0,0
1/01/2023,Kazakhstan,Perak,0,0,0
1/01/2023,Kazakhstan,Perlis,5,2,3
1/01/2023,Kazakhstan,Pulau Pinang,10,5,5
1/01/2023,Kazakhstan,Sabah,2,1,1
1/01/2023,Kazakhstan,Sarawak,1,0,1
1/01/2023,Kazakhstan,Selangor,552,231,321
1/01/2023,Kazakhstan,W.P. Labuan,0,0,0
1/01/2023,Kenya,Johor,35,15,20
1/01/2023,Kenya,Kedah,1,0,1
1/01/2023,Kenya,Kelantan,0,0,0
1/01/2023,Kenya,Perak,0,0,0
1/01/2023,Kenya,Perlis,2,1,1
1/01/2023,Kenya,Pulau Pinang,3,0,3
1/01/2023,Kenya,Sabah,1,1,0
1/01/2023,Kenya,Sarawak,1,1,0
1/01/2023,Kenya,Selangor,286,145,141
1/01/2023,Kyrgyzstan,Johor,13,6,7
1/01/2023,Kyrgyzstan,Kedah,5,5,0
1/01/2023,Kyrgyzstan,Kelantan,0,0,0
1/01/2023,Kyrgyzstan,Perak,0,0,0
1/01/2023,Kyrgyzstan,Perlis,2,0,2
1/01/2023,Kyrgyzstan,Pulau Pinang,6,2,4
1/01/2023,Kyrgyzstan,Sabah,0,0,0
1/01/2023,Kyrgyzstan,Sarawak,0,0,0
1/01/2023,Kyrgyzstan,Selangor,232,138,94
1/01/2023,Cambodia,Johor,2470,1075,1395
1/01/2023,Cambodia,Kedah,298,263,35
1/01/2023,Cambodia,Kelantan,827,605,222
1/01/2023,Cambodia,Melaka,3,2,1
1/01/2023,Cambodia,Negeri Sembilan,0,0,0
1/01/2023,Cambodia,Pahang,0,0,0
1/01/2023,Cambodia,Perak,5,2,3
1/01/2023,Cambodia,Perlis,939,652,287
1/01/2023,Cambodia,Pulau Pinang,41,19,22
1/01/2023,Cambodia,Sabah,2,0,2
1/01/2023,Cambodia,Sarawak,11,1,10
1/01/2023,Cambodia,Selangor,3764,1716,2048
1/01/2023,Cambodia,W.P. Labuan,0,0,0
1/01/2023,Kiribati,Johor,0,0,0
1/01/2023,Kiribati,Sabah,0,0,0
1/01/2023,Kiribati,Selangor,0,0,0
1/01/2023,Saint Kitts and Nevis,Johor,16,13,3
1/01/2023,Saint Kitts and Nevis,Kedah,2,2,0
1/01/2023,Saint Kitts and Nevis,Perlis,0,0,0
1/01/2023,Saint Kitts and Nevis,Pulau Pinang,0,0,0
1/01/2023,Saint Kitts and Nevis,Sabah,1,1,0
1/01/2023,Saint Kitts and Nevis,Selangor,51,35,16
1/01/2023,Saint Kitts and Nevis,W.P. Labuan,0,0,0
1/01/2023,"Korea, Republic of",Johor,17050,8543,8507
1/01/2023,"Korea, Republic of",Kedah,439,213,226
1/01/2023,"Korea, Republic of",Kelantan,3,1,2
1/01/2023,"Korea, Republic of",Melaka,0,0,0
1/01/2023,"Korea, Republic of",Negeri Sembilan,0,0,0
1/01/2023,"Korea, Republic of",Pahang,1,0,1
1/01/2023,"Korea, Republic of",Perak,18,8,10
1/01/2023,"Korea, Republic of",Perlis,101,72,29
1/01/2023,"Korea, Republic of",Pulau Pinang,547,302,245
1/01/2023,"Korea, Republic of",Sabah,21648,9448,12200
1/01/2023,"Korea, Republic of",Sarawak,286,147,139
1/01/2023,"Korea, Republic of",Selangor,16612,8423,8189
1/01/2023,"Korea, Republic of",Terengganu,0,0,0
1/01/2023,"Korea, Republic of",W.P. Labuan,5,1,4
1/01/2023,Kuwait,Johor,59,31,28
1/01/2023,Kuwait,Kedah,12,5,7
1/01/2023,Kuwait,Kelantan,0,0,0
1/01/2023,Kuwait,Perak,0,0,0
1/01/2023,Kuwait,Perlis,0,0,0
1/01/2023,Kuwait,Pulau Pinang,8,5,3
1/01/2023,Kuwait,Sabah,0,0,0
1/01/2023,Kuwait,Sarawak,5,2,3
1/01/2023,Kuwait,Selangor,1191,616,575
1/01/2023,Kuwait,W.P. Labuan,0,0,0
1/01/2023, Lao People's Democratic Republic,Johor,151,55,96
1/01/2023, Lao People's Democratic Republic,Kedah,951,137,814
1/01/2023, Lao People's Democratic Republic,Kelantan,157,24,133
1/01/2023, Lao People's Democratic Republic,Melaka,0,0,0
1/01/2023, Lao People's Democratic Republic,Perak,19,2,17
1/01/2023, Lao People's Democratic Republic,Perlis,299,143,156
1/01/2023, Lao People's Democratic Republic,Pulau Pinang,26,8,18
1/01/2023, Lao People's Democratic Republic,Sabah,4,2,2
1/01/2023, Lao People's Democratic Republic,Sarawak,13,7,6
1/01/2023, Lao People's Democratic Republic,Selangor,183,60,123
1/01/2023, Lao People's Democratic Republic,W.P. Labuan,0,0,0
1/01/2023,Lebanon,Johor,12,9,3
1/01/2023,Lebanon,Kedah,3,1,2
1/01/2023,Lebanon,Kelantan,0,0,0
1/01/2023,Lebanon,Pahang,1,0,1
1/01/2023,Lebanon,Perak,0,0,0
1/01/2023,Lebanon,Perlis,0,0,0
1/01/2023,Lebanon,Pulau Pinang,3,3,0
1/01/2023,Lebanon,Sabah,1,1,0
1/01/2023,Lebanon,Sarawak,0,0,0
1/01/2023,Lebanon,Selangor,167,99,68
1/01/2023,Lebanon,W.P. Labuan,0,0,0
1/01/2023,Liberia,Johor,2,2,0
1/01/2023,Liberia,Kedah,0,0,0
1/01/2023,Liberia,Sabah,0,0,0
1/01/2023,Liberia,Sarawak,0,0,0
1/01/2023,Liberia,Selangor,12,12,0
1/01/2023,Libya,Johor,3,2,1
1/01/2023,Libya,Kedah,2,2,0
1/01/2023,Libya,Perlis,0,0,0
1/01/2023,Libya,Pulau Pinang,1,1,0
1/01/2023,Libya,Sabah,0,0,0
1/01/2023,Libya,Sarawak,2,1,1
1/01/2023,Libya,Selangor,270,205,65
1/01/2023,Saint Lucia,Johor,12,7,5
1/01/2023,Saint Lucia,Kedah,0,0,0
1/01/2023,Saint Lucia,Pulau Pinang,1,0,1
1/01/2023,Saint Lucia,Sarawak,0,0,0
1/01/2023,Saint Lucia,Selangor,10,5,5
1/01/2023,Liechtenstein,Johor,0,0,0
1/01/2023,Liechtenstein,Kedah,1,0,1
1/01/2023,Liechtenstein,Perlis,0,0,0
1/01/2023,Liechtenstein,Pulau Pinang,0,0,0
1/01/2023,Liechtenstein,Sabah,0,0,0
1/01/2023,Liechtenstein,Sarawak,0,0,0
1/01/2023,Liechtenstein,Selangor,5,3,2
1/01/2023,LKA,Johor,1096,701,395
1/01/2023,LKA,Kedah,55,28,27
1/01/2023,LKA,Kelantan,0,0,0
1/01/2023,LKA,Melaka,0,0,0
1/01/2023,LKA,Pahang,0,0,0
1/01/2023,LKA,Perak,3,2,1
1/01/2023,LKA,Perlis,4,4,0
1/01/2023,LKA,Pulau Pinang,20,16,4
1/01/2023,LKA,Sabah,15,8,7
1/01/2023,LKA,Sarawak,29,18,11
1/01/2023,LKA,Selangor,2688,1708,980
1/01/2023,LKA,W.P. Labuan,0,0,0
1/01/2023,Lesotho,Johor,0,0,0
1/01/2023,Lesotho,Kedah,0,0,0
1/01/2023,Lesotho,Pulau Pinang,1,0,1
1/01/2023,Lesotho,Sarawak,0,0,0
1/01/2023,Lesotho,Selangor,4,3,1
1/01/2023,Lithuania,Johor,58,23,35
1/01/2023,Lithuania,Kedah,35,14,21
1/01/2023,Lithuania,Kelantan,0,0,0
1/01/2023,Lithuania,Pahang,0,0,0
1/01/2023,Lithuania,Perak,0,0,0
1/01/2023,Lithuania,Perlis,7,4,3
1/01/2023,Lithuania,Pulau Pinang,8,4,4
1/01/2023,Lithuania,Sabah,3,2,1
1/01/2023,Lithuania,Sarawak,1,0,1
1/01/2023,Lithuania,Selangor,330,171,159
1/01/2023,Lithuania,W.P. Labuan,0,0,0
1/01/2023,Luxembourg,Johor,7,7,0
1/01/2023,Luxembourg,Kedah,5,2,3
1/01/2023,Luxembourg,Kelantan,0,0,0
1/01/2023,Luxembourg,Perak,0,0,0
1/01/2023,Luxembourg,Perlis,3,3,0
1/01/2023,Luxembourg,Pulau Pinang,1,1,0
1/01/2023,Luxembourg,Sabah,2,0,2
1/01/2023,Luxembourg,Sarawak,0,0,0
1/01/2023,Luxembourg,Selangor,50,33,17
1/01/2023,Latvia,Johor,35,16,19
1/01/2023,Latvia,Kedah,32,15,17
1/01/2023,Latvia,Kelantan,0,0,0
1/01/2023,Latvia,Pahang,0,0,0
1/01/2023,Latvia,Perak,0,0,0
1/01/2023,Latvia,Perlis,5,4,1
1/01/2023,Latvia,Pulau Pinang,4,2,2
1/01/2023,Latvia,Sabah,2,1,1
1/01/2023,Latvia,Sarawak,8,2,6
1/01/2023,Latvia,Selangor,200,101,99
1/01/2023,Latvia,W.P. Labuan,0,0,0
1/01/2023,Macao,Johor,0,0,0
1/01/2023,Macao,Pahang,0,0,0
1/01/2023,Macao,Perak,0,0,0
1/01/2023,Macao,Selangor,2,1,1
1/01/2023,Macao,W.P. Labuan,0,0,0
1/01/2023,Morocco,Johor,82,63,19
1/01/2023,Morocco,Kedah,11,10,1
1/01/2023,Morocco,Kelantan,0,0,0
1/01/2023,Morocco,Melaka,0,0,0
1/01/2023,Morocco,Pahang,0,0,0
1/01/2023,Morocco,Perak,0,0,0
1/01/2023,Morocco,Perlis,2,2,0
1/01/2023,Morocco,Pulau Pinang,6,6,0
1/01/2023,Morocco,Sabah,5,3,2
1/01/2023,Morocco,Sarawak,3,3,0
1/01/2023,Morocco,Selangor,430,259,171
1/01/2023,Morocco,W.P. Labuan,0,0,0
1/01/2023,Monaco,Johor,0,0,0
1/01/2023,Monaco,Kedah,0,0,0
1/01/2023,Monaco,Sabah,0,0,0
1/01/2023,Monaco,Selangor,0,0,0
1/01/2023,"Moldova, Republic of",Johor,1,1,0
1/01/2023,"Moldova, Republic of",Kedah,0,0,0
1/01/2023,"Moldova, Republic of",Kelantan,0,0,0
1/01/2023,"Moldova, Republic of",Negeri Sembilan,0,0,0
1/01/2023,"Moldova, Republic of",Perlis,1,1,0
1/01/2023,"Moldova, Republic of",Pulau Pinang,2,2,0
1/01/2023,"Moldova, Republic of",Sabah,0,0,0
1/01/2023,"Moldova, Republic of",Sarawak,2,0,2
1/01/2023,"Moldova, Republic of",Selangor,22,10,12
1/01/2023,Madagascar,Johor,6,2,4
1/01/2023,Madagascar,Kedah,0,0,0
1/01/2023,Madagascar,Perak,0,0,0
1/01/2023,Madagascar,Perlis,0,0,0
1/01/2023,Madagascar,Pulau Pinang,1,0,1
1/01/2023,Madagascar,Sabah,0,0,0
1/01/2023,Madagascar,Sarawak,0,0,0
1/01/2023,Madagascar,Selangor,20,13,7
1/01/2023,Maldives,Johor,169,86,83
1/01/2023,Maldives,Kedah,1,0,1
1/01/2023,Maldives,Kelantan,0,0,0
1/01/2023,Maldives,Perak,0,0,0
1/01/2023,Maldives,Perlis,0,0,0
1/01/2023,Maldives,Pulau Pinang,8,3,5
1/01/2023,Maldives,Sabah,0,0,0
1/01/2023,Maldives,Sarawak,0,0,0
1/01/2023,Maldives,Selangor,2046,1045,1001
1/01/2023,Mexico,Johor,95,62,33
1/01/2023,Mexico,Kedah,8,2,6
1/01/2023,Mexico,Kelantan,1,1,0
1/01/2023,Mexico,Pahang,0,0,0
1/01/2023,Mexico,Perak,2,1,1
1/01/2023,Mexico,Perlis,7,3,4
1/01/2023,Mexico,Pulau Pinang,20,11,9
1/01/2023,Mexico,Sabah,4,2,2
1/01/2023,Mexico,Sarawak,4,2,2
1/01/2023,Mexico,Selangor,411,207,204
1/01/2023,Mexico,W.P. Labuan,0,0,0
1/01/2023,Marshall Islands,Johor,2,2,0
1/01/2023,Marshall Islands,Kedah,0,0,0
1/01/2023,Marshall Islands,Perak,0,0,0
1/01/2023,Marshall Islands,Pulau Pinang,1,1,0
1/01/2023,Marshall Islands,Sabah,0,0,0
1/01/2023,Marshall Islands,Selangor,6,2,4
1/01/2023,North Macedonia,Johor,1,1,0
1/01/2023,North Macedonia,Kedah,3,1,2
1/01/2023,North Macedonia,Perak,0,0,0
1/01/2023,North Macedonia,Pulau Pinang,1,0,1
1/01/2023,North Macedonia,Sabah,1,1,0
1/01/2023,North Macedonia,Sarawak,1,0,1
1/01/2023,North Macedonia,Selangor,24,12,12
1/01/2023,Mali,Johor,2,2,0
1/01/2023,Mali,Sabah,0,0,0
1/01/2023,Mali,Selangor,16,14,2
1/01/2023,Malta,Johor,10,6,4
1/01/2023,Malta,Kedah,1,0,1
1/01/2023,Malta,Kelantan,1,1,0
1/01/2023,Malta,Perak,0,0,0
1/01/2023,Malta,Perlis,0,0,0
1/01/2023,Malta,Pulau Pinang,3,2,1
1/01/2023,Malta,Sabah,2,1,1
1/01/2023,Malta,Sarawak,1,1,0
1/01/2023,Malta,Selangor,60,31,29
1/01/2023,Malta,W.P. Labuan,0,0,0
1/01/2023,Myanmar,Johor,4954,1508,3446
1/01/2023,Myanmar,Kedah,59,9,50
1/01/2023,Myanmar,Kelantan,4,1,3
1/01/2023,Myanmar,Negeri Sembilan,0,0,0
1/01/2023,Myanmar,Pahang,1,1,0
1/01/2023,Myanmar,Perak,24,6,18
1/01/2023,Myanmar,Perlis,12,1,11
1/01/2023,Myanmar,Pulau Pinang,212,100,112
1/01/2023,Myanmar,Sabah,23,6,17
1/01/2023,Myanmar,Sarawak,80,35,45
1/01/2023,Myanmar,Selangor,6605,4497,2108
1/01/2023,Myanmar,Terengganu,0,0,0
1/01/2023,Myanmar,W.P. Labuan,0,0,0
1/01/2023,Montenegro,Johor,1,1,0
1/01/2023,Montenegro,Kedah,0,0,0
1/01/2023,Montenegro,Pulau Pinang,0,0,0
1/01/2023,Montenegro,Sabah,0,0,0
1/01/2023,Montenegro,Sarawak,0,0,0
1/01/2023,Montenegro,Selangor,6,4,2
1/01/2023,Mongolia,Johor,575,271,304
1/01/2023,Mongolia,Kedah,17,8,9
1/01/2023,Mongolia,Kelantan,0,0,0
1/01/2023,Mongolia,Perak,0,0,0
1/01/2023,Mongolia,Perlis,14,10,4
1/01/2023,Mongolia,Pulau Pinang,24,11,13
1/01/2023,Mongolia,Sabah,17,8,9
1/01/2023,Mongolia,Sarawak,0,0,0
1/01/2023,Mongolia,Selangor,571,266,305
1/01/2023,Northern Mariana Islands,Selangor,0,0,0
1/01/2023,Mozambique,Johor,0,0,0
1/01/2023,Mozambique,Kedah,3,3,0
1/01/2023,Mozambique,Perak,0,0,0
1/01/2023,Mozambique,Pulau Pinang,4,2,2
1/01/2023,Mozambique,Sabah,0,0,0
1/01/2023,Mozambique,Sarawak,0,0,0
1/01/2023,Mozambique,Selangor,39,17,22
1/01/2023,Mauritania,Johor,0,0,0
1/01/2023,Mauritania,Kedah,0,0,0
1/01/2023,Mauritania,Pulau Pinang,0,0,0
1/01/2023,Mauritania,Sabah,0,0,0
1/01/2023,Mauritania,Sarawak,0,0,0
1/01/2023,Mauritania,Selangor,18,12,6
1/01/2023,Mauritius,Johor,132,69,63
1/01/2023,Mauritius,Kedah,4,1,3
1/01/2023,Mauritius,Kelantan,0,0,0
1/01/2023,Mauritius,Pahang,0,0,0
1/01/2023,Mauritius,Perak,1,1,0
1/01/2023,Mauritius,Perlis,0,0,0
1/01/2023,Mauritius,Pulau Pinang,14,5,9
1/01/2023,Mauritius,Sabah,1,1,0
1/01/2023,Mauritius,Sarawak,3,3,0
1/01/2023,Mauritius,Selangor,1266,653,613
1/01/2023,Malawi,Johor,0,0,0
1/01/2023,Malawi,Pulau Pinang,0,0,0
1/01/2023,Malawi,Sabah,0,0,0
1/01/2023,Malawi,Sarawak,0,0,0
1/01/2023,Malawi,Selangor,19,12,7
1/01/2023,Mayotte,Selangor,0,0,0
1/01/2023,Namibia,Johor,1,0,1
1/01/2023,Namibia,Kedah,0,0,0
1/01/2023,Namibia,Perak,0,0,0
1/01/2023,Namibia,Perlis,0,0,0
1/01/2023,Namibia,Pulau Pinang,0,0,0
1/01/2023,Namibia,Sabah,0,0,0
1/01/2023,Namibia,Sarawak,0,0,0
1/01/2023,Namibia,Selangor,11,4,7
1/01/2023,New Caledonia,Selangor,0,0,0
1/01/2023,Niger,Johor,0,0,0
1/01/2023,Niger,Sabah,0,0,0
1/01/2023,Niger,Selangor,0,0,0
1/01/2023,Nigeria,Johor,26,26,0
1/01/2023,Nigeria,Kedah,1,1,0
1/01/2023,Nigeria,Perlis,0,0,0
1/01/2023,Nigeria,Pulau Pinang,0,0,0
1/01/2023,Nigeria,Sabah,0,0,0
1/01/2023,Nigeria,Sarawak,3,2,1
1/01/2023,Nigeria,Selangor,334,264,70
1/01/2023,Nicaragua,Johor,4,0,4
1/01/2023,Nicaragua,Kedah,0,0,0
1/01/2023,Nicaragua,Pulau Pinang,0,0,0
1/01/2023,Nicaragua,Sabah,0,0,0
1/01/2023,Nicaragua,Selangor,6,1,5
1/01/2023,Netherlands,Johor,927,609,318
1/01/2023,Netherlands,Kedah,499,252,247
1/01/2023,Netherlands,Kelantan,5,5,0
1/01/2023,Netherlands,Melaka,1,1,0
1/01/2023,Netherlands,Negeri Sembilan,0,0,0
1/01/2023,Netherlands,Pahang,0,0,0
1/01/2023,Netherlands,Perak,11,9,2
1/01/2023,Netherlands,Perlis,42,30,12
1/01/2023,Netherlands,Pulau Pinang,245,156,89
1/01/2023,Netherlands,Sabah,75,47,28
1/01/2023,Netherlands,Sarawak,118,80,38
1/01/2023,Netherlands,Selangor,3524,2040,1484
1/01/2023,Netherlands,Terengganu,0,0,0
1/01/2023,Netherlands,W.P. Labuan,4,0,4
1/01/2023,Norway,Johor,162,104,58
1/01/2023,Norway,Kedah,104,53,51
1/01/2023,Norway,Kelantan,0,0,0
1/01/2023,Norway,Melaka,0,0,0
1/01/2023,Norway,Pahang,0,0,0
1/01/2023,Norway,Perak,0,0,0
1/01/2023,Norway,Perlis,21,13,8
1/01/2023,Norway,Pulau Pinang,45,28,17
1/01/2023,Norway,Sabah,15,14,1
1/01/2023,Norway,Sarawak,8,7,1
1/01/2023,Norway,Selangor,693,420,273
1/01/2023,Norway,W.P. Labuan,5,3,2
1/01/2023,Nepal,Johor,1181,983,198
1/01/2023,Nepal,Kedah,11,8,3
1/01/2023,Nepal,Pahang,0,0,0
1/01/2023,Nepal,Perak,0,0,0
1/01/2023,Nepal,Perlis,0,0,0
1/01/2023,Nepal,Pulau Pinang,26,26,0
1/01/2023,Nepal,Sabah,3,3,0
1/01/2023,Nepal,Sarawak,232,169,63
1/01/2023,Nepal,Selangor,16929,16159,770
1/01/2023,Nepal,W.P. Labuan,30,28,2
1/01/2023,Nauru,Johor,0,0,0
1/01/2023,Nauru,Pulau Pinang,0,0,0
1/01/2023,Nauru,Selangor,1,1,0
1/01/2023,New Zealand,Johor,856,494,362
1/01/2023,New Zealand,Kedah,114,68,46
1/01/2023,New Zealand,Kelantan,1,1,0
1/01/2023,New Zealand,Melaka,1,1,0
1/01/2023,New Zealand,Negeri Sembilan,0,0,0
1/01/2023,New Zealand,Pahang,0,0,0
1/01/2023,New Zealand,Perak,29,16,13
1/01/2023,New Zealand,Perlis,33,19,14
1/01/2023,New Zealand,Pulau Pinang,224,139,85
1/01/2023,New Zealand,Sabah,86,47,39
1/01/2023,New Zealand,Sarawak,174,86,88
1/01/2023,New Zealand,Selangor,3031,1765,1266
1/01/2023,New Zealand,Terengganu,0,0,0
1/01/2023,New Zealand,W.P. Labuan,6,5,1
1/01/2023,Oman,Johor,48,22,26
1/01/2023,Oman,Kedah,0,0,0
1/01/2023,Oman,Kelantan,0,0,0
1/01/2023,Oman,Melaka,0,0,0
1/01/2023,Oman,Perak,0,0,0
1/01/2023,Oman,Perlis,0,0,0
1/01/2023,Oman,Pulau Pinang,5,4,1
1/01/2023,Oman,Sabah,0,0,0
1/01/2023,Oman,Sarawak,14,7,7
1/01/2023,Oman,Selangor,779,460,319
1/01/2023,Pakistan,Johor,665,486,179
1/01/2023,Pakistan,Kedah,97,76,21
1/01/2023,Pakistan,Kelantan,8,8,0
1/01/2023,Pakistan,Melaka,0,0,0
1/01/2023,Pakistan,Negeri Sembilan,0,0,0
1/01/2023,Pakistan,Pahang,0,0,0
1/01/2023,Pakistan,Perak,49,47,2
1/01/2023,Pakistan,Perlis,35,34,1
1/01/2023,Pakistan,Pulau Pinang,127,114,13
1/01/2023,Pakistan,Sabah,12,10,2
1/01/2023,Pakistan,Sarawak,90,67,23
1/01/2023,Pakistan,Selangor,11473,10061,1412
1/01/2023,Pakistan,W.P. Labuan,5,4,1
1/01/2023,Panama,Johor,25,10,15
1/01/2023,Panama,Kedah,0,0,0
1/01/2023,Panama,Perak,0,0,0
1/01/2023,Panama,Perlis,0,0,0
1/01/2023,Panama,Pulau Pinang,2,0,2
1/01/2023,Panama,Sabah,0,0,0
1/01/2023,Panama,Sarawak,0,0,0
1/01/2023,Panama,Selangor,13,3,10
1/01/2023,Peru,Johor,27,16,11
1/01/2023,Peru,Kedah,1,1,0
1/01/2023,Peru,Kelantan,0,0,0
1/01/2023,Peru,Pahang,0,0,0
1/01/2023,Peru,Perak,1,1,0
1/01/2023,Peru,Perlis,0,0,0
1/01/2023,Peru,Pulau Pinang,1,1,0
1/01/2023,Peru,Sabah,1,1,0
1/01/2023,Peru,Sarawak,1,1,0
1/01/2023,Peru,Selangor,110,56,54
1/01/2023,Peru,W.P. Labuan,0,0,0
1/01/2023,Philippines,Johor,15410,4502,10908
1/01/2023,Philippines,Kedah,506,189,317
1/01/2023,Philippines,Kelantan,14,4,10
1/01/2023,Philippines,Melaka,1,0,1
1/01/2023,Philippines,Negeri Sembilan,2,1,1
1/01/2023,Philippines,Pahang,9,2,7
1/01/2023,Philippines,Perak,56,12,44
1/01/2023,Philippines,Perlis,129,40,89
1/01/2023,Philippines,Pulau Pinang,429,159,270
1/01/2023,Philippines,Sabah,1792,723,1069
1/01/2023,Philippines,Sarawak,2200,831,1369
1/01/2023,Philippines,Selangor,15849,5688,10161
1/01/2023,Philippines,Terengganu,0,0,0
1/01/2023,Philippines,W.P. Labuan,91,32,59
1/01/2023,Palau,Johor,0,0,0
1/01/2023,Palau,Pulau Pinang,0,0,0
1/01/2023,Palau,Selangor,0,0,0
1/01/2023,Papua New Guinea,Johor,13,6,7
1/01/2023,Papua New Guinea,Kedah,0,0,0
1/01/2023,Papua New Guinea,Kelantan,0,0,0
1/01/2023,Papua New Guinea,Perak,1,1,0
1/01/2023,Papua New Guinea,Pulau Pinang,0,0,0
1/01/2023,Papua New Guinea,Sabah,1,0,1
1/01/2023,Papua New Guinea,Sarawak,7,1,6
1/01/2023,Papua New Guinea,Selangor,55,31,24
1/01/2023,Poland,Johor,610,327,283
1/01/2023,Poland,Kedah,230,122,108
1/01/2023,Poland,Kelantan,4,2,2
1/01/2023,Poland,Melaka,0,0,0
1/01/2023,Poland,Negeri Sembilan,0,0,0
1/01/2023,Poland,Pahang,0,0,0
1/01/2023,Poland,Perak,3,0,3
1/01/2023,Poland,Perlis,40,24,16
1/01/2023,Poland,Pulau Pinang,60,34,26
1/01/2023,Poland,Sabah,37,17,20
1/01/2023,Poland,Sarawak,28,12,16
1/01/2023,Poland,Selangor,1183,632,551
1/01/2023,Poland,Terengganu,0,0,0
1/01/2023,Poland,W.P. Labuan,0,0,0
1/01/2023,"North Korea, Democratic People's Republic of",Selangor,0,0,0
1/01/2023,Portugal,Johor,112,63,49
1/01/2023,Portugal,Kedah,58,35,23
1/01/2023,Portugal,Kelantan,0,0,0
1/01/2023,Portugal,Melaka,0,0,0
1/01/2023,Portugal,Pahang,0,0,0
1/01/2023,Portugal,Perak,3,3,0
1/01/2023,Portugal,Perlis,3,3,0
1/01/2023,Portugal,Pulau Pinang,18,7,11
1/01/2023,Portugal,Sabah,3,1,2
1/01/2023,Portugal,Sarawak,14,9,5
1/01/2023,Portugal,Selangor,443,255,188
1/01/2023,Portugal,W.P. Labuan,0,0,0
1/01/2023,Paraguay,Johor,9,6,3
1/01/2023,Paraguay,Kedah,0,0,0
1/01/2023,Paraguay,Perak,0,0,0
1/01/2023,Paraguay,Perlis,0,0,0
1/01/2023,Paraguay,Pulau Pinang,0,0,0
1/01/2023,Paraguay,Sabah,0,0,0
1/01/2023,Paraguay,Sarawak,0,0,0
1/01/2023,Paraguay,Selangor,19,12,7
1/01/2023,"Palestine, State of",Johor,9,6,3
1/01/2023,"Palestine, State of",Kedah,1,0,1
1/01/2023,"Palestine, State of",Kelantan,1,1,0
1/01/2023,"Palestine, State of",Melaka,0,0,0
1/01/2023,"Palestine, State of",Perak,4,3,1
1/01/2023,"Palestine, State of",Perlis,0,0,0
1/01/2023,"Palestine, State of",Pulau Pinang,0,0,0
1/01/2023,"Palestine, State of",Sabah,0,0,0
1/01/2023,"Palestine, State of",Sarawak,2,2,0
1/01/2023,"Palestine, State of",Selangor,257,177,80
1/01/2023,Qatar,Johor,2,2,0
1/01/2023,Qatar,Kedah,0,0,0
1/01/2023,Qatar,Perlis,1,1,0
1/01/2023,Qatar,Pulau Pinang,2,1,1
1/01/2023,Qatar,Sabah,0,0,0
1/01/2023,Qatar,Sarawak,3,2,1
1/01/2023,Qatar,Selangor,64,41,23
1/01/2023,Réunion,Johor,0,0,0
1/01/2023,Réunion,Sarawak,0,0,0
1/01/2023,Romania,Johor,171,104,67
1/01/2023,Romania,Kedah,73,38,35
1/01/2023,Romania,Kelantan,0,0,0
1/01/2023,Romania,Negeri Sembilan,0,0,0
1/01/2023,Romania,Pahang,1,1,0
1/01/2023,Romania,Perak,1,1,0
1/01/2023,Romania,Perlis,4,2,2
1/01/2023,Romania,Pulau Pinang,31,22,9
1/01/2023,Romania,Sabah,19,9,10
1/01/2023,Romania,Sarawak,10,7,3
1/01/2023,Romania,Selangor,719,371,348
1/01/2023,Romania,W.P. Labuan,0,0,0
1/01/2023,Russian Federation (Russia),Johor,370,187,183
1/01/2023,Russian Federation (Russia),Kedah,918,490,428
1/01/2023,Russian Federation (Russia),Kelantan,78,37,41
1/01/2023,Russian Federation (Russia),Melaka,0,0,0
1/01/2023,Russian Federation (Russia),Negeri Sembilan,0,0,0
1/01/2023,Russian Federation (Russia),Pahang,0,0,0
1/01/2023,Russian Federation (Russia),Perak,2,1,1
1/01/2023,Russian Federation (Russia),Perlis,510,290,220
1/01/2023,Russian Federation (Russia),Pulau Pinang,475,250,225
1/01/2023,Russian Federation (Russia),Sabah,63,37,26
1/01/2023,Russian Federation (Russia),Sarawak,61,23,38
1/01/2023,Russian Federation (Russia),Selangor,14260,7333,6927
1/01/2023,Russian Federation (Russia),W.P. Labuan,4,2,2
1/01/2023,Rwanda,Johor,0,0,0
1/01/2023,Rwanda,Kedah,0,0,0
1/01/2023,Rwanda,Pulau Pinang,0,0,0
1/01/2023,Rwanda,Selangor,10,4,6
1/01/2023,Saudi Arabia,Johor,105,64,41
1/01/2023,Saudi Arabia,Kedah,16,11,5
1/01/2023,Saudi Arabia,Kelantan,1,1,0
1/01/2023,Saudi Arabia,Melaka,0,0,0
1/01/2023,Saudi Arabia,Perak,0,0,0
1/01/2023,Saudi Arabia,Perlis,5,5,0
1/01/2023,Saudi Arabia,Pulau Pinang,17,9,8
1/01/2023,Saudi Arabia,Sabah,0,0,0
1/01/2023,Saudi Arabia,Sarawak,16,11,5
1/01/2023,Saudi Arabia,Selangor,2314,1339,975
1/01/2023,Saudi Arabia,W.P. Labuan,1,1,0
1/01/2023,Sudan,Johor,5,4,1
1/01/2023,Sudan,Kedah,0,0,0
1/01/2023,Sudan,Kelantan,1,0,1
1/01/2023,Sudan,Perlis,0,0,0
1/01/2023,Sudan,Pulau Pinang,0,0,0
1/01/2023,Sudan,Sabah,0,0,0
1/01/2023,Sudan,Sarawak,3,3,0
1/01/2023,Sudan,Selangor,1102,622,480
1/01/2023,Sudan,W.P. Labuan,0,0,0
1/01/2023,Senegal,Johor,0,0,0
1/01/2023,Senegal,Kedah,0,0,0
1/01/2023,Senegal,Kelantan,0,0,0
1/01/2023,Senegal,Perak,0,0,0
1/01/2023,Senegal,Perlis,0,0,0
1/01/2023,Senegal,Pulau Pinang,0,0,0
1/01/2023,Senegal,Sabah,0,0,0
1/01/2023,Senegal,Sarawak,0,0,0
1/01/2023,Senegal,Selangor,24,17,7
1/01/2023,Singapore,Johor,986919,567095,419824
1/01/2023,Singapore,Kedah,3088,1644,1444
1/01/2023,Singapore,Kelantan,70,50,20
1/01/2023,Singapore,Melaka,16,14,2
1/01/2023,Singapore,Negeri Sembilan,0,0,0
1/01/2023,Singapore,Pahang,345,182,163
1/01/2023,Singapore,Perak,4904,2430,2474
1/01/2023,Singapore,Perlis,283,162,121
1/01/2023,Singapore,Pulau Pinang,12369,6430,5939
1/01/2023,Singapore,Sabah,2166,1159,1007
1/01/2023,Singapore,Sarawak,3852,2138,1714
1/01/2023,Singapore,Selangor,46820,23613,23207
1/01/2023,Singapore,Terengganu,0,0,0
1/01/2023,Singapore,W.P. Labuan,12,9,3
1/01/2023,South Georgia and the South Sandwich Islands,Johor,0,0,0
1/01/2023,South Georgia and the South Sandwich Islands,Sabah,0,0,0
1/01/2023,South Georgia and the South Sandwich Islands,Selangor,0,0,0
1/01/2023,Saint Helena,Sarawak,0,0,0
1/01/2023,Solomon Islands,Johor,0,0,0
1/01/2023,Solomon Islands,Perlis,0,0,0
1/01/2023,Solomon Islands,Pulau Pinang,0,0,0
1/01/2023,Solomon Islands,Sabah,0,0,0
1/01/2023,Solomon Islands,Sarawak,8,0,8
1/01/2023,Solomon Islands,Selangor,11,2,9
1/01/2023,Solomon Islands,W.P. Labuan,0,0,0
1/01/2023,Sierra Leone,Johor,3,1,2
1/01/2023,Sierra Leone,Kedah,0,0,0
1/01/2023,Sierra Leone,Perak,0,0,0
1/01/2023,Sierra Leone,Pulau Pinang,0,0,0
1/01/2023,Sierra Leone,Sabah,0,0,0
1/01/2023,Sierra Leone,Selangor,21,14,7
1/01/2023,El Salvador,Johor,1,1,0
1/01/2023,El Salvador,Kedah,0,0,0
1/01/2023,El Salvador,Perak,0,0,0
1/01/2023,El Salvador,Perlis,0,0,0
1/01/2023,El Salvador,Pulau Pinang,0,0,0
1/01/2023,El Salvador,Sabah,0,0,0
1/01/2023,El Salvador,Selangor,9,4,5
1/01/2023,El Salvador,W.P. Labuan,0,0,0
1/01/2023,San Marino,Johor,0,0,0
1/01/2023,San Marino,Selangor,2,2,0
1/01/2023,Somalia,Johor,0,0,0
1/01/2023,Somalia,Kedah,2,2,0
1/01/2023,Somalia,Kelantan,0,0,0
1/01/2023,Somalia,Perlis,0,0,0
1/01/2023,Somalia,Sabah,0,0,0
1/01/2023,Somalia,Sarawak,0,0,0
1/01/2023,Somalia,Selangor,251,152,99
1/01/2023,Serbia,Johor,7,3,4
1/01/2023,Serbia,Kedah,3,2,1
1/01/2023,Serbia,Kelantan,0,0,0
1/01/2023,Serbia,Pahang,0,0,0
1/01/2023,Serbia,Perak,0,0,0
1/01/2023,Serbia,Perlis,0,0,0
1/01/2023,Serbia,Pulau Pinang,0,0,0
1/01/2023,Serbia,Sabah,0,0,0
1/01/2023,Serbia,Sarawak,0,0,0
1/01/2023,Serbia,Selangor,57,38,19
1/01/2023,South Sudan,Johor,0,0,0
1/01/2023,South Sudan,Kedah,0,0,0
1/01/2023,South Sudan,Sarawak,0,0,0
1/01/2023,South Sudan,Selangor,47,33,14
1/01/2023,South Sudan,W.P. Labuan,0,0,0
1/01/2023,Sao Tome and Principe,Selangor,3,3,0
1/01/2023,Suriname,Johor,3,2,1
1/01/2023,Suriname,Kedah,0,0,0
1/01/2023,Suriname,Kelantan,1,1,0
1/01/2023,Suriname,Perak,0,0,0
1/01/2023,Suriname,Perlis,0,0,0
1/01/2023,Suriname,Pulau Pinang,0,0,0
1/01/2023,Suriname,Sabah,1,0,1
1/01/2023,Suriname,Sarawak,0,0,0
1/01/2023,Suriname,Selangor,6,4,2
1/01/2023,Slovakia,Johor,47,27,20
1/01/2023,Slovakia,Kedah,129,72,57
1/01/2023,Slovakia,Kelantan,2,1,1
1/01/2023,Slovakia,Negeri Sembilan,0,0,0
1/01/2023,Slovakia,Pahang,0,0,0
1/01/2023,Slovakia,Perak,0,0,0
1/01/2023,Slovakia,Perlis,8,5,3
1/01/2023,Slovakia,Pulau Pinang,21,16,5
1/01/2023,Slovakia,Sabah,11,7,4
1/01/2023,Slovakia,Sarawak,2,1,1
1/01/2023,Slovakia,Selangor,401,218,183
1/01/2023,Slovakia,W.P. Labuan,2,1,1
1/01/2023,Slovenia,Johor,21,12,9
1/01/2023,Slovenia,Kedah,15,8,7
1/01/2023,Slovenia,Kelantan,0,0,0
1/01/2023,Slovenia,Perak,0,0,0
1/01/2023,Slovenia,Perlis,0,0,0
1/01/2023,Slovenia,Pulau Pinang,5,3,2
1/01/2023,Slovenia,Sabah,1,0,1
1/01/2023,Slovenia,Sarawak,1,0,1
1/01/2023,Slovenia,Selangor,116,73,43
1/01/2023,Slovenia,W.P. Labuan,0,0,0
1/01/2023,Sweden,Johor,272,157,115
1/01/2023,Sweden,Kedah,423,206,217
1/01/2023,Sweden,Kelantan,2,2,0
1/01/2023,Sweden,Melaka,0,0,0
1/01/2023,Sweden,Negeri Sembilan,0,0,0
1/01/2023,Sweden,Pahang,0,0,0
1/01/2023,Sweden,Perak,5,5,0
1/01/2023,Sweden,Perlis,40,28,12
1/01/2023,Sweden,Pulau Pinang,85,57,28
1/01/2023,Sweden,Sabah,26,13,13
1/01/2023,Sweden,Sarawak,9,5,4
1/01/2023,Sweden,Selangor,1316,766,550
1/01/2023,Sweden,W.P. Labuan,1,1,0
1/01/2023,Eswatini,Johor,7,5,2
1/01/2023,Eswatini,Kedah,0,0,0
1/01/2023,Eswatini,Pulau Pinang,0,0,0
1/01/2023,Eswatini,Sabah,0,0,0
1/01/2023,Eswatini,Selangor,5,2,3
1/01/2023,Seychelles,Johor,9,5,4
1/01/2023,Seychelles,Kedah,0,0,0
1/01/2023,Seychelles,Pulau Pinang,0,0,0
1/01/2023,Seychelles,Sabah,0,0,0
1/01/2023,Seychelles,Sarawak,0,0,0
1/01/2023,Seychelles,Selangor,70,27,43
1/01/2023,Syrian Arab Republic,Johor,12,7,5
1/01/2023,Syrian Arab Republic,Kedah,1,1,0
1/01/2023,Syrian Arab Republic,Kelantan,0,0,0
1/01/2023,Syrian Arab Republic,Pahang,0,0,0
1/01/2023,Syrian Arab Republic,Perlis,0,0,0
1/01/2023,Syrian Arab Republic,Pulau Pinang,1,1,0
1/01/2023,Syrian Arab Republic,Sabah,4,1,3
1/01/2023,Syrian Arab Republic,Sarawak,2,2,0
1/01/2023,Syrian Arab Republic,Selangor,493,325,168
1/01/2023,Syrian Arab Republic,W.P. Labuan,0,0,0
1/01/2023,Turks and Caicos Islands,Perlis,0,0,0
1/01/2023,TCD,Johor,0,0,0
1/01/2023,TCD,Kedah,0,0,0
1/01/2023,TCD,Perlis,0,0,0
1/01/2023,TCD,Selangor,13,8,5
1/01/2023,Togo,Johor,1,1,0
1/01/2023,Togo,Perak,0,0,0
1/01/2023,Togo,Pulau Pinang,0,0,0
1/01/2023,Togo,Selangor,1,0,1
1/01/2023,Thailand,Johor,6207,1770,4437
1/01/2023,Thailand,Kedah,62053,36668,25385
1/01/2023,Thailand,Kelantan,48524,25810,22714
1/01/2023,Thailand,Melaka,5,3,2
1/01/2023,Thailand,Negeri Sembilan,0,0,0
1/01/2023,Thailand,Pahang,0,0,0
1/01/2023,Thailand,Perak,8606,4001,4605
1/01/2023,Thailand,Perlis,54106,33481,20625
1/01/2023,Thailand,Pulau Pinang,1667,658,1009
1/01/2023,Thailand,Sabah,133,29,104
1/01/2023,Thailand,Sarawak,367,126,241
1/01/2023,Thailand,Selangor,9090,3460,5630
1/01/2023,Thailand,Terengganu,0,0,0
1/01/2023,Thailand,W.P. Labuan,5,2,3
1/01/2023,Tajikistan,Johor,0,0,0
1/01/2023,Tajikistan,Kedah,0,0,0
1/01/2023,Tajikistan,Perlis,0,0,0
1/01/2023,Tajikistan,Pulau Pinang,1,1,0
1/01/2023,Tajikistan,Sabah,1,1,0
1/01/2023,Tajikistan,Selangor,99,66,33
1/01/2023,Tokelau,Selangor,0,0,0
1/01/2023,Turkmenistan,Johor,2,1,1
1/01/2023,Turkmenistan,Kedah,1,1,0
1/01/2023,Turkmenistan,Kelantan,0,0,0
1/01/2023,Turkmenistan,Perlis,0,0,0
1/01/2023,Turkmenistan,Pulau Pinang,0,0,0
1/01/2023,Turkmenistan,Sabah,0,0,0
1/01/2023,Turkmenistan,Sarawak,3,3,0
1/01/2023,Turkmenistan,Selangor,107,55,52
1/01/2023,Timor-Leste,Johor,4,1,3
1/01/2023,Timor-Leste,Kedah,0,0,0
1/01/2023,Timor-Leste,Perlis,0,0,0
1/01/2023,Timor-Leste,Pulau Pinang,5,3,2
1/01/2023,Timor-Leste,Sabah,4,4,0
1/01/2023,Timor-Leste,Sarawak,2,0,2
1/01/2023,Timor-Leste,Selangor,171,92,79
1/01/2023,Tonga,Johor,0,0,0
1/01/2023,Tonga,Pulau Pinang,1,1,0
1/01/2023,Tonga,Sarawak,0,0,0
1/01/2023,Tonga,Selangor,13,8,5
1/01/2023,Trinidad and Tobago,Johor,3,0,3
1/01/2023,Trinidad and Tobago,Kedah,0,0,0
1/01/2023,Trinidad and Tobago,Pahang,0,0,0
1/01/2023,Trinidad and Tobago,Pulau Pinang,0,0,0
1/01/2023,Trinidad and Tobago,Sabah,0,0,0
1/01/2023,Trinidad and Tobago,Sarawak,2,0,2
1/01/2023,Trinidad and Tobago,Selangor,21,14,7
1/01/2023,Tunisia,Johor,17,8,9
1/01/2023,Tunisia,Kedah,5,3,2
1/01/2023,Tunisia,Kelantan,0,0,0
1/01/2023,Tunisia,Melaka,2,1,1
1/01/2023,Tunisia,Perak,0,0,0
1/01/2023,Tunisia,Perlis,0,0,0
1/01/2023,Tunisia,Pulau Pinang,3,1,2
1/01/2023,Tunisia,Sabah,2,1,1
1/01/2023,Tunisia,Sarawak,2,0,2
1/01/2023,Tunisia,Selangor,589,278,311
1/01/2023,Tunisia,W.P. Labuan,0,0,0
1/01/2023,Türkiye,Johor,251,167,84
1/01/2023,Türkiye,Kedah,56,35,21
1/01/2023,Türkiye,Kelantan,2,0,2
1/01/2023,Türkiye,Melaka,1,1,0
1/01/2023,Türkiye,Negeri Sembilan,0,0,0
1/01/2023,Türkiye,Pahang,1,0,1
1/01/2023,Türkiye,Perak,2,1,1
1/01/2023,Türkiye,Perlis,23,17,6
1/01/2023,Türkiye,Pulau Pinang,40,29,11
1/01/2023,Türkiye,Sabah,13,8,5
1/01/2023,Türkiye,Sarawak,24,18,6
1/01/2023,Türkiye,Selangor,952,648,304
1/01/2023,Türkiye,W.P. Labuan,0,0,0
1/01/2023,Tuvalu,Selangor,0,0,0
1/01/2023,"Taiwan, Province of China",Johor,5464,2449,3015
1/01/2023,"Taiwan, Province of China",Kedah,169,88,81
1/01/2023,"Taiwan, Province of China",Kelantan,3,2,1
1/01/2023,"Taiwan, Province of China",Melaka,1,1,0
1/01/2023,"Taiwan, Province of China",Negeri Sembilan,0,0,0
1/01/2023,"Taiwan, Province of China",Pahang,12,6,6
1/01/2023,"Taiwan, Province of China",Perak,51,28,23
1/01/2023,"Taiwan, Province of China",Perlis,32,14,18
1/01/2023,"Taiwan, Province of China",Pulau Pinang,3376,1686,1690
1/01/2023,"Taiwan, Province of China",Sabah,1244,553,691
1/01/2023,"Taiwan, Province of China",Sarawak,483,192,291
1/01/2023,"Taiwan, Province of China",Selangor,12199,5864,6335
1/01/2023,"Taiwan, Province of China",W.P. Labuan,4,3,1
1/01/2023,"Tanzania, United Republic of",Johor,15,12,3
1/01/2023,"Tanzania, United Republic of",Kedah,2,2,0
1/01/2023,"Tanzania, United Republic of",Perak,0,0,0
1/01/2023,"Tanzania, United Republic of",Perlis,2,2,0
1/01/2023,"Tanzania, United Republic of",Pulau Pinang,0,0,0
1/01/2023,"Tanzania, United Republic of",Sabah,1,0,1
1/01/2023,"Tanzania, United Republic of",Sarawak,1,1,0
1/01/2023,"Tanzania, United Republic of",Selangor,119,51,68
1/01/2023,Uganda,Johor,25,9,16
1/01/2023,Uganda,Kedah,3,0,3
1/01/2023,Uganda,Perak,0,0,0
1/01/2023,Uganda,Perlis,1,1,0
1/01/2023,Uganda,Pulau Pinang,1,0,1
1/01/2023,Uganda,Sabah,0,0,0
1/01/2023,Uganda,Sarawak,0,0,0
1/01/2023,Uganda,Selangor,69,33,36
1/01/2023,Ukraine,Johor,81,57,24
1/01/2023,Ukraine,Kedah,70,32,38
1/01/2023,Ukraine,Kelantan,2,2,0
1/01/2023,Ukraine,Melaka,0,0,0
1/01/2023,Ukraine,Negeri Sembilan,0,0,0
1/01/2023,Ukraine,Pahang,3,2,1
1/01/2023,Ukraine,Perak,2,1,1
1/01/2023,Ukraine,Perlis,12,5,7
1/01/2023,Ukraine,Pulau Pinang,34,18,16
1/01/2023,Ukraine,Sabah,2,1,1
1/01/2023,Ukraine,Sarawak,2,0,2
1/01/2023,Ukraine,Selangor,1000,451,549
1/01/2023,Ukraine,W.P. Labuan,0,0,0
1/01/2023,Uruguay,Johor,15,8,7
1/01/2023,Uruguay,Kedah,3,2,1
1/01/2023,Uruguay,Kelantan,2,1,1
1/01/2023,Uruguay,Perak,0,0,0
1/01/2023,Uruguay,Perlis,0,0,0
1/01/2023,Uruguay,Pulau Pinang,0,0,0
1/01/2023,Uruguay,Sabah,0,0,0
1/01/2023,Uruguay,Sarawak,0,0,0
1/01/2023,Uruguay,Selangor,49,23,26
1/01/2023,Uruguay,W.P. Labuan,0,0,0
1/01/2023,United States of America,Johor,4101,2417,1684
1/01/2023,United States of America,Kedah,577,303,274
1/01/2023,United States of America,Kelantan,7,6,1
1/01/2023,United States of America,Melaka,0,0,0
1/01/2023,United States of America,Negeri Sembilan,0,0,0
1/01/2023,United States of America,Pahang,6,5,1
1/01/2023,United States of America,Perak,139,71,68
1/01/2023,United States of America,Perlis,137,84,53
1/01/2023,United States of America,Pulau Pinang,1739,1072,667
1/01/2023,United States of America,Sabah,315,174,141
1/01/2023,United States of America,Sarawak,251,144,107
1/01/2023,United States of America,Selangor,13199,7574,5625
1/01/2023,United States of America,Terengganu,0,0,0
1/01/2023,United States of America,W.P. Labuan,12,8,4
1/01/2023,Uzbekistan,Johor,93,78,15
1/01/2023,Uzbekistan,Kedah,37,22,15
1/01/2023,Uzbekistan,Kelantan,1,0,1
1/01/2023,Uzbekistan,Perak,0,0,0
1/01/2023,Uzbekistan,Perlis,2,1,1
1/01/2023,Uzbekistan,Pulau Pinang,15,3,12
1/01/2023,Uzbekistan,Sabah,6,4,2
1/01/2023,Uzbekistan,Sarawak,2,1,1
1/01/2023,Uzbekistan,Selangor,1930,1208,722
1/01/2023,Holy See,Johor,0,0,0
1/01/2023,Holy See,Sarawak,0,0,0
1/01/2023,Holy See,Selangor,0,0,0
1/01/2023,Saint Vincent and the Grenadines,Johor,0,0,0
1/01/2023,Saint Vincent and the Grenadines,Kedah,0,0,0
1/01/2023,Saint Vincent and the Grenadines,Pulau Pinang,0,0,0
1/01/2023,Saint Vincent and the Grenadines,Sarawak,0,0,0
1/01/2023,Saint Vincent and the Grenadines,Selangor,4,1,3
1/01/2023,"Venezuela, Bolivarian Republic of",Johor,19,7,12
1/01/2023,"Venezuela, Bolivarian Republic of",Kedah,1,0,1
1/01/2023,"Venezuela, Bolivarian Republic of",Kelantan,0,0,0
1/01/2023,"Venezuela, Bolivarian Republic of",Melaka,0,0,0
1/01/2023,"Venezuela, Bolivarian Republic of",Perak,0,0,0
1/01/2023,"Venezuela, Bolivarian Republic of",Perlis,0,0,0
1/01/2023,"Venezuela, Bolivarian Republic of",Pulau Pinang,3,3,0
1/01/2023,"Venezuela, Bolivarian Republic of",Sabah,0,0,0
1/01/2023,"Venezuela, Bolivarian Republic of",Sarawak,1,1,0
1/01/2023,"Venezuela, Bolivarian Republic of",Selangor,82,40,42
1/01/2023,"Venezuela, Bolivarian Republic of",W.P. Labuan,0,0,0
1/01/2023,Viet Nam,Johor,9635,2835,6800
1/01/2023,Viet Nam,Kedah,287,48,239
1/01/2023,Viet Nam,Kelantan,7,3,4
1/01/2023,Viet Nam,Melaka,0,0,0
1/01/2023,Viet Nam,Negeri Sembilan,1,0,1
1/01/2023,Viet Nam,Pahang,3,1,2
1/01/2023,Viet Nam,Perak,79,3,76
1/01/2023,Viet Nam,Perlis,178,15,163
1/01/2023,Viet Nam,Pulau Pinang,1270,330,940
1/01/2023,Viet Nam,Sabah,18,4,14
1/01/2023,Viet Nam,Sarawak,158,33,125
1/01/2023,Viet Nam,Selangor,13425,4331,9094
1/01/2023,Viet Nam,Terengganu,0,0,0
1/01/2023,Viet Nam,W.P. Labuan,6,4,2
1/01/2023,Vanuatu,Johor,37,21,16
1/01/2023,Vanuatu,Kedah,0,0,0
1/01/2023,Vanuatu,Pulau Pinang,10,5,5
1/01/2023,Vanuatu,Sabah,1,1,0
1/01/2023,Vanuatu,Sarawak,0,0,0
1/01/2023,Vanuatu,Selangor,39,34,5
1/01/2023, Samoa,Johor,0,0,0
1/01/2023, Samoa,Sarawak,0,0,0
1/01/2023, Samoa,Selangor,0,0,0
1/01/2023,Yemen,Johor,31,22,9
1/01/2023,Yemen,Kedah,3,2,1
1/01/2023,Yemen,Kelantan,4,4,0
1/01/2023,Yemen,Melaka,5,3,2
1/01/2023,Yemen,Pahang,0,0,0
1/01/2023,Yemen,Perak,0,0,0
1/01/2023,Yemen,Perlis,2,2,0
1/01/2023,Yemen,Pulau Pinang,1,1,0
1/01/2023,Yemen,Sabah,2,2,0
1/01/2023,Yemen,Sarawak,0,0,0
1/01/2023,Yemen,Selangor,1064,746,318
1/01/2023,Yemen,W.P. Labuan,0,0,0
1/01/2023,South Africa,Johor,279,159,120
1/01/2023,South Africa,Kedah,75,41,34
1/01/2023,South Africa,Kelantan,0,0,0
1/01/2023,South Africa,Melaka,1,1,0
1/01/2023,South Africa,Pahang,2,0,2
1/01/2023,South Africa,Perak,2,2,0
1/01/2023,South Africa,Perlis,10,4,6
1/01/2023,South Africa,Pulau Pinang,42,24,18
1/01/2023,South Africa,Sabah,10,7,3
1/01/2023,South Africa,Sarawak,43,27,16
1/01/2023,South Africa,Selangor,1194,621,573
1/01/2023,South Africa,Terengganu,0,0,0
1/01/2023,South Africa,W.P. Labuan,16,7,9
1/01/2023,ZAR,Selangor,0,0,0
1/01/2023,Zambia,Johor,2,1,1
1/01/2023,Zambia,Kedah,0,0,0
1/01/2023,Zambia,Perak,0,0,0
1/01/2023,Zambia,Perlis,0,0,0
1/01/2023,Zambia,Pulau Pinang,0,0,0
1/01/2023,Zambia,Sabah,0,0,0
1/01/2023,Zambia,Sarawak,0,0,0
1/01/2023,Zambia,Selangor,67,38,29
1/01/2023,Zimbabwe,Johor,6,4,2
1/01/2023,Zimbabwe,Kedah,0,0,0
1/01/2023,Zimbabwe,Kelantan,0,0,0
1/01/2023,Zimbabwe,Perak,0,0,0
1/01/2023,Zimbabwe,Perlis,0,0,0
1/01/2023,Zimbabwe,Pulau Pinang,0,0,0
1/01/2023,Zimbabwe,Sabah,0,0,0
1/01/2023,Zimbabwe,Sarawak,0,0,0
1/01/2023,Zimbabwe,Selangor,119,59,60
1/02/2023,Aruba,Kedah,0,0,0
1/02/2023,Aruba,Pulau Pinang,0,0,0
1/02/2023,Afghanistan,Johor,0,0,0
1/02/2023,Afghanistan,Kedah,0,0,0
1/02/2023,Afghanistan,Perlis,0,0,0
1/02/2023,Afghanistan,Pulau Pinang,0,0,0
1/02/2023,Afghanistan,Sarawak,1,1,0
1/02/2023,Afghanistan,Selangor,39,35,4
1/02/2023,Angola,Johor,0,0,0
1/02/2023,Angola,Kedah,0,0,0
1/02/2023,Angola,Sabah,0,0,0
1/02/2023,Angola,Selangor,5,4,1
1/02/2023,Anguilla,Selangor,0,0,0
1/02/2023,Albania,Johor,9,7,2
1/02/2023,Albania,Kedah,3,3,0
1/02/2023,Albania,Perak,0,0,0
1/02/2023,Albania,Perlis,1,0,1
1/02/2023,Albania,Pulau Pinang,1,1,0
1/02/2023,Albania,Sabah,0,0,0
1/02/2023,Albania,Sarawak,0,0,0
1/02/2023,Albania,Selangor,23,15,8
1/02/2023,Andorra,Johor,0,0,0
1/02/2023,Andorra,Kedah,0,0,0
1/02/2023,Andorra,Perlis,0,0,0
1/02/2023,Andorra,Pulau Pinang,0,0,0
1/02/2023,Andorra,Selangor,5,3,2
1/02/2023,Antigua and Barbuda,Selangor,0,0,0
1/02/2023,United Arab Emirates,Johor,9,6,3
1/02/2023,United Arab Emirates,Kedah,0,0,0
1/02/2023,United Arab Emirates,Kelantan,0,0,0
1/02/2023,United Arab Emirates,Perak,0,0,0
1/02/2023,United Arab Emirates,Perlis,0,0,0
1/02/2023,United Arab Emirates,Pulau Pinang,2,2,0
1/02/2023,United Arab Emirates,Sabah,1,1,0
1/02/2023,United Arab Emirates,Sarawak,0,0,0
1/02/2023,United Arab Emirates,Selangor,274,188,86
1/02/2023,Argentina,Johor,70,46,24
1/02/2023,Argentina,Kedah,71,34,37
1/02/2023,Argentina,Kelantan,0,0,0
1/02/2023,Argentina,Melaka,0,0,0
1/02/2023,Argentina,Perak,0,0,0
1/02/2023,Argentina,Perlis,5,3,2
1/02/2023,Argentina,Pulau Pinang,4,2,2
1/02/2023,Argentina,Sabah,3,2,1
1/02/2023,Argentina,Sarawak,2,1,1
1/02/2023,Argentina,Selangor,301,175,126
1/02/2023,Argentina,W.P. Labuan,0,0,0
1/02/2023,Armenia,Johor,0,0,0
1/02/2023,Armenia,Kedah,1,0,1
1/02/2023,Armenia,Kelantan,0,0,0
1/02/2023,Armenia,Perak,0,0,0
1/02/2023,Armenia,Perlis,0,0,0
1/02/2023,Armenia,Pulau Pinang,4,1,3
1/02/2023,Armenia,Sabah,3,1,2
1/02/2023,Armenia,Sarawak,0,0,0
1/02/2023,Armenia,Selangor,37,18,19
1/02/2023,Antarctica,Selangor,0,0,0
1/02/2023,Antigua and Barbuda,Johor,3,2,1
1/02/2023,Antigua and Barbuda,Kedah,0,0,0
1/02/2023,Antigua and Barbuda,Pulau Pinang,0,0,0
1/02/2023,Antigua and Barbuda,Sarawak,0,0,0
1/02/2023,Antigua and Barbuda,Selangor,12,9,3
1/02/2023,Australia,Johor,4214,2536,1678
1/02/2023,Australia,Kedah,509,280,229
1/02/2023,Australia,Kelantan,4,4,0
1/02/2023,Australia,Melaka,4,4,0
1/02/2023,Australia,Negeri Sembilan,1,1,0
1/02/2023,Australia,Pahang,1,1,0
1/02/2023,Australia,Perak,218,118,100
1/02/2023,Australia,Perlis,81,54,27
1/02/2023,Australia,Pulau Pinang,1650,914,736
1/02/2023,Australia,Sabah,272,136,136
1/02/2023,Australia,Sarawak,501,282,219
1/02/2023,Australia,Selangor,15945,9512,6433
1/02/2023,Australia,Terengganu,0,0,0
1/02/2023,Australia,W.P. Labuan,13,7,6
1/02/2023,Austria,Johor,178,97,81
1/02/2023,Austria,Kedah,174,99,75
1/02/2023,Austria,Kelantan,3,3,0
1/02/2023,Austria,Melaka,1,1,0
1/02/2023,Austria,Negeri Sembilan,0,0,0
1/02/2023,Austria,Pahang,0,0,0
1/02/2023,Austria,Perak,4,2,2
1/02/2023,Austria,Perlis,28,21,7
1/02/2023,Austria,Pulau Pinang,84,43,41
1/02/2023,Austria,Sabah,15,9,6
1/02/2023,Austria,Sarawak,11,7,4
1/02/2023,Austria,Selangor,878,528,350
1/02/2023,Austria,Terengganu,0,0,0
1/02/2023,Austria,W.P. Labuan,4,4,0
1/02/2023,Azerbaijan,Johor,2,2,0
1/02/2023,Azerbaijan,Kedah,1,1,0
1/02/2023,Azerbaijan,Kelantan,0,0,0
1/02/2023,Azerbaijan,Melaka,0,0,0
1/02/2023,Azerbaijan,Perlis,0,0,0
1/02/2023,Azerbaijan,Pulau Pinang,2,2,0
1/02/2023,Azerbaijan,Sabah,1,1,0
1/02/2023,Azerbaijan,Sarawak,2,1,1
1/02/2023,Azerbaijan,Selangor,69,41,28
1/02/2023,Azerbaijan,W.P. Labuan,0,0,0
1/02/2023,Burundi,Pulau Pinang,0,0,0
1/02/2023,Burundi,Sarawak,0,0,0
1/02/2023,Burundi,Selangor,3,2,1
1/02/2023,Belgium,Johor,231,159,72
1/02/2023,Belgium,Kedah,121,60,61
1/02/2023,Belgium,Kelantan,1,1,0
1/02/2023,Belgium,Melaka,1,1,0
1/02/2023,Belgium,Negeri Sembilan,1,0,1
1/02/2023,Belgium,Pahang,5,3,2
1/02/2023,Belgium,Perak,7,4,3
1/02/2023,Belgium,Perlis,29,14,15
1/02/2023,Belgium,Pulau Pinang,50,40,10
1/02/2023,Belgium,Sabah,21,10,11
1/02/2023,Belgium,Sarawak,29,12,17
1/02/2023,Belgium,Selangor,979,624,355
1/02/2023,Belgium,W.P. Labuan,0,0,0
1/02/2023,Benin,Johor,1,1,0
1/02/2023,Benin,Kedah,0,0,0
1/02/2023,Benin,Perak,0,0,0
1/02/2023,Benin,Pulau Pinang,0,0,0
1/02/2023,Benin,Sabah,0,0,0
1/02/2023,Benin,Sarawak,1,1,0
1/02/2023,Benin,Selangor,5,4,1
1/02/2023,Burkina Faso,Perak,0,0,0
1/02/2023,Burkina Faso,Pulau Pinang,0,0,0
1/02/2023,Burkina Faso,Selangor,4,4,0
1/02/2023,Bangladesh,Johor,2295,1920,375
1/02/2023,Bangladesh,Kedah,37,18,19
1/02/2023,Bangladesh,Kelantan,1,1,0
1/02/2023,Bangladesh,Melaka,1,1,0
1/02/2023,Bangladesh,Negeri Sembilan,0,0,0
1/02/2023,Bangladesh,Pahang,0,0,0
1/02/2023,Bangladesh,Perak,17,17,0
1/02/2023,Bangladesh,Perlis,4,4,0
1/02/2023,Bangladesh,Pulau Pinang,648,636,12
1/02/2023,Bangladesh,Sabah,2,2,0
1/02/2023,Bangladesh,Sarawak,28,26,2
1/02/2023,Bangladesh,Selangor,56313,54724,1589
1/02/2023,Bangladesh,W.P. Labuan,4,4,0
1/02/2023,Bulgaria,Johor,44,27,17
1/02/2023,Bulgaria,Kedah,21,11,10
1/02/2023,Bulgaria,Kelantan,0,0,0
1/02/2023,Bulgaria,Pahang,0,0,0
1/02/2023,Bulgaria,Perak,1,0,1
1/02/2023,Bulgaria,Perlis,5,4,1
1/02/2023,Bulgaria,Pulau Pinang,14,7,7
1/02/2023,Bulgaria,Sabah,4,1,3
1/02/2023,Bulgaria,Sarawak,2,1,1
1/02/2023,Bulgaria,Selangor,250,140,110
1/02/2023,Bulgaria,W.P. Labuan,0,0,0
1/02/2023,Bahrain,Johor,6,3,3
1/02/2023,Bahrain,Kedah,2,2,0
1/02/2023,Bahrain,Kelantan,1,1,0
1/02/2023,Bahrain,Perlis,1,1,0
1/02/2023,Bahrain,Pulau Pinang,3,3,0
1/02/2023,Bahrain,Sabah,0,0,0
1/02/2023,Bahrain,Sarawak,0,0,0
1/02/2023,Bahrain,Selangor,105,56,49
1/02/2023,Bahamas,Johor,5,1,4
1/02/2023,Bahamas,Kedah,0,0,0
1/02/2023,Bahamas,Perak,0,0,0
1/02/2023,Bahamas,Sabah,0,0,0
1/02/2023,Bahamas,Sarawak,0,0,0
1/02/2023,Bahamas,Selangor,3,3,0
1/02/2023,Bosnia and Herzegovina,Johor,10,7,3
1/02/2023,Bosnia and Herzegovina,Kedah,0,0,0
1/02/2023,Bosnia and Herzegovina,Perlis,0,0,0
1/02/2023,Bosnia and Herzegovina,Pulau Pinang,3,1,2
1/02/2023,Bosnia and Herzegovina,Sabah,0,0,0
1/02/2023,Bosnia and Herzegovina,Sarawak,1,1,0
1/02/2023,Bosnia and Herzegovina,Selangor,55,32,23
1/02/2023,Belarus,Johor,6,2,4
1/02/2023,Belarus,Kedah,10,4,6
1/02/2023,Belarus,Kelantan,2,2,0
1/02/2023,Belarus,Pahang,0,0,0
1/02/2023,Belarus,Perak,0,0,0
1/02/2023,Belarus,Perlis,8,4,4
1/02/2023,Belarus,Pulau Pinang,11,4,7
1/02/2023,Belarus,Sabah,0,0,0
1/02/2023,Belarus,Sarawak,0,0,0
1/02/2023,Belarus,Selangor,476,237,239
1/02/2023,Belarus,W.P. Labuan,0,0,0
1/02/2023,Belize,Johor,7,3,4
1/02/2023,Belize,Pulau Pinang,0,0,0
1/02/2023,Belize,Sarawak,0,0,0
1/02/2023,Belize,Selangor,5,4,1
1/02/2023,Bermuda,Selangor,0,0,0
1/02/2023,Bolivia,Johor,1,0,1
1/02/2023,Bolivia,Kedah,0,0,0
1/02/2023,Bolivia,Melaka,0,0,0
1/02/2023,Bolivia,Perak,0,0,0
1/02/2023,Bolivia,Perlis,0,0,0
1/02/2023,Bolivia,Pulau Pinang,0,0,0
1/02/2023,Bolivia,Sabah,1,1,0
1/02/2023,Bolivia,Sarawak,2,0,2
1/02/2023,Bolivia,Selangor,12,6,6
1/02/2023,Brazil,Johor,155,91,64
1/02/2023,Brazil,Kedah,72,34,38
1/02/2023,Brazil,Kelantan,0,0,0
1/02/2023,Brazil,Melaka,0,0,0
1/02/2023,Brazil,Pahang,0,0,0
1/02/2023,Brazil,Perak,1,0,1
1/02/2023,Brazil,Perlis,5,2,3
1/02/2023,Brazil,Pulau Pinang,27,14,13
1/02/2023,Brazil,Sabah,7,6,1
1/02/2023,Brazil,Sarawak,5,3,2
1/02/2023,Brazil,Selangor,694,401,293
1/02/2023,Brazil,W.P. Labuan,2,1,1
1/02/2023,Barbados,Johor,0,0,0
1/02/2023,Barbados,Kedah,0,0,0
1/02/2023,Barbados,Perlis,0,0,0
1/02/2023,Barbados,Pulau Pinang,0,0,0
1/02/2023,Barbados,Selangor,4,2,2
1/02/2023,Brunei Darussalam,Johor,446,224,222
1/02/2023,Brunei Darussalam,Kedah,23,15,8
1/02/2023,Brunei Darussalam,Kelantan,1,1,0
1/02/2023,Brunei Darussalam,Melaka,0,0,0
1/02/2023,Brunei Darussalam,Pahang,0,0,0
1/02/2023,Brunei Darussalam,Perak,7,7,0
1/02/2023,Brunei Darussalam,Perlis,8,2,6
1/02/2023,Brunei Darussalam,Pulau Pinang,11,8,3
1/02/2023,Brunei Darussalam,Sabah,754,313,441
1/02/2023,Brunei Darussalam,Sarawak,84606,46519,38087
1/02/2023,Brunei Darussalam,Selangor,4262,2120,2142
1/02/2023,Brunei Darussalam,W.P. Labuan,1362,910,452
1/02/2023,Bhutan,Johor,4,4,0
1/02/2023,Bhutan,Kedah,0,0,0
1/02/2023,Bhutan,Perak,0,0,0
1/02/2023,Bhutan,Perlis,0,0,0
1/02/2023,Bhutan,Pulau Pinang,3,2,1
1/02/2023,Bhutan,Sabah,0,0,0
1/02/2023,Bhutan,Sarawak,0,0,0
1/02/2023,Bhutan,Selangor,18,12,6
1/02/2023,Botswana,Johor,0,0,0
1/02/2023,Botswana,Kedah,0,0,0
1/02/2023,Botswana,Perlis,0,0,0
1/02/2023,Botswana,Pulau Pinang,0,0,0
1/02/2023,Botswana,Sabah,0,0,0
1/02/2023,Botswana,Sarawak,0,0,0
1/02/2023,Botswana,Selangor,12,2,10
1/02/2023,Central African Republic,Kedah,0,0,0
1/02/2023,Central African Republic,Selangor,0,0,0
1/02/2023,Canada,Johor,1490,814,676
1/02/2023,Canada,Kedah,343,179,164
1/02/2023,Canada,Kelantan,2,1,1
1/02/2023,Canada,Melaka,0,0,0
1/02/2023,Canada,Negeri Sembilan,0,0,0
1/02/2023,Canada,Pahang,1,1,0
1/02/2023,Canada,Perak,43,25,18
1/02/2023,Canada,Perlis,82,50,32
1/02/2023,Canada,Pulau Pinang,646,339,307
1/02/2023,Canada,Sabah,183,99,84
1/02/2023,Canada,Sarawak,400,222,178
1/02/2023,Canada,Selangor,4360,2563,1797
1/02/2023,Canada,Terengganu,0,0,0
1/02/2023,Canada,W.P. Labuan,9,6,3
1/02/2023,Cocos (Keeling) Islands,Selangor,0,0,0
1/02/2023,Switzerland,Johor,335,198,137
1/02/2023,Switzerland,Kedah,218,111,107
1/02/2023,Switzerland,Kelantan,3,3,0
1/02/2023,Switzerland,Melaka,0,0,0
1/02/2023,Switzerland,Negeri Sembilan,0,0,0
1/02/2023,Switzerland,Pahang,0,0,0
1/02/2023,Switzerland,Perak,9,5,4
1/02/2023,Switzerland,Perlis,52,35,17
1/02/2023,Switzerland,Pulau Pinang,151,91,60
1/02/2023,Switzerland,Sabah,28,14,14
1/02/2023,Switzerland,Sarawak,43,19,24
1/02/2023,Switzerland,Selangor,1268,749,519
1/02/2023,Switzerland,W.P. Labuan,2,2,0
1/02/2023,Chile,Johor,27,9,18
1/02/2023,Chile,Kedah,22,11,11
1/02/2023,Chile,Kelantan,1,0,1
1/02/2023,Chile,Melaka,0,0,0
1/02/2023,Chile,Pahang,0,0,0
1/02/2023,Chile,Perak,0,0,0
1/02/2023,Chile,Perlis,4,2,2
1/02/2023,Chile,Pulau Pinang,5,1,4
1/02/2023,Chile,Sabah,4,2,2
1/02/2023,Chile,Sarawak,1,1,0
1/02/2023,Chile,Selangor,266,128,138
1/02/2023,China,Johor,19461,8292,11169
1/02/2023,China,Kedah,477,195,282
1/02/2023,China,Kelantan,2,0,2
1/02/2023,China,Melaka,0,0,0
1/02/2023,China,Pahang,1,1,0
1/02/2023,China,Perak,193,79,114
1/02/2023,China,Perlis,64,42,22
1/02/2023,China,Pulau Pinang,3144,1682,1462
1/02/2023,China,Sabah,1049,560,489
1/02/2023,China,Sarawak,600,315,285
1/02/2023,China,Selangor,39835,23650,16185
1/02/2023,China,Terengganu,0,0,0
1/02/2023,China,W.P. Labuan,66,61,5
1/02/2023,Côte d'Ivoire,Johor,1,0,1
1/02/2023,Côte d'Ivoire,Kedah,0,0,0
1/02/2023,Côte d'Ivoire,Pulau Pinang,0,0,0
1/02/2023,Côte d'Ivoire,Sabah,0,0,0
1/02/2023,Côte d'Ivoire,Sarawak,0,0,0
1/02/2023,Côte d'Ivoire,Selangor,26,21,5
1/02/2023,Cameroon,Johor,0,0,0
1/02/2023,Cameroon,Kedah,0,0,0
1/02/2023,Cameroon,Pulau Pinang,1,1,0
1/02/2023,Cameroon,Sabah,0,0,0
1/02/2023,Cameroon,Sarawak,0,0,0
1/02/2023,Cameroon,Selangor,15,10,5
1/02/2023,Congo,Johor,3,3,0
1/02/2023,Congo,Pulau Pinang,0,0,0
1/02/2023,Congo,Sarawak,0,0,0
1/02/2023,Congo,Selangor,3,3,0
1/02/2023,Congo,Johor,0,0,0
1/02/2023,Congo,Kedah,0,0,0
1/02/2023,Congo,Selangor,2,2,0
1/02/2023,Cook Islands,Selangor,0,0,0
1/02/2023,Colombia,Johor,25,13,12
1/02/2023,Colombia,Kedah,0,0,0
1/02/2023,Colombia,Perak,0,0,0
1/02/2023,Colombia,Pulau Pinang,1,0,1
1/02/2023,Colombia,Sabah,1,1,0
1/02/2023,Colombia,Sarawak,0,0,0
1/02/2023,Colombia,Selangor,103,54,49
1/02/2023,Colombia,W.P. Labuan,0,0,0
1/02/2023,Comoros,Johor,5,3,2
1/02/2023,Comoros,Kedah,0,0,0
1/02/2023,Comoros,Selangor,17,6,11
1/02/2023,Cabo Verde,Johor,0,0,0
1/02/2023,Cabo Verde,Kedah,0,0,0
1/02/2023,Cabo Verde,Pulau Pinang,0,0,0
1/02/2023,Cabo Verde,Sabah,1,1,0
1/02/2023,Cabo Verde,Selangor,1,1,0
1/02/2023,Costa Rica,Johor,3,2,1
1/02/2023,Costa Rica,Kedah,1,0,1
1/02/2023,Costa Rica,Perak,0,0,0
1/02/2023,Costa Rica,Perlis,0,0,0
1/02/2023,Costa Rica,Pulau Pinang,2,1,1
1/02/2023,Costa Rica,Sabah,0,0,0
1/02/2023,Costa Rica,Sarawak,0,0,0
1/02/2023,Costa Rica,Selangor,44,28,16
1/02/2023,Cuba,Johor,3,2,1
1/02/2023,Cuba,Kedah,0,0,0
1/02/2023,Cuba,Perlis,0,0,0
1/02/2023,Cuba,Pulau Pinang,0,0,0
1/02/2023,Cuba,Sabah,1,0,1
1/02/2023,Cuba,Sarawak,0,0,0
1/02/2023,Cuba,Selangor,15,7,8
1/02/2023,Cyprus,Johor,11,9,2
1/02/2023,Cyprus,Kedah,2,1,1
1/02/2023,Cyprus,Perak,0,0,0
1/02/2023,Cyprus,Perlis,0,0,0
1/02/2023,Cyprus,Pulau Pinang,2,1,1
1/02/2023,Cyprus,Sabah,0,0,0
1/02/2023,Cyprus,Sarawak,0,0,0
1/02/2023,Cyprus,Selangor,32,21,11
1/02/2023,Czechia,Johor,143,74,69
1/02/2023,Czechia,Kedah,170,89,81
1/02/2023,Czechia,Kelantan,3,3,0
1/02/2023,Czechia,Melaka,0,0,0
1/02/2023,Czechia,Negeri Sembilan,0,0,0
1/02/2023,Czechia,Perak,1,0,1
1/02/2023,Czechia,Perlis,10,3,7
1/02/2023,Czechia,Pulau Pinang,29,17,12
1/02/2023,Czechia,Sabah,18,12,6
1/02/2023,Czechia,Sarawak,11,7,4
1/02/2023,Czechia,Selangor,629,372,257
1/02/2023,Czechia,W.P. Labuan,6,3,3
1/02/2023,Germany,Johor,2361,1448,913
1/02/2023,Germany,Kedah,1167,570,597
1/02/2023,Germany,Kelantan,18,13,5
1/02/2023,Germany,Melaka,6,5,1
1/02/2023,Germany,Negeri Sembilan,0,0,0
1/02/2023,Germany,Pahang,5,4,1
1/02/2023,Germany,Perak,27,18,9
1/02/2023,Germany,Perlis,235,142,93
1/02/2023,Germany,Pulau Pinang,847,578,269
1/02/2023,Germany,Sabah,138,84,54
1/02/2023,Germany,Sarawak,245,141,104
1/02/2023,Germany,Selangor,8981,5352,3629
1/02/2023,Germany,Terengganu,0,0,0
1/02/2023,Germany,W.P. Labuan,17,12,5
1/02/2023,Djibouti,Johor,0,0,0
1/02/2023,Djibouti,Selangor,5,3,2
1/02/2023,Dominica,Johor,4,4,0
1/02/2023,Dominica,Kedah,0,0,0
1/02/2023,Dominica,Pulau Pinang,1,1,0
1/02/2023,Dominica,Sabah,0,0,0
1/02/2023,Dominica,Sarawak,0,0,0
1/02/2023,Dominica,Selangor,37,28,9
1/02/2023,Dominica,W.P. Labuan,0,0,0
1/02/2023,Denmark,Johor,321,219,102
1/02/2023,Denmark,Kedah,368,178,190
1/02/2023,Denmark,Kelantan,0,0,0
1/02/2023,Denmark,Melaka,0,0,0
1/02/2023,Denmark,Negeri Sembilan,3,3,0
1/02/2023,Denmark,Pahang,0,0,0
1/02/2023,Denmark,Perak,10,4,6
1/02/2023,Denmark,Perlis,21,16,5
1/02/2023,Denmark,Pulau Pinang,82,56,26
1/02/2023,Denmark,Sabah,53,29,24
1/02/2023,Denmark,Sarawak,20,11,9
1/02/2023,Denmark,Selangor,1087,626,461
1/02/2023,Denmark,W.P. Labuan,0,0,0
1/02/2023,Dominican Republic,Johor,4,3,1
1/02/2023,Dominican Republic,Kedah,0,0,0
1/02/2023,Dominican Republic,Perak,0,0,0
1/02/2023,Dominican Republic,Perlis,0,0,0
1/02/2023,Dominican Republic,Pulau Pinang,3,1,2
1/02/2023,Dominican Republic,Sabah,0,0,0
1/02/2023,Dominican Republic,Sarawak,0,0,0
1/02/2023,Dominican Republic,Selangor,16,7,9
1/02/2023,Algeria,Johor,22,14,8
1/02/2023,Algeria,Kedah,5,2,3
1/02/2023,Algeria,Kelantan,1,1,0
1/02/2023,Algeria,Melaka,0,0,0
1/02/2023,Algeria,Perak,0,0,0
1/02/2023,Algeria,Perlis,1,1,0
1/02/2023,Algeria,Pulau Pinang,0,0,0
1/02/2023,Algeria,Sabah,1,1,0
1/02/2023,Algeria,Sarawak,5,5,0
1/02/2023,Algeria,Selangor,369,256,113
1/02/2023,Algeria,W.P. Labuan,0,0,0
1/02/2023,Ecuador,Johor,11,10,1
1/02/2023,Ecuador,Kedah,0,0,0
1/02/2023,Ecuador,Perak,0,0,0
1/02/2023,Ecuador,Perlis,0,0,0
1/02/2023,Ecuador,Pulau Pinang,1,0,1
1/02/2023,Ecuador,Sabah,0,0,0
1/02/2023,Ecuador,Sarawak,0,0,0
1/02/2023,Ecuador,Selangor,44,30,14
1/02/2023,Egypt,Johor,181,150,31
1/02/2023,Egypt,Kedah,7,3,4
1/02/2023,Egypt,Kelantan,0,0,0
1/02/2023,Egypt,Melaka,0,0,0
1/02/2023,Egypt,Pahang,0,0,0
1/02/2023,Egypt,Perak,0,0,0
1/02/2023,Egypt,Perlis,2,2,0
1/02/2023,Egypt,Pulau Pinang,10,8,2
1/02/2023,Egypt,Sabah,6,5,1
1/02/2023,Egypt,Sarawak,129,87,42
1/02/2023,Egypt,Selangor,1442,996,446
1/02/2023,Egypt,Terengganu,0,0,0
1/02/2023,Egypt,W.P. Labuan,0,0,0
1/02/2023,Eritrea,Johor,1,0,1
1/02/2023,Eritrea,Pulau Pinang,0,0,0
1/02/2023,Eritrea,Sabah,0,0,0
1/02/2023,Eritrea,Selangor,7,4,3
1/02/2023,Spain,Johor,360,229,131
1/02/2023,Spain,Kedah,184,94,90
1/02/2023,Spain,Kelantan,5,3,2
1/02/2023,Spain,Melaka,1,1,0
1/02/2023,Spain,Negeri Sembilan,0,0,0
1/02/2023,Spain,Pahang,0,0,0
1/02/2023,Spain,Perak,6,4,2
1/02/2023,Spain,Perlis,27,16,11
1/02/2023,Spain,Pulau Pinang,97,61,36
1/02/2023,Spain,Sabah,21,12,9
1/02/2023,Spain,Sarawak,29,20,9
1/02/2023,Spain,Selangor,1469,931,538
1/02/2023,Spain,W.P. Labuan,4,2,2
1/02/2023,Estonia,Johor,70,41,29
1/02/2023,Estonia,Kedah,91,45,46
1/02/2023,Estonia,Kelantan,0,0,0
1/02/2023,Estonia,Pahang,0,0,0
1/02/2023,Estonia,Perak,0,0,0
1/02/2023,Estonia,Perlis,4,3,1
1/02/2023,Estonia,Pulau Pinang,34,18,16
1/02/2023,Estonia,Sabah,12,5,7
1/02/2023,Estonia,Sarawak,12,6,6
1/02/2023,Estonia,Selangor,308,164,144
1/02/2023,Estonia,W.P. Labuan,4,1,3
1/02/2023,Ethiopia,Johor,2,2,0
1/02/2023,Ethiopia,Kedah,0,0,0
1/02/2023,Ethiopia,Pulau Pinang,1,1,0
1/02/2023,Ethiopia,Sarawak,0,0,0
1/02/2023,Ethiopia,Selangor,29,23,6
1/02/2023,Finland,Johor,184,120,64
1/02/2023,Finland,Kedah,184,91,93
1/02/2023,Finland,Kelantan,4,2,2
1/02/2023,Finland,Melaka,0,0,0
1/02/2023,Finland,Negeri Sembilan,0,0,0
1/02/2023,Finland,Pahang,0,0,0
1/02/2023,Finland,Perak,8,4,4
1/02/2023,Finland,Perlis,14,12,2
1/02/2023,Finland,Pulau Pinang,60,35,25
1/02/2023,Finland,Sabah,24,13,11
1/02/2023,Finland,Sarawak,19,12,7
1/02/2023,Finland,Selangor,660,371,289
1/02/2023,Finland,W.P. Labuan,6,5,1
1/02/2023,Fiji,Johor,41,19,22
1/02/2023,Fiji,Kedah,1,1,0
1/02/2023,Fiji,Kelantan,0,0,0
1/02/2023,Fiji,Perak,0,0,0
1/02/2023,Fiji,Perlis,0,0,0
1/02/2023,Fiji,Pulau Pinang,5,1,4
1/02/2023,Fiji,Sabah,0,0,0
1/02/2023,Fiji,Sarawak,1,0,1
1/02/2023,Fiji,Selangor,57,36,21
1/02/2023,France,Johor,1781,1100,681
1/02/2023,France,Kedah,1029,546,483
1/02/2023,France,Kelantan,21,13,8
1/02/2023,France,Melaka,3,2,1
1/02/2023,France,Negeri Sembilan,1,1,0
1/02/2023,France,Pahang,4,3,1
1/02/2023,France,Perak,53,32,21
1/02/2023,France,Perlis,162,106,56
1/02/2023,France,Pulau Pinang,421,267,154
1/02/2023,France,Sabah,92,58,34
1/02/2023,France,Sarawak,101,71,30
1/02/2023,France,Selangor,6983,4205,2778
1/02/2023,France,Terengganu,0,0,0
1/02/2023,France,W.P. Labuan,4,3,1
1/02/2023,"Micronesia, Federated States of",Johor,0,0,0
1/02/2023,"Micronesia, Federated States of",Pulau Pinang,0,0,0
1/02/2023,"Micronesia, Federated States of",Selangor,0,0,0
1/02/2023,Gabon,Johor,0,0,0
1/02/2023,Gabon,Pulau Pinang,0,0,0
1/02/2023,Gabon,Sarawak,0,0,0
1/02/2023,Gabon,Selangor,2,1,1
1/02/2023,United Kingdom of Great Britain and Northern Ireland,Johor,4190,2769,1421
1/02/2023,United Kingdom of Great Britain and Northern Ireland,Kedah,1502,798,704
1/02/2023,United Kingdom of Great Britain and Northern Ireland,Kelantan,18,16,2
1/02/2023,United Kingdom of Great Britain and Northern Ireland,Melaka,1,1,0
1/02/2023,United Kingdom of Great Britain and Northern Ireland,Negeri Sembilan,1,1,0
1/02/2023,United Kingdom of Great Britain and Northern Ireland,Pahang,9,6,3
1/02/2023,United Kingdom of Great Britain and Northern Ireland,Perak,126,69,57
1/02/2023,United Kingdom of Great Britain and Northern Ireland,Perlis,239,163,76
1/02/2023,United Kingdom of Great Britain and Northern Ireland,Pulau Pinang,1713,1002,711
1/02/2023,United Kingdom of Great Britain and Northern Ireland,Sabah,464,243,221
1/02/2023,United Kingdom of Great Britain and Northern Ireland,Sarawak,1124,677,447
1/02/2023,United Kingdom of Great Britain and Northern Ireland,Selangor,14459,8875,5584
1/02/2023,United Kingdom of Great Britain and Northern Ireland,Terengganu,0,0,0
1/02/2023,United Kingdom of Great Britain and Northern Ireland,W.P. Labuan,40,23,17
1/02/2023,Georgia,Johor,4,1,3
1/02/2023,Georgia,Kedah,3,1,2
1/02/2023,Georgia,Melaka,0,0,0
1/02/2023,Georgia,Perak,0,0,0
1/02/2023,Georgia,Perlis,2,1,1
1/02/2023,Georgia,Pulau Pinang,1,0,1
1/02/2023,Georgia,Sabah,0,0,0
1/02/2023,Georgia,Sarawak,0,0,0
1/02/2023,Georgia,Selangor,75,59,16
1/02/2023,Ghana,Johor,2,2,0
1/02/2023,Ghana,Kedah,0,0,0
1/02/2023,Ghana,Kelantan,1,1,0
1/02/2023,Ghana,Pulau Pinang,1,1,0
1/02/2023,Ghana,Sabah,1,1,0
1/02/2023,Ghana,Sarawak,3,1,2
1/02/2023,Ghana,Selangor,48,34,14
1/02/2023,Gibraltar,Johor,0,0,0
1/02/2023,Gibraltar,Sarawak,0,0,0
1/02/2023,Guinea,Johor,4,1,3
1/02/2023,Guinea,Kedah,0,0,0
1/02/2023,Guinea,Kelantan,0,0,0
1/02/2023,Guinea,Perlis,0,0,0
1/02/2023,Guinea,Pulau Pinang,0,0,0
1/02/2023,Guinea,Sabah,1,0,1
1/02/2023,Guinea,Sarawak,0,0,0
1/02/2023,Guinea,Selangor,41,33,8
1/02/2023,Guadeloupe,Selangor,0,0,0
1/02/2023,Gambia,Johor,1,1,0
1/02/2023,Gambia,Kedah,0,0,0
1/02/2023,Gambia,Kelantan,0,0,0
1/02/2023,Gambia,Pulau Pinang,0,0,0
1/02/2023,Gambia,Sabah,0,0,0
1/02/2023,Gambia,Sarawak,0,0,0
1/02/2023,Gambia,Selangor,7,5,2
1/02/2023,Guinea-Bissau,Johor,0,0,0
1/02/2023,Guinea-Bissau,Selangor,0,0,0
1/02/2023,Equatorial Guinea,Johor,0,0,0
1/02/2023,Equatorial Guinea,Selangor,1,1,0
1/02/2023,Greece,Johor,50,40,10
1/02/2023,Greece,Kedah,43,26,17
1/02/2023,Greece,Kelantan,0,0,0
1/02/2023,Greece,Melaka,0,0,0
1/02/2023,Greece,Negeri Sembilan,0,0,0
1/02/2023,Greece,Pahang,0,0,0
1/02/2023,Greece,Perak,0,0,0
1/02/2023,Greece,Perlis,9,5,4
1/02/2023,Greece,Pulau Pinang,11,10,1
1/02/2023,Greece,Sabah,4,4,0
1/02/2023,Greece,Sarawak,3,2,1
1/02/2023,Greece,Selangor,277,200,77
1/02/2023,Grenada,Johor,3,2,1
1/02/2023,Grenada,Kedah,0,0,0
1/02/2023,Grenada,Pulau Pinang,0,0,0
1/02/2023,Grenada,Sabah,1,1,0
1/02/2023,Grenada,Sarawak,0,0,0
1/02/2023,Grenada,Selangor,6,6,0
1/02/2023,Greenland,Johor,0,0,0
1/02/2023,Greenland,Selangor,0,0,0
1/02/2023,Guatemala,Johor,0,0,0
1/02/2023,Guatemala,Kedah,0,0,0
1/02/2023,Guatemala,Pahang,0,0,0
1/02/2023,Guatemala,Perak,0,0,0
1/02/2023,Guatemala,Pulau Pinang,0,0,0
1/02/2023,Guatemala,Sabah,0,0,0
1/02/2023,Guatemala,Sarawak,0,0,0
1/02/2023,Guatemala,Selangor,23,10,13
1/02/2023,Guatemala,W.P. Labuan,0,0,0
1/02/2023,Guyana,Johor,4,1,3
1/02/2023,Guyana,Kedah,0,0,0
1/02/2023,Guyana,Pulau Pinang,0,0,0
1/02/2023,Guyana,Sarawak,0,0,0
1/02/2023,Guyana,Selangor,12,7,5
1/02/2023,Hong Kong,Johor,4,2,2
1/02/2023,Hong Kong,Kedah,3,3,0
1/02/2023,Hong Kong,Kelantan,0,0,0
1/02/2023,Hong Kong,Pahang,0,0,0
1/02/2023,Hong Kong,Perak,34,17,17
1/02/2023,Hong Kong,Perlis,4,2,2
1/02/2023,Hong Kong,Pulau Pinang,0,0,0
1/02/2023,Hong Kong,Sabah,2,1,1
1/02/2023,Hong Kong,Sarawak,0,0,0
1/02/2023,Hong Kong,Selangor,2,1,1
1/02/2023,Hong Kong,Terengganu,0,0,0
1/02/2023,Heard Island and McDonald Islands,Johor,0,0,0
1/02/2023,Honduras,Johor,1,1,0
1/02/2023,Honduras,Kedah,0,0,0
1/02/2023,Honduras,Perak,0,0,0
1/02/2023,Honduras,Pulau Pinang,1,0,1
1/02/2023,Honduras,Sabah,0,0,0
1/02/2023,Honduras,Sarawak,0,0,0
1/02/2023,Honduras,Selangor,29,20,9
1/02/2023,Croatia,Johor,55,45,10
1/02/2023,Croatia,Kedah,10,4,6
1/02/2023,Croatia,Kelantan,6,6,0
1/02/2023,Croatia,Melaka,0,0,0
1/02/2023,Croatia,Pahang,0,0,0
1/02/2023,Croatia,Perak,0,0,0
1/02/2023,Croatia,Perlis,0,0,0
1/02/2023,Croatia,Pulau Pinang,9,8,1
1/02/2023,Croatia,Sabah,4,3,1
1/02/2023,Croatia,Sarawak,3,3,0
1/02/2023,Croatia,Selangor,139,86,53
1/02/2023,Haiti,Johor,4,3,1
1/02/2023,Haiti,Kedah,0,0,0
1/02/2023,Haiti,Kelantan,1,1,0
1/02/2023,Haiti,Perak,0,0,0
1/02/2023,Haiti,Pulau Pinang,0,0,0
1/02/2023,Haiti,Sabah,0,0,0
1/02/2023,Haiti,Selangor,4,4,0
1/02/2023,Hungary,Johor,93,61,32
1/02/2023,Hungary,Kedah,59,32,27
1/02/2023,Hungary,Kelantan,1,0,1
1/02/2023,Hungary,Pahang,0,0,0
1/02/2023,Hungary,Perak,0,0,0
1/02/2023,Hungary,Perlis,3,0,3
1/02/2023,Hungary,Pulau Pinang,33,22,11
1/02/2023,Hungary,Sabah,8,6,2
1/02/2023,Hungary,Sarawak,13,7,6
1/02/2023,Hungary,Selangor,741,399,342
1/02/2023,Hungary,W.P. Labuan,0,0,0
1/02/2023,Indonesia,Johor,91426,49248,42178
1/02/2023,Indonesia,Kedah,3939,1460,2479
1/02/2023,Indonesia,Kelantan,153,97,56
1/02/2023,Indonesia,Melaka,5198,2292,2906
1/02/2023,Indonesia,Negeri Sembilan,9819,6587,3232
1/02/2023,Indonesia,Pahang,3,1,2
1/02/2023,Indonesia,Perak,142,41,101
1/02/2023,Indonesia,Perlis,496,196,300
1/02/2023,Indonesia,Pulau Pinang,32124,12557,19567
1/02/2023,Indonesia,Sabah,4504,2149,2355
1/02/2023,Indonesia,Sarawak,35011,18720,16291
1/02/2023,Indonesia,Selangor,83391,41316,42075
1/02/2023,Indonesia,Terengganu,3,3,0
1/02/2023,Indonesia,W.P. Labuan,50,30,20
1/02/2023,India,Johor,13413,9737,3676
1/02/2023,India,Kedah,424,246,178
1/02/2023,India,Kelantan,2,2,0
1/02/2023,India,Melaka,1,1,0
1/02/2023,India,Negeri Sembilan,0,0,0
1/02/2023,India,Pahang,0,0,0
1/02/2023,India,Perak,403,340,63
1/02/2023,India,Perlis,48,35,13
1/02/2023,India,Pulau Pinang,626,457,169
1/02/2023,India,Sabah,174,131,43
1/02/2023,India,Sarawak,1090,805,285
1/02/2023,India,Selangor,36026,26746,9280
1/02/2023,India,Terengganu,0,0,0
1/02/2023,India,W.P. Labuan,107,85,22
1/02/2023, British Indian Ocean Territory,Pulau Pinang,0,0,0
1/02/2023, British Indian Ocean Territory,Selangor,0,0,0
1/02/2023,Ireland,Johor,227,156,71
1/02/2023,Ireland,Kedah,99,61,38
1/02/2023,Ireland,Kelantan,3,2,1
1/02/2023,Ireland,Negeri Sembilan,0,0,0
1/02/2023,Ireland,Pahang,1,0,1
1/02/2023,Ireland,Perak,7,4,3
1/02/2023,Ireland,Perlis,26,16,10
1/02/2023,Ireland,Pulau Pinang,120,71,49
1/02/2023,Ireland,Sabah,17,11,6
1/02/2023,Ireland,Sarawak,42,21,21
1/02/2023,Ireland,Selangor,1087,654,433
1/02/2023,Ireland,Terengganu,0,0,0
1/02/2023,Ireland,W.P. Labuan,3,1,2
1/02/2023,"Iran, Islamic Republic of",Johor,83,61,22
1/02/2023,"Iran, Islamic Republic of",Kedah,6,3,3
1/02/2023,"Iran, Islamic Republic of",Kelantan,0,0,0
1/02/2023,"Iran, Islamic Republic of",Perak,0,0,0
1/02/2023,"Iran, Islamic Republic of",Perlis,15,9,6
1/02/2023,"Iran, Islamic Republic of",Pulau Pinang,4,2,2
1/02/2023,"Iran, Islamic Republic of",Sabah,3,2,1
1/02/2023,"Iran, Islamic Republic of",Sarawak,4,2,2
1/02/2023,"Iran, Islamic Republic of",Selangor,861,469,392
1/02/2023,"Iran, Islamic Republic of",W.P. Labuan,0,0,0
1/02/2023,Iraq,Johor,28,24,4
1/02/2023,Iraq,Kedah,0,0,0
1/02/2023,Iraq,Kelantan,0,0,0
1/02/2023,Iraq,Melaka,0,0,0
1/02/2023,Iraq,Pahang,0,0,0
1/02/2023,Iraq,Perak,0,0,0
1/02/2023,Iraq,Perlis,0,0,0
1/02/2023,Iraq,Pulau Pinang,1,1,0
1/02/2023,Iraq,Sabah,0,0,0
1/02/2023,Iraq,Sarawak,0,0,0
1/02/2023,Iraq,Selangor,793,539,254
1/02/2023,Iceland,Johor,4,2,2
1/02/2023,Iceland,Kedah,3,1,2
1/02/2023,Iceland,Kelantan,0,0,0
1/02/2023,Iceland,Perak,0,0,0
1/02/2023,Iceland,Perlis,1,1,0
1/02/2023,Iceland,Pulau Pinang,3,1,2
1/02/2023,Iceland,Sabah,1,1,0
1/02/2023,Iceland,Sarawak,0,0,0
1/02/2023,Iceland,Selangor,37,17,20
1/02/2023,Iceland,W.P. Labuan,0,0,0
1/02/2023,Israel,Pulau Pinang,0,0,0
1/02/2023,Italy,Johor,544,385,159
1/02/2023,Italy,Kedah,547,291,256
1/02/2023,Italy,Kelantan,8,6,2
1/02/2023,Italy,Melaka,0,0,0
1/02/2023,Italy,Negeri Sembilan,1,1,0
1/02/2023,Italy,Pahang,0,0,0
1/02/2023,Italy,Perak,9,7,2
1/02/2023,Italy,Perlis,55,44,11
1/02/2023,Italy,Pulau Pinang,126,89,37
1/02/2023,Italy,Sabah,34,22,12
1/02/2023,Italy,Sarawak,37,24,13
1/02/2023,Italy,Selangor,2576,1763,813
1/02/2023,Italy,W.P. Labuan,9,4,5
1/02/2023,Jamaica,Johor,0,0,0
1/02/2023,Jamaica,Kedah,0,0,0
1/02/2023,Jamaica,Perak,0,0,0
1/02/2023,Jamaica,Pulau Pinang,4,1,3
1/02/2023,Jamaica,Sabah,0,0,0
1/02/2023,Jamaica,Sarawak,0,0,0
1/02/2023,Jamaica,Selangor,11,5,6
1/02/2023,Jamaica,W.P. Labuan,0,0,0
1/02/2023,Jordan,Johor,11,7,4
1/02/2023,Jordan,Kedah,6,4,2
1/02/2023,Jordan,Kelantan,0,0,0
1/02/2023,Jordan,Melaka,0,0,0
1/02/2023,Jordan,Perlis,1,1,0
1/02/2023,Jordan,Pulau Pinang,2,1,1
1/02/2023,Jordan,Sabah,2,2,0
1/02/2023,Jordan,Sarawak,0,0,0
1/02/2023,Jordan,Selangor,527,330,197
1/02/2023,Jordan,W.P. Labuan,0,0,0
1/02/2023,Japan,Johor,5069,3560,1509
1/02/2023,Japan,Kedah,334,160,174
1/02/2023,Japan,Kelantan,7,5,2
1/02/2023,Japan,Melaka,0,0,0
1/02/2023,Japan,Negeri Sembilan,0,0,0
1/02/2023,Japan,Pahang,4,3,1
1/02/2023,Japan,Perak,85,59,26
1/02/2023,Japan,Perlis,65,54,11
1/02/2023,Japan,Pulau Pinang,1145,817,328
1/02/2023,Japan,Sabah,298,152,146
1/02/2023,Japan,Sarawak,228,133,95
1/02/2023,Japan,Selangor,16124,10292,5832
1/02/2023,Japan,W.P. Labuan,7,5,2
1/02/2023,Kazakhstan,Johor,42,13,29
1/02/2023,Kazakhstan,Kedah,23,11,12
1/02/2023,Kazakhstan,Kelantan,3,1,2
1/02/2023,Kazakhstan,Melaka,0,0,0
1/02/2023,Kazakhstan,Perak,0,0,0
1/02/2023,Kazakhstan,Perlis,10,6,4
1/02/2023,Kazakhstan,Pulau Pinang,16,9,7
1/02/2023,Kazakhstan,Sabah,4,2,2
1/02/2023,Kazakhstan,Sarawak,8,0,8
1/02/2023,Kazakhstan,Selangor,552,225,327
1/02/2023,Kazakhstan,W.P. Labuan,1,0,1
1/02/2023,Kenya,Johor,33,15,18
1/02/2023,Kenya,Kedah,3,1,2
1/02/2023,Kenya,Kelantan,0,0,0
1/02/2023,Kenya,Perak,0,0,0
1/02/2023,Kenya,Perlis,0,0,0
1/02/2023,Kenya,Pulau Pinang,0,0,0
1/02/2023,Kenya,Sabah,2,1,1
1/02/2023,Kenya,Sarawak,2,0,2
1/02/2023,Kenya,Selangor,208,103,105
1/02/2023,Kyrgyzstan,Johor,27,14,13
1/02/2023,Kyrgyzstan,Kedah,6,4,2
1/02/2023,Kyrgyzstan,Kelantan,0,0,0
1/02/2023,Kyrgyzstan,Perak,0,0,0
1/02/2023,Kyrgyzstan,Perlis,1,0,1
1/02/2023,Kyrgyzstan,Pulau Pinang,1,0,1
1/02/2023,Kyrgyzstan,Sabah,2,1,1
1/02/2023,Kyrgyzstan,Sarawak,0,0,0
1/02/2023,Kyrgyzstan,Selangor,173,92,81
1/02/2023,Cambodia,Johor,1991,830,1161
1/02/2023,Cambodia,Kedah,168,134,34
1/02/2023,Cambodia,Kelantan,1314,1077,237
1/02/2023,Cambodia,Melaka,0,0,0
1/02/2023,Cambodia,Negeri Sembilan,0,0,0
1/02/2023,Cambodia,Pahang,0,0,0
1/02/2023,Cambodia,Perak,9,5,4
1/02/2023,Cambodia,Perlis,693,418,275
1/02/2023,Cambodia,Pulau Pinang,32,17,15
1/02/2023,Cambodia,Sabah,1,1,0
1/02/2023,Cambodia,Sarawak,1,0,1
1/02/2023,Cambodia,Selangor,3447,1715,1732
1/02/2023,Cambodia,W.P. Labuan,1,0,1
1/02/2023,Kiribati,Johor,0,0,0
1/02/2023,Kiribati,Sabah,0,0,0
1/02/2023,Kiribati,Selangor,1,0,1
1/02/2023,Saint Kitts and Nevis,Johor,21,16,5
1/02/2023,Saint Kitts and Nevis,Kedah,0,0,0
1/02/2023,Saint Kitts and Nevis,Perlis,0,0,0
1/02/2023,Saint Kitts and Nevis,Pulau Pinang,1,1,0
1/02/2023,Saint Kitts and Nevis,Sabah,0,0,0
1/02/2023,Saint Kitts and Nevis,Selangor,44,39,5
1/02/2023,Saint Kitts and Nevis,W.P. Labuan,0,0,0
1/02/2023,"Korea, Republic of",Johor,12972,6643,6329
1/02/2023,"Korea, Republic of",Kedah,404,181,223
1/02/2023,"Korea, Republic of",Kelantan,1,1,0
1/02/2023,"Korea, Republic of",Melaka,0,0,0
1/02/2023,"Korea, Republic of",Negeri Sembilan,0,0,0
1/02/2023,"Korea, Republic of",Pahang,1,0,1
1/02/2023,"Korea, Republic of",Perak,50,20,30
1/02/2023,"Korea, Republic of",Perlis,69,42,27
1/02/2023,"Korea, Republic of",Pulau Pinang,520,288,232
1/02/2023,"Korea, Republic of",Sabah,20731,8885,11846
1/02/2023,"Korea, Republic of",Sarawak,246,138,108
1/02/2023,"Korea, Republic of",Selangor,13525,7320,6205
1/02/2023,"Korea, Republic of",Terengganu,0,0,0
1/02/2023,"Korea, Republic of",W.P. Labuan,6,4,2
1/02/2023,Kuwait,Johor,26,13,13
1/02/2023,Kuwait,Kedah,2,1,1
1/02/2023,Kuwait,Kelantan,1,1,0
1/02/2023,Kuwait,Perak,0,0,0
1/02/2023,Kuwait,Perlis,0,0,0
1/02/2023,Kuwait,Pulau Pinang,0,0,0
1/02/2023,Kuwait,Sabah,0,0,0
1/02/2023,Kuwait,Sarawak,0,0,0
1/02/2023,Kuwait,Selangor,369,221,148
1/02/2023,Kuwait,W.P. Labuan,0,0,0
1/02/2023, Lao People's Democratic Republic,Johor,139,38,101
1/02/2023, Lao People's Democratic Republic,Kedah,937,108,829
1/02/2023, Lao People's Democratic Republic,Kelantan,803,671,132
1/02/2023, Lao People's Democratic Republic,Melaka,0,0,0
1/02/2023, Lao People's Democratic Republic,Perak,21,4,17
1/02/2023, Lao People's Democratic Republic,Perlis,332,150,182
1/02/2023, Lao People's Democratic Republic,Pulau Pinang,10,3,7
1/02/2023, Lao People's Democratic Republic,Sabah,6,1,5
1/02/2023, Lao People's Democratic Republic,Sarawak,6,0,6
1/02/2023, Lao People's Democratic Republic,Selangor,197,85,112
1/02/2023, Lao People's Democratic Republic,W.P. Labuan,0,0,0
1/02/2023,Lebanon,Johor,20,12,8
1/02/2023,Lebanon,Kedah,3,2,1
1/02/2023,Lebanon,Kelantan,0,0,0
1/02/2023,Lebanon,Pahang,0,0,0
1/02/2023,Lebanon,Perak,0,0,0
1/02/2023,Lebanon,Perlis,0,0,0
1/02/2023,Lebanon,Pulau Pinang,3,3,0
1/02/2023,Lebanon,Sabah,0,0,0
1/02/2023,Lebanon,Sarawak,2,2,0
1/02/2023,Lebanon,Selangor,217,134,83
1/02/2023,Lebanon,W.P. Labuan,0,0,0
1/02/2023,Liberia,Johor,2,0,2
1/02/2023,Liberia,Kedah,0,0,0
1/02/2023,Liberia,Sabah,0,0,0
1/02/2023,Liberia,Sarawak,0,0,0
1/02/2023,Liberia,Selangor,5,4,1
1/02/2023,Libya,Johor,2,1,1
1/02/2023,Libya,Kedah,1,1,0
1/02/2023,Libya,Perlis,0,0,0
1/02/2023,Libya,Pulau Pinang,0,0,0
1/02/2023,Libya,Sabah,0,0,0
1/02/2023,Libya,Sarawak,12,7,5
1/02/2023,Libya,Selangor,264,169,95
1/02/2023,Saint Lucia,Johor,7,5,2
1/02/2023,Saint Lucia,Kedah,0,0,0
1/02/2023,Saint Lucia,Pulau Pinang,1,1,0
1/02/2023,Saint Lucia,Sarawak,0,0,0
1/02/2023,Saint Lucia,Selangor,3,2,1
1/02/2023,Liechtenstein,Johor,0,0,0
1/02/2023,Liechtenstein,Kedah,1,0,1
1/02/2023,Liechtenstein,Perlis,0,0,0
1/02/2023,Liechtenstein,Pulau Pinang,1,1,0
1/02/2023,Liechtenstein,Sabah,0,0,0
1/02/2023,Liechtenstein,Sarawak,0,0,0
1/02/2023,Liechtenstein,Selangor,3,0,3
1/02/2023,LKA,Johor,808,552,256
1/02/2023,LKA,Kedah,13,9,4
1/02/2023,LKA,Kelantan,0,0,0
1/02/2023,LKA,Melaka,0,0,0
1/02/2023,LKA,Pahang,0,0,0
1/02/2023,LKA,Perak,2,2,0
1/02/2023,LKA,Perlis,1,1,0
1/02/2023,LKA,Pulau Pinang,19,16,3
1/02/2023,LKA,Sabah,3,2,1
1/02/2023,LKA,Sarawak,14,10,4
1/02/2023,LKA,Selangor,3096,2011,1085
1/02/2023,LKA,W.P. Labuan,0,0,0
1/02/2023,Lesotho,Johor,0,0,0
1/02/2023,Lesotho,Kedah,0,0,0
1/02/2023,Lesotho,Pulau Pinang,0,0,0
1/02/2023,Lesotho,Sarawak,0,0,0
1/02/2023,Lesotho,Selangor,4,2,2
1/02/2023,Lithuania,Johor,99,46,53
1/02/2023,Lithuania,Kedah,99,48,51
1/02/2023,Lithuania,Kelantan,0,0,0
1/02/2023,Lithuania,Pahang,0,0,0
1/02/2023,Lithuania,Perak,6,2,4
1/02/2023,Lithuania,Perlis,11,7,4
1/02/2023,Lithuania,Pulau Pinang,22,12,10
1/02/2023,Lithuania,Sabah,6,3,3
1/02/2023,Lithuania,Sarawak,12,6,6
1/02/2023,Lithuania,Selangor,475,233,242
1/02/2023,Lithuania,W.P. Labuan,6,3,3
1/02/2023,Luxembourg,Johor,8,6,2
1/02/2023,Luxembourg,Kedah,0,0,0
1/02/2023,Luxembourg,Kelantan,0,0,0
1/02/2023,Luxembourg,Perak,0,0,0
1/02/2023,Luxembourg,Perlis,0,0,0
1/02/2023,Luxembourg,Pulau Pinang,4,1,3
1/02/2023,Luxembourg,Sabah,0,0,0
1/02/2023,Luxembourg,Sarawak,0,0,0
1/02/2023,Luxembourg,Selangor,36,26,10
1/02/2023,Latvia,Johor,54,25,29
1/02/2023,Latvia,Kedah,27,10,17
1/02/2023,Latvia,Kelantan,1,0,1
1/02/2023,Latvia,Pahang,0,0,0
1/02/2023,Latvia,Perak,0,0,0
1/02/2023,Latvia,Perlis,3,1,2
1/02/2023,Latvia,Pulau Pinang,6,2,4
1/02/2023,Latvia,Sabah,1,0,1
1/02/2023,Latvia,Sarawak,18,5,13
1/02/2023,Latvia,Selangor,199,92,107
1/02/2023,Latvia,W.P. Labuan,7,0,7
1/02/2023,Macao,Johor,0,0,0
1/02/2023,Macao,Pahang,0,0,0
1/02/2023,Macao,Perak,2,0,2
1/02/2023,Macao,Selangor,1,0,1
1/02/2023,Macao,W.P. Labuan,0,0,0
1/02/2023,Morocco,Johor,71,51,20
1/02/2023,Morocco,Kedah,7,5,2
1/02/2023,Morocco,Kelantan,0,0,0
1/02/2023,Morocco,Melaka,0,0,0
1/02/2023,Morocco,Pahang,0,0,0
1/02/2023,Morocco,Perak,0,0,0
1/02/2023,Morocco,Perlis,3,3,0
1/02/2023,Morocco,Pulau Pinang,15,12,3
1/02/2023,Morocco,Sabah,1,1,0
1/02/2023,Morocco,Sarawak,2,2,0
1/02/2023,Morocco,Selangor,637,349,288
1/02/2023,Morocco,W.P. Labuan,2,2,0
1/02/2023,Monaco,Johor,2,2,0
1/02/2023,Monaco,Kedah,2,1,1
1/02/2023,Monaco,Sabah,0,0,0
1/02/2023,Monaco,Selangor,4,2,2
1/02/2023,"Moldova, Republic of",Johor,2,1,1
1/02/2023,"Moldova, Republic of",Kedah,3,1,2
1/02/2023,"Moldova, Republic of",Kelantan,0,0,0
1/02/2023,"Moldova, Republic of",Negeri Sembilan,0,0,0
1/02/2023,"Moldova, Republic of",Perlis,0,0,0
1/02/2023,"Moldova, Republic of",Pulau Pinang,1,1,0
1/02/2023,"Moldova, Republic of",Sabah,0,0,0
1/02/2023,"Moldova, Republic of",Sarawak,0,0,0
1/02/2023,"Moldova, Republic of",Selangor,42,20,22
1/02/2023,Madagascar,Johor,11,6,5
1/02/2023,Madagascar,Kedah,0,0,0
1/02/2023,Madagascar,Perak,0,0,0
1/02/2023,Madagascar,Perlis,0,0,0
1/02/2023,Madagascar,Pulau Pinang,1,0,1
1/02/2023,Madagascar,Sabah,0,0,0
1/02/2023,Madagascar,Sarawak,0,0,0
1/02/2023,Madagascar,Selangor,19,6,13
1/02/2023,Maldives,Johor,121,63,58
1/02/2023,Maldives,Kedah,2,1,1
1/02/2023,Maldives,Kelantan,0,0,0
1/02/2023,Maldives,Perak,0,0,0
1/02/2023,Maldives,Perlis,0,0,0
1/02/2023,Maldives,Pulau Pinang,1,1,0
1/02/2023,Maldives,Sabah,1,1,0
1/02/2023,Maldives,Sarawak,1,0,1
1/02/2023,Maldives,Selangor,1681,914,767
1/02/2023,Mexico,Johor,105,55,50
1/02/2023,Mexico,Kedah,11,7,4
1/02/2023,Mexico,Kelantan,0,0,0
1/02/2023,Mexico,Pahang,0,0,0
1/02/2023,Mexico,Perak,0,0,0
1/02/2023,Mexico,Perlis,3,2,1
1/02/2023,Mexico,Pulau Pinang,20,14,6
1/02/2023,Mexico,Sabah,4,1,3
1/02/2023,Mexico,Sarawak,1,1,0
1/02/2023,Mexico,Selangor,383,205,178
1/02/2023,Mexico,W.P. Labuan,0,0,0
1/02/2023,Marshall Islands,Johor,0,0,0
1/02/2023,Marshall Islands,Kedah,0,0,0
1/02/2023,Marshall Islands,Perak,0,0,0
1/02/2023,Marshall Islands,Pulau Pinang,0,0,0
1/02/2023,Marshall Islands,Sabah,0,0,0
1/02/2023,Marshall Islands,Selangor,2,2,0
1/02/2023,North Macedonia,Johor,4,2,2
1/02/2023,North Macedonia,Kedah,0,0,0
1/02/2023,North Macedonia,Perak,0,0,0
1/02/2023,North Macedonia,Pulau Pinang,0,0,0
1/02/2023,North Macedonia,Sabah,0,0,0
1/02/2023,North Macedonia,Sarawak,1,0,1
1/02/2023,North Macedonia,Selangor,22,14,8
1/02/2023,Mali,Johor,3,3,0
1/02/2023,Mali,Sabah,0,0,0
1/02/2023,Mali,Selangor,3,1,2
1/02/2023,Malta,Johor,13,9,4
1/02/2023,Malta,Kedah,5,3,2
1/02/2023,Malta,Kelantan,0,0,0
1/02/2023,Malta,Perak,0,0,0
1/02/2023,Malta,Perlis,1,1,0
1/02/2023,Malta,Pulau Pinang,2,1,1
1/02/2023,Malta,Sabah,0,0,0
1/02/2023,Malta,Sarawak,0,0,0
1/02/2023,Malta,Selangor,35,23,12
1/02/2023,Malta,W.P. Labuan,0,0,0
1/02/2023,Myanmar,Johor,2968,923,2045
1/02/2023,Myanmar,Kedah,31,2,29
1/02/2023,Myanmar,Kelantan,1,0,1
1/02/2023,Myanmar,Negeri Sembilan,0,0,0
1/02/2023,Myanmar,Pahang,0,0,0
1/02/2023,Myanmar,Perak,21,9,12
1/02/2023,Myanmar,Perlis,3,0,3
1/02/2023,Myanmar,Pulau Pinang,149,79,70
1/02/2023,Myanmar,Sabah,8,1,7
1/02/2023,Myanmar,Sarawak,77,35,42
1/02/2023,Myanmar,Selangor,7233,5164,2069
1/02/2023,Myanmar,Terengganu,0,0,0
1/02/2023,Myanmar,W.P. Labuan,3,2,1
1/02/2023,Montenegro,Johor,1,1,0
1/02/2023,Montenegro,Kedah,0,0,0
1/02/2023,Montenegro,Pulau Pinang,0,0,0
1/02/2023,Montenegro,Sabah,1,1,0
1/02/2023,Montenegro,Sarawak,0,0,0
1/02/2023,Montenegro,Selangor,7,6,1
1/02/2023,Mongolia,Johor,167,73,94
1/02/2023,Mongolia,Kedah,12,5,7
1/02/2023,Mongolia,Kelantan,0,0,0
1/02/2023,Mongolia,Perak,0,0,0
1/02/2023,Mongolia,Perlis,18,13,5
1/02/2023,Mongolia,Pulau Pinang,6,2,4
1/02/2023,Mongolia,Sabah,0,0,0
1/02/2023,Mongolia,Sarawak,0,0,0
1/02/2023,Mongolia,Selangor,446,162,284
1/02/2023,Northern Mariana Islands,Selangor,0,0,0
1/02/2023,Mozambique,Johor,1,1,0
1/02/2023,Mozambique,Kedah,0,0,0
1/02/2023,Mozambique,Perak,0,0,0
1/02/2023,Mozambique,Pulau Pinang,0,0,0
1/02/2023,Mozambique,Sabah,0,0,0
1/02/2023,Mozambique,Sarawak,1,1,0
1/02/2023,Mozambique,Selangor,11,6,5
1/02/2023,Mauritania,Johor,0,0,0
1/02/2023,Mauritania,Kedah,0,0,0
1/02/2023,Mauritania,Pulau Pinang,0,0,0
1/02/2023,Mauritania,Sabah,0,0,0
1/02/2023,Mauritania,Sarawak,0,0,0
1/02/2023,Mauritania,Selangor,14,11,3
1/02/2023,Mauritius,Johor,92,55,37
1/02/2023,Mauritius,Kedah,4,4,0
1/02/2023,Mauritius,Kelantan,0,0,0
1/02/2023,Mauritius,Pahang,0,0,0
1/02/2023,Mauritius,Perak,4,2,2
1/02/2023,Mauritius,Perlis,2,2,0
1/02/2023,Mauritius,Pulau Pinang,6,4,2
1/02/2023,Mauritius,Sabah,5,2,3
1/02/2023,Mauritius,Sarawak,1,0,1
1/02/2023,Mauritius,Selangor,1064,522,542
1/02/2023,Malawi,Johor,0,0,0
1/02/2023,Malawi,Pulau Pinang,0,0,0
1/02/2023,Malawi,Sabah,0,0,0
1/02/2023,Malawi,Sarawak,0,0,0
1/02/2023,Malawi,Selangor,17,9,8
1/02/2023,Mayotte,Selangor,0,0,0
1/02/2023,Namibia,Johor,0,0,0
1/02/2023,Namibia,Kedah,0,0,0
1/02/2023,Namibia,Perak,0,0,0
1/02/2023,Namibia,Perlis,0,0,0
1/02/2023,Namibia,Pulau Pinang,0,0,0
1/02/2023,Namibia,Sabah,0,0,0
1/02/2023,Namibia,Sarawak,0,0,0
1/02/2023,Namibia,Selangor,19,10,9
1/02/2023,New Caledonia,Selangor,0,0,0
1/02/2023,Niger,Johor,0,0,0
1/02/2023,Niger,Sabah,0,0,0
1/02/2023,Niger,Selangor,1,0,1
1/02/2023,Nigeria,Johor,20,19,1
1/02/2023,Nigeria,Kedah,0,0,0
1/02/2023,Nigeria,Perlis,0,0,0
1/02/2023,Nigeria,Pulau Pinang,1,1,0
1/02/2023,Nigeria,Sabah,0,0,0
1/02/2023,Nigeria,Sarawak,11,5,6
1/02/2023,Nigeria,Selangor,374,295,79
1/02/2023,Nicaragua,Johor,1,0,1
1/02/2023,Nicaragua,Kedah,1,0,1
1/02/2023,Nicaragua,Pulau Pinang,0,0,0
1/02/2023,Nicaragua,Sabah,0,0,0
1/02/2023,Nicaragua,Selangor,7,7,0
1/02/2023,Netherlands,Johor,856,569,287
1/02/2023,Netherlands,Kedah,449,228,221
1/02/2023,Netherlands,Kelantan,0,0,0
1/02/2023,Netherlands,Melaka,4,3,1
1/02/2023,Netherlands,Negeri Sembilan,0,0,0
1/02/2023,Netherlands,Pahang,1,0,1
1/02/2023,Netherlands,Perak,13,7,6
1/02/2023,Netherlands,Perlis,67,44,23
1/02/2023,Netherlands,Pulau Pinang,202,123,79
1/02/2023,Netherlands,Sabah,87,51,36
1/02/2023,Netherlands,Sarawak,152,102,50
1/02/2023,Netherlands,Selangor,3340,2014,1326
1/02/2023,Netherlands,Terengganu,0,0,0
1/02/2023,Netherlands,W.P. Labuan,9,4,5
1/02/2023,Norway,Johor,146,88,58
1/02/2023,Norway,Kedah,119,57,62
1/02/2023,Norway,Kelantan,17,9,8
1/02/2023,Norway,Melaka,0,0,0
1/02/2023,Norway,Pahang,0,0,0
1/02/2023,Norway,Perak,2,1,1
1/02/2023,Norway,Perlis,15,7,8
1/02/2023,Norway,Pulau Pinang,33,18,15
1/02/2023,Norway,Sabah,3,1,2
1/02/2023,Norway,Sarawak,38,26,12
1/02/2023,Norway,Selangor,668,398,270
1/02/2023,Norway,W.P. Labuan,0,0,0
1/02/2023,Nepal,Johor,400,295,105
1/02/2023,Nepal,Kedah,2,1,1
1/02/2023,Nepal,Pahang,0,0,0
1/02/2023,Nepal,Perak,0,0,0
1/02/2023,Nepal,Perlis,0,0,0
1/02/2023,Nepal,Pulau Pinang,24,22,2
1/02/2023,Nepal,Sabah,0,0,0
1/02/2023,Nepal,Sarawak,173,111,62
1/02/2023,Nepal,Selangor,17521,16869,652
1/02/2023,Nepal,W.P. Labuan,28,25,3
1/02/2023,Nauru,Johor,0,0,0
1/02/2023,Nauru,Pulau Pinang,0,0,0
1/02/2023,Nauru,Selangor,0,0,0
1/02/2023,New Zealand,Johor,562,342,220
1/02/2023,New Zealand,Kedah,72,46,26
1/02/2023,New Zealand,Kelantan,1,1,0
1/02/2023,New Zealand,Melaka,1,1,0
1/02/2023,New Zealand,Negeri Sembilan,0,0,0
1/02/2023,New Zealand,Pahang,0,0,0
1/02/2023,New Zealand,Perak,13,8,5
1/02/2023,New Zealand,Perlis,31,18,13
1/02/2023,New Zealand,Pulau Pinang,128,69,59
1/02/2023,New Zealand,Sabah,42,20,22
1/02/2023,New Zealand,Sarawak,87,42,45
1/02/2023,New Zealand,Selangor,1997,1209,788
1/02/2023,New Zealand,Terengganu,0,0,0
1/02/2023,New Zealand,W.P. Labuan,4,3,1
1/02/2023,Oman,Johor,19,11,8
1/02/2023,Oman,Kedah,3,2,1
1/02/2023,Oman,Kelantan,0,0,0
1/02/2023,Oman,Melaka,0,0,0
1/02/2023,Oman,Perak,0,0,0
1/02/2023,Oman,Perlis,0,0,0
1/02/2023,Oman,Pulau Pinang,6,3,3
1/02/2023,Oman,Sabah,0,0,0
1/02/2023,Oman,Sarawak,16,5,11
1/02/2023,Oman,Selangor,726,435,291
1/02/2023,Pakistan,Johor,687,522,165
1/02/2023,Pakistan,Kedah,38,28,10
1/02/2023,Pakistan,Kelantan,7,7,0
1/02/2023,Pakistan,Melaka,0,0,0
1/02/2023,Pakistan,Negeri Sembilan,0,0,0
1/02/2023,Pakistan,Pahang,0,0,0
1/02/2023,Pakistan,Perak,49,48,1
1/02/2023,Pakistan,Perlis,36,35,1
1/02/2023,Pakistan,Pulau Pinang,82,76,6
1/02/2023,Pakistan,Sabah,15,11,4
1/02/2023,Pakistan,Sarawak,123,95,28
1/02/2023,Pakistan,Selangor,12934,11788,1146
1/02/2023,Pakistan,W.P. Labuan,1,1,0
1/02/2023,Panama,Johor,2,1,1
1/02/2023,Panama,Kedah,0,0,0
1/02/2023,Panama,Perak,0,0,0
1/02/2023,Panama,Perlis,0,0,0
1/02/2023,Panama,Pulau Pinang,1,1,0
1/02/2023,Panama,Sabah,0,0,0
1/02/2023,Panama,Sarawak,0,0,0
1/02/2023,Panama,Selangor,44,18,26
1/02/2023,Peru,Johor,51,30,21
1/02/2023,Peru,Kedah,9,3,6
1/02/2023,Peru,Kelantan,0,0,0
1/02/2023,Peru,Pahang,0,0,0
1/02/2023,Peru,Perak,0,0,0
1/02/2023,Peru,Perlis,0,0,0
1/02/2023,Peru,Pulau Pinang,1,0,1
1/02/2023,Peru,Sabah,0,0,0
1/02/2023,Peru,Sarawak,0,0,0
1/02/2023,Peru,Selangor,69,38,31
1/02/2023,Peru,W.P. Labuan,0,0,0
1/02/2023,Philippines,Johor,15098,5021,10077
1/02/2023,Philippines,Kedah,456,154,302
1/02/2023,Philippines,Kelantan,27,17,10
1/02/2023,Philippines,Melaka,0,0,0
1/02/2023,Philippines,Negeri Sembilan,0,0,0
1/02/2023,Philippines,Pahang,12,11,1
1/02/2023,Philippines,Perak,92,37,55
1/02/2023,Philippines,Perlis,53,14,39
1/02/2023,Philippines,Pulau Pinang,417,150,267
1/02/2023,Philippines,Sabah,1261,624,637
1/02/2023,Philippines,Sarawak,2303,916,1387
1/02/2023,Philippines,Selangor,11651,4886,6765
1/02/2023,Philippines,Terengganu,0,0,0
1/02/2023,Philippines,W.P. Labuan,79,22,57
1/02/2023,Palau,Johor,0,0,0
1/02/2023,Palau,Pulau Pinang,0,0,0
1/02/2023,Palau,Selangor,4,1,3
1/02/2023,Papua New Guinea,Johor,7,5,2
1/02/2023,Papua New Guinea,Kedah,0,0,0
1/02/2023,Papua New Guinea,Kelantan,0,0,0
1/02/2023,Papua New Guinea,Perak,0,0,0
1/02/2023,Papua New Guinea,Pulau Pinang,4,4,0
1/02/2023,Papua New Guinea,Sabah,1,0,1
1/02/2023,Papua New Guinea,Sarawak,6,1,5
1/02/2023,Papua New Guinea,Selangor,49,32,17
1/02/2023,Poland,Johor,675,309,366
1/02/2023,Poland,Kedah,327,159,168
1/02/2023,Poland,Kelantan,1,1,0
1/02/2023,Poland,Melaka,0,0,0
1/02/2023,Poland,Negeri Sembilan,0,0,0
1/02/2023,Poland,Pahang,0,0,0
1/02/2023,Poland,Perak,0,0,0
1/02/2023,Poland,Perlis,44,24,20
1/02/2023,Poland,Pulau Pinang,69,41,28
1/02/2023,Poland,Sabah,19,9,10
1/02/2023,Poland,Sarawak,41,18,23
1/02/2023,Poland,Selangor,1394,766,628
1/02/2023,Poland,Terengganu,0,0,0
1/02/2023,Poland,W.P. Labuan,3,2,1
1/02/2023,"North Korea, Democratic People's Republic of",Selangor,0,0,0
1/02/2023,Portugal,Johor,133,73,60
1/02/2023,Portugal,Kedah,58,30,28
1/02/2023,Portugal,Kelantan,0,0,0
1/02/2023,Portugal,Melaka,0,0,0
1/02/2023,Portugal,Pahang,0,0,0
1/02/2023,Portugal,Perak,2,1,1
1/02/2023,Portugal,Perlis,9,4,5
1/02/2023,Portugal,Pulau Pinang,29,17,12
1/02/2023,Portugal,Sabah,15,10,5
1/02/2023,Portugal,Sarawak,13,6,7
1/02/2023,Portugal,Selangor,542,316,226
1/02/2023,Portugal,W.P. Labuan,2,1,1
1/02/2023,Paraguay,Johor,10,8,2
1/02/2023,Paraguay,Kedah,0,0,0
1/02/2023,Paraguay,Perak,0,0,0
1/02/2023,Paraguay,Perlis,0,0,0
1/02/2023,Paraguay,Pulau Pinang,0,0,0
1/02/2023,Paraguay,Sabah,0,0,0
1/02/2023,Paraguay,Sarawak,0,0,0
1/02/2023,Paraguay,Selangor,8,4,4
1/02/2023,"Palestine, State of",Johor,7,7,0
1/02/2023,"Palestine, State of",Kedah,1,1,0
1/02/2023,"Palestine, State of",Kelantan,0,0,0
1/02/2023,"Palestine, State of",Melaka,0,0,0
1/02/2023,"Palestine, State of",Perak,0,0,0
1/02/2023,"Palestine, State of",Perlis,0,0,0
1/02/2023,"Palestine, State of",Pulau Pinang,0,0,0
1/02/2023,"Palestine, State of",Sabah,0,0,0
1/02/2023,"Palestine, State of",Sarawak,1,1,0
1/02/2023,"Palestine, State of",Selangor,241,171,70
1/02/2023,Qatar,Johor,8,7,1
1/02/2023,Qatar,Kedah,0,0,0
1/02/2023,Qatar,Perlis,0,0,0
1/02/2023,Qatar,Pulau Pinang,0,0,0
1/02/2023,Qatar,Sabah,0,0,0
1/02/2023,Qatar,Sarawak,0,0,0
1/02/2023,Qatar,Selangor,121,77,44
1/02/2023,Réunion,Johor,0,0,0
1/02/2023,Réunion,Sarawak,0,0,0
1/02/2023,Romania,Johor,137,77,60
1/02/2023,Romania,Kedah,92,45,47
1/02/2023,Romania,Kelantan,1,1,0
1/02/2023,Romania,Negeri Sembilan,0,0,0
1/02/2023,Romania,Pahang,1,1,0
1/02/2023,Romania,Perak,1,0,1
1/02/2023,Romania,Perlis,11,6,5
1/02/2023,Romania,Pulau Pinang,31,14,17
1/02/2023,Romania,Sabah,4,2,2
1/02/2023,Romania,Sarawak,5,5,0
1/02/2023,Romania,Selangor,558,299,259
1/02/2023,Romania,W.P. Labuan,0,0,0
1/02/2023,Russian Federation (Russia),Johor,334,182,152
1/02/2023,Russian Federation (Russia),Kedah,660,347,313
1/02/2023,Russian Federation (Russia),Kelantan,99,52,47
1/02/2023,Russian Federation (Russia),Melaka,4,2,2
1/02/2023,Russian Federation (Russia),Negeri Sembilan,0,0,0
1/02/2023,Russian Federation (Russia),Pahang,0,0,0
1/02/2023,Russian Federation (Russia),Perak,10,6,4
1/02/2023,Russian Federation (Russia),Perlis,808,451,357
1/02/2023,Russian Federation (Russia),Pulau Pinang,281,156,125
1/02/2023,Russian Federation (Russia),Sabah,43,18,25
1/02/2023,Russian Federation (Russia),Sarawak,75,36,39
1/02/2023,Russian Federation (Russia),Selangor,13648,7048,6600
1/02/2023,Russian Federation (Russia),W.P. Labuan,14,7,7
1/02/2023,Rwanda,Johor,0,0,0
1/02/2023,Rwanda,Kedah,0,0,0
1/02/2023,Rwanda,Pulau Pinang,0,0,0
1/02/2023,Rwanda,Selangor,7,2,5
1/02/2023,Saudi Arabia,Johor,106,68,38
1/02/2023,Saudi Arabia,Kedah,4,3,1
1/02/2023,Saudi Arabia,Kelantan,8,4,4
1/02/2023,Saudi Arabia,Melaka,0,0,0
1/02/2023,Saudi Arabia,Perak,0,0,0
1/02/2023,Saudi Arabia,Perlis,4,4,0
1/02/2023,Saudi Arabia,Pulau Pinang,7,5,2
1/02/2023,Saudi Arabia,Sabah,3,3,0
1/02/2023,Saudi Arabia,Sarawak,9,9,0
1/02/2023,Saudi Arabia,Selangor,2178,1341,837
1/02/2023,Saudi Arabia,W.P. Labuan,0,0,0
1/02/2023,Sudan,Johor,5,4,1
1/02/2023,Sudan,Kedah,0,0,0
1/02/2023,Sudan,Kelantan,0,0,0
1/02/2023,Sudan,Perlis,0,0,0
1/02/2023,Sudan,Pulau Pinang,0,0,0
1/02/2023,Sudan,Sabah,0,0,0
1/02/2023,Sudan,Sarawak,5,4,1
1/02/2023,Sudan,Selangor,927,536,391
1/02/2023,Sudan,W.P. Labuan,0,0,0
1/02/2023,Senegal,Johor,0,0,0
1/02/2023,Senegal,Kedah,0,0,0
1/02/2023,Senegal,Kelantan,0,0,0
1/02/2023,Senegal,Perak,0,0,0
1/02/2023,Senegal,Perlis,0,0,0
1/02/2023,Senegal,Pulau Pinang,0,0,0
1/02/2023,Senegal,Sabah,0,0,0
1/02/2023,Senegal,Sarawak,0,0,0
1/02/2023,Senegal,Selangor,30,15,15
1/02/2023,Singapore,Johor,881960,518353,363607
1/02/2023,Singapore,Kedah,2844,1570,1274
1/02/2023,Singapore,Kelantan,43,28,15
1/02/2023,Singapore,Melaka,13,6,7
1/02/2023,Singapore,Negeri Sembilan,0,0,0
1/02/2023,Singapore,Pahang,165,85,80
1/02/2023,Singapore,Perak,4255,1968,2287
1/02/2023,Singapore,Perlis,155,99,56
1/02/2023,Singapore,Pulau Pinang,11326,5887,5439
1/02/2023,Singapore,Sabah,1957,1089,868
1/02/2023,Singapore,Sarawak,3166,1751,1415
1/02/2023,Singapore,Selangor,33742,17638,16104
1/02/2023,Singapore,Terengganu,0,0,0
1/02/2023,Singapore,W.P. Labuan,7,6,1
1/02/2023,South Georgia and the South Sandwich Islands,Johor,0,0,0
1/02/2023,South Georgia and the South Sandwich Islands,Sabah,0,0,0
1/02/2023,South Georgia and the South Sandwich Islands,Selangor,0,0,0
1/02/2023,Saint Helena,Sarawak,0,0,0
1/02/2023,Solomon Islands,Johor,0,0,0
1/02/2023,Solomon Islands,Perlis,0,0,0
1/02/2023,Solomon Islands,Pulau Pinang,0,0,0
1/02/2023,Solomon Islands,Sabah,0,0,0
1/02/2023,Solomon Islands,Sarawak,2,1,1
1/02/2023,Solomon Islands,Selangor,0,0,0
1/02/2023,Solomon Islands,W.P. Labuan,0,0,0
1/02/2023,Sierra Leone,Johor,6,3,3
1/02/2023,Sierra Leone,Kedah,0,0,0
1/02/2023,Sierra Leone,Perak,0,0,0
1/02/2023,Sierra Leone,Pulau Pinang,0,0,0
1/02/2023,Sierra Leone,Sabah,0,0,0
1/02/2023,Sierra Leone,Selangor,17,9,8
1/02/2023,El Salvador,Johor,1,0,1
1/02/2023,El Salvador,Kedah,0,0,0
1/02/2023,El Salvador,Perak,0,0,0
1/02/2023,El Salvador,Perlis,0,0,0
1/02/2023,El Salvador,Pulau Pinang,2,1,1
1/02/2023,El Salvador,Sabah,0,0,0
1/02/2023,El Salvador,Selangor,14,8,6
1/02/2023,El Salvador,W.P. Labuan,0,0,0
1/02/2023,San Marino,Johor,0,0,0
1/02/2023,San Marino,Selangor,4,4,0
1/02/2023,Somalia,Johor,0,0,0
1/02/2023,Somalia,Kedah,0,0,0
1/02/2023,Somalia,Kelantan,0,0,0
1/02/2023,Somalia,Perlis,0,0,0
1/02/2023,Somalia,Sabah,1,0,1
1/02/2023,Somalia,Sarawak,0,0,0
1/02/2023,Somalia,Selangor,215,133,82
1/02/2023,Serbia,Johor,5,2,3
1/02/2023,Serbia,Kedah,0,0,0
1/02/2023,Serbia,Kelantan,0,0,0
1/02/2023,Serbia,Pahang,0,0,0
1/02/2023,Serbia,Perak,0,0,0
1/02/2023,Serbia,Perlis,1,0,1
1/02/2023,Serbia,Pulau Pinang,2,0,2
1/02/2023,Serbia,Sabah,1,1,0
1/02/2023,Serbia,Sarawak,1,0,1
1/02/2023,Serbia,Selangor,67,38,29
1/02/2023,South Sudan,Johor,0,0,0
1/02/2023,South Sudan,Kedah,0,0,0
1/02/2023,South Sudan,Sarawak,0,0,0
1/02/2023,South Sudan,Selangor,25,15,10
1/02/2023,South Sudan,W.P. Labuan,0,0,0
1/02/2023,Sao Tome and Principe,Selangor,2,1,1
1/02/2023,Suriname,Johor,1,0,1
1/02/2023,Suriname,Kedah,0,0,0
1/02/2023,Suriname,Kelantan,0,0,0
1/02/2023,Suriname,Perak,0,0,0
1/02/2023,Suriname,Perlis,0,0,0
1/02/2023,Suriname,Pulau Pinang,0,0,0
1/02/2023,Suriname,Sabah,0,0,0
1/02/2023,Suriname,Sarawak,0,0,0
1/02/2023,Suriname,Selangor,14,10,4
1/02/2023,Slovakia,Johor,44,27,17
1/02/2023,Slovakia,Kedah,131,61,70
1/02/2023,Slovakia,Kelantan,0,0,0
1/02/2023,Slovakia,Negeri Sembilan,0,0,0
1/02/2023,Slovakia,Pahang,0,0,0
1/02/2023,Slovakia,Perak,0,0,0
1/02/2023,Slovakia,Perlis,7,3,4
1/02/2023,Slovakia,Pulau Pinang,24,14,10
1/02/2023,Slovakia,Sabah,9,3,6
1/02/2023,Slovakia,Sarawak,4,2,2
1/02/2023,Slovakia,Selangor,411,229,182
1/02/2023,Slovakia,W.P. Labuan,3,3,0
1/02/2023,Slovenia,Johor,21,8,13
1/02/2023,Slovenia,Kedah,52,29,23
1/02/2023,Slovenia,Kelantan,0,0,0
1/02/2023,Slovenia,Perak,0,0,0
1/02/2023,Slovenia,Perlis,6,3,3
1/02/2023,Slovenia,Pulau Pinang,2,0,2
1/02/2023,Slovenia,Sabah,2,2,0
1/02/2023,Slovenia,Sarawak,1,0,1
1/02/2023,Slovenia,Selangor,147,76,71
1/02/2023,Slovenia,W.P. Labuan,8,2,6
1/02/2023,Sweden,Johor,255,138,117
1/02/2023,Sweden,Kedah,475,205,270
1/02/2023,Sweden,Kelantan,2,1,1
1/02/2023,Sweden,Melaka,1,1,0
1/02/2023,Sweden,Negeri Sembilan,0,0,0
1/02/2023,Sweden,Pahang,2,1,1
1/02/2023,Sweden,Perak,8,7,1
1/02/2023,Sweden,Perlis,21,17,4
1/02/2023,Sweden,Pulau Pinang,122,77,45
1/02/2023,Sweden,Sabah,45,20,25
1/02/2023,Sweden,Sarawak,22,18,4
1/02/2023,Sweden,Selangor,1457,838,619
1/02/2023,Sweden,W.P. Labuan,2,2,0
1/02/2023,Eswatini,Johor,1,0,1
1/02/2023,Eswatini,Kedah,0,0,0
1/02/2023,Eswatini,Pulau Pinang,0,0,0
1/02/2023,Eswatini,Sabah,0,0,0
1/02/2023,Eswatini,Selangor,14,4,10
1/02/2023,Seychelles,Johor,1,0,1
1/02/2023,Seychelles,Kedah,0,0,0
1/02/2023,Seychelles,Pulau Pinang,0,0,0
1/02/2023,Seychelles,Sabah,0,0,0
1/02/2023,Seychelles,Sarawak,1,1,0
1/02/2023,Seychelles,Selangor,55,15,40
1/02/2023,Syrian Arab Republic,Johor,8,6,2
1/02/2023,Syrian Arab Republic,Kedah,1,1,0
1/02/2023,Syrian Arab Republic,Kelantan,0,0,0
1/02/2023,Syrian Arab Republic,Pahang,0,0,0
1/02/2023,Syrian Arab Republic,Perlis,0,0,0
1/02/2023,Syrian Arab Republic,Pulau Pinang,0,0,0
1/02/2023,Syrian Arab Republic,Sabah,1,1,0
1/02/2023,Syrian Arab Republic,Sarawak,0,0,0
1/02/2023,Syrian Arab Republic,Selangor,512,337,175
1/02/2023,Syrian Arab Republic,W.P. Labuan,1,1,0
1/02/2023,Turks and Caicos Islands,Perlis,1,0,1
1/02/2023,TCD,Johor,0,0,0
1/02/2023,TCD,Kedah,0,0,0
1/02/2023,TCD,Perlis,0,0,0
1/02/2023,TCD,Selangor,10,8,2
1/02/2023,Togo,Johor,2,1,1
1/02/2023,Togo,Perak,0,0,0
1/02/2023,Togo,Pulau Pinang,0,0,0
1/02/2023,Togo,Selangor,3,2,1
1/02/2023,Thailand,Johor,5181,1418,3763
1/02/2023,Thailand,Kedah,61904,37209,24695
1/02/2023,Thailand,Kelantan,48527,25575,22952
1/02/2023,Thailand,Melaka,9,6,3
1/02/2023,Thailand,Negeri Sembilan,1,1,0
1/02/2023,Thailand,Pahang,1,0,1
1/02/2023,Thailand,Perak,9690,4601,5089
1/02/2023,Thailand,Perlis,52242,32191,20051
1/02/2023,Thailand,Pulau Pinang,1700,684,1016
1/02/2023,Thailand,Sabah,143,47,96
1/02/2023,Thailand,Sarawak,292,101,191
1/02/2023,Thailand,Selangor,9860,3971,5889
1/02/2023,Thailand,Terengganu,0,0,0
1/02/2023,Thailand,W.P. Labuan,5,2,3
1/02/2023,Tajikistan,Johor,4,1,3
1/02/2023,Tajikistan,Kedah,0,0,0
1/02/2023,Tajikistan,Perlis,0,0,0
1/02/2023,Tajikistan,Pulau Pinang,2,2,0
1/02/2023,Tajikistan,Sabah,0,0,0
1/02/2023,Tajikistan,Selangor,88,52,36
1/02/2023,Tokelau,Selangor,0,0,0
1/02/2023,Turkmenistan,Johor,3,1,2
1/02/2023,Turkmenistan,Kedah,0,0,0
1/02/2023,Turkmenistan,Kelantan,1,0,1
1/02/2023,Turkmenistan,Perlis,0,0,0
1/02/2023,Turkmenistan,Pulau Pinang,0,0,0
1/02/2023,Turkmenistan,Sabah,0,0,0
1/02/2023,Turkmenistan,Sarawak,1,1,0
1/02/2023,Turkmenistan,Selangor,49,31,18
1/02/2023,Timor-Leste,Johor,4,3,1
1/02/2023,Timor-Leste,Kedah,2,1,1
1/02/2023,Timor-Leste,Perlis,0,0,0
1/02/2023,Timor-Leste,Pulau Pinang,1,0,1
1/02/2023,Timor-Leste,Sabah,0,0,0
1/02/2023,Timor-Leste,Sarawak,4,0,4
1/02/2023,Timor-Leste,Selangor,92,41,51
1/02/2023,Tonga,Johor,0,0,0
1/02/2023,Tonga,Pulau Pinang,2,1,1
1/02/2023,Tonga,Sarawak,0,0,0
1/02/2023,Tonga,Selangor,8,6,2
1/02/2023,Trinidad and Tobago,Johor,2,2,0
1/02/2023,Trinidad and Tobago,Kedah,0,0,0
1/02/2023,Trinidad and Tobago,Pahang,0,0,0
1/02/2023,Trinidad and Tobago,Pulau Pinang,0,0,0
1/02/2023,Trinidad and Tobago,Sabah,0,0,0
1/02/2023,Trinidad and Tobago,Sarawak,0,0,0
1/02/2023,Trinidad and Tobago,Selangor,15,7,8
1/02/2023,Tunisia,Johor,8,4,4
1/02/2023,Tunisia,Kedah,0,0,0
1/02/2023,Tunisia,Kelantan,0,0,0
1/02/2023,Tunisia,Melaka,0,0,0
1/02/2023,Tunisia,Perak,0,0,0
1/02/2023,Tunisia,Perlis,1,0,1
1/02/2023,Tunisia,Pulau Pinang,2,2,0
1/02/2023,Tunisia,Sabah,1,0,1
1/02/2023,Tunisia,Sarawak,2,2,0
1/02/2023,Tunisia,Selangor,275,170,105
1/02/2023,Tunisia,W.P. Labuan,2,0,2
1/02/2023,Türkiye,Johor,198,143,55
1/02/2023,Türkiye,Kedah,44,26,18
1/02/2023,Türkiye,Kelantan,2,2,0
1/02/2023,Türkiye,Melaka,0,0,0
1/02/2023,Türkiye,Negeri Sembilan,0,0,0
1/02/2023,Türkiye,Pahang,0,0,0
1/02/2023,Türkiye,Perak,1,1,0
1/02/2023,Türkiye,Perlis,29,26,3
1/02/2023,Türkiye,Pulau Pinang,47,31,16
1/02/2023,Türkiye,Sabah,11,7,4
1/02/2023,Türkiye,Sarawak,8,7,1
1/02/2023,Türkiye,Selangor,912,632,280
1/02/2023,Türkiye,W.P. Labuan,0,0,0
1/02/2023,Tuvalu,Selangor,0,0,0
1/02/2023,"Taiwan, Province of China",Johor,4132,1820,2312
1/02/2023,"Taiwan, Province of China",Kedah,133,53,80
1/02/2023,"Taiwan, Province of China",Kelantan,0,0,0
1/02/2023,"Taiwan, Province of China",Melaka,0,0,0
1/02/2023,"Taiwan, Province of China",Negeri Sembilan,0,0,0
1/02/2023,"Taiwan, Province of China",Pahang,0,0,0
1/02/2023,"Taiwan, Province of China",Perak,63,34,29
1/02/2023,"Taiwan, Province of China",Perlis,26,10,16
1/02/2023,"Taiwan, Province of China",Pulau Pinang,2360,1261,1099
1/02/2023,"Taiwan, Province of China",Sabah,839,420,419
1/02/2023,"Taiwan, Province of China",Sarawak,401,172,229
1/02/2023,"Taiwan, Province of China",Selangor,8699,4481,4218
1/02/2023,"Taiwan, Province of China",W.P. Labuan,22,8,14
1/02/2023,"Tanzania, United Republic of",Johor,21,10,11
1/02/2023,"Tanzania, United Republic of",Kedah,0,0,0
1/02/2023,"Tanzania, United Republic of",Perak,1,1,0
1/02/2023,"Tanzania, United Republic of",Perlis,0,0,0
1/02/2023,"Tanzania, United Republic of",Pulau Pinang,2,1,1
1/02/2023,"Tanzania, United Republic of",Sabah,0,0,0
1/02/2023,"Tanzania, United Republic of",Sarawak,5,5,0
1/02/2023,"Tanzania, United Republic of",Selangor,93,50,43
1/02/2023,Uganda,Johor,6,4,2
1/02/2023,Uganda,Kedah,0,0,0
1/02/2023,Uganda,Perak,0,0,0
1/02/2023,Uganda,Perlis,1,0,1
1/02/2023,Uganda,Pulau Pinang,0,0,0
1/02/2023,Uganda,Sabah,0,0,0
1/02/2023,Uganda,Sarawak,1,1,0
1/02/2023,Uganda,Selangor,74,38,36
1/02/2023,Ukraine,Johor,119,69,50
1/02/2023,Ukraine,Kedah,49,12,37
1/02/2023,Ukraine,Kelantan,6,5,1
1/02/2023,Ukraine,Melaka,0,0,0
1/02/2023,Ukraine,Negeri Sembilan,0,0,0
1/02/2023,Ukraine,Pahang,0,0,0
1/02/2023,Ukraine,Perak,2,1,1
1/02/2023,Ukraine,Perlis,21,9,12
1/02/2023,Ukraine,Pulau Pinang,25,11,14
1/02/2023,Ukraine,Sabah,7,3,4
1/02/2023,Ukraine,Sarawak,1,1,0
1/02/2023,Ukraine,Selangor,1031,483,548
1/02/2023,Ukraine,W.P. Labuan,0,0,0
1/02/2023,Uruguay,Johor,74,28,46
1/02/2023,Uruguay,Kedah,1,1,0
1/02/2023,Uruguay,Kelantan,0,0,0
1/02/2023,Uruguay,Perak,0,0,0
1/02/2023,Uruguay,Perlis,0,0,0
1/02/2023,Uruguay,Pulau Pinang,1,0,1
1/02/2023,Uruguay,Sabah,1,1,0
1/02/2023,Uruguay,Sarawak,0,0,0
1/02/2023,Uruguay,Selangor,111,53,58
1/02/2023,Uruguay,W.P. Labuan,0,0,0
1/02/2023,United States of America,Johor,3786,2213,1573
1/02/2023,United States of America,Kedah,556,306,250
1/02/2023,United States of America,Kelantan,16,11,5
1/02/2023,United States of America,Melaka,5,2,3
1/02/2023,United States of America,Negeri Sembilan,0,0,0
1/02/2023,United States of America,Pahang,2,1,1
1/02/2023,United States of America,Perak,141,80,61
1/02/2023,United States of America,Perlis,139,90,49
1/02/2023,United States of America,Pulau Pinang,1796,1141,655
1/02/2023,United States of America,Sabah,344,177,167
1/02/2023,United States of America,Sarawak,282,159,123
1/02/2023,United States of America,Selangor,11171,6822,4349
1/02/2023,United States of America,Terengganu,0,0,0
1/02/2023,United States of America,W.P. Labuan,5,4,1
1/02/2023,Uzbekistan,Johor,92,81,11
1/02/2023,Uzbekistan,Kedah,15,7,8
1/02/2023,Uzbekistan,Kelantan,1,1,0
1/02/2023,Uzbekistan,Perak,0,0,0
1/02/2023,Uzbekistan,Perlis,6,4,2
1/02/2023,Uzbekistan,Pulau Pinang,14,2,12
1/02/2023,Uzbekistan,Sabah,1,1,0
1/02/2023,Uzbekistan,Sarawak,0,0,0
1/02/2023,Uzbekistan,Selangor,1321,768,553
1/02/2023,Holy See,Johor,0,0,0
1/02/2023,Holy See,Sarawak,0,0,0
1/02/2023,Holy See,Selangor,1,1,0
1/02/2023,Saint Vincent and the Grenadines,Johor,0,0,0
1/02/2023,Saint Vincent and the Grenadines,Kedah,0,0,0
1/02/2023,Saint Vincent and the Grenadines,Pulau Pinang,0,0,0
1/02/2023,Saint Vincent and the Grenadines,Sarawak,0,0,0
1/02/2023,Saint Vincent and the Grenadines,Selangor,1,1,0
1/02/2023,"Venezuela, Bolivarian Republic of",Johor,17,8,9
1/02/2023,"Venezuela, Bolivarian Republic of",Kedah,0,0,0
1/02/2023,"Venezuela, Bolivarian Republic of",Kelantan,0,0,0
1/02/2023,"Venezuela, Bolivarian Republic of",Melaka,0,0,0
1/02/2023,"Venezuela, Bolivarian Republic of",Perak,0,0,0
1/02/2023,"Venezuela, Bolivarian Republic of",Perlis,0,0,0
1/02/2023,"Venezuela, Bolivarian Republic of",Pulau Pinang,2,1,1
1/02/2023,"Venezuela, Bolivarian Republic of",Sabah,0,0,0
1/02/2023,"Venezuela, Bolivarian Republic of",Sarawak,5,3,2
1/02/2023,"Venezuela, Bolivarian Republic of",Selangor,48,24,24
1/02/2023,"Venezuela, Bolivarian Republic of",W.P. Labuan,0,0,0
1/02/2023,Viet Nam,Johor,10757,3249,7508
1/02/2023,Viet Nam,Kedah,247,29,218
1/02/2023,Viet Nam,Kelantan,5,1,4
1/02/2023,Viet Nam,Melaka,0,0,0
1/02/2023,Viet Nam,Negeri Sembilan,0,0,0
1/02/2023,Viet Nam,Pahang,0,0,0
1/02/2023,Viet Nam,Perak,108,22,86
1/02/2023,Viet Nam,Perlis,180,16,164
1/02/2023,Viet Nam,Pulau Pinang,1378,432,946
1/02/2023,Viet Nam,Sabah,19,4,15
1/02/2023,Viet Nam,Sarawak,169,24,145
1/02/2023,Viet Nam,Selangor,13413,4726,8687
1/02/2023,Viet Nam,Terengganu,0,0,0
1/02/2023,Viet Nam,W.P. Labuan,5,3,2
1/02/2023,Vanuatu,Johor,19,13,6
1/02/2023,Vanuatu,Kedah,0,0,0
1/02/2023,Vanuatu,Pulau Pinang,3,3,0
1/02/2023,Vanuatu,Sabah,1,1,0
1/02/2023,Vanuatu,Sarawak,0,0,0
1/02/2023,Vanuatu,Selangor,37,33,4
1/02/2023, Samoa,Johor,1,1,0
1/02/2023, Samoa,Sarawak,0,0,0
1/02/2023, Samoa,Selangor,1,1,0
1/02/2023,Yemen,Johor,22,12,10
1/02/2023,Yemen,Kedah,0,0,0
1/02/2023,Yemen,Kelantan,0,0,0
1/02/2023,Yemen,Melaka,0,0,0
1/02/2023,Yemen,Pahang,0,0,0
1/02/2023,Yemen,Perak,0,0,0
1/02/2023,Yemen,Perlis,1,1,0
1/02/2023,Yemen,Pulau Pinang,5,5,0
1/02/2023,Yemen,Sabah,0,0,0
1/02/2023,Yemen,Sarawak,5,2,3
1/02/2023,Yemen,Selangor,1012,743,269
1/02/2023,Yemen,W.P. Labuan,0,0,0
1/02/2023,South Africa,Johor,279,176,103
1/02/2023,South Africa,Kedah,44,25,19
1/02/2023,South Africa,Kelantan,1,1,0
1/02/2023,South Africa,Melaka,0,0,0
1/02/2023,South Africa,Pahang,0,0,0
1/02/2023,South Africa,Perak,2,1,1
1/02/2023,South Africa,Perlis,10,5,5
1/02/2023,South Africa,Pulau Pinang,37,19,18
1/02/2023,South Africa,Sabah,6,1,5
1/02/2023,South Africa,Sarawak,86,40,46
1/02/2023,South Africa,Selangor,668,403,265
1/02/2023,South Africa,Terengganu,0,0,0
1/02/2023,South Africa,W.P. Labuan,1,1,0
1/02/2023,ZAR,Selangor,0,0,0
1/02/2023,Zambia,Johor,7,3,4
1/02/2023,Zambia,Kedah,0,0,0
1/02/2023,Zambia,Perak,0,0,0
1/02/2023,Zambia,Perlis,0,0,0
1/02/2023,Zambia,Pulau Pinang,0,0,0
1/02/2023,Zambia,Sabah,0,0,0
1/02/2023,Zambia,Sarawak,2,1,1
1/02/2023,Zambia,Selangor,43,26,17
1/02/2023,Zimbabwe,Johor,8,4,4
1/02/2023,Zimbabwe,Kedah,0,0,0
1/02/2023,Zimbabwe,Kelantan,0,0,0
1/02/2023,Zimbabwe,Perak,0,0,0
1/02/2023,Zimbabwe,Perlis,1,0,1
1/02/2023,Zimbabwe,Pulau Pinang,0,0,0
1/02/2023,Zimbabwe,Sabah,1,0,1
1/02/2023,Zimbabwe,Sarawak,0,0,0
1/02/2023,Zimbabwe,Selangor,79,40,39
1/03/2023,Aruba,Kedah,0,0,0
1/03/2023,Aruba,Pulau Pinang,0,0,0
1/03/2023,Afghanistan,Johor,1,1,0
1/03/2023,Afghanistan,Kedah,0,0,0
1/03/2023,Afghanistan,Perlis,0,0,0
1/03/2023,Afghanistan,Pulau Pinang,0,0,0
1/03/2023,Afghanistan,Sarawak,0,0,0
1/03/2023,Afghanistan,Selangor,29,25,4
1/03/2023,Angola,Johor,1,1,0
1/03/2023,Angola,Kedah,2,2,0
1/03/2023,Angola,Sabah,0,0,0
1/03/2023,Angola,Selangor,19,17,2
1/03/2023,Anguilla,Selangor,0,0,0
1/03/2023,Albania,Johor,10,9,1
1/03/2023,Albania,Kedah,3,0,3
1/03/2023,Albania,Perak,0,0,0
1/03/2023,Albania,Perlis,0,0,0
1/03/2023,Albania,Pulau Pinang,0,0,0
1/03/2023,Albania,Sabah,1,0,1
1/03/2023,Albania,Sarawak,1,1,0
1/03/2023,Albania,Selangor,36,25,11
1/03/2023,Andorra,Johor,0,0,0
1/03/2023,Andorra,Kedah,0,0,0
1/03/2023,Andorra,Perlis,0,0,0
1/03/2023,Andorra,Pulau Pinang,0,0,0
1/03/2023,Andorra,Selangor,0,0,0
1/03/2023,Antigua and Barbuda,Selangor,0,0,0
1/03/2023,United Arab Emirates,Johor,15,14,1
1/03/2023,United Arab Emirates,Kedah,0,0,0
1/03/2023,United Arab Emirates,Kelantan,0,0,0
1/03/2023,United Arab Emirates,Perak,0,0,0
1/03/2023,United Arab Emirates,Perlis,0,0,0
1/03/2023,United Arab Emirates,Pulau Pinang,1,1,0
1/03/2023,United Arab Emirates,Sabah,0,0,0
1/03/2023,United Arab Emirates,Sarawak,1,1,0
1/03/2023,United Arab Emirates,Selangor,224,158,66
1/03/2023,Argentina,Johor,62,39,23
1/03/2023,Argentina,Kedah,69,35,34
1/03/2023,Argentina,Kelantan,0,0,0
1/03/2023,Argentina,Melaka,1,1,0
1/03/2023,Argentina,Perak,1,1,0
1/03/2023,Argentina,Perlis,16,6,10
1/03/2023,Argentina,Pulau Pinang,13,7,6
1/03/2023,Argentina,Sabah,1,0,1
1/03/2023,Argentina,Sarawak,0,0,0
1/03/2023,Argentina,Selangor,373,203,170
1/03/2023,Argentina,W.P. Labuan,0,0,0
1/03/2023,Armenia,Johor,3,2,1
1/03/2023,Armenia,Kedah,0,0,0
1/03/2023,Armenia,Kelantan,0,0,0
1/03/2023,Armenia,Perak,0,0,0
1/03/2023,Armenia,Perlis,0,0,0
1/03/2023,Armenia,Pulau Pinang,0,0,0
1/03/2023,Armenia,Sabah,0,0,0
1/03/2023,Armenia,Sarawak,0,0,0
1/03/2023,Armenia,Selangor,128,51,77
1/03/2023,Antarctica,Selangor,0,0,0
1/03/2023,Antigua and Barbuda,Johor,8,7,1
1/03/2023,Antigua and Barbuda,Kedah,5,2,3
1/03/2023,Antigua and Barbuda,Pulau Pinang,0,0,0
1/03/2023,Antigua and Barbuda,Sarawak,0,0,0
1/03/2023,Antigua and Barbuda,Selangor,17,9,8
1/03/2023,Australia,Johor,4283,2546,1737
1/03/2023,Australia,Kedah,508,293,215
1/03/2023,Australia,Kelantan,13,10,3
1/03/2023,Australia,Melaka,1,1,0
1/03/2023,Australia,Negeri Sembilan,1,1,0
1/03/2023,Australia,Pahang,2,2,0
1/03/2023,Australia,Perak,183,101,82
1/03/2023,Australia,Perlis,74,48,26
1/03/2023,Australia,Pulau Pinang,1589,872,717
1/03/2023,Australia,Sabah,439,228,211
1/03/2023,Australia,Sarawak,639,359,280
1/03/2023,Australia,Selangor,18900,11159,7741
1/03/2023,Australia,Terengganu,0,0,0
1/03/2023,Australia,W.P. Labuan,3,2,1
1/03/2023,Austria,Johor,149,95,54
1/03/2023,Austria,Kedah,106,55,51
1/03/2023,Austria,Kelantan,4,4,0
1/03/2023,Austria,Melaka,3,2,1
1/03/2023,Austria,Negeri Sembilan,0,0,0
1/03/2023,Austria,Pahang,0,0,0
1/03/2023,Austria,Perak,1,0,1
1/03/2023,Austria,Perlis,14,10,4
1/03/2023,Austria,Pulau Pinang,91,67,24
1/03/2023,Austria,Sabah,18,11,7
1/03/2023,Austria,Sarawak,28,21,7
1/03/2023,Austria,Selangor,701,450,251
1/03/2023,Austria,Terengganu,0,0,0
1/03/2023,Austria,W.P. Labuan,0,0,0
1/03/2023,Azerbaijan,Johor,8,4,4
1/03/2023,Azerbaijan,Kedah,10,7,3
1/03/2023,Azerbaijan,Kelantan,0,0,0
1/03/2023,Azerbaijan,Melaka,0,0,0
1/03/2023,Azerbaijan,Perlis,0,0,0
1/03/2023,Azerbaijan,Pulau Pinang,2,1,1
1/03/2023,Azerbaijan,Sabah,0,0,0
1/03/2023,Azerbaijan,Sarawak,4,2,2
1/03/2023,Azerbaijan,Selangor,219,101,118
1/03/2023,Azerbaijan,W.P. Labuan,0,0,0
1/03/2023,Burundi,Pulau Pinang,0,0,0
1/03/2023,Burundi,Sarawak,0,0,0
1/03/2023,Burundi,Selangor,4,1,3
1/03/2023,Belgium,Johor,230,159,71
1/03/2023,Belgium,Kedah,130,69,61
1/03/2023,Belgium,Kelantan,5,3,2
1/03/2023,Belgium,Melaka,0,0,0
1/03/2023,Belgium,Negeri Sembilan,0,0,0
1/03/2023,Belgium,Pahang,0,0,0
1/03/2023,Belgium,Perak,1,1,0
1/03/2023,Belgium,Perlis,24,11,13
1/03/2023,Belgium,Pulau Pinang,65,40,25
1/03/2023,Belgium,Sabah,10,6,4
1/03/2023,Belgium,Sarawak,23,11,12
1/03/2023,Belgium,Selangor,939,606,333
1/03/2023,Belgium,W.P. Labuan,0,0,0
1/03/2023,Benin,Johor,2,2,0
1/03/2023,Benin,Kedah,0,0,0
1/03/2023,Benin,Perak,0,0,0
1/03/2023,Benin,Pulau Pinang,0,0,0
1/03/2023,Benin,Sabah,1,1,0
1/03/2023,Benin,Sarawak,0,0,0
1/03/2023,Benin,Selangor,8,6,2
1/03/2023,Burkina Faso,Perak,0,0,0
1/03/2023,Burkina Faso,Pulau Pinang,1,1,0
1/03/2023,Burkina Faso,Selangor,4,4,0
1/03/2023,Bangladesh,Johor,2780,2342,438
1/03/2023,Bangladesh,Kedah,34,22,12
1/03/2023,Bangladesh,Kelantan,1,1,0
1/03/2023,Bangladesh,Melaka,0,0,0
1/03/2023,Bangladesh,Negeri Sembilan,0,0,0
1/03/2023,Bangladesh,Pahang,1,1,0
1/03/2023,Bangladesh,Perak,0,0,0
1/03/2023,Bangladesh,Perlis,4,4,0
1/03/2023,Bangladesh,Pulau Pinang,755,739,16
1/03/2023,Bangladesh,Sabah,4,3,1
1/03/2023,Bangladesh,Sarawak,82,77,5
1/03/2023,Bangladesh,Selangor,59315,57741,1574
1/03/2023,Bangladesh,W.P. Labuan,1,1,0
1/03/2023,Bulgaria,Johor,46,22,24
1/03/2023,Bulgaria,Kedah,24,14,10
1/03/2023,Bulgaria,Kelantan,0,0,0
1/03/2023,Bulgaria,Pahang,0,0,0
1/03/2023,Bulgaria,Perak,0,0,0
1/03/2023,Bulgaria,Perlis,2,1,1
1/03/2023,Bulgaria,Pulau Pinang,7,5,2
1/03/2023,Bulgaria,Sabah,5,3,2
1/03/2023,Bulgaria,Sarawak,2,1,1
1/03/2023,Bulgaria,Selangor,265,132,133
1/03/2023,Bulgaria,W.P. Labuan,0,0,0
1/03/2023,Bahrain,Johor,1,1,0
1/03/2023,Bahrain,Kedah,0,0,0
1/03/2023,Bahrain,Kelantan,0,0,0
1/03/2023,Bahrain,Perlis,0,0,0
1/03/2023,Bahrain,Pulau Pinang,1,1,0
1/03/2023,Bahrain,Sabah,0,0,0
1/03/2023,Bahrain,Sarawak,0,0,0
1/03/2023,Bahrain,Selangor,72,46,26
1/03/2023,Bahamas,Johor,1,1,0
1/03/2023,Bahamas,Kedah,0,0,0
1/03/2023,Bahamas,Perak,0,0,0
1/03/2023,Bahamas,Sabah,0,0,0
1/03/2023,Bahamas,Sarawak,0,0,0
1/03/2023,Bahamas,Selangor,16,9,7
1/03/2023,Bosnia and Herzegovina,Johor,9,2,7
1/03/2023,Bosnia and Herzegovina,Kedah,2,1,1
1/03/2023,Bosnia and Herzegovina,Perlis,0,0,0
1/03/2023,Bosnia and Herzegovina,Pulau Pinang,0,0,0
1/03/2023,Bosnia and Herzegovina,Sabah,2,1,1
1/03/2023,Bosnia and Herzegovina,Sarawak,1,1,0
1/03/2023,Bosnia and Herzegovina,Selangor,59,32,27
1/03/2023,Belarus,Johor,23,4,19
1/03/2023,Belarus,Kedah,23,14,9
1/03/2023,Belarus,Kelantan,1,0,1
1/03/2023,Belarus,Pahang,0,0,0
1/03/2023,Belarus,Perak,0,0,0
1/03/2023,Belarus,Perlis,3,1,2
1/03/2023,Belarus,Pulau Pinang,6,2,4
1/03/2023,Belarus,Sabah,6,2,4
1/03/2023,Belarus,Sarawak,1,0,1
1/03/2023,Belarus,Selangor,526,259,267
1/03/2023,Belarus,W.P. Labuan,0,0,0
1/03/2023,Belize,Johor,1,0,1
1/03/2023,Belize,Pulau Pinang,0,0,0
1/03/2023,Belize,Sarawak,0,0,0
1/03/2023,Belize,Selangor,8,4,4
1/03/2023,Bermuda,Selangor,0,0,0
1/03/2023,Bolivia,Johor,0,0,0
1/03/2023,Bolivia,Kedah,0,0,0
1/03/2023,Bolivia,Melaka,1,1,0
1/03/2023,Bolivia,Perak,0,0,0
1/03/2023,Bolivia,Perlis,0,0,0
1/03/2023,Bolivia,Pulau Pinang,2,0,2
1/03/2023,Bolivia,Sabah,0,0,0
1/03/2023,Bolivia,Sarawak,1,1,0
1/03/2023,Bolivia,Selangor,12,9,3
1/03/2023,Brazil,Johor,246,157,89
1/03/2023,Brazil,Kedah,85,39,46
1/03/2023,Brazil,Kelantan,2,1,1
1/03/2023,Brazil,Melaka,2,2,0
1/03/2023,Brazil,Pahang,1,1,0
1/03/2023,Brazil,Perak,1,1,0
1/03/2023,Brazil,Perlis,6,3,3
1/03/2023,Brazil,Pulau Pinang,28,18,10
1/03/2023,Brazil,Sabah,14,8,6
1/03/2023,Brazil,Sarawak,7,6,1
1/03/2023,Brazil,Selangor,778,455,323
1/03/2023,Brazil,W.P. Labuan,0,0,0
1/03/2023,Barbados,Johor,2,0,2
1/03/2023,Barbados,Kedah,0,0,0
1/03/2023,Barbados,Perlis,0,0,0
1/03/2023,Barbados,Pulau Pinang,0,0,0
1/03/2023,Barbados,Selangor,1,1,0
1/03/2023,Brunei Darussalam,Johor,366,194,172
1/03/2023,Brunei Darussalam,Kedah,38,28,10
1/03/2023,Brunei Darussalam,Kelantan,5,3,2
1/03/2023,Brunei Darussalam,Melaka,3,3,0
1/03/2023,Brunei Darussalam,Pahang,0,0,0
1/03/2023,Brunei Darussalam,Perak,6,4,2
1/03/2023,Brunei Darussalam,Perlis,20,9,11
1/03/2023,Brunei Darussalam,Pulau Pinang,23,11,12
1/03/2023,Brunei Darussalam,Sabah,623,275,348
1/03/2023,Brunei Darussalam,Sarawak,90248,49820,40428
1/03/2023,Brunei Darussalam,Selangor,4819,2330,2489
1/03/2023,Brunei Darussalam,W.P. Labuan,992,686,306
1/03/2023,Bhutan,Johor,17,11,6
1/03/2023,Bhutan,Kedah,0,0,0
1/03/2023,Bhutan,Perak,0,0,0
1/03/2023,Bhutan,Perlis,0,0,0
1/03/2023,Bhutan,Pulau Pinang,0,0,0
1/03/2023,Bhutan,Sabah,0,0,0
1/03/2023,Bhutan,Sarawak,1,1,0
1/03/2023,Bhutan,Selangor,48,40,8
1/03/2023,Botswana,Johor,0,0,0
1/03/2023,Botswana,Kedah,0,0,0
1/03/2023,Botswana,Perlis,0,0,0
1/03/2023,Botswana,Pulau Pinang,0,0,0
1/03/2023,Botswana,Sabah,0,0,0
1/03/2023,Botswana,Sarawak,0,0,0
1/03/2023,Botswana,Selangor,13,8,5
1/03/2023,Central African Republic,Kedah,0,0,0
1/03/2023,Central African Republic,Selangor,0,0,0
1/03/2023,Canada,Johor,1589,899,690
1/03/2023,Canada,Kedah,298,168,130
1/03/2023,Canada,Kelantan,6,5,1
1/03/2023,Canada,Melaka,3,2,1
1/03/2023,Canada,Negeri Sembilan,0,0,0
1/03/2023,Canada,Pahang,0,0,0
1/03/2023,Canada,Perak,43,20,23
1/03/2023,Canada,Perlis,71,42,29
1/03/2023,Canada,Pulau Pinang,549,305,244
1/03/2023,Canada,Sabah,221,109,112
1/03/2023,Canada,Sarawak,471,260,211
1/03/2023,Canada,Selangor,4673,2709,1964
1/03/2023,Canada,Terengganu,5,5,0
1/03/2023,Canada,W.P. Labuan,3,3,0
1/03/2023,Cocos (Keeling) Islands,Selangor,0,0,0
1/03/2023,Switzerland,Johor,353,212,141
1/03/2023,Switzerland,Kedah,211,119,92
1/03/2023,Switzerland,Kelantan,2,2,0
1/03/2023,Switzerland,Melaka,0,0,0
1/03/2023,Switzerland,Negeri Sembilan,0,0,0
1/03/2023,Switzerland,Pahang,0,0,0
1/03/2023,Switzerland,Perak,9,5,4
1/03/2023,Switzerland,Perlis,25,16,9
1/03/2023,Switzerland,Pulau Pinang,156,98,58
1/03/2023,Switzerland,Sabah,39,18,21
1/03/2023,Switzerland,Sarawak,45,22,23
1/03/2023,Switzerland,Selangor,1305,798,507
1/03/2023,Switzerland,W.P. Labuan,0,0,0
1/03/2023,Chile,Johor,19,12,7
1/03/2023,Chile,Kedah,17,8,9
1/03/2023,Chile,Kelantan,1,1,0
1/03/2023,Chile,Melaka,0,0,0
1/03/2023,Chile,Pahang,0,0,0
1/03/2023,Chile,Perak,0,0,0
1/03/2023,Chile,Perlis,2,1,1
1/03/2023,Chile,Pulau Pinang,5,3,2
1/03/2023,Chile,Sabah,2,1,1
1/03/2023,Chile,Sarawak,2,1,1
1/03/2023,Chile,Selangor,199,108,91
1/03/2023,China,Johor,28268,11991,16277
1/03/2023,China,Kedah,669,307,362
1/03/2023,China,Kelantan,4,3,1
1/03/2023,China,Melaka,4,4,0
1/03/2023,China,Pahang,8,5,3
1/03/2023,China,Perak,162,63,99
1/03/2023,China,Perlis,112,40,72
1/03/2023,China,Pulau Pinang,5099,2686,2413
1/03/2023,China,Sabah,5054,2563,2491
1/03/2023,China,Sarawak,919,455,464
1/03/2023,China,Selangor,62452,34414,28038
1/03/2023,China,Terengganu,0,0,0
1/03/2023,China,W.P. Labuan,23,19,4
1/03/2023,Côte d'Ivoire,Johor,1,0,1
1/03/2023,Côte d'Ivoire,Kedah,0,0,0
1/03/2023,Côte d'Ivoire,Pulau Pinang,0,0,0
1/03/2023,Côte d'Ivoire,Sabah,0,0,0
1/03/2023,Côte d'Ivoire,Sarawak,0,0,0
1/03/2023,Côte d'Ivoire,Selangor,12,8,4
1/03/2023,Cameroon,Johor,1,1,0
1/03/2023,Cameroon,Kedah,0,0,0
1/03/2023,Cameroon,Pulau Pinang,0,0,0
1/03/2023,Cameroon,Sabah,0,0,0
1/03/2023,Cameroon,Sarawak,0,0,0
1/03/2023,Cameroon,Selangor,25,18,7
1/03/2023,Congo,Johor,3,3,0
1/03/2023,Congo,Pulau Pinang,0,0,0
1/03/2023,Congo,Sarawak,0,0,0
1/03/2023,Congo,Selangor,11,9,2
1/03/2023,Congo,Johor,0,0,0
1/03/2023,Congo,Kedah,0,0,0
1/03/2023,Congo,Selangor,0,0,0
1/03/2023,Cook Islands,Selangor,0,0,0
1/03/2023,Colombia,Johor,13,7,6
1/03/2023,Colombia,Kedah,4,0,4
1/03/2023,Colombia,Perak,0,0,0
1/03/2023,Colombia,Pulau Pinang,3,1,2
1/03/2023,Colombia,Sabah,0,0,0
1/03/2023,Colombia,Sarawak,2,1,1
1/03/2023,Colombia,Selangor,143,72,71
1/03/2023,Colombia,W.P. Labuan,0,0,0
1/03/2023,Comoros,Johor,0,0,0
1/03/2023,Comoros,Kedah,0,0,0
1/03/2023,Comoros,Selangor,11,3,8
1/03/2023,Cabo Verde,Johor,2,0,2
1/03/2023,Cabo Verde,Kedah,0,0,0
1/03/2023,Cabo Verde,Pulau Pinang,0,0,0
1/03/2023,Cabo Verde,Sabah,0,0,0
1/03/2023,Cabo Verde,Selangor,1,1,0
1/03/2023,Costa Rica,Johor,14,10,4
1/03/2023,Costa Rica,Kedah,0,0,0
1/03/2023,Costa Rica,Perak,0,0,0
1/03/2023,Costa Rica,Perlis,0,0,0
1/03/2023,Costa Rica,Pulau Pinang,3,3,0
1/03/2023,Costa Rica,Sabah,1,1,0
1/03/2023,Costa Rica,Sarawak,0,0,0
1/03/2023,Costa Rica,Selangor,48,27,21
1/03/2023,Cuba,Johor,2,1,1
1/03/2023,Cuba,Kedah,0,0,0
1/03/2023,Cuba,Perlis,0,0,0
1/03/2023,Cuba,Pulau Pinang,1,1,0
1/03/2023,Cuba,Sabah,0,0,0
1/03/2023,Cuba,Sarawak,0,0,0
1/03/2023,Cuba,Selangor,20,11,9
1/03/2023,Cyprus,Johor,9,4,5
1/03/2023,Cyprus,Kedah,0,0,0
1/03/2023,Cyprus,Perak,0,0,0
1/03/2023,Cyprus,Perlis,3,2,1
1/03/2023,Cyprus,Pulau Pinang,2,2,0
1/03/2023,Cyprus,Sabah,0,0,0
1/03/2023,Cyprus,Sarawak,2,1,1
1/03/2023,Cyprus,Selangor,75,47,28
1/03/2023,Czechia,Johor,146,88,58
1/03/2023,Czechia,Kedah,156,72,84
1/03/2023,Czechia,Kelantan,4,2,2
1/03/2023,Czechia,Melaka,0,0,0
1/03/2023,Czechia,Negeri Sembilan,0,0,0
1/03/2023,Czechia,Perak,0,0,0
1/03/2023,Czechia,Perlis,14,11,3
1/03/2023,Czechia,Pulau Pinang,51,31,20
1/03/2023,Czechia,Sabah,23,12,11
1/03/2023,Czechia,Sarawak,21,15,6
1/03/2023,Czechia,Selangor,744,438,306
1/03/2023,Czechia,W.P. Labuan,6,4,2
1/03/2023,Germany,Johor,2655,1542,1113
1/03/2023,Germany,Kedah,1183,596,587
1/03/2023,Germany,Kelantan,13,7,6
1/03/2023,Germany,Melaka,3,3,0
1/03/2023,Germany,Negeri Sembilan,1,1,0
1/03/2023,Germany,Pahang,4,3,1
1/03/2023,Germany,Perak,31,16,15
1/03/2023,Germany,Perlis,209,120,89
1/03/2023,Germany,Pulau Pinang,860,596,264
1/03/2023,Germany,Sabah,160,91,69
1/03/2023,Germany,Sarawak,272,140,132
1/03/2023,Germany,Selangor,7648,4761,2887
1/03/2023,Germany,Terengganu,0,0,0
1/03/2023,Germany,W.P. Labuan,9,4,5
1/03/2023,Djibouti,Johor,0,0,0
1/03/2023,Djibouti,Selangor,4,1,3
1/03/2023,Dominica,Johor,17,13,4
1/03/2023,Dominica,Kedah,1,1,0
1/03/2023,Dominica,Pulau Pinang,1,1,0
1/03/2023,Dominica,Sabah,1,0,1
1/03/2023,Dominica,Sarawak,0,0,0
1/03/2023,Dominica,Selangor,45,35,10
1/03/2023,Dominica,W.P. Labuan,0,0,0
1/03/2023,Denmark,Johor,238,163,75
1/03/2023,Denmark,Kedah,190,80,110
1/03/2023,Denmark,Kelantan,1,1,0
1/03/2023,Denmark,Melaka,0,0,0
1/03/2023,Denmark,Negeri Sembilan,0,0,0
1/03/2023,Denmark,Pahang,0,0,0
1/03/2023,Denmark,Perak,8,3,5
1/03/2023,Denmark,Perlis,25,16,9
1/03/2023,Denmark,Pulau Pinang,52,39,13
1/03/2023,Denmark,Sabah,69,31,38
1/03/2023,Denmark,Sarawak,45,22,23
1/03/2023,Denmark,Selangor,1215,697,518
1/03/2023,Denmark,W.P. Labuan,1,1,0
1/03/2023,Dominican Republic,Johor,0,0,0
1/03/2023,Dominican Republic,Kedah,0,0,0
1/03/2023,Dominican Republic,Perak,0,0,0
1/03/2023,Dominican Republic,Perlis,0,0,0
1/03/2023,Dominican Republic,Pulau Pinang,3,1,2
1/03/2023,Dominican Republic,Sabah,0,0,0
1/03/2023,Dominican Republic,Sarawak,0,0,0
1/03/2023,Dominican Republic,Selangor,67,40,27
1/03/2023,Algeria,Johor,20,16,4
1/03/2023,Algeria,Kedah,2,2,0
1/03/2023,Algeria,Kelantan,0,0,0
1/03/2023,Algeria,Melaka,0,0,0
1/03/2023,Algeria,Perak,1,1,0
1/03/2023,Algeria,Perlis,2,2,0
1/03/2023,Algeria,Pulau Pinang,2,1,1
1/03/2023,Algeria,Sabah,1,1,0
1/03/2023,Algeria,Sarawak,0,0,0
1/03/2023,Algeria,Selangor,386,281,105
1/03/2023,Algeria,W.P. Labuan,0,0,0
1/03/2023,Ecuador,Johor,12,7,5
1/03/2023,Ecuador,Kedah,2,1,1
1/03/2023,Ecuador,Perak,0,0,0
1/03/2023,Ecuador,Perlis,0,0,0
1/03/2023,Ecuador,Pulau Pinang,0,0,0
1/03/2023,Ecuador,Sabah,0,0,0
1/03/2023,Ecuador,Sarawak,0,0,0
1/03/2023,Ecuador,Selangor,67,35,32
1/03/2023,Egypt,Johor,250,216,34
1/03/2023,Egypt,Kedah,9,6,3
1/03/2023,Egypt,Kelantan,0,0,0
1/03/2023,Egypt,Melaka,2,2,0
1/03/2023,Egypt,Pahang,1,1,0
1/03/2023,Egypt,Perak,1,1,0
1/03/2023,Egypt,Perlis,2,2,0
1/03/2023,Egypt,Pulau Pinang,5,4,1
1/03/2023,Egypt,Sabah,0,0,0
1/03/2023,Egypt,Sarawak,105,70,35
1/03/2023,Egypt,Selangor,1178,907,271
1/03/2023,Egypt,Terengganu,2,2,0
1/03/2023,Egypt,W.P. Labuan,1,1,0
1/03/2023,Eritrea,Johor,2,1,1
1/03/2023,Eritrea,Pulau Pinang,0,0,0
1/03/2023,Eritrea,Sabah,0,0,0
1/03/2023,Eritrea,Selangor,27,17,10
1/03/2023,Spain,Johor,431,258,173
1/03/2023,Spain,Kedah,196,106,90
1/03/2023,Spain,Kelantan,4,2,2
1/03/2023,Spain,Melaka,0,0,0
1/03/2023,Spain,Negeri Sembilan,0,0,0
1/03/2023,Spain,Pahang,0,0,0
1/03/2023,Spain,Perak,1,1,0
1/03/2023,Spain,Perlis,19,9,10
1/03/2023,Spain,Pulau Pinang,94,53,41
1/03/2023,Spain,Sabah,41,25,16
1/03/2023,Spain,Sarawak,37,25,12
1/03/2023,Spain,Selangor,1955,1153,802
1/03/2023,Spain,W.P. Labuan,0,0,0
1/03/2023,Estonia,Johor,45,24,21
1/03/2023,Estonia,Kedah,88,51,37
1/03/2023,Estonia,Kelantan,0,0,0
1/03/2023,Estonia,Pahang,0,0,0
1/03/2023,Estonia,Perak,0,0,0
1/03/2023,Estonia,Perlis,4,1,3
1/03/2023,Estonia,Pulau Pinang,17,9,8
1/03/2023,Estonia,Sabah,1,0,1
1/03/2023,Estonia,Sarawak,5,3,2
1/03/2023,Estonia,Selangor,268,131,137
1/03/2023,Estonia,W.P. Labuan,0,0,0
1/03/2023,Ethiopia,Johor,2,2,0
1/03/2023,Ethiopia,Kedah,0,0,0
1/03/2023,Ethiopia,Pulau Pinang,0,0,0
1/03/2023,Ethiopia,Sarawak,0,0,0
1/03/2023,Ethiopia,Selangor,20,17,3
1/03/2023,Finland,Johor,191,107,84
1/03/2023,Finland,Kedah,132,71,61
1/03/2023,Finland,Kelantan,1,1,0
1/03/2023,Finland,Melaka,0,0,0
1/03/2023,Finland,Negeri Sembilan,0,0,0
1/03/2023,Finland,Pahang,0,0,0
1/03/2023,Finland,Perak,7,4,3
1/03/2023,Finland,Perlis,12,8,4
1/03/2023,Finland,Pulau Pinang,65,38,27
1/03/2023,Finland,Sabah,29,18,11
1/03/2023,Finland,Sarawak,15,9,6
1/03/2023,Finland,Selangor,671,376,295
1/03/2023,Finland,W.P. Labuan,2,2,0
1/03/2023,Fiji,Johor,42,25,17
1/03/2023,Fiji,Kedah,3,1,2
1/03/2023,Fiji,Kelantan,0,0,0
1/03/2023,Fiji,Perak,0,0,0
1/03/2023,Fiji,Perlis,0,0,0
1/03/2023,Fiji,Pulau Pinang,7,5,2
1/03/2023,Fiji,Sabah,3,0,3
1/03/2023,Fiji,Sarawak,2,1,1
1/03/2023,Fiji,Selangor,93,51,42
1/03/2023,France,Johor,1756,1074,682
1/03/2023,France,Kedah,950,500,450
1/03/2023,France,Kelantan,32,18,14
1/03/2023,France,Melaka,2,2,0
1/03/2023,France,Negeri Sembilan,1,1,0
1/03/2023,France,Pahang,10,7,3
1/03/2023,France,Perak,32,16,16
1/03/2023,France,Perlis,131,90,41
1/03/2023,France,Pulau Pinang,453,281,172
1/03/2023,France,Sabah,110,64,46
1/03/2023,France,Sarawak,138,80,58
1/03/2023,France,Selangor,7694,4574,3120
1/03/2023,France,Terengganu,0,0,0
1/03/2023,France,W.P. Labuan,2,2,0
1/03/2023,"Micronesia, Federated States of",Johor,0,0,0
1/03/2023,"Micronesia, Federated States of",Pulau Pinang,0,0,0
1/03/2023,"Micronesia, Federated States of",Selangor,1,0,1
1/03/2023,Gabon,Johor,0,0,0
1/03/2023,Gabon,Pulau Pinang,0,0,0
1/03/2023,Gabon,Sarawak,0,0,0
1/03/2023,Gabon,Selangor,4,2,2
1/03/2023,United Kingdom of Great Britain and Northern Ireland,Johor,4531,2864,1667
1/03/2023,United Kingdom of Great Britain and Northern Ireland,Kedah,1489,791,698
1/03/2023,United Kingdom of Great Britain and Northern Ireland,Kelantan,20,18,2
1/03/2023,United Kingdom of Great Britain and Northern Ireland,Melaka,6,3,3
1/03/2023,United Kingdom of Great Britain and Northern Ireland,Negeri Sembilan,1,1,0
1/03/2023,United Kingdom of Great Britain and Northern Ireland,Pahang,4,4,0
1/03/2023,United Kingdom of Great Britain and Northern Ireland,Perak,96,53,43
1/03/2023,United Kingdom of Great Britain and Northern Ireland,Perlis,251,168,83
1/03/2023,United Kingdom of Great Britain and Northern Ireland,Pulau Pinang,1604,919,685
1/03/2023,United Kingdom of Great Britain and Northern Ireland,Sabah,699,375,324
1/03/2023,United Kingdom of Great Britain and Northern Ireland,Sarawak,1484,876,608
1/03/2023,United Kingdom of Great Britain and Northern Ireland,Selangor,16846,10148,6698
1/03/2023,United Kingdom of Great Britain and Northern Ireland,Terengganu,0,0,0
1/03/2023,United Kingdom of Great Britain and Northern Ireland,W.P. Labuan,21,14,7
1/03/2023,Georgia,Johor,12,11,1
1/03/2023,Georgia,Kedah,2,1,1
1/03/2023,Georgia,Melaka,0,0,0
1/03/2023,Georgia,Perak,0,0,0
1/03/2023,Georgia,Perlis,5,3,2
1/03/2023,Georgia,Pulau Pinang,1,1,0
1/03/2023,Georgia,Sabah,0,0,0
1/03/2023,Georgia,Sarawak,0,0,0
1/03/2023,Georgia,Selangor,73,48,25
1/03/2023,Ghana,Johor,14,14,0
1/03/2023,Ghana,Kedah,0,0,0
1/03/2023,Ghana,Kelantan,0,0,0
1/03/2023,Ghana,Pulau Pinang,0,0,0
1/03/2023,Ghana,Sabah,0,0,0
1/03/2023,Ghana,Sarawak,0,0,0
1/03/2023,Ghana,Selangor,66,46,20
1/03/2023,Gibraltar,Johor,0,0,0
1/03/2023,Gibraltar,Sarawak,0,0,0
1/03/2023,Guinea,Johor,1,1,0
1/03/2023,Guinea,Kedah,1,1,0
1/03/2023,Guinea,Kelantan,2,2,0
1/03/2023,Guinea,Perlis,0,0,0
1/03/2023,Guinea,Pulau Pinang,0,0,0
1/03/2023,Guinea,Sabah,0,0,0
1/03/2023,Guinea,Sarawak,0,0,0
1/03/2023,Guinea,Selangor,56,40,16
1/03/2023,Guadeloupe,Selangor,0,0,0
1/03/2023,Gambia,Johor,1,0,1
1/03/2023,Gambia,Kedah,0,0,0
1/03/2023,Gambia,Kelantan,0,0,0
1/03/2023,Gambia,Pulau Pinang,0,0,0
1/03/2023,Gambia,Sabah,1,1,0
1/03/2023,Gambia,Sarawak,0,0,0
1/03/2023,Gambia,Selangor,17,11,6
1/03/2023,Guinea-Bissau,Johor,3,3,0
1/03/2023,Guinea-Bissau,Selangor,0,0,0
1/03/2023,Equatorial Guinea,Johor,0,0,0
1/03/2023,Equatorial Guinea,Selangor,2,2,0
1/03/2023,Greece,Johor,59,43,16
1/03/2023,Greece,Kedah,26,14,12
1/03/2023,Greece,Kelantan,1,1,0
1/03/2023,Greece,Melaka,0,0,0
1/03/2023,Greece,Negeri Sembilan,0,0,0
1/03/2023,Greece,Pahang,3,3,0
1/03/2023,Greece,Perak,1,0,1
1/03/2023,Greece,Perlis,2,2,0
1/03/2023,Greece,Pulau Pinang,14,11,3
1/03/2023,Greece,Sabah,5,3,2
1/03/2023,Greece,Sarawak,3,2,1
1/03/2023,Greece,Selangor,253,187,66
1/03/2023,Grenada,Johor,4,3,1
1/03/2023,Grenada,Kedah,0,0,0
1/03/2023,Grenada,Pulau Pinang,0,0,0
1/03/2023,Grenada,Sabah,0,0,0
1/03/2023,Grenada,Sarawak,0,0,0
1/03/2023,Grenada,Selangor,9,8,1
1/03/2023,Greenland,Johor,0,0,0
1/03/2023,Greenland,Selangor,0,0,0
1/03/2023,Guatemala,Johor,6,3,3
1/03/2023,Guatemala,Kedah,0,0,0
1/03/2023,Guatemala,Pahang,0,0,0
1/03/2023,Guatemala,Perak,0,0,0
1/03/2023,Guatemala,Pulau Pinang,1,1,0
1/03/2023,Guatemala,Sabah,0,0,0
1/03/2023,Guatemala,Sarawak,0,0,0
1/03/2023,Guatemala,Selangor,25,13,12
1/03/2023,Guatemala,W.P. Labuan,0,0,0
1/03/2023,Guyana,Johor,1,0,1
1/03/2023,Guyana,Kedah,0,0,0
1/03/2023,Guyana,Pulau Pinang,0,0,0
1/03/2023,Guyana,Sarawak,0,0,0
1/03/2023,Guyana,Selangor,5,3,2
1/03/2023,Hong Kong,Johor,8,3,5
1/03/2023,Hong Kong,Kedah,0,0,0
1/03/2023,Hong Kong,Kelantan,0,0,0
1/03/2023,Hong Kong,Pahang,0,0,0
1/03/2023,Hong Kong,Perak,45,16,29
1/03/2023,Hong Kong,Perlis,3,2,1
1/03/2023,Hong Kong,Pulau Pinang,0,0,0
1/03/2023,Hong Kong,Sabah,102,54,48
1/03/2023,Hong Kong,Sarawak,0,0,0
1/03/2023,Hong Kong,Selangor,5,4,1
1/03/2023,Hong Kong,Terengganu,0,0,0
1/03/2023,Heard Island and McDonald Islands,Johor,0,0,0
1/03/2023,Honduras,Johor,2,1,1
1/03/2023,Honduras,Kedah,0,0,0
1/03/2023,Honduras,Perak,0,0,0
1/03/2023,Honduras,Pulau Pinang,0,0,0
1/03/2023,Honduras,Sabah,2,0,2
1/03/2023,Honduras,Sarawak,0,0,0
1/03/2023,Honduras,Selangor,10,2,8
1/03/2023,Croatia,Johor,57,45,12
1/03/2023,Croatia,Kedah,6,5,1
1/03/2023,Croatia,Kelantan,0,0,0
1/03/2023,Croatia,Melaka,0,0,0
1/03/2023,Croatia,Pahang,0,0,0
1/03/2023,Croatia,Perak,0,0,0
1/03/2023,Croatia,Perlis,1,1,0
1/03/2023,Croatia,Pulau Pinang,9,4,5
1/03/2023,Croatia,Sabah,1,0,1
1/03/2023,Croatia,Sarawak,4,2,2
1/03/2023,Croatia,Selangor,139,104,35
1/03/2023,Haiti,Johor,1,1,0
1/03/2023,Haiti,Kedah,0,0,0
1/03/2023,Haiti,Kelantan,0,0,0
1/03/2023,Haiti,Perak,0,0,0
1/03/2023,Haiti,Pulau Pinang,0,0,0
1/03/2023,Haiti,Sabah,0,0,0
1/03/2023,Haiti,Selangor,3,2,1
1/03/2023,Hungary,Johor,101,57,44
1/03/2023,Hungary,Kedah,44,23,21
1/03/2023,Hungary,Kelantan,0,0,0
1/03/2023,Hungary,Pahang,0,0,0
1/03/2023,Hungary,Perak,4,3,1
1/03/2023,Hungary,Perlis,5,3,2
1/03/2023,Hungary,Pulau Pinang,27,17,10
1/03/2023,Hungary,Sabah,11,6,5
1/03/2023,Hungary,Sarawak,19,8,11
1/03/2023,Hungary,Selangor,481,274,207
1/03/2023,Hungary,W.P. Labuan,0,0,0
1/03/2023,Indonesia,Johor,97877,52135,45742
1/03/2023,Indonesia,Kedah,3817,1458,2359
1/03/2023,Indonesia,Kelantan,141,91,50
1/03/2023,Indonesia,Melaka,4491,2035,2456
1/03/2023,Indonesia,Negeri Sembilan,8443,5513,2930
1/03/2023,Indonesia,Pahang,4,0,4
1/03/2023,Indonesia,Perak,181,61,120
1/03/2023,Indonesia,Perlis,440,173,267
1/03/2023,Indonesia,Pulau Pinang,32495,13104,19391
1/03/2023,Indonesia,Sabah,4963,2455,2508
1/03/2023,Indonesia,Sarawak,34456,18391,16065
1/03/2023,Indonesia,Selangor,88888,43351,45537
1/03/2023,Indonesia,Terengganu,3,3,0
1/03/2023,Indonesia,W.P. Labuan,54,39,15
1/03/2023,India,Johor,18870,12982,5888
1/03/2023,India,Kedah,879,496,383
1/03/2023,India,Kelantan,3,3,0
1/03/2023,India,Melaka,3,3,0
1/03/2023,India,Negeri Sembilan,0,0,0
1/03/2023,India,Pahang,3,3,0
1/03/2023,India,Perak,516,429,87
1/03/2023,India,Perlis,32,26,6
1/03/2023,India,Pulau Pinang,723,523,200
1/03/2023,India,Sabah,243,174,69
1/03/2023,India,Sarawak,1147,924,223
1/03/2023,India,Selangor,39734,29937,9797
1/03/2023,India,Terengganu,0,0,0
1/03/2023,India,W.P. Labuan,35,33,2
1/03/2023, British Indian Ocean Territory,Pulau Pinang,0,0,0
1/03/2023, British Indian Ocean Territory,Selangor,0,0,0
1/03/2023,Ireland,Johor,271,185,86
1/03/2023,Ireland,Kedah,97,51,46
1/03/2023,Ireland,Kelantan,3,3,0
1/03/2023,Ireland,Negeri Sembilan,0,0,0
1/03/2023,Ireland,Pahang,0,0,0
1/03/2023,Ireland,Perak,4,2,2
1/03/2023,Ireland,Perlis,16,11,5
1/03/2023,Ireland,Pulau Pinang,98,55,43
1/03/2023,Ireland,Sabah,30,15,15
1/03/2023,Ireland,Sarawak,60,27,33
1/03/2023,Ireland,Selangor,1164,661,503
1/03/2023,Ireland,Terengganu,0,0,0
1/03/2023,Ireland,W.P. Labuan,3,1,2
1/03/2023,"Iran, Islamic Republic of",Johor,266,146,120
1/03/2023,"Iran, Islamic Republic of",Kedah,12,6,6
1/03/2023,"Iran, Islamic Republic of",Kelantan,0,0,0
1/03/2023,"Iran, Islamic Republic of",Perak,0,0,0
1/03/2023,"Iran, Islamic Republic of",Perlis,7,5,2
1/03/2023,"Iran, Islamic Republic of",Pulau Pinang,15,10,5
1/03/2023,"Iran, Islamic Republic of",Sabah,1,0,1
1/03/2023,"Iran, Islamic Republic of",Sarawak,18,11,7
1/03/2023,"Iran, Islamic Republic of",Selangor,2780,1416,1364
1/03/2023,"Iran, Islamic Republic of",W.P. Labuan,0,0,0
1/03/2023,Iraq,Johor,20,17,3
1/03/2023,Iraq,Kedah,1,1,0
1/03/2023,Iraq,Kelantan,0,0,0
1/03/2023,Iraq,Melaka,0,0,0
1/03/2023,Iraq,Pahang,0,0,0
1/03/2023,Iraq,Perak,0,0,0
1/03/2023,Iraq,Perlis,1,1,0
1/03/2023,Iraq,Pulau Pinang,0,0,0
1/03/2023,Iraq,Sabah,0,0,0
1/03/2023,Iraq,Sarawak,1,1,0
1/03/2023,Iraq,Selangor,733,540,193
1/03/2023,Iceland,Johor,4,3,1
1/03/2023,Iceland,Kedah,4,2,2
1/03/2023,Iceland,Kelantan,0,0,0
1/03/2023,Iceland,Perak,0,0,0
1/03/2023,Iceland,Perlis,0,0,0
1/03/2023,Iceland,Pulau Pinang,0,0,0
1/03/2023,Iceland,Sabah,0,0,0
1/03/2023,Iceland,Sarawak,0,0,0
1/03/2023,Iceland,Selangor,48,25,23
1/03/2023,Iceland,W.P. Labuan,0,0,0
1/03/2023,Israel,Pulau Pinang,0,0,0
1/03/2023,Italy,Johor,591,428,163
1/03/2023,Italy,Kedah,411,218,193
1/03/2023,Italy,Kelantan,5,5,0
1/03/2023,Italy,Melaka,0,0,0
1/03/2023,Italy,Negeri Sembilan,0,0,0
1/03/2023,Italy,Pahang,0,0,0
1/03/2023,Italy,Perak,3,2,1
1/03/2023,Italy,Perlis,42,30,12
1/03/2023,Italy,Pulau Pinang,143,109,34
1/03/2023,Italy,Sabah,34,22,12
1/03/2023,Italy,Sarawak,73,45,28
1/03/2023,Italy,Selangor,2623,1720,903
1/03/2023,Italy,W.P. Labuan,1,1,0
1/03/2023,Jamaica,Johor,5,0,5
1/03/2023,Jamaica,Kedah,1,0,1
1/03/2023,Jamaica,Perak,0,0,0
1/03/2023,Jamaica,Pulau Pinang,1,1,0
1/03/2023,Jamaica,Sabah,0,0,0
1/03/2023,Jamaica,Sarawak,0,0,0
1/03/2023,Jamaica,Selangor,17,7,10
1/03/2023,Jamaica,W.P. Labuan,0,0,0
1/03/2023,Jordan,Johor,13,9,4
1/03/2023,Jordan,Kedah,8,3,5
1/03/2023,Jordan,Kelantan,1,1,0
1/03/2023,Jordan,Melaka,0,0,0
1/03/2023,Jordan,Perlis,1,1,0
1/03/2023,Jordan,Pulau Pinang,5,4,1
1/03/2023,Jordan,Sabah,0,0,0
1/03/2023,Jordan,Sarawak,0,0,0
1/03/2023,Jordan,Selangor,558,373,185
1/03/2023,Jordan,W.P. Labuan,0,0,0
1/03/2023,Japan,Johor,5620,3761,1859
1/03/2023,Japan,Kedah,282,131,151
1/03/2023,Japan,Kelantan,10,7,3
1/03/2023,Japan,Melaka,3,3,0
1/03/2023,Japan,Negeri Sembilan,0,0,0
1/03/2023,Japan,Pahang,2,1,1
1/03/2023,Japan,Perak,43,24,19
1/03/2023,Japan,Perlis,122,93,29
1/03/2023,Japan,Pulau Pinang,1021,724,297
1/03/2023,Japan,Sabah,525,250,275
1/03/2023,Japan,Sarawak,230,141,89
1/03/2023,Japan,Selangor,17959,11204,6755
1/03/2023,Japan,W.P. Labuan,17,7,10
1/03/2023,Kazakhstan,Johor,62,29,33
1/03/2023,Kazakhstan,Kedah,19,9,10
1/03/2023,Kazakhstan,Kelantan,4,0,4
1/03/2023,Kazakhstan,Melaka,0,0,0
1/03/2023,Kazakhstan,Perak,0,0,0
1/03/2023,Kazakhstan,Perlis,3,2,1
1/03/2023,Kazakhstan,Pulau Pinang,6,2,4
1/03/2023,Kazakhstan,Sabah,4,0,4
1/03/2023,Kazakhstan,Sarawak,3,1,2
1/03/2023,Kazakhstan,Selangor,719,310,409
1/03/2023,Kazakhstan,W.P. Labuan,0,0,0
1/03/2023,Kenya,Johor,253,108,145
1/03/2023,Kenya,Kedah,1,1,0
1/03/2023,Kenya,Kelantan,0,0,0
1/03/2023,Kenya,Perak,0,0,0
1/03/2023,Kenya,Perlis,0,0,0
1/03/2023,Kenya,Pulau Pinang,1,0,1
1/03/2023,Kenya,Sabah,1,1,0
1/03/2023,Kenya,Sarawak,6,4,2
1/03/2023,Kenya,Selangor,292,171,121
1/03/2023,Kyrgyzstan,Johor,17,10,7
1/03/2023,Kyrgyzstan,Kedah,2,1,1
1/03/2023,Kyrgyzstan,Kelantan,1,0,1
1/03/2023,Kyrgyzstan,Perak,0,0,0
1/03/2023,Kyrgyzstan,Perlis,0,0,0
1/03/2023,Kyrgyzstan,Pulau Pinang,1,1,0
1/03/2023,Kyrgyzstan,Sabah,0,0,0
1/03/2023,Kyrgyzstan,Sarawak,0,0,0
1/03/2023,Kyrgyzstan,Selangor,189,85,104
1/03/2023,Cambodia,Johor,2081,846,1235
1/03/2023,Cambodia,Kedah,172,108,64
1/03/2023,Cambodia,Kelantan,832,510,322
1/03/2023,Cambodia,Melaka,0,0,0
1/03/2023,Cambodia,Negeri Sembilan,0,0,0
1/03/2023,Cambodia,Pahang,0,0,0
1/03/2023,Cambodia,Perak,6,2,4
1/03/2023,Cambodia,Perlis,679,401,278
1/03/2023,Cambodia,Pulau Pinang,46,23,23
1/03/2023,Cambodia,Sabah,5,3,2
1/03/2023,Cambodia,Sarawak,6,2,4
1/03/2023,Cambodia,Selangor,3951,1790,2161
1/03/2023,Cambodia,W.P. Labuan,0,0,0
1/03/2023,Kiribati,Johor,3,3,0
1/03/2023,Kiribati,Sabah,0,0,0
1/03/2023,Kiribati,Selangor,2,2,0
1/03/2023,Saint Kitts and Nevis,Johor,28,18,10
1/03/2023,Saint Kitts and Nevis,Kedah,0,0,0
1/03/2023,Saint Kitts and Nevis,Perlis,0,0,0
1/03/2023,Saint Kitts and Nevis,Pulau Pinang,0,0,0
1/03/2023,Saint Kitts and Nevis,Sabah,1,0,1
1/03/2023,Saint Kitts and Nevis,Selangor,49,39,10
1/03/2023,Saint Kitts and Nevis,W.P. Labuan,0,0,0
1/03/2023,"Korea, Republic of",Johor,8421,4565,3856
1/03/2023,"Korea, Republic of",Kedah,258,134,124
1/03/2023,"Korea, Republic of",Kelantan,2,2,0
1/03/2023,"Korea, Republic of",Melaka,0,0,0
1/03/2023,"Korea, Republic of",Negeri Sembilan,0,0,0
1/03/2023,"Korea, Republic of",Pahang,2,1,1
1/03/2023,"Korea, Republic of",Perak,18,9,9
1/03/2023,"Korea, Republic of",Perlis,87,58,29
1/03/2023,"Korea, Republic of",Pulau Pinang,426,255,171
1/03/2023,"Korea, Republic of",Sabah,16116,6347,9769
1/03/2023,"Korea, Republic of",Sarawak,246,137,109
1/03/2023,"Korea, Republic of",Selangor,9891,5724,4167
1/03/2023,"Korea, Republic of",Terengganu,0,0,0
1/03/2023,"Korea, Republic of",W.P. Labuan,13,11,2
1/03/2023,Kuwait,Johor,7,6,1
1/03/2023,Kuwait,Kedah,3,1,2
1/03/2023,Kuwait,Kelantan,2,1,1
1/03/2023,Kuwait,Perak,0,0,0
1/03/2023,Kuwait,Perlis,0,0,0
1/03/2023,Kuwait,Pulau Pinang,1,1,0
1/03/2023,Kuwait,Sabah,0,0,0
1/03/2023,Kuwait,Sarawak,0,0,0
1/03/2023,Kuwait,Selangor,213,139,74
1/03/2023,Kuwait,W.P. Labuan,0,0,0
1/03/2023, Lao People's Democratic Republic,Johor,158,39,119
1/03/2023, Lao People's Democratic Republic,Kedah,1144,122,1022
1/03/2023, Lao People's Democratic Republic,Kelantan,346,170,176
1/03/2023, Lao People's Democratic Republic,Melaka,0,0,0
1/03/2023, Lao People's Democratic Republic,Perak,12,3,9
1/03/2023, Lao People's Democratic Republic,Perlis,220,83,137
1/03/2023, Lao People's Democratic Republic,Pulau Pinang,18,4,14
1/03/2023, Lao People's Democratic Republic,Sabah,9,5,4
1/03/2023, Lao People's Democratic Republic,Sarawak,15,6,9
1/03/2023, Lao People's Democratic Republic,Selangor,216,66,150
1/03/2023, Lao People's Democratic Republic,W.P. Labuan,0,0,0
1/03/2023,Lebanon,Johor,9,8,1
1/03/2023,Lebanon,Kedah,6,5,1
1/03/2023,Lebanon,Kelantan,0,0,0
1/03/2023,Lebanon,Pahang,0,0,0
1/03/2023,Lebanon,Perak,0,0,0
1/03/2023,Lebanon,Perlis,0,0,0
1/03/2023,Lebanon,Pulau Pinang,4,3,1
1/03/2023,Lebanon,Sabah,3,2,1
1/03/2023,Lebanon,Sarawak,1,1,0
1/03/2023,Lebanon,Selangor,201,134,67
1/03/2023,Lebanon,W.P. Labuan,0,0,0
1/03/2023,Liberia,Johor,2,2,0
1/03/2023,Liberia,Kedah,0,0,0
1/03/2023,Liberia,Sabah,0,0,0
1/03/2023,Liberia,Sarawak,0,0,0
1/03/2023,Liberia,Selangor,6,5,1
1/03/2023,Libya,Johor,2,2,0
1/03/2023,Libya,Kedah,0,0,0
1/03/2023,Libya,Perlis,0,0,0
1/03/2023,Libya,Pulau Pinang,1,1,0
1/03/2023,Libya,Sabah,0,0,0
1/03/2023,Libya,Sarawak,3,3,0
1/03/2023,Libya,Selangor,228,172,56
1/03/2023,Saint Lucia,Johor,5,5,0
1/03/2023,Saint Lucia,Kedah,0,0,0
1/03/2023,Saint Lucia,Pulau Pinang,0,0,0
1/03/2023,Saint Lucia,Sarawak,0,0,0
1/03/2023,Saint Lucia,Selangor,11,9,2
1/03/2023,Liechtenstein,Johor,1,1,0
1/03/2023,Liechtenstein,Kedah,0,0,0
1/03/2023,Liechtenstein,Perlis,0,0,0
1/03/2023,Liechtenstein,Pulau Pinang,0,0,0
1/03/2023,Liechtenstein,Sabah,0,0,0
1/03/2023,Liechtenstein,Sarawak,0,0,0
1/03/2023,Liechtenstein,Selangor,3,2,1
1/03/2023,LKA,Johor,1159,775,384
1/03/2023,LKA,Kedah,43,22,21
1/03/2023,LKA,Kelantan,0,0,0
1/03/2023,LKA,Melaka,0,0,0
1/03/2023,LKA,Pahang,0,0,0
1/03/2023,LKA,Perak,0,0,0
1/03/2023,LKA,Perlis,1,1,0
1/03/2023,LKA,Pulau Pinang,26,16,10
1/03/2023,LKA,Sabah,13,8,5
1/03/2023,LKA,Sarawak,26,14,12
1/03/2023,LKA,Selangor,3231,2243,988
1/03/2023,LKA,W.P. Labuan,0,0,0
1/03/2023,Lesotho,Johor,1,1,0
1/03/2023,Lesotho,Kedah,0,0,0
1/03/2023,Lesotho,Pulau Pinang,0,0,0
1/03/2023,Lesotho,Sarawak,0,0,0
1/03/2023,Lesotho,Selangor,4,1,3
1/03/2023,Lithuania,Johor,119,46,73
1/03/2023,Lithuania,Kedah,39,13,26
1/03/2023,Lithuania,Kelantan,0,0,0
1/03/2023,Lithuania,Pahang,0,0,0
1/03/2023,Lithuania,Perak,1,0,1
1/03/2023,Lithuania,Perlis,7,5,2
1/03/2023,Lithuania,Pulau Pinang,7,2,5
1/03/2023,Lithuania,Sabah,6,3,3
1/03/2023,Lithuania,Sarawak,42,15,27
1/03/2023,Lithuania,Selangor,447,206,241
1/03/2023,Lithuania,W.P. Labuan,0,0,0
1/03/2023,Luxembourg,Johor,6,6,0
1/03/2023,Luxembourg,Kedah,9,5,4
1/03/2023,Luxembourg,Kelantan,0,0,0
1/03/2023,Luxembourg,Perak,0,0,0
1/03/2023,Luxembourg,Perlis,1,0,1
1/03/2023,Luxembourg,Pulau Pinang,1,0,1
1/03/2023,Luxembourg,Sabah,0,0,0
1/03/2023,Luxembourg,Sarawak,0,0,0
1/03/2023,Luxembourg,Selangor,54,33,21
1/03/2023,Latvia,Johor,55,23,32
1/03/2023,Latvia,Kedah,18,8,10
1/03/2023,Latvia,Kelantan,0,0,0
1/03/2023,Latvia,Pahang,2,2,0
1/03/2023,Latvia,Perak,0,0,0
1/03/2023,Latvia,Perlis,4,2,2
1/03/2023,Latvia,Pulau Pinang,1,1,0
1/03/2023,Latvia,Sabah,9,2,7
1/03/2023,Latvia,Sarawak,61,21,40
1/03/2023,Latvia,Selangor,335,155,180
1/03/2023,Latvia,W.P. Labuan,0,0,0
1/03/2023,Macao,Johor,0,0,0
1/03/2023,Macao,Pahang,1,0,1
1/03/2023,Macao,Perak,2,1,1
1/03/2023,Macao,Selangor,0,0,0
1/03/2023,Macao,W.P. Labuan,0,0,0
1/03/2023,Morocco,Johor,68,47,21
1/03/2023,Morocco,Kedah,3,2,1
1/03/2023,Morocco,Kelantan,0,0,0
1/03/2023,Morocco,Melaka,0,0,0
1/03/2023,Morocco,Pahang,0,0,0
1/03/2023,Morocco,Perak,0,0,0
1/03/2023,Morocco,Perlis,3,3,0
1/03/2023,Morocco,Pulau Pinang,19,16,3
1/03/2023,Morocco,Sabah,5,3,2
1/03/2023,Morocco,Sarawak,12,9,3
1/03/2023,Morocco,Selangor,522,298,224
1/03/2023,Morocco,W.P. Labuan,0,0,0
1/03/2023,Monaco,Johor,0,0,0
1/03/2023,Monaco,Kedah,0,0,0
1/03/2023,Monaco,Sabah,0,0,0
1/03/2023,Monaco,Selangor,1,1,0
1/03/2023,"Moldova, Republic of",Johor,0,0,0
1/03/2023,"Moldova, Republic of",Kedah,0,0,0
1/03/2023,"Moldova, Republic of",Kelantan,0,0,0
1/03/2023,"Moldova, Republic of",Negeri Sembilan,1,1,0
1/03/2023,"Moldova, Republic of",Perlis,0,0,0
1/03/2023,"Moldova, Republic of",Pulau Pinang,1,0,1
1/03/2023,"Moldova, Republic of",Sabah,0,0,0
1/03/2023,"Moldova, Republic of",Sarawak,0,0,0
1/03/2023,"Moldova, Republic of",Selangor,35,21,14
1/03/2023,Madagascar,Johor,24,6,18
1/03/2023,Madagascar,Kedah,3,2,1
1/03/2023,Madagascar,Perak,0,0,0
1/03/2023,Madagascar,Perlis,0,0,0
1/03/2023,Madagascar,Pulau Pinang,2,1,1
1/03/2023,Madagascar,Sabah,0,0,0
1/03/2023,Madagascar,Sarawak,0,0,0
1/03/2023,Madagascar,Selangor,75,26,49
1/03/2023,Maldives,Johor,76,52,24
1/03/2023,Maldives,Kedah,1,1,0
1/03/2023,Maldives,Kelantan,0,0,0
1/03/2023,Maldives,Perak,1,1,0
1/03/2023,Maldives,Perlis,0,0,0
1/03/2023,Maldives,Pulau Pinang,5,3,2
1/03/2023,Maldives,Sabah,1,1,0
1/03/2023,Maldives,Sarawak,0,0,0
1/03/2023,Maldives,Selangor,1804,1037,767
1/03/2023,Mexico,Johor,124,58,66
1/03/2023,Mexico,Kedah,19,5,14
1/03/2023,Mexico,Kelantan,0,0,0
1/03/2023,Mexico,Pahang,0,0,0
1/03/2023,Mexico,Perak,1,1,0
1/03/2023,Mexico,Perlis,4,2,2
1/03/2023,Mexico,Pulau Pinang,20,16,4
1/03/2023,Mexico,Sabah,6,3,3
1/03/2023,Mexico,Sarawak,12,5,7
1/03/2023,Mexico,Selangor,486,262,224
1/03/2023,Mexico,W.P. Labuan,0,0,0
1/03/2023,Marshall Islands,Johor,0,0,0
1/03/2023,Marshall Islands,Kedah,0,0,0
1/03/2023,Marshall Islands,Perak,0,0,0
1/03/2023,Marshall Islands,Pulau Pinang,0,0,0
1/03/2023,Marshall Islands,Sabah,1,1,0
1/03/2023,Marshall Islands,Selangor,3,3,0
1/03/2023,North Macedonia,Johor,4,1,3
1/03/2023,North Macedonia,Kedah,0,0,0
1/03/2023,North Macedonia,Perak,0,0,0
1/03/2023,North Macedonia,Pulau Pinang,1,1,0
1/03/2023,North Macedonia,Sabah,1,0,1
1/03/2023,North Macedonia,Sarawak,1,0,1
1/03/2023,North Macedonia,Selangor,54,31,23
1/03/2023,Mali,Johor,1,1,0
1/03/2023,Mali,Sabah,0,0,0
1/03/2023,Mali,Selangor,6,5,1
1/03/2023,Malta,Johor,6,2,4
1/03/2023,Malta,Kedah,7,6,1
1/03/2023,Malta,Kelantan,0,0,0
1/03/2023,Malta,Perak,0,0,0
1/03/2023,Malta,Perlis,2,2,0
1/03/2023,Malta,Pulau Pinang,4,1,3
1/03/2023,Malta,Sabah,0,0,0
1/03/2023,Malta,Sarawak,4,3,1
1/03/2023,Malta,Selangor,44,30,14
1/03/2023,Malta,W.P. Labuan,0,0,0
1/03/2023,Myanmar,Johor,4218,1186,3032
1/03/2023,Myanmar,Kedah,66,19,47
1/03/2023,Myanmar,Kelantan,1,0,1
1/03/2023,Myanmar,Negeri Sembilan,0,0,0
1/03/2023,Myanmar,Pahang,2,0,2
1/03/2023,Myanmar,Perak,16,3,13
1/03/2023,Myanmar,Perlis,5,0,5
1/03/2023,Myanmar,Pulau Pinang,176,104,72
1/03/2023,Myanmar,Sabah,17,5,12
1/03/2023,Myanmar,Sarawak,75,36,39
1/03/2023,Myanmar,Selangor,7170,5120,2050
1/03/2023,Myanmar,Terengganu,0,0,0
1/03/2023,Myanmar,W.P. Labuan,2,1,1
1/03/2023,Montenegro,Johor,3,3,0
1/03/2023,Montenegro,Kedah,0,0,0
1/03/2023,Montenegro,Pulau Pinang,0,0,0
1/03/2023,Montenegro,Sabah,0,0,0
1/03/2023,Montenegro,Sarawak,0,0,0
1/03/2023,Montenegro,Selangor,10,10,0
1/03/2023,Mongolia,Johor,172,66,106
1/03/2023,Mongolia,Kedah,4,2,2
1/03/2023,Mongolia,Kelantan,0,0,0
1/03/2023,Mongolia,Perak,0,0,0
1/03/2023,Mongolia,Perlis,12,5,7
1/03/2023,Mongolia,Pulau Pinang,8,2,6
1/03/2023,Mongolia,Sabah,3,0,3
1/03/2023,Mongolia,Sarawak,1,1,0
1/03/2023,Mongolia,Selangor,291,117,174
1/03/2023,Northern Mariana Islands,Selangor,1,0,1
1/03/2023,Mozambique,Johor,0,0,0
1/03/2023,Mozambique,Kedah,0,0,0
1/03/2023,Mozambique,Perak,0,0,0
1/03/2023,Mozambique,Pulau Pinang,0,0,0
1/03/2023,Mozambique,Sabah,0,0,0
1/03/2023,Mozambique,Sarawak,0,0,0
1/03/2023,Mozambique,Selangor,14,5,9
1/03/2023,Mauritania,Johor,0,0,0
1/03/2023,Mauritania,Kedah,1,1,0
1/03/2023,Mauritania,Pulau Pinang,0,0,0
1/03/2023,Mauritania,Sabah,0,0,0
1/03/2023,Mauritania,Sarawak,0,0,0
1/03/2023,Mauritania,Selangor,22,20,2
1/03/2023,Mauritius,Johor,215,106,109
1/03/2023,Mauritius,Kedah,5,4,1
1/03/2023,Mauritius,Kelantan,0,0,0
1/03/2023,Mauritius,Pahang,0,0,0
1/03/2023,Mauritius,Perak,3,2,1
1/03/2023,Mauritius,Perlis,1,1,0
1/03/2023,Mauritius,Pulau Pinang,4,3,1
1/03/2023,Mauritius,Sabah,2,1,1
1/03/2023,Mauritius,Sarawak,1,1,0
1/03/2023,Mauritius,Selangor,1753,915,838
1/03/2023,Malawi,Johor,3,2,1
1/03/2023,Malawi,Pulau Pinang,0,0,0
1/03/2023,Malawi,Sabah,0,0,0
1/03/2023,Malawi,Sarawak,0,0,0
1/03/2023,Malawi,Selangor,21,9,12
1/03/2023,Mayotte,Selangor,0,0,0
1/03/2023,Namibia,Johor,1,1,0
1/03/2023,Namibia,Kedah,0,0,0
1/03/2023,Namibia,Perak,0,0,0
1/03/2023,Namibia,Perlis,0,0,0
1/03/2023,Namibia,Pulau Pinang,0,0,0
1/03/2023,Namibia,Sabah,0,0,0
1/03/2023,Namibia,Sarawak,0,0,0
1/03/2023,Namibia,Selangor,14,6,8
1/03/2023,New Caledonia,Selangor,0,0,0
1/03/2023,Niger,Johor,0,0,0
1/03/2023,Niger,Sabah,0,0,0
1/03/2023,Niger,Selangor,1,1,0
1/03/2023,Nigeria,Johor,20,18,2
1/03/2023,Nigeria,Kedah,2,0,2
1/03/2023,Nigeria,Perlis,0,0,0
1/03/2023,Nigeria,Pulau Pinang,3,3,0
1/03/2023,Nigeria,Sabah,0,0,0
1/03/2023,Nigeria,Sarawak,6,3,3
1/03/2023,Nigeria,Selangor,466,371,95
1/03/2023,Nicaragua,Johor,0,0,0
1/03/2023,Nicaragua,Kedah,0,0,0
1/03/2023,Nicaragua,Pulau Pinang,0,0,0
1/03/2023,Nicaragua,Sabah,0,0,0
1/03/2023,Nicaragua,Selangor,2,1,1
1/03/2023,Netherlands,Johor,1034,683,351
1/03/2023,Netherlands,Kedah,496,231,265
1/03/2023,Netherlands,Kelantan,4,2,2
1/03/2023,Netherlands,Melaka,2,2,0
1/03/2023,Netherlands,Negeri Sembilan,0,0,0
1/03/2023,Netherlands,Pahang,0,0,0
1/03/2023,Netherlands,Perak,18,12,6
1/03/2023,Netherlands,Perlis,37,24,13
1/03/2023,Netherlands,Pulau Pinang,247,154,93
1/03/2023,Netherlands,Sabah,73,40,33
1/03/2023,Netherlands,Sarawak,163,102,61
1/03/2023,Netherlands,Selangor,3749,2253,1496
1/03/2023,Netherlands,Terengganu,0,0,0
1/03/2023,Netherlands,W.P. Labuan,3,2,1
1/03/2023,Norway,Johor,197,129,68
1/03/2023,Norway,Kedah,90,34,56
1/03/2023,Norway,Kelantan,2,1,1
1/03/2023,Norway,Melaka,0,0,0
1/03/2023,Norway,Pahang,0,0,0
1/03/2023,Norway,Perak,1,1,0
1/03/2023,Norway,Perlis,22,9,13
1/03/2023,Norway,Pulau Pinang,28,19,9
1/03/2023,Norway,Sabah,10,6,4
1/03/2023,Norway,Sarawak,18,13,5
1/03/2023,Norway,Selangor,773,465,308
1/03/2023,Norway,W.P. Labuan,0,0,0
1/03/2023,Nepal,Johor,442,326,116
1/03/2023,Nepal,Kedah,11,8,3
1/03/2023,Nepal,Pahang,0,0,0
1/03/2023,Nepal,Perak,0,0,0
1/03/2023,Nepal,Perlis,0,0,0
1/03/2023,Nepal,Pulau Pinang,30,30,0
1/03/2023,Nepal,Sabah,7,6,1
1/03/2023,Nepal,Sarawak,341,256,85
1/03/2023,Nepal,Selangor,18301,17762,539
1/03/2023,Nepal,W.P. Labuan,66,63,3
1/03/2023,Nauru,Johor,0,0,0
1/03/2023,Nauru,Pulau Pinang,0,0,0
1/03/2023,Nauru,Selangor,0,0,0
1/03/2023,New Zealand,Johor,561,363,198
1/03/2023,New Zealand,Kedah,77,46,31
1/03/2023,New Zealand,Kelantan,5,2,3
1/03/2023,New Zealand,Melaka,0,0,0
1/03/2023,New Zealand,Negeri Sembilan,0,0,0
1/03/2023,New Zealand,Pahang,0,0,0
1/03/2023,New Zealand,Perak,18,8,10
1/03/2023,New Zealand,Perlis,20,12,8
1/03/2023,New Zealand,Pulau Pinang,141,77,64
1/03/2023,New Zealand,Sabah,55,28,27
1/03/2023,New Zealand,Sarawak,145,81,64
1/03/2023,New Zealand,Selangor,2177,1307,870
1/03/2023,New Zealand,Terengganu,2,2,0
1/03/2023,New Zealand,W.P. Labuan,4,3,1
1/03/2023,Oman,Johor,12,7,5
1/03/2023,Oman,Kedah,0,0,0
1/03/2023,Oman,Kelantan,0,0,0
1/03/2023,Oman,Melaka,0,0,0
1/03/2023,Oman,Perak,0,0,0
1/03/2023,Oman,Perlis,0,0,0
1/03/2023,Oman,Pulau Pinang,1,0,1
1/03/2023,Oman,Sabah,0,0,0
1/03/2023,Oman,Sarawak,5,2,3
1/03/2023,Oman,Selangor,458,300,158
1/03/2023,Pakistan,Johor,735,543,192
1/03/2023,Pakistan,Kedah,122,113,9
1/03/2023,Pakistan,Kelantan,11,11,0
1/03/2023,Pakistan,Melaka,0,0,0
1/03/2023,Pakistan,Negeri Sembilan,1,1,0
1/03/2023,Pakistan,Pahang,0,0,0
1/03/2023,Pakistan,Perak,28,26,2
1/03/2023,Pakistan,Perlis,34,31,3
1/03/2023,Pakistan,Pulau Pinang,67,63,4
1/03/2023,Pakistan,Sabah,14,8,6
1/03/2023,Pakistan,Sarawak,123,105,18
1/03/2023,Pakistan,Selangor,14252,13035,1217
1/03/2023,Pakistan,W.P. Labuan,2,2,0
1/03/2023,Panama,Johor,1,1,0
1/03/2023,Panama,Kedah,1,0,1
1/03/2023,Panama,Perak,0,0,0
1/03/2023,Panama,Perlis,1,1,0
1/03/2023,Panama,Pulau Pinang,1,1,0
1/03/2023,Panama,Sabah,0,0,0
1/03/2023,Panama,Sarawak,0,0,0
1/03/2023,Panama,Selangor,24,11,13
1/03/2023,Peru,Johor,27,20,7
1/03/2023,Peru,Kedah,9,4,5
1/03/2023,Peru,Kelantan,0,0,0
1/03/2023,Peru,Pahang,0,0,0
1/03/2023,Peru,Perak,0,0,0
1/03/2023,Peru,Perlis,1,1,0
1/03/2023,Peru,Pulau Pinang,4,4,0
1/03/2023,Peru,Sabah,3,1,2
1/03/2023,Peru,Sarawak,1,0,1
1/03/2023,Peru,Selangor,73,45,28
1/03/2023,Peru,W.P. Labuan,0,0,0
1/03/2023,Philippines,Johor,17453,5455,11998
1/03/2023,Philippines,Kedah,509,164,345
1/03/2023,Philippines,Kelantan,19,13,6
1/03/2023,Philippines,Melaka,1,0,1
1/03/2023,Philippines,Negeri Sembilan,0,0,0
1/03/2023,Philippines,Pahang,10,10,0
1/03/2023,Philippines,Perak,53,8,45
1/03/2023,Philippines,Perlis,62,21,41
1/03/2023,Philippines,Pulau Pinang,523,207,316
1/03/2023,Philippines,Sabah,1589,732,857
1/03/2023,Philippines,Sarawak,2289,893,1396
1/03/2023,Philippines,Selangor,14815,5807,9008
1/03/2023,Philippines,Terengganu,1,1,0
1/03/2023,Philippines,W.P. Labuan,104,37,67
1/03/2023,Palau,Johor,0,0,0
1/03/2023,Palau,Pulau Pinang,1,1,0
1/03/2023,Palau,Selangor,0,0,0
1/03/2023,Papua New Guinea,Johor,16,6,10
1/03/2023,Papua New Guinea,Kedah,0,0,0
1/03/2023,Papua New Guinea,Kelantan,0,0,0
1/03/2023,Papua New Guinea,Perak,0,0,0
1/03/2023,Papua New Guinea,Pulau Pinang,0,0,0
1/03/2023,Papua New Guinea,Sabah,1,1,0
1/03/2023,Papua New Guinea,Sarawak,7,5,2
1/03/2023,Papua New Guinea,Selangor,81,45,36
1/03/2023,Poland,Johor,513,255,258
1/03/2023,Poland,Kedah,248,124,124
1/03/2023,Poland,Kelantan,2,0,2
1/03/2023,Poland,Melaka,0,0,0
1/03/2023,Poland,Negeri Sembilan,0,0,0
1/03/2023,Poland,Pahang,0,0,0
1/03/2023,Poland,Perak,4,1,3
1/03/2023,Poland,Perlis,31,21,10
1/03/2023,Poland,Pulau Pinang,71,36,35
1/03/2023,Poland,Sabah,64,39,25
1/03/2023,Poland,Sarawak,56,26,30
1/03/2023,Poland,Selangor,1379,734,645
1/03/2023,Poland,Terengganu,0,0,0
1/03/2023,Poland,W.P. Labuan,1,1,0
1/03/2023,"North Korea, Democratic People's Republic of",Selangor,0,0,0
1/03/2023,Portugal,Johor,144,83,61
1/03/2023,Portugal,Kedah,80,38,42
1/03/2023,Portugal,Kelantan,0,0,0
1/03/2023,Portugal,Melaka,0,0,0
1/03/2023,Portugal,Pahang,0,0,0
1/03/2023,Portugal,Perak,3,2,1
1/03/2023,Portugal,Perlis,12,7,5
1/03/2023,Portugal,Pulau Pinang,47,21,26
1/03/2023,Portugal,Sabah,12,8,4
1/03/2023,Portugal,Sarawak,11,7,4
1/03/2023,Portugal,Selangor,580,346,234
1/03/2023,Portugal,W.P. Labuan,0,0,0
1/03/2023,Paraguay,Johor,3,0,3
1/03/2023,Paraguay,Kedah,0,0,0
1/03/2023,Paraguay,Perak,0,0,0
1/03/2023,Paraguay,Perlis,0,0,0
1/03/2023,Paraguay,Pulau Pinang,0,0,0
1/03/2023,Paraguay,Sabah,0,0,0
1/03/2023,Paraguay,Sarawak,0,0,0
1/03/2023,Paraguay,Selangor,11,5,6
1/03/2023,"Palestine, State of",Johor,27,26,1
1/03/2023,"Palestine, State of",Kedah,0,0,0
1/03/2023,"Palestine, State of",Kelantan,0,0,0
1/03/2023,"Palestine, State of",Melaka,0,0,0
1/03/2023,"Palestine, State of",Perak,0,0,0
1/03/2023,"Palestine, State of",Perlis,0,0,0
1/03/2023,"Palestine, State of",Pulau Pinang,0,0,0
1/03/2023,"Palestine, State of",Sabah,0,0,0
1/03/2023,"Palestine, State of",Sarawak,0,0,0
1/03/2023,"Palestine, State of",Selangor,249,204,45
1/03/2023,Qatar,Johor,4,3,1
1/03/2023,Qatar,Kedah,1,1,0
1/03/2023,Qatar,Perlis,0,0,0
1/03/2023,Qatar,Pulau Pinang,0,0,0
1/03/2023,Qatar,Sabah,0,0,0
1/03/2023,Qatar,Sarawak,1,1,0
1/03/2023,Qatar,Selangor,89,50,39
1/03/2023,Réunion,Johor,0,0,0
1/03/2023,Réunion,Sarawak,0,0,0
1/03/2023,Romania,Johor,158,86,72
1/03/2023,Romania,Kedah,28,12,16
1/03/2023,Romania,Kelantan,0,0,0
1/03/2023,Romania,Negeri Sembilan,0,0,0
1/03/2023,Romania,Pahang,0,0,0
1/03/2023,Romania,Perak,0,0,0
1/03/2023,Romania,Perlis,8,3,5
1/03/2023,Romania,Pulau Pinang,18,9,9
1/03/2023,Romania,Sabah,29,19,10
1/03/2023,Romania,Sarawak,14,13,1
1/03/2023,Romania,Selangor,647,344,303
1/03/2023,Romania,W.P. Labuan,0,0,0
1/03/2023,Russian Federation (Russia),Johor,434,216,218
1/03/2023,Russian Federation (Russia),Kedah,694,355,339
1/03/2023,Russian Federation (Russia),Kelantan,70,36,34
1/03/2023,Russian Federation (Russia),Melaka,0,0,0
1/03/2023,Russian Federation (Russia),Negeri Sembilan,0,0,0
1/03/2023,Russian Federation (Russia),Pahang,1,1,0
1/03/2023,Russian Federation (Russia),Perak,3,1,2
1/03/2023,Russian Federation (Russia),Perlis,489,279,210
1/03/2023,Russian Federation (Russia),Pulau Pinang,221,111,110
1/03/2023,Russian Federation (Russia),Sabah,54,23,31
1/03/2023,Russian Federation (Russia),Sarawak,78,39,39
1/03/2023,Russian Federation (Russia),Selangor,14201,7235,6966
1/03/2023,Russian Federation (Russia),W.P. Labuan,2,1,1
1/03/2023,Rwanda,Johor,0,0,0
1/03/2023,Rwanda,Kedah,0,0,0
1/03/2023,Rwanda,Pulau Pinang,0,0,0
1/03/2023,Rwanda,Selangor,9,7,2
1/03/2023,Saudi Arabia,Johor,105,65,40
1/03/2023,Saudi Arabia,Kedah,24,12,12
1/03/2023,Saudi Arabia,Kelantan,1,1,0
1/03/2023,Saudi Arabia,Melaka,0,0,0
1/03/2023,Saudi Arabia,Perak,0,0,0
1/03/2023,Saudi Arabia,Perlis,3,3,0
1/03/2023,Saudi Arabia,Pulau Pinang,22,10,12
1/03/2023,Saudi Arabia,Sabah,1,1,0
1/03/2023,Saudi Arabia,Sarawak,7,7,0
1/03/2023,Saudi Arabia,Selangor,2328,1291,1037
1/03/2023,Saudi Arabia,W.P. Labuan,0,0,0
1/03/2023,Sudan,Johor,5,5,0
1/03/2023,Sudan,Kedah,4,1,3
1/03/2023,Sudan,Kelantan,0,0,0
1/03/2023,Sudan,Perlis,2,2,0
1/03/2023,Sudan,Pulau Pinang,1,1,0
1/03/2023,Sudan,Sabah,0,0,0
1/03/2023,Sudan,Sarawak,11,6,5
1/03/2023,Sudan,Selangor,925,567,358
1/03/2023,Sudan,W.P. Labuan,0,0,0
1/03/2023,Senegal,Johor,3,0,3
1/03/2023,Senegal,Kedah,0,0,0
1/03/2023,Senegal,Kelantan,0,0,0
1/03/2023,Senegal,Perak,0,0,0
1/03/2023,Senegal,Perlis,0,0,0
1/03/2023,Senegal,Pulau Pinang,0,0,0
1/03/2023,Senegal,Sabah,0,0,0
1/03/2023,Senegal,Sarawak,0,0,0
1/03/2023,Senegal,Selangor,48,37,11
1/03/2023,Singapore,Johor,1059355,604758,454597
1/03/2023,Singapore,Kedah,3602,1985,1617
1/03/2023,Singapore,Kelantan,76,56,20
1/03/2023,Singapore,Melaka,18,11,7
1/03/2023,Singapore,Negeri Sembilan,0,0,0
1/03/2023,Singapore,Pahang,194,96,98
1/03/2023,Singapore,Perak,6743,3165,3578
1/03/2023,Singapore,Perlis,239,140,99
1/03/2023,Singapore,Pulau Pinang,17485,8836,8649
1/03/2023,Singapore,Sabah,3829,1942,1887
1/03/2023,Singapore,Sarawak,5212,2778,2434
1/03/2023,Singapore,Selangor,43708,23088,20620
1/03/2023,Singapore,Terengganu,2,2,0
1/03/2023,Singapore,W.P. Labuan,10,10,0
1/03/2023,South Georgia and the South Sandwich Islands,Johor,0,0,0
1/03/2023,South Georgia and the South Sandwich Islands,Sabah,0,0,0
1/03/2023,South Georgia and the South Sandwich Islands,Selangor,0,0,0
1/03/2023,Saint Helena,Sarawak,0,0,0
1/03/2023,Solomon Islands,Johor,0,0,0
1/03/2023,Solomon Islands,Perlis,0,0,0
1/03/2023,Solomon Islands,Pulau Pinang,0,0,0
1/03/2023,Solomon Islands,Sabah,0,0,0
1/03/2023,Solomon Islands,Sarawak,4,1,3
1/03/2023,Solomon Islands,Selangor,5,2,3
1/03/2023,Solomon Islands,W.P. Labuan,0,0,0
1/03/2023,Sierra Leone,Johor,3,3,0
1/03/2023,Sierra Leone,Kedah,0,0,0
1/03/2023,Sierra Leone,Perak,0,0,0
1/03/2023,Sierra Leone,Pulau Pinang,0,0,0
1/03/2023,Sierra Leone,Sabah,0,0,0
1/03/2023,Sierra Leone,Selangor,23,17,6
1/03/2023,El Salvador,Johor,4,1,3
1/03/2023,El Salvador,Kedah,0,0,0
1/03/2023,El Salvador,Perak,0,0,0
1/03/2023,El Salvador,Perlis,1,1,0
1/03/2023,El Salvador,Pulau Pinang,1,1,0
1/03/2023,El Salvador,Sabah,2,2,0
1/03/2023,El Salvador,Selangor,10,6,4
1/03/2023,El Salvador,W.P. Labuan,0,0,0
1/03/2023,San Marino,Johor,0,0,0
1/03/2023,San Marino,Selangor,1,1,0
1/03/2023,Somalia,Johor,0,0,0
1/03/2023,Somalia,Kedah,0,0,0
1/03/2023,Somalia,Kelantan,1,0,1
1/03/2023,Somalia,Perlis,0,0,0
1/03/2023,Somalia,Sabah,0,0,0
1/03/2023,Somalia,Sarawak,0,0,0
1/03/2023,Somalia,Selangor,250,163,87
1/03/2023,Serbia,Johor,16,12,4
1/03/2023,Serbia,Kedah,12,8,4
1/03/2023,Serbia,Kelantan,0,0,0
1/03/2023,Serbia,Pahang,0,0,0
1/03/2023,Serbia,Perak,0,0,0
1/03/2023,Serbia,Perlis,0,0,0
1/03/2023,Serbia,Pulau Pinang,1,0,1
1/03/2023,Serbia,Sabah,0,0,0
1/03/2023,Serbia,Sarawak,1,0,1
1/03/2023,Serbia,Selangor,56,35,21
1/03/2023,South Sudan,Johor,1,1,0
1/03/2023,South Sudan,Kedah,0,0,0
1/03/2023,South Sudan,Sarawak,2,2,0
1/03/2023,South Sudan,Selangor,36,18,18
1/03/2023,South Sudan,W.P. Labuan,0,0,0
1/03/2023,Sao Tome and Principe,Selangor,2,1,1
1/03/2023,Suriname,Johor,6,2,4
1/03/2023,Suriname,Kedah,0,0,0
1/03/2023,Suriname,Kelantan,0,0,0
1/03/2023,Suriname,Perak,0,0,0
1/03/2023,Suriname,Perlis,1,1,0
1/03/2023,Suriname,Pulau Pinang,1,1,0
1/03/2023,Suriname,Sabah,0,0,0
1/03/2023,Suriname,Sarawak,0,0,0
1/03/2023,Suriname,Selangor,8,6,2
1/03/2023,Slovakia,Johor,65,39,26
1/03/2023,Slovakia,Kedah,100,57,43
1/03/2023,Slovakia,Kelantan,3,2,1
1/03/2023,Slovakia,Negeri Sembilan,0,0,0
1/03/2023,Slovakia,Pahang,0,0,0
1/03/2023,Slovakia,Perak,1,1,0
1/03/2023,Slovakia,Perlis,9,8,1
1/03/2023,Slovakia,Pulau Pinang,10,7,3
1/03/2023,Slovakia,Sabah,10,3,7
1/03/2023,Slovakia,Sarawak,6,6,0
1/03/2023,Slovakia,Selangor,351,188,163
1/03/2023,Slovakia,W.P. Labuan,10,6,4
1/03/2023,Slovenia,Johor,20,10,10
1/03/2023,Slovenia,Kedah,21,12,9
1/03/2023,Slovenia,Kelantan,0,0,0
1/03/2023,Slovenia,Perak,0,0,0
1/03/2023,Slovenia,Perlis,2,2,0
1/03/2023,Slovenia,Pulau Pinang,9,2,7
1/03/2023,Slovenia,Sabah,3,1,2
1/03/2023,Slovenia,Sarawak,0,0,0
1/03/2023,Slovenia,Selangor,119,64,55
1/03/2023,Slovenia,W.P. Labuan,0,0,0
1/03/2023,Sweden,Johor,249,139,110
1/03/2023,Sweden,Kedah,348,154,194
1/03/2023,Sweden,Kelantan,8,5,3
1/03/2023,Sweden,Melaka,0,0,0
1/03/2023,Sweden,Negeri Sembilan,0,0,0
1/03/2023,Sweden,Pahang,0,0,0
1/03/2023,Sweden,Perak,8,7,1
1/03/2023,Sweden,Perlis,30,21,9
1/03/2023,Sweden,Pulau Pinang,65,47,18
1/03/2023,Sweden,Sabah,39,20,19
1/03/2023,Sweden,Sarawak,23,18,5
1/03/2023,Sweden,Selangor,1388,833,555
1/03/2023,Sweden,W.P. Labuan,1,0,1
1/03/2023,Eswatini,Johor,0,0,0
1/03/2023,Eswatini,Kedah,0,0,0
1/03/2023,Eswatini,Pulau Pinang,0,0,0
1/03/2023,Eswatini,Sabah,0,0,0
1/03/2023,Eswatini,Selangor,11,2,9
1/03/2023,Seychelles,Johor,3,2,1
1/03/2023,Seychelles,Kedah,0,0,0
1/03/2023,Seychelles,Pulau Pinang,0,0,0
1/03/2023,Seychelles,Sabah,0,0,0
1/03/2023,Seychelles,Sarawak,0,0,0
1/03/2023,Seychelles,Selangor,61,23,38
1/03/2023,Syrian Arab Republic,Johor,9,6,3
1/03/2023,Syrian Arab Republic,Kedah,0,0,0
1/03/2023,Syrian Arab Republic,Kelantan,0,0,0
1/03/2023,Syrian Arab Republic,Pahang,0,0,0
1/03/2023,Syrian Arab Republic,Perlis,1,1,0
1/03/2023,Syrian Arab Republic,Pulau Pinang,1,1,0
1/03/2023,Syrian Arab Republic,Sabah,0,0,0
1/03/2023,Syrian Arab Republic,Sarawak,2,2,0
1/03/2023,Syrian Arab Republic,Selangor,561,405,156
1/03/2023,Syrian Arab Republic,W.P. Labuan,0,0,0
1/03/2023,Turks and Caicos Islands,Perlis,0,0,0
1/03/2023,TCD,Johor,2,2,0
1/03/2023,TCD,Kedah,2,2,0
1/03/2023,TCD,Perlis,1,1,0
1/03/2023,TCD,Selangor,27,17,10
1/03/2023,Togo,Johor,2,2,0
1/03/2023,Togo,Perak,0,0,0
1/03/2023,Togo,Pulau Pinang,0,0,0
1/03/2023,Togo,Selangor,8,8,0
1/03/2023,Thailand,Johor,7143,2179,4964
1/03/2023,Thailand,Kedah,78894,46381,32513
1/03/2023,Thailand,Kelantan,56877,28776,28101
1/03/2023,Thailand,Melaka,35,24,11
1/03/2023,Thailand,Negeri Sembilan,1,1,0
1/03/2023,Thailand,Pahang,2,1,1
1/03/2023,Thailand,Perak,12610,5880,6730
1/03/2023,Thailand,Perlis,65383,39899,25484
1/03/2023,Thailand,Pulau Pinang,2231,925,1306
1/03/2023,Thailand,Sabah,216,82,134
1/03/2023,Thailand,Sarawak,389,144,245
1/03/2023,Thailand,Selangor,13308,5196,8112
1/03/2023,Thailand,Terengganu,2,2,0
1/03/2023,Thailand,W.P. Labuan,2,2,0
1/03/2023,Tajikistan,Johor,1,1,0
1/03/2023,Tajikistan,Kedah,0,0,0
1/03/2023,Tajikistan,Perlis,0,0,0
1/03/2023,Tajikistan,Pulau Pinang,0,0,0
1/03/2023,Tajikistan,Sabah,0,0,0
1/03/2023,Tajikistan,Selangor,105,65,40
1/03/2023,Tokelau,Selangor,0,0,0
1/03/2023,Turkmenistan,Johor,0,0,0
1/03/2023,Turkmenistan,Kedah,2,1,1
1/03/2023,Turkmenistan,Kelantan,0,0,0
1/03/2023,Turkmenistan,Perlis,0,0,0
1/03/2023,Turkmenistan,Pulau Pinang,0,0,0
1/03/2023,Turkmenistan,Sabah,0,0,0
1/03/2023,Turkmenistan,Sarawak,2,2,0
1/03/2023,Turkmenistan,Selangor,109,78,31
1/03/2023,Timor-Leste,Johor,6,6,0
1/03/2023,Timor-Leste,Kedah,0,0,0
1/03/2023,Timor-Leste,Perlis,0,0,0
1/03/2023,Timor-Leste,Pulau Pinang,7,2,5
1/03/2023,Timor-Leste,Sabah,0,0,0
1/03/2023,Timor-Leste,Sarawak,0,0,0
1/03/2023,Timor-Leste,Selangor,190,113,77
1/03/2023,Tonga,Johor,0,0,0
1/03/2023,Tonga,Pulau Pinang,0,0,0
1/03/2023,Tonga,Sarawak,0,0,0
1/03/2023,Tonga,Selangor,11,4,7
1/03/2023,Trinidad and Tobago,Johor,4,3,1
1/03/2023,Trinidad and Tobago,Kedah,0,0,0
1/03/2023,Trinidad and Tobago,Pahang,0,0,0
1/03/2023,Trinidad and Tobago,Pulau Pinang,0,0,0
1/03/2023,Trinidad and Tobago,Sabah,0,0,0
1/03/2023,Trinidad and Tobago,Sarawak,4,3,1
1/03/2023,Trinidad and Tobago,Selangor,25,19,6
1/03/2023,Tunisia,Johor,14,9,5
1/03/2023,Tunisia,Kedah,6,4,2
1/03/2023,Tunisia,Kelantan,1,1,0
1/03/2023,Tunisia,Melaka,0,0,0
1/03/2023,Tunisia,Perak,0,0,0
1/03/2023,Tunisia,Perlis,0,0,0
1/03/2023,Tunisia,Pulau Pinang,3,2,1
1/03/2023,Tunisia,Sabah,0,0,0
1/03/2023,Tunisia,Sarawak,1,1,0
1/03/2023,Tunisia,Selangor,339,197,142
1/03/2023,Tunisia,W.P. Labuan,0,0,0
1/03/2023,Türkiye,Johor,247,182,65
1/03/2023,Türkiye,Kedah,46,35,11
1/03/2023,Türkiye,Kelantan,6,4,2
1/03/2023,Türkiye,Melaka,0,0,0
1/03/2023,Türkiye,Negeri Sembilan,0,0,0
1/03/2023,Türkiye,Pahang,0,0,0
1/03/2023,Türkiye,Perak,1,0,1
1/03/2023,Türkiye,Perlis,18,16,2
1/03/2023,Türkiye,Pulau Pinang,47,33,14
1/03/2023,Türkiye,Sabah,5,3,2
1/03/2023,Türkiye,Sarawak,18,10,8
1/03/2023,Türkiye,Selangor,1300,935,365
1/03/2023,Türkiye,W.P. Labuan,1,1,0
1/03/2023,Tuvalu,Selangor,0,0,0
1/03/2023,"Taiwan, Province of China",Johor,3971,1698,2273
1/03/2023,"Taiwan, Province of China",Kedah,117,65,52
1/03/2023,"Taiwan, Province of China",Kelantan,5,3,2
1/03/2023,"Taiwan, Province of China",Melaka,3,1,2
1/03/2023,"Taiwan, Province of China",Negeri Sembilan,0,0,0
1/03/2023,"Taiwan, Province of China",Pahang,1,0,1
1/03/2023,"Taiwan, Province of China",Perak,40,20,20
1/03/2023,"Taiwan, Province of China",Perlis,10,6,4
1/03/2023,"Taiwan, Province of China",Pulau Pinang,2738,1419,1319
1/03/2023,"Taiwan, Province of China",Sabah,1019,486,533
1/03/2023,"Taiwan, Province of China",Sarawak,323,138,185
1/03/2023,"Taiwan, Province of China",Selangor,10593,5326,5267
1/03/2023,"Taiwan, Province of China",W.P. Labuan,5,3,2
1/03/2023,"Tanzania, United Republic of",Johor,17,7,10
1/03/2023,"Tanzania, United Republic of",Kedah,0,0,0
1/03/2023,"Tanzania, United Republic of",Perak,1,1,0
1/03/2023,"Tanzania, United Republic of",Perlis,0,0,0
1/03/2023,"Tanzania, United Republic of",Pulau Pinang,0,0,0
1/03/2023,"Tanzania, United Republic of",Sabah,0,0,0
1/03/2023,"Tanzania, United Republic of",Sarawak,6,6,0
1/03/2023,"Tanzania, United Republic of",Selangor,106,55,51
1/03/2023,Uganda,Johor,15,9,6
1/03/2023,Uganda,Kedah,2,1,1
1/03/2023,Uganda,Perak,0,0,0
1/03/2023,Uganda,Perlis,0,0,0
1/03/2023,Uganda,Pulau Pinang,1,0,1
1/03/2023,Uganda,Sabah,0,0,0
1/03/2023,Uganda,Sarawak,1,1,0
1/03/2023,Uganda,Selangor,67,30,37
1/03/2023,Ukraine,Johor,114,63,51
1/03/2023,Ukraine,Kedah,55,29,26
1/03/2023,Ukraine,Kelantan,2,1,1
1/03/2023,Ukraine,Melaka,0,0,0
1/03/2023,Ukraine,Negeri Sembilan,0,0,0
1/03/2023,Ukraine,Pahang,3,3,0
1/03/2023,Ukraine,Perak,0,0,0
1/03/2023,Ukraine,Perlis,9,6,3
1/03/2023,Ukraine,Pulau Pinang,17,10,7
1/03/2023,Ukraine,Sabah,9,2,7
1/03/2023,Ukraine,Sarawak,7,7,0
1/03/2023,Ukraine,Selangor,1193,540,653
1/03/2023,Ukraine,W.P. Labuan,9,2,7
1/03/2023,Uruguay,Johor,58,17,41
1/03/2023,Uruguay,Kedah,2,0,2
1/03/2023,Uruguay,Kelantan,0,0,0
1/03/2023,Uruguay,Perak,0,0,0
1/03/2023,Uruguay,Perlis,0,0,0
1/03/2023,Uruguay,Pulau Pinang,0,0,0
1/03/2023,Uruguay,Sabah,2,1,1
1/03/2023,Uruguay,Sarawak,0,0,0
1/03/2023,Uruguay,Selangor,131,56,75
1/03/2023,Uruguay,W.P. Labuan,0,0,0
1/03/2023,United States of America,Johor,4316,2512,1804
1/03/2023,United States of America,Kedah,579,304,275
1/03/2023,United States of America,Kelantan,11,10,1
1/03/2023,United States of America,Melaka,8,6,2
1/03/2023,United States of America,Negeri Sembilan,0,0,0
1/03/2023,United States of America,Pahang,0,0,0
1/03/2023,United States of America,Perak,110,67,43
1/03/2023,United States of America,Perlis,142,94,48
1/03/2023,United States of America,Pulau Pinang,1870,1094,776
1/03/2023,United States of America,Sabah,565,291,274
1/03/2023,United States of America,Sarawak,423,233,190
1/03/2023,United States of America,Selangor,13532,7999,5533
1/03/2023,United States of America,Terengganu,0,0,0
1/03/2023,United States of America,W.P. Labuan,14,12,2
1/03/2023,Uzbekistan,Johor,99,79,20
1/03/2023,Uzbekistan,Kedah,9,5,4
1/03/2023,Uzbekistan,Kelantan,0,0,0
1/03/2023,Uzbekistan,Perak,1,1,0
1/03/2023,Uzbekistan,Perlis,5,4,1
1/03/2023,Uzbekistan,Pulau Pinang,12,5,7
1/03/2023,Uzbekistan,Sabah,4,4,0
1/03/2023,Uzbekistan,Sarawak,0,0,0
1/03/2023,Uzbekistan,Selangor,1356,818,538
1/03/2023,Holy See,Johor,0,0,0
1/03/2023,Holy See,Sarawak,0,0,0
1/03/2023,Holy See,Selangor,0,0,0
1/03/2023,Saint Vincent and the Grenadines,Johor,0,0,0
1/03/2023,Saint Vincent and the Grenadines,Kedah,0,0,0
1/03/2023,Saint Vincent and the Grenadines,Pulau Pinang,0,0,0
1/03/2023,Saint Vincent and the Grenadines,Sarawak,2,2,0
1/03/2023,Saint Vincent and the Grenadines,Selangor,2,2,0
1/03/2023,"Venezuela, Bolivarian Republic of",Johor,7,2,5
1/03/2023,"Venezuela, Bolivarian Republic of",Kedah,5,2,3
1/03/2023,"Venezuela, Bolivarian Republic of",Kelantan,0,0,0
1/03/2023,"Venezuela, Bolivarian Republic of",Melaka,0,0,0
1/03/2023,"Venezuela, Bolivarian Republic of",Perak,0,0,0
1/03/2023,"Venezuela, Bolivarian Republic of",Perlis,0,0,0
1/03/2023,"Venezuela, Bolivarian Republic of",Pulau Pinang,1,0,1
1/03/2023,"Venezuela, Bolivarian Republic of",Sabah,3,1,2
1/03/2023,"Venezuela, Bolivarian Republic of",Sarawak,5,5,0
1/03/2023,"Venezuela, Bolivarian Republic of",Selangor,73,44,29
1/03/2023,"Venezuela, Bolivarian Republic of",W.P. Labuan,0,0,0
1/03/2023,Viet Nam,Johor,13546,4103,9443
1/03/2023,Viet Nam,Kedah,296,40,256
1/03/2023,Viet Nam,Kelantan,10,5,5
1/03/2023,Viet Nam,Melaka,0,0,0
1/03/2023,Viet Nam,Negeri Sembilan,0,0,0
1/03/2023,Viet Nam,Pahang,0,0,0
1/03/2023,Viet Nam,Perak,112,14,98
1/03/2023,Viet Nam,Perlis,269,18,251
1/03/2023,Viet Nam,Pulau Pinang,1423,445,978
1/03/2023,Viet Nam,Sabah,33,8,25
1/03/2023,Viet Nam,Sarawak,203,42,161
1/03/2023,Viet Nam,Selangor,18317,6156,12161
1/03/2023,Viet Nam,Terengganu,0,0,0
1/03/2023,Viet Nam,W.P. Labuan,0,0,0
1/03/2023,Vanuatu,Johor,41,25,16
1/03/2023,Vanuatu,Kedah,1,1,0
1/03/2023,Vanuatu,Pulau Pinang,6,4,2
1/03/2023,Vanuatu,Sabah,0,0,0
1/03/2023,Vanuatu,Sarawak,0,0,0
1/03/2023,Vanuatu,Selangor,64,52,12
1/03/2023, Samoa,Johor,0,0,0
1/03/2023, Samoa,Sarawak,0,0,0
1/03/2023, Samoa,Selangor,6,3,3
1/03/2023,Yemen,Johor,36,26,10
1/03/2023,Yemen,Kedah,11,10,1
1/03/2023,Yemen,Kelantan,1,0,1
1/03/2023,Yemen,Melaka,1,1,0
1/03/2023,Yemen,Pahang,0,0,0
1/03/2023,Yemen,Perak,0,0,0
1/03/2023,Yemen,Perlis,0,0,0
1/03/2023,Yemen,Pulau Pinang,2,1,1
1/03/2023,Yemen,Sabah,2,2,0
1/03/2023,Yemen,Sarawak,5,3,2
1/03/2023,Yemen,Selangor,962,714,248
1/03/2023,Yemen,W.P. Labuan,0,0,0
1/03/2023,South Africa,Johor,242,148,94
1/03/2023,South Africa,Kedah,46,29,17
1/03/2023,South Africa,Kelantan,3,3,0
1/03/2023,South Africa,Melaka,0,0,0
1/03/2023,South Africa,Pahang,0,0,0
1/03/2023,South Africa,Perak,1,1,0
1/03/2023,South Africa,Perlis,8,5,3
1/03/2023,South Africa,Pulau Pinang,31,19,12
1/03/2023,South Africa,Sabah,22,10,12
1/03/2023,South Africa,Sarawak,96,51,45
1/03/2023,South Africa,Selangor,735,436,299
1/03/2023,South Africa,Terengganu,1,1,0
1/03/2023,South Africa,W.P. Labuan,0,0,0
1/03/2023,ZAR,Selangor,0,0,0
1/03/2023,Zambia,Johor,4,3,1
1/03/2023,Zambia,Kedah,1,1,0
1/03/2023,Zambia,Perak,0,0,0
1/03/2023,Zambia,Perlis,0,0,0
1/03/2023,Zambia,Pulau Pinang,1,1,0
1/03/2023,Zambia,Sabah,0,0,0
1/03/2023,Zambia,Sarawak,2,1,1
1/03/2023,Zambia,Selangor,56,29,27
1/03/2023,Zimbabwe,Johor,8,2,6
1/03/2023,Zimbabwe,Kedah,4,1,3
1/03/2023,Zimbabwe,Kelantan,0,0,0
1/03/2023,Zimbabwe,Perak,0,0,0
1/03/2023,Zimbabwe,Perlis,3,2,1
1/03/2023,Zimbabwe,Pulau Pinang,1,0,1
1/03/2023,Zimbabwe,Sabah,0,0,0
1/03/2023,Zimbabwe,Sarawak,3,3,0
1/03/2023,Zimbabwe,Selangor,102,44,58
1/04/2023,Aruba,Kedah,0,0,0
1/04/2023,Aruba,Pulau Pinang,0,0,0
1/04/2023,Afghanistan,Johor,2,2,0
1/04/2023,Afghanistan,Kedah,1,1,0
1/04/2023,Afghanistan,Perlis,0,0,0
1/04/2023,Afghanistan,Pulau Pinang,0,0,0
1/04/2023,Afghanistan,Sarawak,1,1,0
1/04/2023,Afghanistan,Selangor,31,23,8
1/04/2023,Angola,Johor,2,0,2
1/04/2023,Angola,Kedah,0,0,0
1/04/2023,Angola,Sabah,0,0,0
1/04/2023,Angola,Selangor,0,0,0
1/04/2023,Anguilla,Selangor,0,0,0
1/04/2023,Albania,Johor,14,13,1
1/04/2023,Albania,Kedah,1,1,0
1/04/2023,Albania,Perak,0,0,0
1/04/2023,Albania,Perlis,1,1,0
1/04/2023,Albania,Pulau Pinang,1,1,0
1/04/2023,Albania,Sabah,1,1,0
1/04/2023,Albania,Sarawak,0,0,0
1/04/2023,Albania,Selangor,27,18,9
1/04/2023,Andorra,Johor,0,0,0
1/04/2023,Andorra,Kedah,0,0,0
1/04/2023,Andorra,Perlis,0,0,0
1/04/2023,Andorra,Pulau Pinang,0,0,0
1/04/2023,Andorra,Selangor,4,2,2
1/04/2023,Antigua and Barbuda,Selangor,0,0,0
1/04/2023,United Arab Emirates,Johor,17,15,2
1/04/2023,United Arab Emirates,Kedah,1,1,0
1/04/2023,United Arab Emirates,Kelantan,0,0,0
1/04/2023,United Arab Emirates,Perak,0,0,0
1/04/2023,United Arab Emirates,Perlis,0,0,0
1/04/2023,United Arab Emirates,Pulau Pinang,1,0,1
1/04/2023,United Arab Emirates,Sabah,0,0,0
1/04/2023,United Arab Emirates,Sarawak,0,0,0
1/04/2023,United Arab Emirates,Selangor,191,110,81
1/04/2023,Argentina,Johor,54,31,23
1/04/2023,Argentina,Kedah,84,35,49
1/04/2023,Argentina,Kelantan,1,1,0
1/04/2023,Argentina,Melaka,2,1,1
1/04/2023,Argentina,Perak,0,0,0
1/04/2023,Argentina,Perlis,0,0,0
1/04/2023,Argentina,Pulau Pinang,5,4,1
1/04/2023,Argentina,Sabah,0,0,0
1/04/2023,Argentina,Sarawak,2,2,0
1/04/2023,Argentina,Selangor,375,196,179
1/04/2023,Argentina,W.P. Labuan,0,0,0
1/04/2023,Armenia,Johor,2,1,1
1/04/2023,Armenia,Kedah,0,0,0
1/04/2023,Armenia,Kelantan,0,0,0
1/04/2023,Armenia,Perak,0,0,0
1/04/2023,Armenia,Perlis,0,0,0
1/04/2023,Armenia,Pulau Pinang,3,2,1
1/04/2023,Armenia,Sabah,0,0,0
1/04/2023,Armenia,Sarawak,0,0,0
1/04/2023,Armenia,Selangor,45,31,14
1/04/2023,Antarctica,Selangor,0,0,0
1/04/2023,Antigua and Barbuda,Johor,7,4,3
1/04/2023,Antigua and Barbuda,Kedah,0,0,0
1/04/2023,Antigua and Barbuda,Pulau Pinang,0,0,0
1/04/2023,Antigua and Barbuda,Sarawak,1,1,0
1/04/2023,Antigua and Barbuda,Selangor,11,9,2
1/04/2023,Australia,Johor,6016,3378,2638
1/04/2023,Australia,Kedah,816,430,386
1/04/2023,Australia,Kelantan,12,8,4
1/04/2023,Australia,Melaka,3,1,2
1/04/2023,Australia,Negeri Sembilan,0,0,0
1/04/2023,Australia,Pahang,42,26,16
1/04/2023,Australia,Perak,223,109,114
1/04/2023,Australia,Perlis,69,42,27
1/04/2023,Australia,Pulau Pinang,1989,1089,900
1/04/2023,Australia,Sabah,610,311,299
1/04/2023,Australia,Sarawak,706,399,307
1/04/2023,Australia,Selangor,22882,12855,10027
1/04/2023,Australia,Terengganu,0,0,0
1/04/2023,Australia,W.P. Labuan,15,8,7
1/04/2023,Austria,Johor,156,97,59
1/04/2023,Austria,Kedah,76,38,38
1/04/2023,Austria,Kelantan,4,2,2
1/04/2023,Austria,Melaka,0,0,0
1/04/2023,Austria,Negeri Sembilan,0,0,0
1/04/2023,Austria,Pahang,0,0,0
1/04/2023,Austria,Perak,2,2,0
1/04/2023,Austria,Perlis,11,5,6
1/04/2023,Austria,Pulau Pinang,62,40,22
1/04/2023,Austria,Sabah,13,10,3
1/04/2023,Austria,Sarawak,11,6,5
1/04/2023,Austria,Selangor,643,393,250
1/04/2023,Austria,Terengganu,0,0,0
1/04/2023,Austria,W.P. Labuan,0,0,0
1/04/2023,Azerbaijan,Johor,3,1,2
1/04/2023,Azerbaijan,Kedah,0,0,0
1/04/2023,Azerbaijan,Kelantan,1,1,0
1/04/2023,Azerbaijan,Melaka,0,0,0
1/04/2023,Azerbaijan,Perlis,0,0,0
1/04/2023,Azerbaijan,Pulau Pinang,1,0,1
1/04/2023,Azerbaijan,Sabah,0,0,0
1/04/2023,Azerbaijan,Sarawak,4,2,2
1/04/2023,Azerbaijan,Selangor,73,37,36
1/04/2023,Azerbaijan,W.P. Labuan,0,0,0
1/04/2023,Burundi,Pulau Pinang,0,0,0
1/04/2023,Burundi,Sarawak,0,0,0
1/04/2023,Burundi,Selangor,5,3,2
1/04/2023,Belgium,Johor,230,153,77
1/04/2023,Belgium,Kedah,93,53,40
1/04/2023,Belgium,Kelantan,3,2,1
1/04/2023,Belgium,Melaka,0,0,0
1/04/2023,Belgium,Negeri Sembilan,0,0,0
1/04/2023,Belgium,Pahang,0,0,0
1/04/2023,Belgium,Perak,1,1,0
1/04/2023,Belgium,Perlis,10,6,4
1/04/2023,Belgium,Pulau Pinang,48,39,9
1/04/2023,Belgium,Sabah,16,11,5
1/04/2023,Belgium,Sarawak,15,8,7
1/04/2023,Belgium,Selangor,1025,597,428
1/04/2023,Belgium,W.P. Labuan,0,0,0
1/04/2023,Benin,Johor,2,1,1
1/04/2023,Benin,Kedah,0,0,0
1/04/2023,Benin,Perak,0,0,0
1/04/2023,Benin,Pulau Pinang,0,0,0
1/04/2023,Benin,Sabah,0,0,0
1/04/2023,Benin,Sarawak,0,0,0
1/04/2023,Benin,Selangor,9,4,5
1/04/2023,Burkina Faso,Perak,0,0,0
1/04/2023,Burkina Faso,Pulau Pinang,0,0,0
1/04/2023,Burkina Faso,Selangor,1,1,0
1/04/2023,Bangladesh,Johor,3886,3385,501
1/04/2023,Bangladesh,Kedah,96,51,45
1/04/2023,Bangladesh,Kelantan,0,0,0
1/04/2023,Bangladesh,Melaka,0,0,0
1/04/2023,Bangladesh,Negeri Sembilan,0,0,0
1/04/2023,Bangladesh,Pahang,0,0,0
1/04/2023,Bangladesh,Perak,3,2,1
1/04/2023,Bangladesh,Perlis,5,5,0
1/04/2023,Bangladesh,Pulau Pinang,260,242,18
1/04/2023,Bangladesh,Sabah,2,1,1
1/04/2023,Bangladesh,Sarawak,59,35,24
1/04/2023,Bangladesh,Selangor,38998,37421,1577
1/04/2023,Bangladesh,W.P. Labuan,2,2,0
1/04/2023,Bulgaria,Johor,41,24,17
1/04/2023,Bulgaria,Kedah,8,3,5
1/04/2023,Bulgaria,Kelantan,0,0,0
1/04/2023,Bulgaria,Pahang,0,0,0
1/04/2023,Bulgaria,Perak,0,0,0
1/04/2023,Bulgaria,Perlis,2,2,0
1/04/2023,Bulgaria,Pulau Pinang,8,5,3
1/04/2023,Bulgaria,Sabah,2,0,2
1/04/2023,Bulgaria,Sarawak,4,2,2
1/04/2023,Bulgaria,Selangor,269,143,126
1/04/2023,Bulgaria,W.P. Labuan,0,0,0
1/04/2023,Bahrain,Johor,1,1,0
1/04/2023,Bahrain,Kedah,3,1,2
1/04/2023,Bahrain,Kelantan,0,0,0
1/04/2023,Bahrain,Perlis,0,0,0
1/04/2023,Bahrain,Pulau Pinang,1,1,0
1/04/2023,Bahrain,Sabah,0,0,0
1/04/2023,Bahrain,Sarawak,1,1,0
1/04/2023,Bahrain,Selangor,54,34,20
1/04/2023,Bahamas,Johor,0,0,0
1/04/2023,Bahamas,Kedah,0,0,0
1/04/2023,Bahamas,Perak,0,0,0
1/04/2023,Bahamas,Sabah,0,0,0
1/04/2023,Bahamas,Sarawak,0,0,0
1/04/2023,Bahamas,Selangor,4,2,2
1/04/2023,Bosnia and Herzegovina,Johor,17,8,9
1/04/2023,Bosnia and Herzegovina,Kedah,0,0,0
1/04/2023,Bosnia and Herzegovina,Perlis,0,0,0
1/04/2023,Bosnia and Herzegovina,Pulau Pinang,0,0,0
1/04/2023,Bosnia and Herzegovina,Sabah,1,0,1
1/04/2023,Bosnia and Herzegovina,Sarawak,1,1,0
1/04/2023,Bosnia and Herzegovina,Selangor,40,24,16
1/04/2023,Belarus,Johor,10,2,8
1/04/2023,Belarus,Kedah,12,6,6
1/04/2023,Belarus,Kelantan,8,5,3
1/04/2023,Belarus,Pahang,0,0,0
1/04/2023,Belarus,Perak,0,0,0
1/04/2023,Belarus,Perlis,2,1,1
1/04/2023,Belarus,Pulau Pinang,3,2,1
1/04/2023,Belarus,Sabah,3,2,1
1/04/2023,Belarus,Sarawak,3,1,2
1/04/2023,Belarus,Selangor,539,265,274
1/04/2023,Belarus,W.P. Labuan,0,0,0
1/04/2023,Belize,Johor,2,0,2
1/04/2023,Belize,Pulau Pinang,1,1,0
1/04/2023,Belize,Sarawak,0,0,0
1/04/2023,Belize,Selangor,9,6,3
1/04/2023,Bermuda,Selangor,0,0,0
1/04/2023,Bolivia,Johor,2,1,1
1/04/2023,Bolivia,Kedah,1,0,1
1/04/2023,Bolivia,Melaka,0,0,0
1/04/2023,Bolivia,Perak,0,0,0
1/04/2023,Bolivia,Perlis,0,0,0
1/04/2023,Bolivia,Pulau Pinang,2,1,1
1/04/2023,Bolivia,Sabah,0,0,0
1/04/2023,Bolivia,Sarawak,2,1,1
1/04/2023,Bolivia,Selangor,21,14,7
1/04/2023,Brazil,Johor,255,139,116
1/04/2023,Brazil,Kedah,88,41,47
1/04/2023,Brazil,Kelantan,1,1,0
1/04/2023,Brazil,Melaka,0,0,0
1/04/2023,Brazil,Pahang,0,0,0
1/04/2023,Brazil,Perak,14,9,5
1/04/2023,Brazil,Perlis,15,7,8
1/04/2023,Brazil,Pulau Pinang,31,19,12
1/04/2023,Brazil,Sabah,17,8,9
1/04/2023,Brazil,Sarawak,20,13,7
1/04/2023,Brazil,Selangor,868,469,399
1/04/2023,Brazil,W.P. Labuan,0,0,0
1/04/2023,Barbados,Johor,3,1,2
1/04/2023,Barbados,Kedah,0,0,0
1/04/2023,Barbados,Perlis,0,0,0
1/04/2023,Barbados,Pulau Pinang,0,0,0
1/04/2023,Barbados,Selangor,6,4,2
1/04/2023,Brunei Darussalam,Johor,557,312,245
1/04/2023,Brunei Darussalam,Kedah,13,1,12
1/04/2023,Brunei Darussalam,Kelantan,12,5,7
1/04/2023,Brunei Darussalam,Melaka,6,3,3
1/04/2023,Brunei Darussalam,Pahang,0,0,0
1/04/2023,Brunei Darussalam,Perak,3,2,1
1/04/2023,Brunei Darussalam,Perlis,7,4,3
1/04/2023,Brunei Darussalam,Pulau Pinang,23,10,13
1/04/2023,Brunei Darussalam,Sabah,1135,505,630
1/04/2023,Brunei Darussalam,Sarawak,114421,61107,53314
1/04/2023,Brunei Darussalam,Selangor,5228,2439,2789
1/04/2023,Brunei Darussalam,W.P. Labuan,1526,872,654
1/04/2023,Bhutan,Johor,10,4,6
1/04/2023,Bhutan,Kedah,2,2,0
1/04/2023,Bhutan,Perak,0,0,0
1/04/2023,Bhutan,Perlis,0,0,0
1/04/2023,Bhutan,Pulau Pinang,0,0,0
1/04/2023,Bhutan,Sabah,1,1,0
1/04/2023,Bhutan,Sarawak,0,0,0
1/04/2023,Bhutan,Selangor,12,7,5
1/04/2023,Botswana,Johor,6,3,3
1/04/2023,Botswana,Kedah,0,0,0
1/04/2023,Botswana,Perlis,0,0,0
1/04/2023,Botswana,Pulau Pinang,0,0,0
1/04/2023,Botswana,Sabah,0,0,0
1/04/2023,Botswana,Sarawak,0,0,0
1/04/2023,Botswana,Selangor,9,3,6
1/04/2023,Central African Republic,Kedah,0,0,0
1/04/2023,Central African Republic,Selangor,0,0,0
1/04/2023,Canada,Johor,1274,707,567
1/04/2023,Canada,Kedah,214,118,96
1/04/2023,Canada,Kelantan,5,4,1
1/04/2023,Canada,Melaka,0,0,0
1/04/2023,Canada,Negeri Sembilan,0,0,0
1/04/2023,Canada,Pahang,5,2,3
1/04/2023,Canada,Perak,50,27,23
1/04/2023,Canada,Perlis,47,29,18
1/04/2023,Canada,Pulau Pinang,545,296,249
1/04/2023,Canada,Sabah,207,109,98
1/04/2023,Canada,Sarawak,480,255,225
1/04/2023,Canada,Selangor,3835,2125,1710
1/04/2023,Canada,Terengganu,0,0,0
1/04/2023,Canada,W.P. Labuan,5,5,0
1/04/2023,Cocos (Keeling) Islands,Selangor,0,0,0
1/04/2023,Switzerland,Johor,420,266,154
1/04/2023,Switzerland,Kedah,206,106,100
1/04/2023,Switzerland,Kelantan,2,2,0
1/04/2023,Switzerland,Melaka,3,1,2
1/04/2023,Switzerland,Negeri Sembilan,0,0,0
1/04/2023,Switzerland,Pahang,8,5,3
1/04/2023,Switzerland,Perak,3,2,1
1/04/2023,Switzerland,Perlis,35,17,18
1/04/2023,Switzerland,Pulau Pinang,117,68,49
1/04/2023,Switzerland,Sabah,61,35,26
1/04/2023,Switzerland,Sarawak,65,30,35
1/04/2023,Switzerland,Selangor,1290,765,525
1/04/2023,Switzerland,W.P. Labuan,0,0,0
1/04/2023,Chile,Johor,21,10,11
1/04/2023,Chile,Kedah,17,8,9
1/04/2023,Chile,Kelantan,0,0,0
1/04/2023,Chile,Melaka,0,0,0
1/04/2023,Chile,Pahang,4,1,3
1/04/2023,Chile,Perak,0,0,0
1/04/2023,Chile,Perlis,3,1,2
1/04/2023,Chile,Pulau Pinang,9,5,4
1/04/2023,Chile,Sabah,5,2,3
1/04/2023,Chile,Sarawak,2,2,0
1/04/2023,Chile,Selangor,192,94,98
1/04/2023,China,Johor,36651,16061,20590
1/04/2023,China,Kedah,977,411,566
1/04/2023,China,Kelantan,5,1,4
1/04/2023,China,Melaka,0,0,0
1/04/2023,China,Pahang,31,13,18
1/04/2023,China,Perak,254,121,133
1/04/2023,China,Perlis,95,36,59
1/04/2023,China,Pulau Pinang,6448,3336,3112
1/04/2023,China,Sabah,8519,4159,4360
1/04/2023,China,Sarawak,905,435,470
1/04/2023,China,Selangor,70631,36720,33911
1/04/2023,China,Terengganu,0,0,0
1/04/2023,China,W.P. Labuan,67,65,2
1/04/2023,Côte d'Ivoire,Johor,0,0,0
1/04/2023,Côte d'Ivoire,Kedah,0,0,0
1/04/2023,Côte d'Ivoire,Pulau Pinang,2,0,2
1/04/2023,Côte d'Ivoire,Sabah,0,0,0
1/04/2023,Côte d'Ivoire,Sarawak,0,0,0
1/04/2023,Côte d'Ivoire,Selangor,10,6,4
1/04/2023,Cameroon,Johor,0,0,0
1/04/2023,Cameroon,Kedah,0,0,0
1/04/2023,Cameroon,Pulau Pinang,2,2,0
1/04/2023,Cameroon,Sabah,1,1,0
1/04/2023,Cameroon,Sarawak,0,0,0
1/04/2023,Cameroon,Selangor,16,13,3
1/04/2023,Congo,Johor,2,2,0
1/04/2023,Congo,Pulau Pinang,0,0,0
1/04/2023,Congo,Sarawak,0,0,0
1/04/2023,Congo,Selangor,6,5,1
1/04/2023,Congo,Johor,0,0,0
1/04/2023,Congo,Kedah,0,0,0
1/04/2023,Congo,Selangor,0,0,0
1/04/2023,Cook Islands,Selangor,0,0,0
1/04/2023,Colombia,Johor,36,15,21
1/04/2023,Colombia,Kedah,4,1,3
1/04/2023,Colombia,Perak,0,0,0
1/04/2023,Colombia,Pulau Pinang,2,2,0
1/04/2023,Colombia,Sabah,2,1,1
1/04/2023,Colombia,Sarawak,5,3,2
1/04/2023,Colombia,Selangor,155,78,77
1/04/2023,Colombia,W.P. Labuan,0,0,0
1/04/2023,Comoros,Johor,0,0,0
1/04/2023,Comoros,Kedah,0,0,0
1/04/2023,Comoros,Selangor,6,4,2
1/04/2023,Cabo Verde,Johor,0,0,0
1/04/2023,Cabo Verde,Kedah,0,0,0
1/04/2023,Cabo Verde,Pulau Pinang,0,0,0
1/04/2023,Cabo Verde,Sabah,0,0,0
1/04/2023,Cabo Verde,Selangor,0,0,0
1/04/2023,Costa Rica,Johor,10,7,3
1/04/2023,Costa Rica,Kedah,0,0,0
1/04/2023,Costa Rica,Perak,0,0,0
1/04/2023,Costa Rica,Perlis,0,0,0
1/04/2023,Costa Rica,Pulau Pinang,4,3,1
1/04/2023,Costa Rica,Sabah,0,0,0
1/04/2023,Costa Rica,Sarawak,0,0,0
1/04/2023,Costa Rica,Selangor,82,42,40
1/04/2023,Cuba,Johor,8,3,5
1/04/2023,Cuba,Kedah,0,0,0
1/04/2023,Cuba,Perlis,0,0,0
1/04/2023,Cuba,Pulau Pinang,1,1,0
1/04/2023,Cuba,Sabah,1,1,0
1/04/2023,Cuba,Sarawak,0,0,0
1/04/2023,Cuba,Selangor,19,13,6
1/04/2023,Cyprus,Johor,15,9,6
1/04/2023,Cyprus,Kedah,2,1,1
1/04/2023,Cyprus,Perak,0,0,0
1/04/2023,Cyprus,Perlis,0,0,0
1/04/2023,Cyprus,Pulau Pinang,2,2,0
1/04/2023,Cyprus,Sabah,0,0,0
1/04/2023,Cyprus,Sarawak,1,1,0
1/04/2023,Cyprus,Selangor,53,34,19
1/04/2023,Czechia,Johor,89,55,34
1/04/2023,Czechia,Kedah,60,29,31
1/04/2023,Czechia,Kelantan,7,3,4
1/04/2023,Czechia,Melaka,0,0,0
1/04/2023,Czechia,Negeri Sembilan,0,0,0
1/04/2023,Czechia,Perak,2,2,0
1/04/2023,Czechia,Perlis,3,3,0
1/04/2023,Czechia,Pulau Pinang,19,11,8
1/04/2023,Czechia,Sabah,30,21,9
1/04/2023,Czechia,Sarawak,12,5,7
1/04/2023,Czechia,Selangor,546,326,220
1/04/2023,Czechia,W.P. Labuan,4,2,2
1/04/2023,Germany,Johor,2235,1329,906
1/04/2023,Germany,Kedah,939,510,429
1/04/2023,Germany,Kelantan,17,11,6
1/04/2023,Germany,Melaka,2,2,0
1/04/2023,Germany,Negeri Sembilan,0,0,0
1/04/2023,Germany,Pahang,8,4,4
1/04/2023,Germany,Perak,34,23,11
1/04/2023,Germany,Perlis,108,64,44
1/04/2023,Germany,Pulau Pinang,561,363,198
1/04/2023,Germany,Sabah,185,103,82
1/04/2023,Germany,Sarawak,234,145,89
1/04/2023,Germany,Selangor,6427,3816,2611
1/04/2023,Germany,Terengganu,0,0,0
1/04/2023,Germany,W.P. Labuan,20,11,9
1/04/2023,Djibouti,Johor,0,0,0
1/04/2023,Djibouti,Selangor,5,2,3
1/04/2023,Dominica,Johor,6,5,1
1/04/2023,Dominica,Kedah,0,0,0
1/04/2023,Dominica,Pulau Pinang,0,0,0
1/04/2023,Dominica,Sabah,0,0,0
1/04/2023,Dominica,Sarawak,3,2,1
1/04/2023,Dominica,Selangor,19,17,2
1/04/2023,Dominica,W.P. Labuan,0,0,0
1/04/2023,Denmark,Johor,321,212,109
1/04/2023,Denmark,Kedah,154,81,73
1/04/2023,Denmark,Kelantan,1,1,0
1/04/2023,Denmark,Melaka,0,0,0
1/04/2023,Denmark,Negeri Sembilan,0,0,0
1/04/2023,Denmark,Pahang,5,3,2
1/04/2023,Denmark,Perak,1,0,1
1/04/2023,Denmark,Perlis,11,4,7
1/04/2023,Denmark,Pulau Pinang,49,32,17
1/04/2023,Denmark,Sabah,36,18,18
1/04/2023,Denmark,Sarawak,17,10,7
1/04/2023,Denmark,Selangor,1026,593,433
1/04/2023,Denmark,W.P. Labuan,0,0,0
1/04/2023,Dominican Republic,Johor,3,3,0
1/04/2023,Dominican Republic,Kedah,0,0,0
1/04/2023,Dominican Republic,Perak,0,0,0
1/04/2023,Dominican Republic,Perlis,0,0,0
1/04/2023,Dominican Republic,Pulau Pinang,3,0,3
1/04/2023,Dominican Republic,Sabah,3,1,2
1/04/2023,Dominican Republic,Sarawak,0,0,0
1/04/2023,Dominican Republic,Selangor,28,15,13
1/04/2023,Algeria,Johor,16,15,1
1/04/2023,Algeria,Kedah,1,1,0
1/04/2023,Algeria,Kelantan,0,0,0
1/04/2023,Algeria,Melaka,0,0,0
1/04/2023,Algeria,Perak,0,0,0
1/04/2023,Algeria,Perlis,1,1,0
1/04/2023,Algeria,Pulau Pinang,0,0,0
1/04/2023,Algeria,Sabah,0,0,0
1/04/2023,Algeria,Sarawak,1,1,0
1/04/2023,Algeria,Selangor,270,187,83
1/04/2023,Algeria,W.P. Labuan,0,0,0
1/04/2023,Ecuador,Johor,16,8,8
1/04/2023,Ecuador,Kedah,1,0,1
1/04/2023,Ecuador,Perak,0,0,0
1/04/2023,Ecuador,Perlis,2,1,1
1/04/2023,Ecuador,Pulau Pinang,5,1,4
1/04/2023,Ecuador,Sabah,2,1,1
1/04/2023,Ecuador,Sarawak,0,0,0
1/04/2023,Ecuador,Selangor,68,39,29
1/04/2023,Egypt,Johor,199,159,40
1/04/2023,Egypt,Kedah,3,3,0
1/04/2023,Egypt,Kelantan,1,1,0
1/04/2023,Egypt,Melaka,0,0,0
1/04/2023,Egypt,Pahang,1,1,0
1/04/2023,Egypt,Perak,0,0,0
1/04/2023,Egypt,Perlis,0,0,0
1/04/2023,Egypt,Pulau Pinang,10,8,2
1/04/2023,Egypt,Sabah,3,3,0
1/04/2023,Egypt,Sarawak,149,106,43
1/04/2023,Egypt,Selangor,1297,902,395
1/04/2023,Egypt,Terengganu,0,0,0
1/04/2023,Egypt,W.P. Labuan,2,1,1
1/04/2023,Eritrea,Johor,1,0,1
1/04/2023,Eritrea,Pulau Pinang,0,0,0
1/04/2023,Eritrea,Sabah,0,0,0
1/04/2023,Eritrea,Selangor,17,7,10
1/04/2023,Spain,Johor,511,312,199
1/04/2023,Spain,Kedah,209,109,100
1/04/2023,Spain,Kelantan,5,4,1
1/04/2023,Spain,Melaka,0,0,0
1/04/2023,Spain,Negeri Sembilan,0,0,0
1/04/2023,Spain,Pahang,4,2,2
1/04/2023,Spain,Perak,7,3,4
1/04/2023,Spain,Perlis,28,13,15
1/04/2023,Spain,Pulau Pinang,85,48,37
1/04/2023,Spain,Sabah,46,28,18
1/04/2023,Spain,Sarawak,41,27,14
1/04/2023,Spain,Selangor,2144,1163,981
1/04/2023,Spain,W.P. Labuan,2,1,1
1/04/2023,Estonia,Johor,18,12,6
1/04/2023,Estonia,Kedah,23,13,10
1/04/2023,Estonia,Kelantan,0,0,0
1/04/2023,Estonia,Pahang,0,0,0
1/04/2023,Estonia,Perak,0,0,0
1/04/2023,Estonia,Perlis,6,2,4
1/04/2023,Estonia,Pulau Pinang,6,4,2
1/04/2023,Estonia,Sabah,1,1,0
1/04/2023,Estonia,Sarawak,6,5,1
1/04/2023,Estonia,Selangor,156,93,63
1/04/2023,Estonia,W.P. Labuan,0,0,0
1/04/2023,Ethiopia,Johor,1,1,0
1/04/2023,Ethiopia,Kedah,0,0,0
1/04/2023,Ethiopia,Pulau Pinang,1,0,1
1/04/2023,Ethiopia,Sarawak,0,0,0
1/04/2023,Ethiopia,Selangor,19,13,6
1/04/2023,Finland,Johor,145,98,47
1/04/2023,Finland,Kedah,97,49,48
1/04/2023,Finland,Kelantan,0,0,0
1/04/2023,Finland,Melaka,0,0,0
1/04/2023,Finland,Negeri Sembilan,0,0,0
1/04/2023,Finland,Pahang,0,0,0
1/04/2023,Finland,Perak,1,1,0
1/04/2023,Finland,Perlis,5,3,2
1/04/2023,Finland,Pulau Pinang,27,19,8
1/04/2023,Finland,Sabah,16,8,8
1/04/2023,Finland,Sarawak,19,9,10
1/04/2023,Finland,Selangor,503,267,236
1/04/2023,Finland,W.P. Labuan,0,0,0
1/04/2023,Fiji,Johor,66,42,24
1/04/2023,Fiji,Kedah,2,0,2
1/04/2023,Fiji,Kelantan,0,0,0
1/04/2023,Fiji,Perak,0,0,0
1/04/2023,Fiji,Perlis,1,1,0
1/04/2023,Fiji,Pulau Pinang,3,2,1
1/04/2023,Fiji,Sabah,3,2,1
1/04/2023,Fiji,Sarawak,1,0,1
1/04/2023,Fiji,Selangor,101,49,52
1/04/2023,France,Johor,2284,1332,952
1/04/2023,France,Kedah,658,344,314
1/04/2023,France,Kelantan,26,21,5
1/04/2023,France,Melaka,1,0,1
1/04/2023,France,Negeri Sembilan,3,2,1
1/04/2023,France,Pahang,27,15,12
1/04/2023,France,Perak,30,19,11
1/04/2023,France,Perlis,71,50,21
1/04/2023,France,Pulau Pinang,439,267,172
1/04/2023,France,Sabah,217,125,92
1/04/2023,France,Sarawak,207,121,86
1/04/2023,France,Selangor,6536,3816,2720
1/04/2023,France,Terengganu,0,0,0
1/04/2023,France,W.P. Labuan,2,1,1
1/04/2023,"Micronesia, Federated States of",Johor,0,0,0
1/04/2023,"Micronesia, Federated States of",Pulau Pinang,0,0,0
1/04/2023,"Micronesia, Federated States of",Selangor,0,0,0
1/04/2023,Gabon,Johor,1,1,0
1/04/2023,Gabon,Pulau Pinang,0,0,0
1/04/2023,Gabon,Sarawak,0,0,0
1/04/2023,Gabon,Selangor,3,3,0
1/04/2023,United Kingdom of Great Britain and Northern Ireland,Johor,4886,2955,1931
1/04/2023,United Kingdom of Great Britain and Northern Ireland,Kedah,1785,899,886
1/04/2023,United Kingdom of Great Britain and Northern Ireland,Kelantan,10,8,2
1/04/2023,United Kingdom of Great Britain and Northern Ireland,Melaka,1,0,1
1/04/2023,United Kingdom of Great Britain and Northern Ireland,Negeri Sembilan,0,0,0
1/04/2023,United Kingdom of Great Britain and Northern Ireland,Pahang,34,18,16
1/04/2023,United Kingdom of Great Britain and Northern Ireland,Perak,115,64,51
1/04/2023,United Kingdom of Great Britain and Northern Ireland,Perlis,187,106,81
1/04/2023,United Kingdom of Great Britain and Northern Ireland,Pulau Pinang,1598,889,709
1/04/2023,United Kingdom of Great Britain and Northern Ireland,Sabah,965,512,453
1/04/2023,United Kingdom of Great Britain and Northern Ireland,Sarawak,1562,947,615
1/04/2023,United Kingdom of Great Britain and Northern Ireland,Selangor,17137,9882,7255
1/04/2023,United Kingdom of Great Britain and Northern Ireland,Terengganu,0,0,0
1/04/2023,United Kingdom of Great Britain and Northern Ireland,W.P. Labuan,87,66,21
1/04/2023,Georgia,Johor,6,5,1
1/04/2023,Georgia,Kedah,8,5,3
1/04/2023,Georgia,Melaka,0,0,0
1/04/2023,Georgia,Perak,0,0,0
1/04/2023,Georgia,Perlis,0,0,0
1/04/2023,Georgia,Pulau Pinang,1,0,1
1/04/2023,Georgia,Sabah,0,0,0
1/04/2023,Georgia,Sarawak,0,0,0
1/04/2023,Georgia,Selangor,51,27,24
1/04/2023,Ghana,Johor,10,7,3
1/04/2023,Ghana,Kedah,3,3,0
1/04/2023,Ghana,Kelantan,0,0,0
1/04/2023,Ghana,Pulau Pinang,0,0,0
1/04/2023,Ghana,Sabah,1,0,1
1/04/2023,Ghana,Sarawak,0,0,0
1/04/2023,Ghana,Selangor,37,24,13
1/04/2023,Gibraltar,Johor,0,0,0
1/04/2023,Gibraltar,Sarawak,0,0,0
1/04/2023,Guinea,Johor,0,0,0
1/04/2023,Guinea,Kedah,1,1,0
1/04/2023,Guinea,Kelantan,0,0,0
1/04/2023,Guinea,Perlis,1,1,0
1/04/2023,Guinea,Pulau Pinang,0,0,0
1/04/2023,Guinea,Sabah,0,0,0
1/04/2023,Guinea,Sarawak,0,0,0
1/04/2023,Guinea,Selangor,31,26,5
1/04/2023,Guadeloupe,Selangor,0,0,0
1/04/2023,Gambia,Johor,1,1,0
1/04/2023,Gambia,Kedah,0,0,0
1/04/2023,Gambia,Kelantan,0,0,0
1/04/2023,Gambia,Pulau Pinang,0,0,0
1/04/2023,Gambia,Sabah,0,0,0
1/04/2023,Gambia,Sarawak,1,1,0
1/04/2023,Gambia,Selangor,14,11,3
1/04/2023,Guinea-Bissau,Johor,0,0,0
1/04/2023,Guinea-Bissau,Selangor,1,1,0
1/04/2023,Equatorial Guinea,Johor,0,0,0
1/04/2023,Equatorial Guinea,Selangor,2,0,2
1/04/2023,Greece,Johor,52,41,11
1/04/2023,Greece,Kedah,17,8,9
1/04/2023,Greece,Kelantan,2,2,0
1/04/2023,Greece,Melaka,0,0,0
1/04/2023,Greece,Negeri Sembilan,0,0,0
1/04/2023,Greece,Pahang,0,0,0
1/04/2023,Greece,Perak,0,0,0
1/04/2023,Greece,Perlis,3,3,0
1/04/2023,Greece,Pulau Pinang,6,3,3
1/04/2023,Greece,Sabah,8,5,3
1/04/2023,Greece,Sarawak,16,6,10
1/04/2023,Greece,Selangor,218,146,72
1/04/2023,Grenada,Johor,5,1,4
1/04/2023,Grenada,Kedah,0,0,0
1/04/2023,Grenada,Pulau Pinang,0,0,0
1/04/2023,Grenada,Sabah,0,0,0
1/04/2023,Grenada,Sarawak,0,0,0
1/04/2023,Grenada,Selangor,11,10,1
1/04/2023,Greenland,Johor,0,0,0
1/04/2023,Greenland,Selangor,0,0,0
1/04/2023,Guatemala,Johor,3,2,1
1/04/2023,Guatemala,Kedah,0,0,0
1/04/2023,Guatemala,Pahang,0,0,0
1/04/2023,Guatemala,Perak,0,0,0
1/04/2023,Guatemala,Pulau Pinang,0,0,0
1/04/2023,Guatemala,Sabah,0,0,0
1/04/2023,Guatemala,Sarawak,0,0,0
1/04/2023,Guatemala,Selangor,72,35,37
1/04/2023,Guatemala,W.P. Labuan,0,0,0
1/04/2023,Guyana,Johor,0,0,0
1/04/2023,Guyana,Kedah,0,0,0
1/04/2023,Guyana,Pulau Pinang,0,0,0
1/04/2023,Guyana,Sarawak,0,0,0
1/04/2023,Guyana,Selangor,3,3,0
1/04/2023,Hong Kong,Johor,4,2,2
1/04/2023,Hong Kong,Kedah,0,0,0
1/04/2023,Hong Kong,Kelantan,0,0,0
1/04/2023,Hong Kong,Pahang,8,4,4
1/04/2023,Hong Kong,Perak,67,24,43
1/04/2023,Hong Kong,Perlis,8,6,2
1/04/2023,Hong Kong,Pulau Pinang,1,0,1
1/04/2023,Hong Kong,Sabah,42,15,27
1/04/2023,Hong Kong,Sarawak,0,0,0
1/04/2023,Hong Kong,Selangor,6,2,4
1/04/2023,Hong Kong,Terengganu,0,0,0
1/04/2023,Heard Island and McDonald Islands,Johor,0,0,0
1/04/2023,Honduras,Johor,2,1,1
1/04/2023,Honduras,Kedah,0,0,0
1/04/2023,Honduras,Perak,0,0,0
1/04/2023,Honduras,Pulau Pinang,0,0,0
1/04/2023,Honduras,Sabah,0,0,0
1/04/2023,Honduras,Sarawak,0,0,0
1/04/2023,Honduras,Selangor,22,11,11
1/04/2023,Croatia,Johor,39,32,7
1/04/2023,Croatia,Kedah,8,4,4
1/04/2023,Croatia,Kelantan,0,0,0
1/04/2023,Croatia,Melaka,0,0,0
1/04/2023,Croatia,Pahang,0,0,0
1/04/2023,Croatia,Perak,0,0,0
1/04/2023,Croatia,Perlis,0,0,0
1/04/2023,Croatia,Pulau Pinang,3,1,2
1/04/2023,Croatia,Sabah,3,2,1
1/04/2023,Croatia,Sarawak,5,5,0
1/04/2023,Croatia,Selangor,138,83,55
1/04/2023,Haiti,Johor,0,0,0
1/04/2023,Haiti,Kedah,0,0,0
1/04/2023,Haiti,Kelantan,0,0,0
1/04/2023,Haiti,Perak,0,0,0
1/04/2023,Haiti,Pulau Pinang,0,0,0
1/04/2023,Haiti,Sabah,1,1,0
1/04/2023,Haiti,Selangor,3,2,1
1/04/2023,Hungary,Johor,64,31,33
1/04/2023,Hungary,Kedah,26,12,14
1/04/2023,Hungary,Kelantan,0,0,0
1/04/2023,Hungary,Pahang,0,0,0
1/04/2023,Hungary,Perak,2,2,0
1/04/2023,Hungary,Perlis,6,2,4
1/04/2023,Hungary,Pulau Pinang,31,20,11
1/04/2023,Hungary,Sabah,12,6,6
1/04/2023,Hungary,Sarawak,12,4,8
1/04/2023,Hungary,Selangor,544,273,271
1/04/2023,Hungary,W.P. Labuan,0,0,0
1/04/2023,Indonesia,Johor,85436,37705,47731
1/04/2023,Indonesia,Kedah,4430,1644,2786
1/04/2023,Indonesia,Kelantan,139,83,56
1/04/2023,Indonesia,Melaka,5572,2515,3057
1/04/2023,Indonesia,Negeri Sembilan,4328,2164,2164
1/04/2023,Indonesia,Pahang,51,32,19
1/04/2023,Indonesia,Perak,195,63,132
1/04/2023,Indonesia,Perlis,563,226,337
1/04/2023,Indonesia,Pulau Pinang,36741,14511,22230
1/04/2023,Indonesia,Sabah,4607,2266,2341
1/04/2023,Indonesia,Sarawak,42173,20538,21635
1/04/2023,Indonesia,Selangor,108182,50214,57968
1/04/2023,Indonesia,Terengganu,0,0,0
1/04/2023,Indonesia,W.P. Labuan,82,40,42
1/04/2023,India,Johor,22714,15187,7527
1/04/2023,India,Kedah,1466,761,705
1/04/2023,India,Kelantan,5,5,0
1/04/2023,India,Melaka,1,1,0
1/04/2023,India,Negeri Sembilan,0,0,0
1/04/2023,India,Pahang,12,10,2
1/04/2023,India,Perak,525,426,99
1/04/2023,India,Perlis,67,54,13
1/04/2023,India,Pulau Pinang,991,645,346
1/04/2023,India,Sabah,329,198,131
1/04/2023,India,Sarawak,1630,1175,455
1/04/2023,India,Selangor,45077,31100,13977
1/04/2023,India,Terengganu,0,0,0
1/04/2023,India,W.P. Labuan,160,117,43
1/04/2023, British Indian Ocean Territory,Pulau Pinang,0,0,0
1/04/2023, British Indian Ocean Territory,Selangor,0,0,0
1/04/2023,Ireland,Johor,312,195,117
1/04/2023,Ireland,Kedah,112,61,51
1/04/2023,Ireland,Kelantan,0,0,0
1/04/2023,Ireland,Negeri Sembilan,0,0,0
1/04/2023,Ireland,Pahang,0,0,0
1/04/2023,Ireland,Perak,13,6,7
1/04/2023,Ireland,Perlis,10,9,1
1/04/2023,Ireland,Pulau Pinang,110,63,47
1/04/2023,Ireland,Sabah,41,25,16
1/04/2023,Ireland,Sarawak,44,18,26
1/04/2023,Ireland,Selangor,1135,648,487
1/04/2023,Ireland,Terengganu,0,0,0
1/04/2023,Ireland,W.P. Labuan,0,0,0
1/04/2023,"Iran, Islamic Republic of",Johor,251,143,108
1/04/2023,"Iran, Islamic Republic of",Kedah,6,4,2
1/04/2023,"Iran, Islamic Republic of",Kelantan,0,0,0
1/04/2023,"Iran, Islamic Republic of",Perak,0,0,0
1/04/2023,"Iran, Islamic Republic of",Perlis,5,5,0
1/04/2023,"Iran, Islamic Republic of",Pulau Pinang,10,4,6
1/04/2023,"Iran, Islamic Republic of",Sabah,2,0,2
1/04/2023,"Iran, Islamic Republic of",Sarawak,9,5,4
1/04/2023,"Iran, Islamic Republic of",Selangor,1101,599,502
1/04/2023,"Iran, Islamic Republic of",W.P. Labuan,0,0,0
1/04/2023,Iraq,Johor,27,23,4
1/04/2023,Iraq,Kedah,1,1,0
1/04/2023,Iraq,Kelantan,0,0,0
1/04/2023,Iraq,Melaka,0,0,0
1/04/2023,Iraq,Pahang,0,0,0
1/04/2023,Iraq,Perak,0,0,0
1/04/2023,Iraq,Perlis,0,0,0
1/04/2023,Iraq,Pulau Pinang,6,6,0
1/04/2023,Iraq,Sabah,0,0,0
1/04/2023,Iraq,Sarawak,4,2,2
1/04/2023,Iraq,Selangor,571,402,169
1/04/2023,Iceland,Johor,4,3,1
1/04/2023,Iceland,Kedah,0,0,0
1/04/2023,Iceland,Kelantan,0,0,0
1/04/2023,Iceland,Perak,2,1,1
1/04/2023,Iceland,Perlis,1,1,0
1/04/2023,Iceland,Pulau Pinang,4,4,0
1/04/2023,Iceland,Sabah,13,7,6
1/04/2023,Iceland,Sarawak,0,0,0
1/04/2023,Iceland,Selangor,34,17,17
1/04/2023,Iceland,W.P. Labuan,0,0,0
1/04/2023,Israel,Pulau Pinang,0,0,0
1/04/2023,Italy,Johor,577,381,196
1/04/2023,Italy,Kedah,222,136,86
1/04/2023,Italy,Kelantan,3,3,0
1/04/2023,Italy,Melaka,0,0,0
1/04/2023,Italy,Negeri Sembilan,0,0,0
1/04/2023,Italy,Pahang,0,0,0
1/04/2023,Italy,Perak,2,1,1
1/04/2023,Italy,Perlis,22,16,6
1/04/2023,Italy,Pulau Pinang,102,72,30
1/04/2023,Italy,Sabah,56,30,26
1/04/2023,Italy,Sarawak,65,41,24
1/04/2023,Italy,Selangor,2197,1400,797
1/04/2023,Italy,W.P. Labuan,5,3,2
1/04/2023,Jamaica,Johor,5,2,3
1/04/2023,Jamaica,Kedah,0,0,0
1/04/2023,Jamaica,Perak,0,0,0
1/04/2023,Jamaica,Pulau Pinang,0,0,0
1/04/2023,Jamaica,Sabah,0,0,0
1/04/2023,Jamaica,Sarawak,0,0,0
1/04/2023,Jamaica,Selangor,13,2,11
1/04/2023,Jamaica,W.P. Labuan,0,0,0
1/04/2023,Jordan,Johor,17,11,6
1/04/2023,Jordan,Kedah,3,1,2
1/04/2023,Jordan,Kelantan,1,1,0
1/04/2023,Jordan,Melaka,0,0,0
1/04/2023,Jordan,Perlis,1,1,0
1/04/2023,Jordan,Pulau Pinang,2,0,2
1/04/2023,Jordan,Sabah,1,1,0
1/04/2023,Jordan,Sarawak,5,3,2
1/04/2023,Jordan,Selangor,419,272,147
1/04/2023,Jordan,W.P. Labuan,0,0,0
1/04/2023,Japan,Johor,5487,3728,1759
1/04/2023,Japan,Kedah,389,212,177
1/04/2023,Japan,Kelantan,8,5,3
1/04/2023,Japan,Melaka,2,2,0
1/04/2023,Japan,Negeri Sembilan,0,0,0
1/04/2023,Japan,Pahang,8,5,3
1/04/2023,Japan,Perak,43,29,14
1/04/2023,Japan,Perlis,60,50,10
1/04/2023,Japan,Pulau Pinang,1092,711,381
1/04/2023,Japan,Sabah,559,293,266
1/04/2023,Japan,Sarawak,180,110,70
1/04/2023,Japan,Selangor,14071,8501,5570
1/04/2023,Japan,W.P. Labuan,7,5,2
1/04/2023,Kazakhstan,Johor,48,24,24
1/04/2023,Kazakhstan,Kedah,20,8,12
1/04/2023,Kazakhstan,Kelantan,3,3,0
1/04/2023,Kazakhstan,Melaka,0,0,0
1/04/2023,Kazakhstan,Perak,0,0,0
1/04/2023,Kazakhstan,Perlis,5,2,3
1/04/2023,Kazakhstan,Pulau Pinang,5,1,4
1/04/2023,Kazakhstan,Sabah,11,4,7
1/04/2023,Kazakhstan,Sarawak,3,0,3
1/04/2023,Kazakhstan,Selangor,558,229,329
1/04/2023,Kazakhstan,W.P. Labuan,0,0,0
1/04/2023,Kenya,Johor,55,33,22
1/04/2023,Kenya,Kedah,3,1,2
1/04/2023,Kenya,Kelantan,0,0,0
1/04/2023,Kenya,Perak,0,0,0
1/04/2023,Kenya,Perlis,0,0,0
1/04/2023,Kenya,Pulau Pinang,9,6,3
1/04/2023,Kenya,Sabah,1,0,1
1/04/2023,Kenya,Sarawak,0,0,0
1/04/2023,Kenya,Selangor,391,211,180
1/04/2023,Kyrgyzstan,Johor,28,16,12
1/04/2023,Kyrgyzstan,Kedah,1,0,1
1/04/2023,Kyrgyzstan,Kelantan,3,3,0
1/04/2023,Kyrgyzstan,Perak,1,1,0
1/04/2023,Kyrgyzstan,Perlis,0,0,0
1/04/2023,Kyrgyzstan,Pulau Pinang,0,0,0
1/04/2023,Kyrgyzstan,Sabah,0,0,0
1/04/2023,Kyrgyzstan,Sarawak,1,1,0
1/04/2023,Kyrgyzstan,Selangor,136,58,78
1/04/2023,Cambodia,Johor,3503,1474,2029
1/04/2023,Cambodia,Kedah,231,173,58
1/04/2023,Cambodia,Kelantan,462,251,211
1/04/2023,Cambodia,Melaka,1,1,0
1/04/2023,Cambodia,Negeri Sembilan,0,0,0
1/04/2023,Cambodia,Pahang,1,0,1
1/04/2023,Cambodia,Perak,13,2,11
1/04/2023,Cambodia,Perlis,583,355,228
1/04/2023,Cambodia,Pulau Pinang,34,18,16
1/04/2023,Cambodia,Sabah,0,0,0
1/04/2023,Cambodia,Sarawak,9,0,9
1/04/2023,Cambodia,Selangor,5689,2517,3172
1/04/2023,Cambodia,W.P. Labuan,1,0,1
1/04/2023,Kiribati,Johor,0,0,0
1/04/2023,Kiribati,Sabah,0,0,0
1/04/2023,Kiribati,Selangor,1,1,0
1/04/2023,Saint Kitts and Nevis,Johor,41,33,8
1/04/2023,Saint Kitts and Nevis,Kedah,6,4,2
1/04/2023,Saint Kitts and Nevis,Perlis,0,0,0
1/04/2023,Saint Kitts and Nevis,Pulau Pinang,9,7,2
1/04/2023,Saint Kitts and Nevis,Sabah,3,2,1
1/04/2023,Saint Kitts and Nevis,Selangor,66,47,19
1/04/2023,Saint Kitts and Nevis,W.P. Labuan,0,0,0
1/04/2023,"Korea, Republic of",Johor,8372,4679,3693
1/04/2023,"Korea, Republic of",Kedah,283,148,135
1/04/2023,"Korea, Republic of",Kelantan,3,1,2
1/04/2023,"Korea, Republic of",Melaka,0,0,0
1/04/2023,"Korea, Republic of",Negeri Sembilan,4,3,1
1/04/2023,"Korea, Republic of",Pahang,7,3,4
1/04/2023,"Korea, Republic of",Perak,24,10,14
1/04/2023,"Korea, Republic of",Perlis,54,39,15
1/04/2023,"Korea, Republic of",Pulau Pinang,479,262,217
1/04/2023,"Korea, Republic of",Sabah,11789,4929,6860
1/04/2023,"Korea, Republic of",Sarawak,229,135,94
1/04/2023,"Korea, Republic of",Selangor,9420,5422,3998
1/04/2023,"Korea, Republic of",Terengganu,0,0,0
1/04/2023,"Korea, Republic of",W.P. Labuan,20,11,9
1/04/2023,Kuwait,Johor,13,3,10
1/04/2023,Kuwait,Kedah,8,5,3
1/04/2023,Kuwait,Kelantan,0,0,0
1/04/2023,Kuwait,Perak,0,0,0
1/04/2023,Kuwait,Perlis,0,0,0
1/04/2023,Kuwait,Pulau Pinang,0,0,0
1/04/2023,Kuwait,Sabah,0,0,0
1/04/2023,Kuwait,Sarawak,0,0,0
1/04/2023,Kuwait,Selangor,322,183,139
1/04/2023,Kuwait,W.P. Labuan,0,0,0
1/04/2023, Lao People's Democratic Republic,Johor,153,48,105
1/04/2023, Lao People's Democratic Republic,Kedah,987,99,888
1/04/2023, Lao People's Democratic Republic,Kelantan,187,36,151
1/04/2023, Lao People's Democratic Republic,Melaka,0,0,0
1/04/2023, Lao People's Democratic Republic,Perak,13,2,11
1/04/2023, Lao People's Democratic Republic,Perlis,274,113,161
1/04/2023, Lao People's Democratic Republic,Pulau Pinang,24,6,18
1/04/2023, Lao People's Democratic Republic,Sabah,0,0,0
1/04/2023, Lao People's Democratic Republic,Sarawak,21,13,8
1/04/2023, Lao People's Democratic Republic,Selangor,341,120,221
1/04/2023, Lao People's Democratic Republic,W.P. Labuan,0,0,0
1/04/2023,Lebanon,Johor,17,13,4
1/04/2023,Lebanon,Kedah,4,1,3
1/04/2023,Lebanon,Kelantan,0,0,0
1/04/2023,Lebanon,Pahang,0,0,0
1/04/2023,Lebanon,Perak,0,0,0
1/04/2023,Lebanon,Perlis,0,0,0
1/04/2023,Lebanon,Pulau Pinang,2,1,1
1/04/2023,Lebanon,Sabah,2,1,1
1/04/2023,Lebanon,Sarawak,2,2,0
1/04/2023,Lebanon,Selangor,235,150,85
1/04/2023,Lebanon,W.P. Labuan,0,0,0
1/04/2023,Liberia,Johor,2,2,0
1/04/2023,Liberia,Kedah,0,0,0
1/04/2023,Liberia,Sabah,0,0,0
1/04/2023,Liberia,Sarawak,0,0,0
1/04/2023,Liberia,Selangor,5,3,2
1/04/2023,Libya,Johor,2,2,0
1/04/2023,Libya,Kedah,0,0,0
1/04/2023,Libya,Perlis,0,0,0
1/04/2023,Libya,Pulau Pinang,1,1,0
1/04/2023,Libya,Sabah,1,1,0
1/04/2023,Libya,Sarawak,9,6,3
1/04/2023,Libya,Selangor,126,100,26
1/04/2023,Saint Lucia,Johor,7,7,0
1/04/2023,Saint Lucia,Kedah,0,0,0
1/04/2023,Saint Lucia,Pulau Pinang,2,1,1
1/04/2023,Saint Lucia,Sarawak,2,1,1
1/04/2023,Saint Lucia,Selangor,11,5,6
1/04/2023,Liechtenstein,Johor,3,3,0
1/04/2023,Liechtenstein,Kedah,0,0,0
1/04/2023,Liechtenstein,Perlis,0,0,0
1/04/2023,Liechtenstein,Pulau Pinang,0,0,0
1/04/2023,Liechtenstein,Sabah,0,0,0
1/04/2023,Liechtenstein,Sarawak,0,0,0
1/04/2023,Liechtenstein,Selangor,2,0,2
1/04/2023,LKA,Johor,1406,871,535
1/04/2023,LKA,Kedah,45,23,22
1/04/2023,LKA,Kelantan,0,0,0
1/04/2023,LKA,Melaka,0,0,0
1/04/2023,LKA,Pahang,0,0,0
1/04/2023,LKA,Perak,7,3,4
1/04/2023,LKA,Perlis,4,4,0
1/04/2023,LKA,Pulau Pinang,42,21,21
1/04/2023,LKA,Sabah,4,3,1
1/04/2023,LKA,Sarawak,33,21,12
1/04/2023,LKA,Selangor,3762,2329,1433
1/04/2023,LKA,W.P. Labuan,9,8,1
1/04/2023,Lesotho,Johor,2,1,1
1/04/2023,Lesotho,Kedah,0,0,0
1/04/2023,Lesotho,Pulau Pinang,0,0,0
1/04/2023,Lesotho,Sarawak,0,0,0
1/04/2023,Lesotho,Selangor,5,1,4
1/04/2023,Lithuania,Johor,54,21,33
1/04/2023,Lithuania,Kedah,36,14,22
1/04/2023,Lithuania,Kelantan,0,0,0
1/04/2023,Lithuania,Pahang,0,0,0
1/04/2023,Lithuania,Perak,5,2,3
1/04/2023,Lithuania,Perlis,5,5,0
1/04/2023,Lithuania,Pulau Pinang,4,1,3
1/04/2023,Lithuania,Sabah,3,2,1
1/04/2023,Lithuania,Sarawak,5,3,2
1/04/2023,Lithuania,Selangor,361,172,189
1/04/2023,Lithuania,W.P. Labuan,0,0,0
1/04/2023,Luxembourg,Johor,7,4,3
1/04/2023,Luxembourg,Kedah,9,5,4
1/04/2023,Luxembourg,Kelantan,0,0,0
1/04/2023,Luxembourg,Perak,1,1,0
1/04/2023,Luxembourg,Perlis,0,0,0
1/04/2023,Luxembourg,Pulau Pinang,6,3,3
1/04/2023,Luxembourg,Sabah,3,0,3
1/04/2023,Luxembourg,Sarawak,1,0,1
1/04/2023,Luxembourg,Selangor,41,21,20
1/04/2023,Latvia,Johor,13,10,3
1/04/2023,Latvia,Kedah,6,1,5
1/04/2023,Latvia,Kelantan,0,0,0
1/04/2023,Latvia,Pahang,0,0,0
1/04/2023,Latvia,Perak,0,0,0
1/04/2023,Latvia,Perlis,1,1,0
1/04/2023,Latvia,Pulau Pinang,2,1,1
1/04/2023,Latvia,Sabah,1,1,0
1/04/2023,Latvia,Sarawak,7,3,4
1/04/2023,Latvia,Selangor,194,109,85
1/04/2023,Latvia,W.P. Labuan,0,0,0
1/04/2023,Macao,Johor,0,0,0
1/04/2023,Macao,Pahang,0,0,0
1/04/2023,Macao,Perak,8,5,3
1/04/2023,Macao,Selangor,0,0,0
1/04/2023,Macao,W.P. Labuan,0,0,0
1/04/2023,Morocco,Johor,77,50,27
1/04/2023,Morocco,Kedah,6,3,3
1/04/2023,Morocco,Kelantan,1,1,0
1/04/2023,Morocco,Melaka,0,0,0
1/04/2023,Morocco,Pahang,0,0,0
1/04/2023,Morocco,Perak,0,0,0
1/04/2023,Morocco,Perlis,1,1,0
1/04/2023,Morocco,Pulau Pinang,15,12,3
1/04/2023,Morocco,Sabah,1,1,0
1/04/2023,Morocco,Sarawak,13,11,2
1/04/2023,Morocco,Selangor,428,228,200
1/04/2023,Morocco,W.P. Labuan,0,0,0
1/04/2023,Monaco,Johor,0,0,0
1/04/2023,Monaco,Kedah,0,0,0
1/04/2023,Monaco,Sabah,0,0,0
1/04/2023,Monaco,Selangor,3,1,2
1/04/2023,"Moldova, Republic of",Johor,2,2,0
1/04/2023,"Moldova, Republic of",Kedah,4,3,1
1/04/2023,"Moldova, Republic of",Kelantan,0,0,0
1/04/2023,"Moldova, Republic of",Negeri Sembilan,0,0,0
1/04/2023,"Moldova, Republic of",Perlis,0,0,0
1/04/2023,"Moldova, Republic of",Pulau Pinang,0,0,0
1/04/2023,"Moldova, Republic of",Sabah,1,1,0
1/04/2023,"Moldova, Republic of",Sarawak,0,0,0
1/04/2023,"Moldova, Republic of",Selangor,17,7,10
1/04/2023,Madagascar,Johor,17,8,9
1/04/2023,Madagascar,Kedah,4,0,4
1/04/2023,Madagascar,Perak,0,0,0
1/04/2023,Madagascar,Perlis,0,0,0
1/04/2023,Madagascar,Pulau Pinang,0,0,0
1/04/2023,Madagascar,Sabah,0,0,0
1/04/2023,Madagascar,Sarawak,0,0,0
1/04/2023,Madagascar,Selangor,56,27,29
1/04/2023,Maldives,Johor,54,31,23
1/04/2023,Maldives,Kedah,0,0,0
1/04/2023,Maldives,Kelantan,0,0,0
1/04/2023,Maldives,Perak,0,0,0
1/04/2023,Maldives,Perlis,0,0,0
1/04/2023,Maldives,Pulau Pinang,2,1,1
1/04/2023,Maldives,Sabah,0,0,0
1/04/2023,Maldives,Sarawak,1,0,1
1/04/2023,Maldives,Selangor,1366,746,620
1/04/2023,Mexico,Johor,166,90,76
1/04/2023,Mexico,Kedah,11,1,10
1/04/2023,Mexico,Kelantan,0,0,0
1/04/2023,Mexico,Pahang,0,0,0
1/04/2023,Mexico,Perak,0,0,0
1/04/2023,Mexico,Perlis,2,2,0
1/04/2023,Mexico,Pulau Pinang,34,21,13
1/04/2023,Mexico,Sabah,9,4,5
1/04/2023,Mexico,Sarawak,8,5,3
1/04/2023,Mexico,Selangor,747,347,400
1/04/2023,Mexico,W.P. Labuan,0,0,0
1/04/2023,Marshall Islands,Johor,1,1,0
1/04/2023,Marshall Islands,Kedah,0,0,0
1/04/2023,Marshall Islands,Perak,0,0,0
1/04/2023,Marshall Islands,Pulau Pinang,1,1,0
1/04/2023,Marshall Islands,Sabah,0,0,0
1/04/2023,Marshall Islands,Selangor,7,6,1
1/04/2023,North Macedonia,Johor,2,1,1
1/04/2023,North Macedonia,Kedah,0,0,0
1/04/2023,North Macedonia,Perak,0,0,0
1/04/2023,North Macedonia,Pulau Pinang,1,0,1
1/04/2023,North Macedonia,Sabah,0,0,0
1/04/2023,North Macedonia,Sarawak,1,0,1
1/04/2023,North Macedonia,Selangor,48,28,20
1/04/2023,Mali,Johor,0,0,0
1/04/2023,Mali,Sabah,0,0,0
1/04/2023,Mali,Selangor,6,3,3
1/04/2023,Malta,Johor,8,5,3
1/04/2023,Malta,Kedah,0,0,0
1/04/2023,Malta,Kelantan,0,0,0
1/04/2023,Malta,Perak,0,0,0
1/04/2023,Malta,Perlis,0,0,0
1/04/2023,Malta,Pulau Pinang,10,6,4
1/04/2023,Malta,Sabah,0,0,0
1/04/2023,Malta,Sarawak,0,0,0
1/04/2023,Malta,Selangor,41,25,16
1/04/2023,Malta,W.P. Labuan,0,0,0
1/04/2023,Myanmar,Johor,5054,1737,3317
1/04/2023,Myanmar,Kedah,86,18,68
1/04/2023,Myanmar,Kelantan,3,1,2
1/04/2023,Myanmar,Negeri Sembilan,1,1,0
1/04/2023,Myanmar,Pahang,3,0,3
1/04/2023,Myanmar,Perak,17,3,14
1/04/2023,Myanmar,Perlis,13,3,10
1/04/2023,Myanmar,Pulau Pinang,208,94,114
1/04/2023,Myanmar,Sabah,29,6,23
1/04/2023,Myanmar,Sarawak,84,31,53
1/04/2023,Myanmar,Selangor,6295,4199,2096
1/04/2023,Myanmar,Terengganu,0,0,0
1/04/2023,Myanmar,W.P. Labuan,3,1,2
1/04/2023,Montenegro,Johor,1,1,0
1/04/2023,Montenegro,Kedah,1,0,1
1/04/2023,Montenegro,Pulau Pinang,0,0,0
1/04/2023,Montenegro,Sabah,0,0,0
1/04/2023,Montenegro,Sarawak,0,0,0
1/04/2023,Montenegro,Selangor,25,14,11
1/04/2023,Mongolia,Johor,106,45,61
1/04/2023,Mongolia,Kedah,6,3,3
1/04/2023,Mongolia,Kelantan,0,0,0
1/04/2023,Mongolia,Perak,1,0,1
1/04/2023,Mongolia,Perlis,4,3,1
1/04/2023,Mongolia,Pulau Pinang,3,2,1
1/04/2023,Mongolia,Sabah,3,0,3
1/04/2023,Mongolia,Sarawak,0,0,0
1/04/2023,Mongolia,Selangor,298,134,164
1/04/2023,Northern Mariana Islands,Selangor,0,0,0
1/04/2023,Mozambique,Johor,3,1,2
1/04/2023,Mozambique,Kedah,0,0,0
1/04/2023,Mozambique,Perak,0,0,0
1/04/2023,Mozambique,Pulau Pinang,0,0,0
1/04/2023,Mozambique,Sabah,0,0,0
1/04/2023,Mozambique,Sarawak,0,0,0
1/04/2023,Mozambique,Selangor,15,8,7
1/04/2023,Mauritania,Johor,0,0,0
1/04/2023,Mauritania,Kedah,0,0,0
1/04/2023,Mauritania,Pulau Pinang,0,0,0
1/04/2023,Mauritania,Sabah,0,0,0
1/04/2023,Mauritania,Sarawak,0,0,0
1/04/2023,Mauritania,Selangor,11,8,3
1/04/2023,Mauritius,Johor,196,102,94
1/04/2023,Mauritius,Kedah,4,1,3
1/04/2023,Mauritius,Kelantan,0,0,0
1/04/2023,Mauritius,Pahang,0,0,0
1/04/2023,Mauritius,Perak,3,1,2
1/04/2023,Mauritius,Perlis,2,2,0
1/04/2023,Mauritius,Pulau Pinang,10,3,7
1/04/2023,Mauritius,Sabah,0,0,0
1/04/2023,Mauritius,Sarawak,5,3,2
1/04/2023,Mauritius,Selangor,1744,891,853
1/04/2023,Malawi,Johor,0,0,0
1/04/2023,Malawi,Pulau Pinang,0,0,0
1/04/2023,Malawi,Sabah,0,0,0
1/04/2023,Malawi,Sarawak,0,0,0
1/04/2023,Malawi,Selangor,13,7,6
1/04/2023,Mayotte,Selangor,0,0,0
1/04/2023,Namibia,Johor,0,0,0
1/04/2023,Namibia,Kedah,1,0,1
1/04/2023,Namibia,Perak,0,0,0
1/04/2023,Namibia,Perlis,0,0,0
1/04/2023,Namibia,Pulau Pinang,1,0,1
1/04/2023,Namibia,Sabah,0,0,0
1/04/2023,Namibia,Sarawak,0,0,0
1/04/2023,Namibia,Selangor,19,7,12
1/04/2023,New Caledonia,Selangor,0,0,0
1/04/2023,Niger,Johor,0,0,0
1/04/2023,Niger,Sabah,0,0,0
1/04/2023,Niger,Selangor,6,4,2
1/04/2023,Nigeria,Johor,28,25,3
1/04/2023,Nigeria,Kedah,4,0,4
1/04/2023,Nigeria,Perlis,1,1,0
1/04/2023,Nigeria,Pulau Pinang,1,1,0
1/04/2023,Nigeria,Sabah,1,1,0
1/04/2023,Nigeria,Sarawak,5,4,1
1/04/2023,Nigeria,Selangor,337,263,74
1/04/2023,Nicaragua,Johor,0,0,0
1/04/2023,Nicaragua,Kedah,0,0,0
1/04/2023,Nicaragua,Pulau Pinang,0,0,0
1/04/2023,Nicaragua,Sabah,0,0,0
1/04/2023,Nicaragua,Selangor,3,2,1
1/04/2023,Netherlands,Johor,916,580,336
1/04/2023,Netherlands,Kedah,430,202,228
1/04/2023,Netherlands,Kelantan,14,9,5
1/04/2023,Netherlands,Melaka,1,0,1
1/04/2023,Netherlands,Negeri Sembilan,0,0,0
1/04/2023,Netherlands,Pahang,0,0,0
1/04/2023,Netherlands,Perak,17,10,7
1/04/2023,Netherlands,Perlis,40,23,17
1/04/2023,Netherlands,Pulau Pinang,279,161,118
1/04/2023,Netherlands,Sabah,111,62,49
1/04/2023,Netherlands,Sarawak,150,91,59
1/04/2023,Netherlands,Selangor,4113,2357,1756
1/04/2023,Netherlands,Terengganu,0,0,0
1/04/2023,Netherlands,W.P. Labuan,3,2,1
1/04/2023,Norway,Johor,158,105,53
1/04/2023,Norway,Kedah,113,54,59
1/04/2023,Norway,Kelantan,4,4,0
1/04/2023,Norway,Melaka,0,0,0
1/04/2023,Norway,Pahang,0,0,0
1/04/2023,Norway,Perak,3,2,1
1/04/2023,Norway,Perlis,10,6,4
1/04/2023,Norway,Pulau Pinang,33,24,9
1/04/2023,Norway,Sabah,25,15,10
1/04/2023,Norway,Sarawak,21,12,9
1/04/2023,Norway,Selangor,534,320,214
1/04/2023,Norway,W.P. Labuan,4,3,1
1/04/2023,Nepal,Johor,792,660,132
1/04/2023,Nepal,Kedah,5,4,1
1/04/2023,Nepal,Pahang,0,0,0
1/04/2023,Nepal,Perak,0,0,0
1/04/2023,Nepal,Perlis,2,2,0
1/04/2023,Nepal,Pulau Pinang,26,21,5
1/04/2023,Nepal,Sabah,6,6,0
1/04/2023,Nepal,Sarawak,356,242,114
1/04/2023,Nepal,Selangor,13569,13021,548
1/04/2023,Nepal,W.P. Labuan,62,49,13
1/04/2023,Nauru,Johor,0,0,0
1/04/2023,Nauru,Pulau Pinang,0,0,0
1/04/2023,Nauru,Selangor,3,3,0
1/04/2023,New Zealand,Johor,814,484,330
1/04/2023,New Zealand,Kedah,137,82,55
1/04/2023,New Zealand,Kelantan,6,5,1
1/04/2023,New Zealand,Melaka,0,0,0
1/04/2023,New Zealand,Negeri Sembilan,0,0,0
1/04/2023,New Zealand,Pahang,9,5,4
1/04/2023,New Zealand,Perak,14,5,9
1/04/2023,New Zealand,Perlis,28,9,19
1/04/2023,New Zealand,Pulau Pinang,246,137,109
1/04/2023,New Zealand,Sabah,62,38,24
1/04/2023,New Zealand,Sarawak,154,77,77
1/04/2023,New Zealand,Selangor,2864,1646,1218
1/04/2023,New Zealand,Terengganu,0,0,0
1/04/2023,New Zealand,W.P. Labuan,0,0,0
1/04/2023,Oman,Johor,14,7,7
1/04/2023,Oman,Kedah,0,0,0
1/04/2023,Oman,Kelantan,0,0,0
1/04/2023,Oman,Melaka,0,0,0
1/04/2023,Oman,Perak,0,0,0
1/04/2023,Oman,Perlis,0,0,0
1/04/2023,Oman,Pulau Pinang,0,0,0
1/04/2023,Oman,Sabah,1,0,1
1/04/2023,Oman,Sarawak,7,5,2
1/04/2023,Oman,Selangor,301,197,104
1/04/2023,Pakistan,Johor,646,480,166
1/04/2023,Pakistan,Kedah,37,30,7
1/04/2023,Pakistan,Kelantan,10,10,0
1/04/2023,Pakistan,Melaka,0,0,0
1/04/2023,Pakistan,Negeri Sembilan,0,0,0
1/04/2023,Pakistan,Pahang,0,0,0
1/04/2023,Pakistan,Perak,27,24,3
1/04/2023,Pakistan,Perlis,20,19,1
1/04/2023,Pakistan,Pulau Pinang,219,214,5
1/04/2023,Pakistan,Sabah,20,15,5
1/04/2023,Pakistan,Sarawak,140,114,26
1/04/2023,Pakistan,Selangor,12969,12042,927
1/04/2023,Pakistan,W.P. Labuan,7,4,3
1/04/2023,Panama,Johor,11,6,5
1/04/2023,Panama,Kedah,1,0,1
1/04/2023,Panama,Perak,0,0,0
1/04/2023,Panama,Perlis,0,0,0
1/04/2023,Panama,Pulau Pinang,2,1,1
1/04/2023,Panama,Sabah,1,0,1
1/04/2023,Panama,Sarawak,0,0,0
1/04/2023,Panama,Selangor,13,3,10
1/04/2023,Peru,Johor,34,18,16
1/04/2023,Peru,Kedah,8,5,3
1/04/2023,Peru,Kelantan,1,1,0
1/04/2023,Peru,Pahang,0,0,0
1/04/2023,Peru,Perak,0,0,0
1/04/2023,Peru,Perlis,1,1,0
1/04/2023,Peru,Pulau Pinang,3,1,2
1/04/2023,Peru,Sabah,2,1,1
1/04/2023,Peru,Sarawak,3,3,0
1/04/2023,Peru,Selangor,106,46,60
1/04/2023,Peru,W.P. Labuan,0,0,0
1/04/2023,Philippines,Johor,19124,6369,12755
1/04/2023,Philippines,Kedah,526,156,370
1/04/2023,Philippines,Kelantan,34,16,18
1/04/2023,Philippines,Melaka,1,0,1
1/04/2023,Philippines,Negeri Sembilan,0,0,0
1/04/2023,Philippines,Pahang,27,21,6
1/04/2023,Philippines,Perak,58,18,40
1/04/2023,Philippines,Perlis,72,19,53
1/04/2023,Philippines,Pulau Pinang,575,202,373
1/04/2023,Philippines,Sabah,1434,593,841
1/04/2023,Philippines,Sarawak,2959,1134,1825
1/04/2023,Philippines,Selangor,13303,5437,7866
1/04/2023,Philippines,Terengganu,0,0,0
1/04/2023,Philippines,W.P. Labuan,122,56,66
1/04/2023,Palau,Johor,0,0,0
1/04/2023,Palau,Pulau Pinang,0,0,0
1/04/2023,Palau,Selangor,0,0,0
1/04/2023,Papua New Guinea,Johor,3,3,0
1/04/2023,Papua New Guinea,Kedah,0,0,0
1/04/2023,Papua New Guinea,Kelantan,0,0,0
1/04/2023,Papua New Guinea,Perak,0,0,0
1/04/2023,Papua New Guinea,Pulau Pinang,2,1,1
1/04/2023,Papua New Guinea,Sabah,0,0,0
1/04/2023,Papua New Guinea,Sarawak,5,2,3
1/04/2023,Papua New Guinea,Selangor,35,22,13
1/04/2023,Poland,Johor,368,217,151
1/04/2023,Poland,Kedah,111,49,62
1/04/2023,Poland,Kelantan,2,1,1
1/04/2023,Poland,Melaka,0,0,0
1/04/2023,Poland,Negeri Sembilan,0,0,0
1/04/2023,Poland,Pahang,2,0,2
1/04/2023,Poland,Perak,3,2,1
1/04/2023,Poland,Perlis,22,13,9
1/04/2023,Poland,Pulau Pinang,60,27,33
1/04/2023,Poland,Sabah,36,21,15
1/04/2023,Poland,Sarawak,31,9,22
1/04/2023,Poland,Selangor,1017,541,476
1/04/2023,Poland,Terengganu,0,0,0
1/04/2023,Poland,W.P. Labuan,0,0,0
1/04/2023,"North Korea, Democratic People's Republic of",Selangor,0,0,0
1/04/2023,Portugal,Johor,145,71,74
1/04/2023,Portugal,Kedah,116,61,55
1/04/2023,Portugal,Kelantan,1,1,0
1/04/2023,Portugal,Melaka,0,0,0
1/04/2023,Portugal,Pahang,0,0,0
1/04/2023,Portugal,Perak,0,0,0
1/04/2023,Portugal,Perlis,4,1,3
1/04/2023,Portugal,Pulau Pinang,31,19,12
1/04/2023,Portugal,Sabah,31,12,19
1/04/2023,Portugal,Sarawak,5,2,3
1/04/2023,Portugal,Selangor,755,414,341
1/04/2023,Portugal,W.P. Labuan,0,0,0
1/04/2023,Paraguay,Johor,2,1,1
1/04/2023,Paraguay,Kedah,1,0,1
1/04/2023,Paraguay,Perak,0,0,0
1/04/2023,Paraguay,Perlis,0,0,0
1/04/2023,Paraguay,Pulau Pinang,0,0,0
1/04/2023,Paraguay,Sabah,0,0,0
1/04/2023,Paraguay,Sarawak,0,0,0
1/04/2023,Paraguay,Selangor,11,8,3
1/04/2023,"Palestine, State of",Johor,16,16,0
1/04/2023,"Palestine, State of",Kedah,0,0,0
1/04/2023,"Palestine, State of",Kelantan,0,0,0
1/04/2023,"Palestine, State of",Melaka,1,1,0
1/04/2023,"Palestine, State of",Perak,0,0,0
1/04/2023,"Palestine, State of",Perlis,0,0,0
1/04/2023,"Palestine, State of",Pulau Pinang,1,1,0
1/04/2023,"Palestine, State of",Sabah,1,1,0
1/04/2023,"Palestine, State of",Sarawak,11,8,3
1/04/2023,"Palestine, State of",Selangor,178,131,47
1/04/2023,Qatar,Johor,7,5,2
1/04/2023,Qatar,Kedah,0,0,0
1/04/2023,Qatar,Perlis,0,0,0
1/04/2023,Qatar,Pulau Pinang,1,1,0
1/04/2023,Qatar,Sabah,0,0,0
1/04/2023,Qatar,Sarawak,0,0,0
1/04/2023,Qatar,Selangor,135,90,45
1/04/2023,Réunion,Johor,0,0,0
1/04/2023,Réunion,Sarawak,0,0,0
1/04/2023,Romania,Johor,160,80,80
1/04/2023,Romania,Kedah,45,26,19
1/04/2023,Romania,Kelantan,1,1,0
1/04/2023,Romania,Negeri Sembilan,0,0,0
1/04/2023,Romania,Pahang,2,2,0
1/04/2023,Romania,Perak,0,0,0
1/04/2023,Romania,Perlis,2,1,1
1/04/2023,Romania,Pulau Pinang,2,2,0
1/04/2023,Romania,Sabah,7,4,3
1/04/2023,Romania,Sarawak,10,8,2
1/04/2023,Romania,Selangor,652,341,311
1/04/2023,Romania,W.P. Labuan,0,0,0
1/04/2023,Russian Federation (Russia),Johor,409,206,203
1/04/2023,Russian Federation (Russia),Kedah,580,314,266
1/04/2023,Russian Federation (Russia),Kelantan,64,42,22
1/04/2023,Russian Federation (Russia),Melaka,2,2,0
1/04/2023,Russian Federation (Russia),Negeri Sembilan,0,0,0
1/04/2023,Russian Federation (Russia),Pahang,3,2,1
1/04/2023,Russian Federation (Russia),Perak,3,3,0
1/04/2023,Russian Federation (Russia),Perlis,368,200,168
1/04/2023,Russian Federation (Russia),Pulau Pinang,158,85,73
1/04/2023,Russian Federation (Russia),Sabah,54,16,38
1/04/2023,Russian Federation (Russia),Sarawak,87,41,46
1/04/2023,Russian Federation (Russia),Selangor,11358,5770,5588
1/04/2023,Russian Federation (Russia),W.P. Labuan,12,8,4
1/04/2023,Rwanda,Johor,1,1,0
1/04/2023,Rwanda,Kedah,0,0,0
1/04/2023,Rwanda,Pulau Pinang,0,0,0
1/04/2023,Rwanda,Selangor,4,2,2
1/04/2023,Saudi Arabia,Johor,103,54,49
1/04/2023,Saudi Arabia,Kedah,6,5,1
1/04/2023,Saudi Arabia,Kelantan,0,0,0
1/04/2023,Saudi Arabia,Melaka,0,0,0
1/04/2023,Saudi Arabia,Perak,0,0,0
1/04/2023,Saudi Arabia,Perlis,4,4,0
1/04/2023,Saudi Arabia,Pulau Pinang,9,5,4
1/04/2023,Saudi Arabia,Sabah,2,2,0
1/04/2023,Saudi Arabia,Sarawak,12,8,4
1/04/2023,Saudi Arabia,Selangor,2211,1253,958
1/04/2023,Saudi Arabia,W.P. Labuan,0,0,0
1/04/2023,Sudan,Johor,12,10,2
1/04/2023,Sudan,Kedah,0,0,0
1/04/2023,Sudan,Kelantan,0,0,0
1/04/2023,Sudan,Perlis,0,0,0
1/04/2023,Sudan,Pulau Pinang,1,0,1
1/04/2023,Sudan,Sabah,0,0,0
1/04/2023,Sudan,Sarawak,3,1,2
1/04/2023,Sudan,Selangor,451,256,195
1/04/2023,Sudan,W.P. Labuan,0,0,0
1/04/2023,Senegal,Johor,21,17,4
1/04/2023,Senegal,Kedah,0,0,0
1/04/2023,Senegal,Kelantan,0,0,0
1/04/2023,Senegal,Perak,0,0,0
1/04/2023,Senegal,Perlis,0,0,0
1/04/2023,Senegal,Pulau Pinang,1,0,1
1/04/2023,Senegal,Sabah,0,0,0
1/04/2023,Senegal,Sarawak,0,0,0
1/04/2023,Senegal,Selangor,58,48,10
1/04/2023,Singapore,Johor,979155,563701,415454
1/04/2023,Singapore,Kedah,3327,1785,1542
1/04/2023,Singapore,Kelantan,34,24,10
1/04/2023,Singapore,Melaka,26,17,9
1/04/2023,Singapore,Negeri Sembilan,0,0,0
1/04/2023,Singapore,Pahang,492,246,246
1/04/2023,Singapore,Perak,5172,2437,2735
1/04/2023,Singapore,Perlis,157,89,68
1/04/2023,Singapore,Pulau Pinang,13384,6801,6583
1/04/2023,Singapore,Sabah,2423,1331,1092
1/04/2023,Singapore,Sarawak,4066,2328,1738
1/04/2023,Singapore,Selangor,33575,17754,15821
1/04/2023,Singapore,Terengganu,1,1,0
1/04/2023,Singapore,W.P. Labuan,14,14,0
1/04/2023,South Georgia and the South Sandwich Islands,Johor,0,0,0
1/04/2023,South Georgia and the South Sandwich Islands,Sabah,0,0,0
1/04/2023,South Georgia and the South Sandwich Islands,Selangor,1,0,1
1/04/2023,Saint Helena,Sarawak,1,1,0
1/04/2023,Solomon Islands,Johor,1,0,1
1/04/2023,Solomon Islands,Perlis,0,0,0
1/04/2023,Solomon Islands,Pulau Pinang,2,1,1
1/04/2023,Solomon Islands,Sabah,0,0,0
1/04/2023,Solomon Islands,Sarawak,5,1,4
1/04/2023,Solomon Islands,Selangor,6,2,4
1/04/2023,Solomon Islands,W.P. Labuan,0,0,0
1/04/2023,Sierra Leone,Johor,3,2,1
1/04/2023,Sierra Leone,Kedah,0,0,0
1/04/2023,Sierra Leone,Perak,0,0,0
1/04/2023,Sierra Leone,Pulau Pinang,0,0,0
1/04/2023,Sierra Leone,Sabah,0,0,0
1/04/2023,Sierra Leone,Selangor,10,10,0
1/04/2023,El Salvador,Johor,0,0,0
1/04/2023,El Salvador,Kedah,1,1,0
1/04/2023,El Salvador,Perak,0,0,0
1/04/2023,El Salvador,Perlis,0,0,0
1/04/2023,El Salvador,Pulau Pinang,0,0,0
1/04/2023,El Salvador,Sabah,0,0,0
1/04/2023,El Salvador,Selangor,26,16,10
1/04/2023,El Salvador,W.P. Labuan,0,0,0
1/04/2023,San Marino,Johor,2,2,0
1/04/2023,San Marino,Selangor,7,0,7
1/04/2023,Somalia,Johor,0,0,0
1/04/2023,Somalia,Kedah,1,1,0
1/04/2023,Somalia,Kelantan,0,0,0
1/04/2023,Somalia,Perlis,0,0,0
1/04/2023,Somalia,Sabah,0,0,0
1/04/2023,Somalia,Sarawak,0,0,0
1/04/2023,Somalia,Selangor,161,98,63
1/04/2023,Serbia,Johor,4,2,2
1/04/2023,Serbia,Kedah,2,2,0
1/04/2023,Serbia,Kelantan,0,0,0
1/04/2023,Serbia,Pahang,0,0,0
1/04/2023,Serbia,Perak,0,0,0
1/04/2023,Serbia,Perlis,0,0,0
1/04/2023,Serbia,Pulau Pinang,1,0,1
1/04/2023,Serbia,Sabah,0,0,0
1/04/2023,Serbia,Sarawak,0,0,0
1/04/2023,Serbia,Selangor,97,47,50
1/04/2023,South Sudan,Johor,0,0,0
1/04/2023,South Sudan,Kedah,0,0,0
1/04/2023,South Sudan,Sarawak,0,0,0
1/04/2023,South Sudan,Selangor,22,12,10
1/04/2023,South Sudan,W.P. Labuan,0,0,0
1/04/2023,Sao Tome and Principe,Selangor,0,0,0
1/04/2023,Suriname,Johor,2,0,2
1/04/2023,Suriname,Kedah,1,0,1
1/04/2023,Suriname,Kelantan,0,0,0
1/04/2023,Suriname,Perak,0,0,0
1/04/2023,Suriname,Perlis,5,5,0
1/04/2023,Suriname,Pulau Pinang,0,0,0
1/04/2023,Suriname,Sabah,0,0,0
1/04/2023,Suriname,Sarawak,0,0,0
1/04/2023,Suriname,Selangor,16,11,5
1/04/2023,Slovakia,Johor,35,22,13
1/04/2023,Slovakia,Kedah,75,39,36
1/04/2023,Slovakia,Kelantan,1,1,0
1/04/2023,Slovakia,Negeri Sembilan,0,0,0
1/04/2023,Slovakia,Pahang,0,0,0
1/04/2023,Slovakia,Perak,0,0,0
1/04/2023,Slovakia,Perlis,2,2,0
1/04/2023,Slovakia,Pulau Pinang,7,5,2
1/04/2023,Slovakia,Sabah,5,4,1
1/04/2023,Slovakia,Sarawak,2,1,1
1/04/2023,Slovakia,Selangor,270,156,114
1/04/2023,Slovakia,W.P. Labuan,4,4,0
1/04/2023,Slovenia,Johor,35,19,16
1/04/2023,Slovenia,Kedah,9,5,4
1/04/2023,Slovenia,Kelantan,0,0,0
1/04/2023,Slovenia,Perak,0,0,0
1/04/2023,Slovenia,Perlis,0,0,0
1/04/2023,Slovenia,Pulau Pinang,6,1,5
1/04/2023,Slovenia,Sabah,2,2,0
1/04/2023,Slovenia,Sarawak,1,1,0
1/04/2023,Slovenia,Selangor,158,86,72
1/04/2023,Slovenia,W.P. Labuan,0,0,0
1/04/2023,Sweden,Johor,261,153,108
1/04/2023,Sweden,Kedah,179,76,103
1/04/2023,Sweden,Kelantan,8,6,2
1/04/2023,Sweden,Melaka,0,0,0
1/04/2023,Sweden,Negeri Sembilan,0,0,0
1/04/2023,Sweden,Pahang,0,0,0
1/04/2023,Sweden,Perak,3,3,0
1/04/2023,Sweden,Perlis,11,6,5
1/04/2023,Sweden,Pulau Pinang,57,33,24
1/04/2023,Sweden,Sabah,50,35,15
1/04/2023,Sweden,Sarawak,9,8,1
1/04/2023,Sweden,Selangor,983,605,378
1/04/2023,Sweden,W.P. Labuan,1,1,0
1/04/2023,Eswatini,Johor,0,0,0
1/04/2023,Eswatini,Kedah,0,0,0
1/04/2023,Eswatini,Pulau Pinang,0,0,0
1/04/2023,Eswatini,Sabah,0,0,0
1/04/2023,Eswatini,Selangor,18,8,10
1/04/2023,Seychelles,Johor,0,0,0
1/04/2023,Seychelles,Kedah,0,0,0
1/04/2023,Seychelles,Pulau Pinang,0,0,0
1/04/2023,Seychelles,Sabah,0,0,0
1/04/2023,Seychelles,Sarawak,0,0,0
1/04/2023,Seychelles,Selangor,87,40,47
1/04/2023,Syrian Arab Republic,Johor,12,9,3
1/04/2023,Syrian Arab Republic,Kedah,1,1,0
1/04/2023,Syrian Arab Republic,Kelantan,0,0,0
1/04/2023,Syrian Arab Republic,Pahang,0,0,0
1/04/2023,Syrian Arab Republic,Perlis,0,0,0
1/04/2023,Syrian Arab Republic,Pulau Pinang,3,3,0
1/04/2023,Syrian Arab Republic,Sabah,0,0,0
1/04/2023,Syrian Arab Republic,Sarawak,2,2,0
1/04/2023,Syrian Arab Republic,Selangor,486,317,169
1/04/2023,Syrian Arab Republic,W.P. Labuan,0,0,0
1/04/2023,Turks and Caicos Islands,Perlis,0,0,0
1/04/2023,TCD,Johor,4,4,0
1/04/2023,TCD,Kedah,0,0,0
1/04/2023,TCD,Perlis,0,0,0
1/04/2023,TCD,Selangor,18,13,5
1/04/2023,Togo,Johor,4,4,0
1/04/2023,Togo,Perak,0,0,0
1/04/2023,Togo,Pulau Pinang,0,0,0
1/04/2023,Togo,Selangor,5,3,2
1/04/2023,Thailand,Johor,6807,2074,4733
1/04/2023,Thailand,Kedah,63470,35000,28470
1/04/2023,Thailand,Kelantan,45732,22705,23027
1/04/2023,Thailand,Melaka,1,0,1
1/04/2023,Thailand,Negeri Sembilan,3,3,0
1/04/2023,Thailand,Pahang,23,15,8
1/04/2023,Thailand,Perak,11797,5219,6578
1/04/2023,Thailand,Perlis,50770,29713,21057
1/04/2023,Thailand,Pulau Pinang,2532,1007,1525
1/04/2023,Thailand,Sabah,64,27,37
1/04/2023,Thailand,Sarawak,426,162,264
1/04/2023,Thailand,Selangor,13420,5257,8163
1/04/2023,Thailand,Terengganu,0,0,0
1/04/2023,Thailand,W.P. Labuan,12,9,3
1/04/2023,Tajikistan,Johor,2,2,0
1/04/2023,Tajikistan,Kedah,0,0,0
1/04/2023,Tajikistan,Perlis,0,0,0
1/04/2023,Tajikistan,Pulau Pinang,0,0,0
1/04/2023,Tajikistan,Sabah,0,0,0
1/04/2023,Tajikistan,Selangor,40,31,9
1/04/2023,Tokelau,Selangor,0,0,0
1/04/2023,Turkmenistan,Johor,2,1,1
1/04/2023,Turkmenistan,Kedah,0,0,0
1/04/2023,Turkmenistan,Kelantan,0,0,0
1/04/2023,Turkmenistan,Perlis,0,0,0
1/04/2023,Turkmenistan,Pulau Pinang,0,0,0
1/04/2023,Turkmenistan,Sabah,0,0,0
1/04/2023,Turkmenistan,Sarawak,1,1,0
1/04/2023,Turkmenistan,Selangor,48,28,20
1/04/2023,Timor-Leste,Johor,0,0,0
1/04/2023,Timor-Leste,Kedah,1,1,0
1/04/2023,Timor-Leste,Perlis,0,0,0
1/04/2023,Timor-Leste,Pulau Pinang,3,1,2
1/04/2023,Timor-Leste,Sabah,0,0,0
1/04/2023,Timor-Leste,Sarawak,1,1,0
1/04/2023,Timor-Leste,Selangor,162,80,82
1/04/2023,Tonga,Johor,0,0,0
1/04/2023,Tonga,Pulau Pinang,3,1,2
1/04/2023,Tonga,Sarawak,0,0,0
1/04/2023,Tonga,Selangor,11,6,5
1/04/2023,Trinidad and Tobago,Johor,10,6,4
1/04/2023,Trinidad and Tobago,Kedah,0,0,0
1/04/2023,Trinidad and Tobago,Pahang,0,0,0
1/04/2023,Trinidad and Tobago,Pulau Pinang,4,2,2
1/04/2023,Trinidad and Tobago,Sabah,1,1,0
1/04/2023,Trinidad and Tobago,Sarawak,1,1,0
1/04/2023,Trinidad and Tobago,Selangor,25,13,12
1/04/2023,Tunisia,Johor,16,7,9
1/04/2023,Tunisia,Kedah,9,7,2
1/04/2023,Tunisia,Kelantan,0,0,0
1/04/2023,Tunisia,Melaka,0,0,0
1/04/2023,Tunisia,Perak,0,0,0
1/04/2023,Tunisia,Perlis,0,0,0
1/04/2023,Tunisia,Pulau Pinang,1,1,0
1/04/2023,Tunisia,Sabah,4,4,0
1/04/2023,Tunisia,Sarawak,2,1,1
1/04/2023,Tunisia,Selangor,199,107,92
1/04/2023,Tunisia,W.P. Labuan,0,0,0
1/04/2023,Türkiye,Johor,223,153,70
1/04/2023,Türkiye,Kedah,53,30,23
1/04/2023,Türkiye,Kelantan,4,4,0
1/04/2023,Türkiye,Melaka,0,0,0
1/04/2023,Türkiye,Negeri Sembilan,0,0,0
1/04/2023,Türkiye,Pahang,0,0,0
1/04/2023,Türkiye,Perak,0,0,0
1/04/2023,Türkiye,Perlis,18,16,2
1/04/2023,Türkiye,Pulau Pinang,30,21,9
1/04/2023,Türkiye,Sabah,13,8,5
1/04/2023,Türkiye,Sarawak,24,19,5
1/04/2023,Türkiye,Selangor,1143,767,376
1/04/2023,Türkiye,W.P. Labuan,0,0,0
1/04/2023,Tuvalu,Selangor,0,0,0
1/04/2023,"Taiwan, Province of China",Johor,5061,2205,2856
1/04/2023,"Taiwan, Province of China",Kedah,166,74,92
1/04/2023,"Taiwan, Province of China",Kelantan,1,0,1
1/04/2023,"Taiwan, Province of China",Melaka,10,2,8
1/04/2023,"Taiwan, Province of China",Negeri Sembilan,0,0,0
1/04/2023,"Taiwan, Province of China",Pahang,3,1,2
1/04/2023,"Taiwan, Province of China",Perak,63,35,28
1/04/2023,"Taiwan, Province of China",Perlis,12,2,10
1/04/2023,"Taiwan, Province of China",Pulau Pinang,2989,1442,1547
1/04/2023,"Taiwan, Province of China",Sabah,1895,913,982
1/04/2023,"Taiwan, Province of China",Sarawak,307,138,169
1/04/2023,"Taiwan, Province of China",Selangor,12359,5939,6420
1/04/2023,"Taiwan, Province of China",W.P. Labuan,13,6,7
1/04/2023,"Tanzania, United Republic of",Johor,2,1,1
1/04/2023,"Tanzania, United Republic of",Kedah,0,0,0
1/04/2023,"Tanzania, United Republic of",Perak,0,0,0
1/04/2023,"Tanzania, United Republic of",Perlis,0,0,0
1/04/2023,"Tanzania, United Republic of",Pulau Pinang,0,0,0
1/04/2023,"Tanzania, United Republic of",Sabah,1,0,1
1/04/2023,"Tanzania, United Republic of",Sarawak,3,3,0
1/04/2023,"Tanzania, United Republic of",Selangor,101,47,54
1/04/2023,Uganda,Johor,8,2,6
1/04/2023,Uganda,Kedah,0,0,0
1/04/2023,Uganda,Perak,0,0,0
1/04/2023,Uganda,Perlis,1,0,1
1/04/2023,Uganda,Pulau Pinang,0,0,0
1/04/2023,Uganda,Sabah,1,1,0
1/04/2023,Uganda,Sarawak,0,0,0
1/04/2023,Uganda,Selangor,80,29,51
1/04/2023,Ukraine,Johor,85,40,45
1/04/2023,Ukraine,Kedah,47,17,30
1/04/2023,Ukraine,Kelantan,10,7,3
1/04/2023,Ukraine,Melaka,1,1,0
1/04/2023,Ukraine,Negeri Sembilan,0,0,0
1/04/2023,Ukraine,Pahang,1,1,0
1/04/2023,Ukraine,Perak,5,3,2
1/04/2023,Ukraine,Perlis,13,8,5
1/04/2023,Ukraine,Pulau Pinang,19,7,12
1/04/2023,Ukraine,Sabah,18,12,6
1/04/2023,Ukraine,Sarawak,8,7,1
1/04/2023,Ukraine,Selangor,1100,465,635
1/04/2023,Ukraine,W.P. Labuan,0,0,0
1/04/2023,Uruguay,Johor,16,10,6
1/04/2023,Uruguay,Kedah,1,1,0
1/04/2023,Uruguay,Kelantan,0,0,0
1/04/2023,Uruguay,Perak,0,0,0
1/04/2023,Uruguay,Perlis,0,0,0
1/04/2023,Uruguay,Pulau Pinang,0,0,0
1/04/2023,Uruguay,Sabah,2,1,1
1/04/2023,Uruguay,Sarawak,0,0,0
1/04/2023,Uruguay,Selangor,186,77,109
1/04/2023,Uruguay,W.P. Labuan,0,0,0
1/04/2023,United States of America,Johor,3763,2235,1528
1/04/2023,United States of America,Kedah,621,345,276
1/04/2023,United States of America,Kelantan,15,6,9
1/04/2023,United States of America,Melaka,1,0,1
1/04/2023,United States of America,Negeri Sembilan,1,1,0
1/04/2023,United States of America,Pahang,13,8,5
1/04/2023,United States of America,Perak,115,55,60
1/04/2023,United States of America,Perlis,113,70,43
1/04/2023,United States of America,Pulau Pinang,1684,1023,661
1/04/2023,United States of America,Sabah,671,336,335
1/04/2023,United States of America,Sarawak,293,168,125
1/04/2023,United States of America,Selangor,11293,6612,4681
1/04/2023,United States of America,Terengganu,0,0,0
1/04/2023,United States of America,W.P. Labuan,9,3,6
1/04/2023,Uzbekistan,Johor,83,73,10
1/04/2023,Uzbekistan,Kedah,14,6,8
1/04/2023,Uzbekistan,Kelantan,0,0,0
1/04/2023,Uzbekistan,Perak,0,0,0
1/04/2023,Uzbekistan,Perlis,2,1,1
1/04/2023,Uzbekistan,Pulau Pinang,9,2,7
1/04/2023,Uzbekistan,Sabah,5,4,1
1/04/2023,Uzbekistan,Sarawak,1,0,1
1/04/2023,Uzbekistan,Selangor,668,387,281
1/04/2023,Holy See,Johor,0,0,0
1/04/2023,Holy See,Sarawak,0,0,0
1/04/2023,Holy See,Selangor,0,0,0
1/04/2023,Saint Vincent and the Grenadines,Johor,0,0,0
1/04/2023,Saint Vincent and the Grenadines,Kedah,0,0,0
1/04/2023,Saint Vincent and the Grenadines,Pulau Pinang,0,0,0
1/04/2023,Saint Vincent and the Grenadines,Sarawak,2,2,0
1/04/2023,Saint Vincent and the Grenadines,Selangor,1,1,0
1/04/2023,"Venezuela, Bolivarian Republic of",Johor,5,3,2
1/04/2023,"Venezuela, Bolivarian Republic of",Kedah,6,2,4
1/04/2023,"Venezuela, Bolivarian Republic of",Kelantan,0,0,0
1/04/2023,"Venezuela, Bolivarian Republic of",Melaka,0,0,0
1/04/2023,"Venezuela, Bolivarian Republic of",Perak,0,0,0
1/04/2023,"Venezuela, Bolivarian Republic of",Perlis,0,0,0
1/04/2023,"Venezuela, Bolivarian Republic of",Pulau Pinang,1,1,0
1/04/2023,"Venezuela, Bolivarian Republic of",Sabah,3,2,1
1/04/2023,"Venezuela, Bolivarian Republic of",Sarawak,7,6,1
1/04/2023,"Venezuela, Bolivarian Republic of",Selangor,77,43,34
1/04/2023,"Venezuela, Bolivarian Republic of",W.P. Labuan,0,0,0
1/04/2023,Viet Nam,Johor,12560,3972,8588
1/04/2023,Viet Nam,Kedah,436,58,378
1/04/2023,Viet Nam,Kelantan,8,1,7
1/04/2023,Viet Nam,Melaka,1,1,0
1/04/2023,Viet Nam,Negeri Sembilan,0,0,0
1/04/2023,Viet Nam,Pahang,1,0,1
1/04/2023,Viet Nam,Perak,163,10,153
1/04/2023,Viet Nam,Perlis,244,29,215
1/04/2023,Viet Nam,Pulau Pinang,1380,429,951
1/04/2023,Viet Nam,Sabah,38,13,25
1/04/2023,Viet Nam,Sarawak,210,35,175
1/04/2023,Viet Nam,Selangor,14699,5375,9324
1/04/2023,Viet Nam,Terengganu,0,0,0
1/04/2023,Viet Nam,W.P. Labuan,2,1,1
1/04/2023,Vanuatu,Johor,23,20,3
1/04/2023,Vanuatu,Kedah,2,1,1
1/04/2023,Vanuatu,Pulau Pinang,4,4,0
1/04/2023,Vanuatu,Sabah,1,1,0
1/04/2023,Vanuatu,Sarawak,0,0,0
1/04/2023,Vanuatu,Selangor,57,46,11
1/04/2023, Samoa,Johor,1,0,1
1/04/2023, Samoa,Sarawak,0,0,0
1/04/2023, Samoa,Selangor,3,1,2
1/04/2023,Yemen,Johor,33,24,9
1/04/2023,Yemen,Kedah,2,2,0
1/04/2023,Yemen,Kelantan,1,1,0
1/04/2023,Yemen,Melaka,0,0,0
1/04/2023,Yemen,Pahang,1,1,0
1/04/2023,Yemen,Perak,1,1,0
1/04/2023,Yemen,Perlis,1,1,0
1/04/2023,Yemen,Pulau Pinang,1,1,0
1/04/2023,Yemen,Sabah,1,1,0
1/04/2023,Yemen,Sarawak,2,1,1
1/04/2023,Yemen,Selangor,916,621,295
1/04/2023,Yemen,W.P. Labuan,0,0,0
1/04/2023,South Africa,Johor,312,183,129
1/04/2023,South Africa,Kedah,89,40,49
1/04/2023,South Africa,Kelantan,2,1,1
1/04/2023,South Africa,Melaka,0,0,0
1/04/2023,South Africa,Pahang,2,2,0
1/04/2023,South Africa,Perak,1,1,0
1/04/2023,South Africa,Perlis,8,6,2
1/04/2023,South Africa,Pulau Pinang,46,22,24
1/04/2023,South Africa,Sabah,30,16,14
1/04/2023,South Africa,Sarawak,164,82,82
1/04/2023,South Africa,Selangor,1002,491,511
1/04/2023,South Africa,Terengganu,0,0,0
1/04/2023,South Africa,W.P. Labuan,7,4,3
1/04/2023,ZAR,Selangor,0,0,0
1/04/2023,Zambia,Johor,1,1,0
1/04/2023,Zambia,Kedah,0,0,0
1/04/2023,Zambia,Perak,0,0,0
1/04/2023,Zambia,Perlis,0,0,0
1/04/2023,Zambia,Pulau Pinang,1,1,0
1/04/2023,Zambia,Sabah,0,0,0
1/04/2023,Zambia,Sarawak,2,2,0
1/04/2023,Zambia,Selangor,41,26,15
1/04/2023,Zimbabwe,Johor,8,5,3
1/04/2023,Zimbabwe,Kedah,1,0,1
1/04/2023,Zimbabwe,Kelantan,0,0,0
1/04/2023,Zimbabwe,Perak,0,0,0
1/04/2023,Zimbabwe,Perlis,1,1,0
1/04/2023,Zimbabwe,Pulau Pinang,1,0,1
1/04/2023,Zimbabwe,Sabah,0,0,0
1/04/2023,Zimbabwe,Sarawak,0,0,0
1/04/2023,Zimbabwe,Selangor,94,40,54
1/05/2023,Aruba,Kedah,0,0,0
1/05/2023,Aruba,Pulau Pinang,0,0,0
1/05/2023,Afghanistan,Johor,2,2,0
1/05/2023,Afghanistan,Kedah,1,1,0
1/05/2023,Afghanistan,Perlis,0,0,0
1/05/2023,Afghanistan,Pulau Pinang,0,0,0
1/05/2023,Afghanistan,Sarawak,0,0,0
1/05/2023,Afghanistan,Selangor,51,35,16
1/05/2023,Angola,Johor,0,0,0
1/05/2023,Angola,Kedah,0,0,0
1/05/2023,Angola,Sabah,0,0,0
1/05/2023,Angola,Selangor,6,5,1
1/05/2023,Anguilla,Selangor,0,0,0
1/05/2023,Albania,Johor,17,13,4
1/05/2023,Albania,Kedah,1,0,1
1/05/2023,Albania,Perak,0,0,0
1/05/2023,Albania,Perlis,0,0,0
1/05/2023,Albania,Pulau Pinang,2,0,2
1/05/2023,Albania,Sabah,0,0,0
1/05/2023,Albania,Sarawak,0,0,0
1/05/2023,Albania,Selangor,27,21,6
1/05/2023,Andorra,Johor,0,0,0
1/05/2023,Andorra,Kedah,0,0,0
1/05/2023,Andorra,Perlis,0,0,0
1/05/2023,Andorra,Pulau Pinang,1,1,0
1/05/2023,Andorra,Selangor,2,1,1
1/05/2023,Antigua and Barbuda,Selangor,0,0,0
1/05/2023,United Arab Emirates,Johor,14,10,4
1/05/2023,United Arab Emirates,Kedah,81,78,3
1/05/2023,United Arab Emirates,Kelantan,0,0,0
1/05/2023,United Arab Emirates,Perak,0,0,0
1/05/2023,United Arab Emirates,Perlis,0,0,0
1/05/2023,United Arab Emirates,Pulau Pinang,0,0,0
1/05/2023,United Arab Emirates,Sabah,0,0,0
1/05/2023,United Arab Emirates,Sarawak,2,2,0
1/05/2023,United Arab Emirates,Selangor,509,363,146
1/05/2023,Argentina,Johor,64,39,25
1/05/2023,Argentina,Kedah,36,14,22
1/05/2023,Argentina,Kelantan,0,0,0
1/05/2023,Argentina,Melaka,0,0,0
1/05/2023,Argentina,Perak,2,1,1
1/05/2023,Argentina,Perlis,10,6,4
1/05/2023,Argentina,Pulau Pinang,4,1,3
1/05/2023,Argentina,Sabah,3,2,1
1/05/2023,Argentina,Sarawak,3,2,1
1/05/2023,Argentina,Selangor,335,181,154
1/05/2023,Argentina,W.P. Labuan,0,0,0
1/05/2023,Armenia,Johor,19,4,15
1/05/2023,Armenia,Kedah,0,0,0
1/05/2023,Armenia,Kelantan,0,0,0
1/05/2023,Armenia,Perak,0,0,0
1/05/2023,Armenia,Perlis,0,0,0
1/05/2023,Armenia,Pulau Pinang,4,2,2
1/05/2023,Armenia,Sabah,1,1,0
1/05/2023,Armenia,Sarawak,0,0,0
1/05/2023,Armenia,Selangor,48,28,20
1/05/2023,Antarctica,Selangor,0,0,0
1/05/2023,Antigua and Barbuda,Johor,5,5,0
1/05/2023,Antigua and Barbuda,Kedah,0,0,0
1/05/2023,Antigua and Barbuda,Pulau Pinang,0,0,0
1/05/2023,Antigua and Barbuda,Sarawak,0,0,0
1/05/2023,Antigua and Barbuda,Selangor,9,7,2
1/05/2023,Australia,Johor,4250,2490,1760
1/05/2023,Australia,Kedah,459,271,188
1/05/2023,Australia,Kelantan,30,24,6
1/05/2023,Australia,Melaka,2,1,1
1/05/2023,Australia,Negeri Sembilan,1,1,0
1/05/2023,Australia,Pahang,13,10,3
1/05/2023,Australia,Perak,158,81,77
1/05/2023,Australia,Perlis,59,32,27
1/05/2023,Australia,Pulau Pinang,1621,872,749
1/05/2023,Australia,Sabah,390,204,186
1/05/2023,Australia,Sarawak,575,315,260
1/05/2023,Australia,Selangor,18192,10579,7613
1/05/2023,Australia,Terengganu,0,0,0
1/05/2023,Australia,W.P. Labuan,7,2,5
1/05/2023,Austria,Johor,138,94,44
1/05/2023,Austria,Kedah,46,28,18
1/05/2023,Austria,Kelantan,4,2,2
1/05/2023,Austria,Melaka,0,0,0
1/05/2023,Austria,Negeri Sembilan,0,0,0
1/05/2023,Austria,Pahang,1,1,0
1/05/2023,Austria,Perak,3,2,1
1/05/2023,Austria,Perlis,11,7,4
1/05/2023,Austria,Pulau Pinang,72,56,16
1/05/2023,Austria,Sabah,9,2,7
1/05/2023,Austria,Sarawak,44,24,20
1/05/2023,Austria,Selangor,742,455,287
1/05/2023,Austria,Terengganu,0,0,0
1/05/2023,Austria,W.P. Labuan,0,0,0
1/05/2023,Azerbaijan,Johor,5,1,4
1/05/2023,Azerbaijan,Kedah,2,1,1
1/05/2023,Azerbaijan,Kelantan,0,0,0
1/05/2023,Azerbaijan,Melaka,0,0,0
1/05/2023,Azerbaijan,Perlis,0,0,0
1/05/2023,Azerbaijan,Pulau Pinang,0,0,0
1/05/2023,Azerbaijan,Sabah,0,0,0
1/05/2023,Azerbaijan,Sarawak,1,0,1
1/05/2023,Azerbaijan,Selangor,119,75,44
1/05/2023,Azerbaijan,W.P. Labuan,0,0,0
1/05/2023,Burundi,Pulau Pinang,0,0,0
1/05/2023,Burundi,Sarawak,0,0,0
1/05/2023,Burundi,Selangor,2,1,1
1/05/2023,Belgium,Johor,242,133,109
1/05/2023,Belgium,Kedah,84,45,39
1/05/2023,Belgium,Kelantan,1,1,0
1/05/2023,Belgium,Melaka,0,0,0
1/05/2023,Belgium,Negeri Sembilan,0,0,0
1/05/2023,Belgium,Pahang,0,0,0
1/05/2023,Belgium,Perak,0,0,0
1/05/2023,Belgium,Perlis,13,7,6
1/05/2023,Belgium,Pulau Pinang,50,37,13
1/05/2023,Belgium,Sabah,17,10,7
1/05/2023,Belgium,Sarawak,25,12,13
1/05/2023,Belgium,Selangor,1019,633,386
1/05/2023,Belgium,W.P. Labuan,3,2,1
1/05/2023,Benin,Johor,0,0,0
1/05/2023,Benin,Kedah,0,0,0
1/05/2023,Benin,Perak,0,0,0
1/05/2023,Benin,Pulau Pinang,0,0,0
1/05/2023,Benin,Sabah,0,0,0
1/05/2023,Benin,Sarawak,0,0,0
1/05/2023,Benin,Selangor,12,9,3
1/05/2023,Burkina Faso,Perak,0,0,0
1/05/2023,Burkina Faso,Pulau Pinang,0,0,0
1/05/2023,Burkina Faso,Selangor,14,13,1
1/05/2023,Bangladesh,Johor,2602,2243,359
1/05/2023,Bangladesh,Kedah,37,25,12
1/05/2023,Bangladesh,Kelantan,0,0,0
1/05/2023,Bangladesh,Melaka,0,0,0
1/05/2023,Bangladesh,Negeri Sembilan,0,0,0
1/05/2023,Bangladesh,Pahang,0,0,0
1/05/2023,Bangladesh,Perak,1,1,0
1/05/2023,Bangladesh,Perlis,2,2,0
1/05/2023,Bangladesh,Pulau Pinang,680,661,19
1/05/2023,Bangladesh,Sabah,3,1,2
1/05/2023,Bangladesh,Sarawak,50,45,5
1/05/2023,Bangladesh,Selangor,45160,43891,1269
1/05/2023,Bangladesh,W.P. Labuan,15,14,1
1/05/2023,Bulgaria,Johor,50,32,18
1/05/2023,Bulgaria,Kedah,4,2,2
1/05/2023,Bulgaria,Kelantan,2,1,1
1/05/2023,Bulgaria,Pahang,0,0,0
1/05/2023,Bulgaria,Perak,0,0,0
1/05/2023,Bulgaria,Perlis,0,0,0
1/05/2023,Bulgaria,Pulau Pinang,6,4,2
1/05/2023,Bulgaria,Sabah,0,0,0
1/05/2023,Bulgaria,Sarawak,0,0,0
1/05/2023,Bulgaria,Selangor,191,105,86
1/05/2023,Bulgaria,W.P. Labuan,0,0,0
1/05/2023,Bahrain,Johor,6,3,3
1/05/2023,Bahrain,Kedah,0,0,0
1/05/2023,Bahrain,Kelantan,0,0,0
1/05/2023,Bahrain,Perlis,0,0,0
1/05/2023,Bahrain,Pulau Pinang,0,0,0
1/05/2023,Bahrain,Sabah,0,0,0
1/05/2023,Bahrain,Sarawak,0,0,0
1/05/2023,Bahrain,Selangor,120,68,52
1/05/2023,Bahamas,Johor,1,1,0
1/05/2023,Bahamas,Kedah,0,0,0
1/05/2023,Bahamas,Perak,0,0,0
1/05/2023,Bahamas,Sabah,0,0,0
1/05/2023,Bahamas,Sarawak,0,0,0
1/05/2023,Bahamas,Selangor,9,6,3
1/05/2023,Bosnia and Herzegovina,Johor,13,9,4
1/05/2023,Bosnia and Herzegovina,Kedah,0,0,0
1/05/2023,Bosnia and Herzegovina,Perlis,0,0,0
1/05/2023,Bosnia and Herzegovina,Pulau Pinang,2,2,0
1/05/2023,Bosnia and Herzegovina,Sabah,0,0,0
1/05/2023,Bosnia and Herzegovina,Sarawak,2,2,0
1/05/2023,Bosnia and Herzegovina,Selangor,46,25,21
1/05/2023,Belarus,Johor,10,4,6
1/05/2023,Belarus,Kedah,10,6,4
1/05/2023,Belarus,Kelantan,0,0,0
1/05/2023,Belarus,Pahang,0,0,0
1/05/2023,Belarus,Perak,0,0,0
1/05/2023,Belarus,Perlis,3,3,0
1/05/2023,Belarus,Pulau Pinang,3,2,1
1/05/2023,Belarus,Sabah,0,0,0
1/05/2023,Belarus,Sarawak,1,0,1
1/05/2023,Belarus,Selangor,364,175,189
1/05/2023,Belarus,W.P. Labuan,0,0,0
1/05/2023,Belize,Johor,3,0,3
1/05/2023,Belize,Pulau Pinang,0,0,0
1/05/2023,Belize,Sarawak,0,0,0
1/05/2023,Belize,Selangor,6,2,4
1/05/2023,Bermuda,Selangor,0,0,0
1/05/2023,Bolivia,Johor,1,0,1
1/05/2023,Bolivia,Kedah,1,1,0
1/05/2023,Bolivia,Melaka,0,0,0
1/05/2023,Bolivia,Perak,0,0,0
1/05/2023,Bolivia,Perlis,0,0,0
1/05/2023,Bolivia,Pulau Pinang,0,0,0
1/05/2023,Bolivia,Sabah,1,1,0
1/05/2023,Bolivia,Sarawak,0,0,0
1/05/2023,Bolivia,Selangor,38,26,12
1/05/2023,Brazil,Johor,208,122,86
1/05/2023,Brazil,Kedah,83,40,43
1/05/2023,Brazil,Kelantan,0,0,0
1/05/2023,Brazil,Melaka,0,0,0
1/05/2023,Brazil,Pahang,0,0,0
1/05/2023,Brazil,Perak,2,2,0
1/05/2023,Brazil,Perlis,7,4,3
1/05/2023,Brazil,Pulau Pinang,31,12,19
1/05/2023,Brazil,Sabah,21,12,9
1/05/2023,Brazil,Sarawak,7,4,3
1/05/2023,Brazil,Selangor,772,463,309
1/05/2023,Brazil,W.P. Labuan,0,0,0
1/05/2023,Barbados,Johor,0,0,0
1/05/2023,Barbados,Kedah,0,0,0
1/05/2023,Barbados,Perlis,0,0,0
1/05/2023,Barbados,Pulau Pinang,0,0,0
1/05/2023,Barbados,Selangor,6,3,3
1/05/2023,Brunei Darussalam,Johor,330,185,145
1/05/2023,Brunei Darussalam,Kedah,22,10,12
1/05/2023,Brunei Darussalam,Kelantan,6,3,3
1/05/2023,Brunei Darussalam,Melaka,0,0,0
1/05/2023,Brunei Darussalam,Pahang,0,0,0
1/05/2023,Brunei Darussalam,Perak,4,1,3
1/05/2023,Brunei Darussalam,Perlis,5,2,3
1/05/2023,Brunei Darussalam,Pulau Pinang,11,7,4
1/05/2023,Brunei Darussalam,Sabah,729,303,426
1/05/2023,Brunei Darussalam,Sarawak,84510,47743,36767
1/05/2023,Brunei Darussalam,Selangor,3820,1898,1922
1/05/2023,Brunei Darussalam,W.P. Labuan,1202,764,438
1/05/2023,Bhutan,Johor,6,5,1
1/05/2023,Bhutan,Kedah,0,0,0
1/05/2023,Bhutan,Perak,0,0,0
1/05/2023,Bhutan,Perlis,0,0,0
1/05/2023,Bhutan,Pulau Pinang,1,1,0
1/05/2023,Bhutan,Sabah,0,0,0
1/05/2023,Bhutan,Sarawak,0,0,0
1/05/2023,Bhutan,Selangor,35,27,8
1/05/2023,Botswana,Johor,0,0,0
1/05/2023,Botswana,Kedah,0,0,0
1/05/2023,Botswana,Perlis,0,0,0
1/05/2023,Botswana,Pulau Pinang,0,0,0
1/05/2023,Botswana,Sabah,0,0,0
1/05/2023,Botswana,Sarawak,2,2,0
1/05/2023,Botswana,Selangor,10,3,7
1/05/2023,Central African Republic,Kedah,0,0,0
1/05/2023,Central African Republic,Selangor,1,1,0
1/05/2023,Canada,Johor,1363,758,605
1/05/2023,Canada,Kedah,160,88,72
1/05/2023,Canada,Kelantan,11,8,3
1/05/2023,Canada,Melaka,0,0,0
1/05/2023,Canada,Negeri Sembilan,0,0,0
1/05/2023,Canada,Pahang,0,0,0
1/05/2023,Canada,Perak,31,16,15
1/05/2023,Canada,Perlis,67,30,37
1/05/2023,Canada,Pulau Pinang,416,237,179
1/05/2023,Canada,Sabah,171,79,92
1/05/2023,Canada,Sarawak,488,255,233
1/05/2023,Canada,Selangor,3929,2222,1707
1/05/2023,Canada,Terengganu,0,0,0
1/05/2023,Canada,W.P. Labuan,6,3,3
1/05/2023,Cocos (Keeling) Islands,Selangor,0,0,0
1/05/2023,Switzerland,Johor,324,194,130
1/05/2023,Switzerland,Kedah,150,79,71
1/05/2023,Switzerland,Kelantan,0,0,0
1/05/2023,Switzerland,Melaka,1,0,1
1/05/2023,Switzerland,Negeri Sembilan,0,0,0
1/05/2023,Switzerland,Pahang,5,2,3
1/05/2023,Switzerland,Perak,3,1,2
1/05/2023,Switzerland,Perlis,35,17,18
1/05/2023,Switzerland,Pulau Pinang,124,87,37
1/05/2023,Switzerland,Sabah,56,34,22
1/05/2023,Switzerland,Sarawak,43,23,20
1/05/2023,Switzerland,Selangor,1044,646,398
1/05/2023,Switzerland,W.P. Labuan,2,1,1
1/05/2023,Chile,Johor,21,11,10
1/05/2023,Chile,Kedah,14,5,9
1/05/2023,Chile,Kelantan,0,0,0
1/05/2023,Chile,Melaka,0,0,0
1/05/2023,Chile,Pahang,0,0,0
1/05/2023,Chile,Perak,0,0,0
1/05/2023,Chile,Perlis,4,2,2
1/05/2023,Chile,Pulau Pinang,4,2,2
1/05/2023,Chile,Sabah,2,1,1
1/05/2023,Chile,Sarawak,2,1,1
1/05/2023,Chile,Selangor,222,123,99
1/05/2023,China,Johor,36806,16137,20669
1/05/2023,China,Kedah,920,481,439
1/05/2023,China,Kelantan,11,4,7
1/05/2023,China,Melaka,2,1,1
1/05/2023,China,Pahang,45,31,14
1/05/2023,China,Perak,259,116,143
1/05/2023,China,Perlis,84,45,39
1/05/2023,China,Pulau Pinang,7202,4011,3191
1/05/2023,China,Sabah,11645,5509,6136
1/05/2023,China,Sarawak,785,360,425
1/05/2023,China,Selangor,75302,39798,35504
1/05/2023,China,Terengganu,0,0,0
1/05/2023,China,W.P. Labuan,75,64,11
1/05/2023,Côte d'Ivoire,Johor,0,0,0
1/05/2023,Côte d'Ivoire,Kedah,0,0,0
1/05/2023,Côte d'Ivoire,Pulau Pinang,0,0,0
1/05/2023,Côte d'Ivoire,Sabah,0,0,0
1/05/2023,Côte d'Ivoire,Sarawak,0,0,0
1/05/2023,Côte d'Ivoire,Selangor,37,28,9
1/05/2023,Cameroon,Johor,1,1,0
1/05/2023,Cameroon,Kedah,0,0,0
1/05/2023,Cameroon,Pulau Pinang,0,0,0
1/05/2023,Cameroon,Sabah,0,0,0
1/05/2023,Cameroon,Sarawak,0,0,0
1/05/2023,Cameroon,Selangor,32,21,11
1/05/2023,Congo,Johor,0,0,0
1/05/2023,Congo,Pulau Pinang,0,0,0
1/05/2023,Congo,Sarawak,0,0,0
1/05/2023,Congo,Selangor,16,12,4
1/05/2023,Congo,Johor,0,0,0
1/05/2023,Congo,Kedah,0,0,0
1/05/2023,Congo,Selangor,0,0,0
1/05/2023,Cook Islands,Selangor,0,0,0
1/05/2023,Colombia,Johor,29,13,16
1/05/2023,Colombia,Kedah,1,0,1
1/05/2023,Colombia,Perak,0,0,0
1/05/2023,Colombia,Pulau Pinang,7,4,3
1/05/2023,Colombia,Sabah,3,0,3
1/05/2023,Colombia,Sarawak,5,2,3
1/05/2023,Colombia,Selangor,188,91,97
1/05/2023,Colombia,W.P. Labuan,0,0,0
1/05/2023,Comoros,Johor,0,0,0
1/05/2023,Comoros,Kedah,1,1,0
1/05/2023,Comoros,Selangor,3,3,0
1/05/2023,Cabo Verde,Johor,0,0,0
1/05/2023,Cabo Verde,Kedah,0,0,0
1/05/2023,Cabo Verde,Pulau Pinang,0,0,0
1/05/2023,Cabo Verde,Sabah,0,0,0
1/05/2023,Cabo Verde,Selangor,1,0,1
1/05/2023,Costa Rica,Johor,3,2,1
1/05/2023,Costa Rica,Kedah,0,0,0
1/05/2023,Costa Rica,Perak,0,0,0
1/05/2023,Costa Rica,Perlis,0,0,0
1/05/2023,Costa Rica,Pulau Pinang,11,8,3
1/05/2023,Costa Rica,Sabah,4,2,2
1/05/2023,Costa Rica,Sarawak,0,0,0
1/05/2023,Costa Rica,Selangor,44,24,20
1/05/2023,Cuba,Johor,1,1,0
1/05/2023,Cuba,Kedah,0,0,0
1/05/2023,Cuba,Perlis,0,0,0
1/05/2023,Cuba,Pulau Pinang,0,0,0
1/05/2023,Cuba,Sabah,0,0,0
1/05/2023,Cuba,Sarawak,0,0,0
1/05/2023,Cuba,Selangor,31,17,14
1/05/2023,Cyprus,Johor,9,3,6
1/05/2023,Cyprus,Kedah,1,1,0
1/05/2023,Cyprus,Perak,0,0,0
1/05/2023,Cyprus,Perlis,0,0,0
1/05/2023,Cyprus,Pulau Pinang,1,1,0
1/05/2023,Cyprus,Sabah,0,0,0
1/05/2023,Cyprus,Sarawak,0,0,0
1/05/2023,Cyprus,Selangor,47,32,15
1/05/2023,Czechia,Johor,58,39,19
1/05/2023,Czechia,Kedah,33,18,15
1/05/2023,Czechia,Kelantan,0,0,0
1/05/2023,Czechia,Melaka,0,0,0
1/05/2023,Czechia,Negeri Sembilan,0,0,0
1/05/2023,Czechia,Perak,1,1,0
1/05/2023,Czechia,Perlis,4,1,3
1/05/2023,Czechia,Pulau Pinang,16,11,5
1/05/2023,Czechia,Sabah,15,10,5
1/05/2023,Czechia,Sarawak,17,12,5
1/05/2023,Czechia,Selangor,299,189,110
1/05/2023,Czechia,W.P. Labuan,2,1,1
1/05/2023,Germany,Johor,1735,1109,626
1/05/2023,Germany,Kedah,546,271,275
1/05/2023,Germany,Kelantan,16,9,7
1/05/2023,Germany,Melaka,6,6,0
1/05/2023,Germany,Negeri Sembilan,1,1,0
1/05/2023,Germany,Pahang,21,12,9
1/05/2023,Germany,Perak,41,26,15
1/05/2023,Germany,Perlis,114,70,44
1/05/2023,Germany,Pulau Pinang,655,459,196
1/05/2023,Germany,Sabah,127,68,59
1/05/2023,Germany,Sarawak,241,135,106
1/05/2023,Germany,Selangor,7816,4542,3274
1/05/2023,Germany,Terengganu,0,0,0
1/05/2023,Germany,W.P. Labuan,12,8,4
1/05/2023,Djibouti,Johor,1,1,0
1/05/2023,Djibouti,Selangor,39,21,18
1/05/2023,Dominica,Johor,7,7,0
1/05/2023,Dominica,Kedah,0,0,0
1/05/2023,Dominica,Pulau Pinang,2,2,0
1/05/2023,Dominica,Sabah,0,0,0
1/05/2023,Dominica,Sarawak,0,0,0
1/05/2023,Dominica,Selangor,23,21,2
1/05/2023,Dominica,W.P. Labuan,0,0,0
1/05/2023,Denmark,Johor,252,181,71
1/05/2023,Denmark,Kedah,41,26,15
1/05/2023,Denmark,Kelantan,0,0,0
1/05/2023,Denmark,Melaka,1,1,0
1/05/2023,Denmark,Negeri Sembilan,0,0,0
1/05/2023,Denmark,Pahang,1,1,0
1/05/2023,Denmark,Perak,0,0,0
1/05/2023,Denmark,Perlis,6,4,2
1/05/2023,Denmark,Pulau Pinang,50,36,14
1/05/2023,Denmark,Sabah,30,15,15
1/05/2023,Denmark,Sarawak,12,8,4
1/05/2023,Denmark,Selangor,743,500,243
1/05/2023,Denmark,W.P. Labuan,2,0,2
1/05/2023,Dominican Republic,Johor,2,2,0
1/05/2023,Dominican Republic,Kedah,0,0,0
1/05/2023,Dominican Republic,Perak,0,0,0
1/05/2023,Dominican Republic,Perlis,0,0,0
1/05/2023,Dominican Republic,Pulau Pinang,1,0,1
1/05/2023,Dominican Republic,Sabah,0,0,0
1/05/2023,Dominican Republic,Sarawak,0,0,0
1/05/2023,Dominican Republic,Selangor,19,12,7
1/05/2023,Algeria,Johor,24,19,5
1/05/2023,Algeria,Kedah,5,5,0
1/05/2023,Algeria,Kelantan,0,0,0
1/05/2023,Algeria,Melaka,0,0,0
1/05/2023,Algeria,Perak,0,0,0
1/05/2023,Algeria,Perlis,0,0,0
1/05/2023,Algeria,Pulau Pinang,1,1,0
1/05/2023,Algeria,Sabah,4,4,0
1/05/2023,Algeria,Sarawak,5,4,1
1/05/2023,Algeria,Selangor,616,403,213
1/05/2023,Algeria,W.P. Labuan,1,1,0
1/05/2023,Ecuador,Johor,5,1,4
1/05/2023,Ecuador,Kedah,1,0,1
1/05/2023,Ecuador,Perak,0,0,0
1/05/2023,Ecuador,Perlis,0,0,0
1/05/2023,Ecuador,Pulau Pinang,1,1,0
1/05/2023,Ecuador,Sabah,0,0,0
1/05/2023,Ecuador,Sarawak,0,0,0
1/05/2023,Ecuador,Selangor,53,28,25
1/05/2023,Egypt,Johor,201,158,43
1/05/2023,Egypt,Kedah,13,9,4
1/05/2023,Egypt,Kelantan,3,1,2
1/05/2023,Egypt,Melaka,1,1,0
1/05/2023,Egypt,Pahang,0,0,0
1/05/2023,Egypt,Perak,0,0,0
1/05/2023,Egypt,Perlis,2,1,1
1/05/2023,Egypt,Pulau Pinang,4,3,1
1/05/2023,Egypt,Sabah,6,6,0
1/05/2023,Egypt,Sarawak,155,113,42
1/05/2023,Egypt,Selangor,1735,1299,436
1/05/2023,Egypt,Terengganu,0,0,0
1/05/2023,Egypt,W.P. Labuan,1,1,0
1/05/2023,Eritrea,Johor,0,0,0
1/05/2023,Eritrea,Pulau Pinang,0,0,0
1/05/2023,Eritrea,Sabah,0,0,0
1/05/2023,Eritrea,Selangor,3,2,1
1/05/2023,Spain,Johor,393,247,146
1/05/2023,Spain,Kedah,86,51,35
1/05/2023,Spain,Kelantan,7,5,2
1/05/2023,Spain,Melaka,2,2,0
1/05/2023,Spain,Negeri Sembilan,1,1,0
1/05/2023,Spain,Pahang,0,0,0
1/05/2023,Spain,Perak,4,3,1
1/05/2023,Spain,Perlis,17,10,7
1/05/2023,Spain,Pulau Pinang,77,41,36
1/05/2023,Spain,Sabah,31,16,15
1/05/2023,Spain,Sarawak,56,40,16
1/05/2023,Spain,Selangor,1688,1027,661
1/05/2023,Spain,W.P. Labuan,2,0,2
1/05/2023,Estonia,Johor,37,22,15
1/05/2023,Estonia,Kedah,22,13,9
1/05/2023,Estonia,Kelantan,0,0,0
1/05/2023,Estonia,Pahang,0,0,0
1/05/2023,Estonia,Perak,0,0,0
1/05/2023,Estonia,Perlis,0,0,0
1/05/2023,Estonia,Pulau Pinang,1,1,0
1/05/2023,Estonia,Sabah,1,0,1
1/05/2023,Estonia,Sarawak,12,5,7
1/05/2023,Estonia,Selangor,97,51,46
1/05/2023,Estonia,W.P. Labuan,3,1,2
1/05/2023,Ethiopia,Johor,13,5,8
1/05/2023,Ethiopia,Kedah,0,0,0
1/05/2023,Ethiopia,Pulau Pinang,0,0,0
1/05/2023,Ethiopia,Sarawak,0,0,0
1/05/2023,Ethiopia,Selangor,28,16,12
1/05/2023,Finland,Johor,124,72,52
1/05/2023,Finland,Kedah,34,16,18
1/05/2023,Finland,Kelantan,2,1,1
1/05/2023,Finland,Melaka,0,0,0
1/05/2023,Finland,Negeri Sembilan,0,0,0
1/05/2023,Finland,Pahang,0,0,0
1/05/2023,Finland,Perak,6,5,1
1/05/2023,Finland,Perlis,7,7,0
1/05/2023,Finland,Pulau Pinang,23,15,8
1/05/2023,Finland,Sabah,13,5,8
1/05/2023,Finland,Sarawak,11,7,4
1/05/2023,Finland,Selangor,337,214,123
1/05/2023,Finland,W.P. Labuan,1,0,1
1/05/2023,Fiji,Johor,95,54,41
1/05/2023,Fiji,Kedah,0,0,0
1/05/2023,Fiji,Kelantan,0,0,0
1/05/2023,Fiji,Perak,0,0,0
1/05/2023,Fiji,Perlis,1,1,0
1/05/2023,Fiji,Pulau Pinang,4,3,1
1/05/2023,Fiji,Sabah,0,0,0
1/05/2023,Fiji,Sarawak,3,1,2
1/05/2023,Fiji,Selangor,107,65,42
1/05/2023,France,Johor,1777,1089,688
1/05/2023,France,Kedah,663,357,306
1/05/2023,France,Kelantan,20,11,9
1/05/2023,France,Melaka,4,1,3
1/05/2023,France,Negeri Sembilan,0,0,0
1/05/2023,France,Pahang,16,9,7
1/05/2023,France,Perak,32,18,14
1/05/2023,France,Perlis,97,65,32
1/05/2023,France,Pulau Pinang,368,230,138
1/05/2023,France,Sabah,122,71,51
1/05/2023,France,Sarawak,137,95,42
1/05/2023,France,Selangor,7387,4267,3120
1/05/2023,France,Terengganu,0,0,0
1/05/2023,France,W.P. Labuan,4,3,1
1/05/2023,"Micronesia, Federated States of",Johor,0,0,0
1/05/2023,"Micronesia, Federated States of",Pulau Pinang,0,0,0
1/05/2023,"Micronesia, Federated States of",Selangor,0,0,0
1/05/2023,Gabon,Johor,1,1,0
1/05/2023,Gabon,Pulau Pinang,0,0,0
1/05/2023,Gabon,Sarawak,0,0,0
1/05/2023,Gabon,Selangor,12,7,5
1/05/2023,United Kingdom of Great Britain and Northern Ireland,Johor,4306,2708,1598
1/05/2023,United Kingdom of Great Britain and Northern Ireland,Kedah,1040,561,479
1/05/2023,United Kingdom of Great Britain and Northern Ireland,Kelantan,7,6,1
1/05/2023,United Kingdom of Great Britain and Northern Ireland,Melaka,1,1,0
1/05/2023,United Kingdom of Great Britain and Northern Ireland,Negeri Sembilan,0,0,0
1/05/2023,United Kingdom of Great Britain and Northern Ireland,Pahang,19,15,4
1/05/2023,United Kingdom of Great Britain and Northern Ireland,Perak,82,53,29
1/05/2023,United Kingdom of Great Britain and Northern Ireland,Perlis,153,99,54
1/05/2023,United Kingdom of Great Britain and Northern Ireland,Pulau Pinang,1083,651,432
1/05/2023,United Kingdom of Great Britain and Northern Ireland,Sabah,577,301,276
1/05/2023,United Kingdom of Great Britain and Northern Ireland,Sarawak,1454,873,581
1/05/2023,United Kingdom of Great Britain and Northern Ireland,Selangor,14201,8717,5484
1/05/2023,United Kingdom of Great Britain and Northern Ireland,Terengganu,0,0,0
1/05/2023,United Kingdom of Great Britain and Northern Ireland,W.P. Labuan,40,26,14
1/05/2023,Georgia,Johor,4,4,0
1/05/2023,Georgia,Kedah,2,2,0
1/05/2023,Georgia,Melaka,0,0,0
1/05/2023,Georgia,Perak,0,0,0
1/05/2023,Georgia,Perlis,1,1,0
1/05/2023,Georgia,Pulau Pinang,0,0,0
1/05/2023,Georgia,Sabah,0,0,0
1/05/2023,Georgia,Sarawak,0,0,0
1/05/2023,Georgia,Selangor,55,30,25
1/05/2023,Ghana,Johor,9,8,1
1/05/2023,Ghana,Kedah,2,1,1
1/05/2023,Ghana,Kelantan,0,0,0
1/05/2023,Ghana,Pulau Pinang,0,0,0
1/05/2023,Ghana,Sabah,0,0,0
1/05/2023,Ghana,Sarawak,2,1,1
1/05/2023,Ghana,Selangor,57,43,14
1/05/2023,Gibraltar,Johor,0,0,0
1/05/2023,Gibraltar,Sarawak,0,0,0
1/05/2023,Guinea,Johor,20,15,5
1/05/2023,Guinea,Kedah,0,0,0
1/05/2023,Guinea,Kelantan,0,0,0
1/05/2023,Guinea,Perlis,0,0,0
1/05/2023,Guinea,Pulau Pinang,1,1,0
1/05/2023,Guinea,Sabah,0,0,0
1/05/2023,Guinea,Sarawak,1,1,0
1/05/2023,Guinea,Selangor,56,45,11
1/05/2023,Guadeloupe,Selangor,0,0,0
1/05/2023,Gambia,Johor,6,3,3
1/05/2023,Gambia,Kedah,0,0,0
1/05/2023,Gambia,Kelantan,0,0,0
1/05/2023,Gambia,Pulau Pinang,0,0,0
1/05/2023,Gambia,Sabah,0,0,0
1/05/2023,Gambia,Sarawak,0,0,0
1/05/2023,Gambia,Selangor,26,21,5
1/05/2023,Guinea-Bissau,Johor,0,0,0
1/05/2023,Guinea-Bissau,Selangor,1,1,0
1/05/2023,Equatorial Guinea,Johor,0,0,0
1/05/2023,Equatorial Guinea,Selangor,0,0,0
1/05/2023,Greece,Johor,67,58,9
1/05/2023,Greece,Kedah,8,7,1
1/05/2023,Greece,Kelantan,0,0,0
1/05/2023,Greece,Melaka,0,0,0
1/05/2023,Greece,Negeri Sembilan,0,0,0
1/05/2023,Greece,Pahang,1,1,0
1/05/2023,Greece,Perak,0,0,0
1/05/2023,Greece,Perlis,1,1,0
1/05/2023,Greece,Pulau Pinang,6,6,0
1/05/2023,Greece,Sabah,4,2,2
1/05/2023,Greece,Sarawak,4,3,1
1/05/2023,Greece,Selangor,155,119,36
1/05/2023,Grenada,Johor,6,3,3
1/05/2023,Grenada,Kedah,0,0,0
1/05/2023,Grenada,Pulau Pinang,1,1,0
1/05/2023,Grenada,Sabah,0,0,0
1/05/2023,Grenada,Sarawak,0,0,0
1/05/2023,Grenada,Selangor,6,6,0
1/05/2023,Greenland,Johor,0,0,0
1/05/2023,Greenland,Selangor,0,0,0
1/05/2023,Guatemala,Johor,6,2,4
1/05/2023,Guatemala,Kedah,0,0,0
1/05/2023,Guatemala,Pahang,0,0,0
1/05/2023,Guatemala,Perak,0,0,0
1/05/2023,Guatemala,Pulau Pinang,0,0,0
1/05/2023,Guatemala,Sabah,1,0,1
1/05/2023,Guatemala,Sarawak,0,0,0
1/05/2023,Guatemala,Selangor,19,11,8
1/05/2023,Guatemala,W.P. Labuan,0,0,0
1/05/2023,Guyana,Johor,0,0,0
1/05/2023,Guyana,Kedah,0,0,0
1/05/2023,Guyana,Pulau Pinang,1,1,0
1/05/2023,Guyana,Sarawak,0,0,0
1/05/2023,Guyana,Selangor,4,1,3
1/05/2023,Hong Kong,Johor,6,4,2
1/05/2023,Hong Kong,Kedah,0,0,0
1/05/2023,Hong Kong,Kelantan,0,0,0
1/05/2023,Hong Kong,Pahang,3,1,2
1/05/2023,Hong Kong,Perak,46,19,27
1/05/2023,Hong Kong,Perlis,3,3,0
1/05/2023,Hong Kong,Pulau Pinang,0,0,0
1/05/2023,Hong Kong,Sabah,39,21,18
1/05/2023,Hong Kong,Sarawak,0,0,0
1/05/2023,Hong Kong,Selangor,19,7,12
1/05/2023,Hong Kong,Terengganu,0,0,0
1/05/2023,Heard Island and McDonald Islands,Johor,0,0,0
1/05/2023,Honduras,Johor,1,1,0
1/05/2023,Honduras,Kedah,0,0,0
1/05/2023,Honduras,Perak,0,0,0
1/05/2023,Honduras,Pulau Pinang,0,0,0
1/05/2023,Honduras,Sabah,0,0,0
1/05/2023,Honduras,Sarawak,0,0,0
1/05/2023,Honduras,Selangor,7,5,2
1/05/2023,Croatia,Johor,38,35,3
1/05/2023,Croatia,Kedah,8,5,3
1/05/2023,Croatia,Kelantan,1,1,0
1/05/2023,Croatia,Melaka,0,0,0
1/05/2023,Croatia,Pahang,0,0,0
1/05/2023,Croatia,Perak,0,0,0
1/05/2023,Croatia,Perlis,0,0,0
1/05/2023,Croatia,Pulau Pinang,7,5,2
1/05/2023,Croatia,Sabah,1,1,0
1/05/2023,Croatia,Sarawak,4,2,2
1/05/2023,Croatia,Selangor,138,99,39
1/05/2023,Haiti,Johor,4,4,0
1/05/2023,Haiti,Kedah,0,0,0
1/05/2023,Haiti,Kelantan,0,0,0
1/05/2023,Haiti,Perak,0,0,0
1/05/2023,Haiti,Pulau Pinang,0,0,0
1/05/2023,Haiti,Sabah,0,0,0
1/05/2023,Haiti,Selangor,5,5,0
1/05/2023,Hungary,Johor,59,37,22
1/05/2023,Hungary,Kedah,21,12,9
1/05/2023,Hungary,Kelantan,0,0,0
1/05/2023,Hungary,Pahang,0,0,0
1/05/2023,Hungary,Perak,0,0,0
1/05/2023,Hungary,Perlis,0,0,0
1/05/2023,Hungary,Pulau Pinang,12,9,3
1/05/2023,Hungary,Sabah,3,2,1
1/05/2023,Hungary,Sarawak,5,1,4
1/05/2023,Hungary,Selangor,334,188,146
1/05/2023,Hungary,W.P. Labuan,0,0,0
1/05/2023,Indonesia,Johor,102377,54873,47504
1/05/2023,Indonesia,Kedah,4628,1831,2797
1/05/2023,Indonesia,Kelantan,88,52,36
1/05/2023,Indonesia,Melaka,5199,2270,2929
1/05/2023,Indonesia,Negeri Sembilan,14294,10157,4137
1/05/2023,Indonesia,Pahang,33,22,11
1/05/2023,Indonesia,Perak,177,50,127
1/05/2023,Indonesia,Perlis,452,173,279
1/05/2023,Indonesia,Pulau Pinang,37752,14698,23054
1/05/2023,Indonesia,Sabah,6116,3204,2912
1/05/2023,Indonesia,Sarawak,47222,27986,19236
1/05/2023,Indonesia,Selangor,108569,52889,55680
1/05/2023,Indonesia,Terengganu,1,1,0
1/05/2023,Indonesia,W.P. Labuan,59,29,30
1/05/2023,India,Johor,24610,15682,8928
1/05/2023,India,Kedah,1429,726,703
1/05/2023,India,Kelantan,7,6,1
1/05/2023,India,Melaka,0,0,0
1/05/2023,India,Negeri Sembilan,0,0,0
1/05/2023,India,Pahang,5,4,1
1/05/2023,India,Perak,302,234,68
1/05/2023,India,Perlis,40,28,12
1/05/2023,India,Pulau Pinang,1042,715,327
1/05/2023,India,Sabah,280,192,88
1/05/2023,India,Sarawak,1411,1096,315
1/05/2023,India,Selangor,61760,40584,21176
1/05/2023,India,Terengganu,0,0,0
1/05/2023,India,W.P. Labuan,69,48,21
1/05/2023, British Indian Ocean Territory,Pulau Pinang,0,0,0
1/05/2023, British Indian Ocean Territory,Selangor,0,0,0
1/05/2023,Ireland,Johor,258,157,101
1/05/2023,Ireland,Kedah,73,36,37
1/05/2023,Ireland,Kelantan,3,2,1
1/05/2023,Ireland,Negeri Sembilan,0,0,0
1/05/2023,Ireland,Pahang,1,1,0
1/05/2023,Ireland,Perak,6,3,3
1/05/2023,Ireland,Perlis,26,20,6
1/05/2023,Ireland,Pulau Pinang,103,78,25
1/05/2023,Ireland,Sabah,19,9,10
1/05/2023,Ireland,Sarawak,52,31,21
1/05/2023,Ireland,Selangor,999,642,357
1/05/2023,Ireland,Terengganu,0,0,0
1/05/2023,Ireland,W.P. Labuan,2,2,0
1/05/2023,"Iran, Islamic Republic of",Johor,94,60,34
1/05/2023,"Iran, Islamic Republic of",Kedah,22,11,11
1/05/2023,"Iran, Islamic Republic of",Kelantan,2,1,1
1/05/2023,"Iran, Islamic Republic of",Perak,0,0,0
1/05/2023,"Iran, Islamic Republic of",Perlis,16,8,8
1/05/2023,"Iran, Islamic Republic of",Pulau Pinang,9,4,5
1/05/2023,"Iran, Islamic Republic of",Sabah,0,0,0
1/05/2023,"Iran, Islamic Republic of",Sarawak,0,0,0
1/05/2023,"Iran, Islamic Republic of",Selangor,1050,611,439
1/05/2023,"Iran, Islamic Republic of",W.P. Labuan,0,0,0
1/05/2023,Iraq,Johor,22,17,5
1/05/2023,Iraq,Kedah,0,0,0
1/05/2023,Iraq,Kelantan,0,0,0
1/05/2023,Iraq,Melaka,0,0,0
1/05/2023,Iraq,Pahang,0,0,0
1/05/2023,Iraq,Perak,0,0,0
1/05/2023,Iraq,Perlis,0,0,0
1/05/2023,Iraq,Pulau Pinang,0,0,0
1/05/2023,Iraq,Sabah,0,0,0
1/05/2023,Iraq,Sarawak,2,1,1
1/05/2023,Iraq,Selangor,852,597,255
1/05/2023,Iceland,Johor,4,4,0
1/05/2023,Iceland,Kedah,3,3,0
1/05/2023,Iceland,Kelantan,0,0,0
1/05/2023,Iceland,Perak,0,0,0
1/05/2023,Iceland,Perlis,0,0,0
1/05/2023,Iceland,Pulau Pinang,1,1,0
1/05/2023,Iceland,Sabah,1,1,0
1/05/2023,Iceland,Sarawak,4,3,1
1/05/2023,Iceland,Selangor,35,13,22
1/05/2023,Iceland,W.P. Labuan,0,0,0
1/05/2023,Israel,Pulau Pinang,1,1,0
1/05/2023,Italy,Johor,515,383,132
1/05/2023,Italy,Kedah,122,82,40
1/05/2023,Italy,Kelantan,2,1,1
1/05/2023,Italy,Melaka,0,0,0
1/05/2023,Italy,Negeri Sembilan,0,0,0
1/05/2023,Italy,Pahang,1,1,0
1/05/2023,Italy,Perak,6,4,2
1/05/2023,Italy,Perlis,14,12,2
1/05/2023,Italy,Pulau Pinang,87,69,18
1/05/2023,Italy,Sabah,32,18,14
1/05/2023,Italy,Sarawak,63,32,31
1/05/2023,Italy,Selangor,1995,1401,594
1/05/2023,Italy,W.P. Labuan,0,0,0
1/05/2023,Jamaica,Johor,1,0,1
1/05/2023,Jamaica,Kedah,4,2,2
1/05/2023,Jamaica,Perak,0,0,0
1/05/2023,Jamaica,Pulau Pinang,2,2,0
1/05/2023,Jamaica,Sabah,0,0,0
1/05/2023,Jamaica,Sarawak,0,0,0
1/05/2023,Jamaica,Selangor,23,11,12
1/05/2023,Jamaica,W.P. Labuan,0,0,0
1/05/2023,Jordan,Johor,13,8,5
1/05/2023,Jordan,Kedah,9,8,1
1/05/2023,Jordan,Kelantan,1,0,1
1/05/2023,Jordan,Melaka,1,1,0
1/05/2023,Jordan,Perlis,1,1,0
1/05/2023,Jordan,Pulau Pinang,9,6,3
1/05/2023,Jordan,Sabah,1,1,0
1/05/2023,Jordan,Sarawak,0,0,0
1/05/2023,Jordan,Selangor,690,436,254
1/05/2023,Jordan,W.P. Labuan,0,0,0
1/05/2023,Japan,Johor,5169,3541,1628
1/05/2023,Japan,Kedah,312,158,154
1/05/2023,Japan,Kelantan,10,9,1
1/05/2023,Japan,Melaka,0,0,0
1/05/2023,Japan,Negeri Sembilan,0,0,0
1/05/2023,Japan,Pahang,7,7,0
1/05/2023,Japan,Perak,75,56,19
1/05/2023,Japan,Perlis,83,66,17
1/05/2023,Japan,Pulau Pinang,1283,967,316
1/05/2023,Japan,Sabah,361,189,172
1/05/2023,Japan,Sarawak,211,121,90
1/05/2023,Japan,Selangor,15311,9895,5416
1/05/2023,Japan,W.P. Labuan,10,9,1
1/05/2023,Kazakhstan,Johor,42,22,20
1/05/2023,Kazakhstan,Kedah,12,5,7
1/05/2023,Kazakhstan,Kelantan,1,0,1
1/05/2023,Kazakhstan,Melaka,0,0,0
1/05/2023,Kazakhstan,Perak,0,0,0
1/05/2023,Kazakhstan,Perlis,0,0,0
1/05/2023,Kazakhstan,Pulau Pinang,5,2,3
1/05/2023,Kazakhstan,Sabah,1,1,0
1/05/2023,Kazakhstan,Sarawak,2,0,2
1/05/2023,Kazakhstan,Selangor,602,217,385
1/05/2023,Kazakhstan,W.P. Labuan,0,0,0
1/05/2023,Kenya,Johor,37,16,21
1/05/2023,Kenya,Kedah,4,2,2
1/05/2023,Kenya,Kelantan,0,0,0
1/05/2023,Kenya,Perak,0,0,0
1/05/2023,Kenya,Perlis,0,0,0
1/05/2023,Kenya,Pulau Pinang,1,0,1
1/05/2023,Kenya,Sabah,0,0,0
1/05/2023,Kenya,Sarawak,4,3,1
1/05/2023,Kenya,Selangor,327,164,163
1/05/2023,Kyrgyzstan,Johor,32,24,8
1/05/2023,Kyrgyzstan,Kedah,1,1,0
1/05/2023,Kyrgyzstan,Kelantan,0,0,0
1/05/2023,Kyrgyzstan,Perak,0,0,0
1/05/2023,Kyrgyzstan,Perlis,0,0,0
1/05/2023,Kyrgyzstan,Pulau Pinang,1,0,1
1/05/2023,Kyrgyzstan,Sabah,0,0,0
1/05/2023,Kyrgyzstan,Sarawak,0,0,0
1/05/2023,Kyrgyzstan,Selangor,204,102,102
1/05/2023,Cambodia,Johor,2888,1185,1703
1/05/2023,Cambodia,Kedah,253,148,105
1/05/2023,Cambodia,Kelantan,608,322,286
1/05/2023,Cambodia,Melaka,0,0,0
1/05/2023,Cambodia,Negeri Sembilan,0,0,0
1/05/2023,Cambodia,Pahang,0,0,0
1/05/2023,Cambodia,Perak,11,5,6
1/05/2023,Cambodia,Perlis,816,519,297
1/05/2023,Cambodia,Pulau Pinang,31,16,15
1/05/2023,Cambodia,Sabah,0,0,0
1/05/2023,Cambodia,Sarawak,16,4,12
1/05/2023,Cambodia,Selangor,4822,2239,2583
1/05/2023,Cambodia,W.P. Labuan,1,0,1
1/05/2023,Kiribati,Johor,1,1,0
1/05/2023,Kiribati,Sabah,0,0,0
1/05/2023,Kiribati,Selangor,0,0,0
1/05/2023,Saint Kitts and Nevis,Johor,14,12,2
1/05/2023,Saint Kitts and Nevis,Kedah,0,0,0
1/05/2023,Saint Kitts and Nevis,Perlis,0,0,0
1/05/2023,Saint Kitts and Nevis,Pulau Pinang,2,2,0
1/05/2023,Saint Kitts and Nevis,Sabah,0,0,0
1/05/2023,Saint Kitts and Nevis,Selangor,59,46,13
1/05/2023,Saint Kitts and Nevis,W.P. Labuan,0,0,0
1/05/2023,"Korea, Republic of",Johor,7381,4226,3155
1/05/2023,"Korea, Republic of",Kedah,313,218,95
1/05/2023,"Korea, Republic of",Kelantan,0,0,0
1/05/2023,"Korea, Republic of",Melaka,1,1,0
1/05/2023,"Korea, Republic of",Negeri Sembilan,0,0,0
1/05/2023,"Korea, Republic of",Pahang,1,0,1
1/05/2023,"Korea, Republic of",Perak,34,15,19
1/05/2023,"Korea, Republic of",Perlis,62,47,15
1/05/2023,"Korea, Republic of",Pulau Pinang,487,303,184
1/05/2023,"Korea, Republic of",Sabah,14466,5891,8575
1/05/2023,"Korea, Republic of",Sarawak,248,145,103
1/05/2023,"Korea, Republic of",Selangor,10165,5951,4214
1/05/2023,"Korea, Republic of",Terengganu,0,0,0
1/05/2023,"Korea, Republic of",W.P. Labuan,15,14,1
1/05/2023,Kuwait,Johor,10,5,5
1/05/2023,Kuwait,Kedah,11,7,4
1/05/2023,Kuwait,Kelantan,1,1,0
1/05/2023,Kuwait,Perak,0,0,0
1/05/2023,Kuwait,Perlis,0,0,0
1/05/2023,Kuwait,Pulau Pinang,1,1,0
1/05/2023,Kuwait,Sabah,0,0,0
1/05/2023,Kuwait,Sarawak,1,1,0
1/05/2023,Kuwait,Selangor,387,243,144
1/05/2023,Kuwait,W.P. Labuan,0,0,0
1/05/2023, Lao People's Democratic Republic,Johor,115,27,88
1/05/2023, Lao People's Democratic Republic,Kedah,1312,121,1191
1/05/2023, Lao People's Democratic Republic,Kelantan,227,13,214
1/05/2023, Lao People's Democratic Republic,Melaka,0,0,0
1/05/2023, Lao People's Democratic Republic,Perak,26,8,18
1/05/2023, Lao People's Democratic Republic,Perlis,294,109,185
1/05/2023, Lao People's Democratic Republic,Pulau Pinang,27,11,16
1/05/2023, Lao People's Democratic Republic,Sabah,1,0,1
1/05/2023, Lao People's Democratic Republic,Sarawak,11,5,6
1/05/2023, Lao People's Democratic Republic,Selangor,256,91,165
1/05/2023, Lao People's Democratic Republic,W.P. Labuan,0,0,0
1/05/2023,Lebanon,Johor,30,18,12
1/05/2023,Lebanon,Kedah,5,1,4
1/05/2023,Lebanon,Kelantan,0,0,0
1/05/2023,Lebanon,Pahang,0,0,0
1/05/2023,Lebanon,Perak,0,0,0
1/05/2023,Lebanon,Perlis,0,0,0
1/05/2023,Lebanon,Pulau Pinang,2,2,0
1/05/2023,Lebanon,Sabah,1,1,0
1/05/2023,Lebanon,Sarawak,1,1,0
1/05/2023,Lebanon,Selangor,226,165,61
1/05/2023,Lebanon,W.P. Labuan,0,0,0
1/05/2023,Liberia,Johor,2,1,1
1/05/2023,Liberia,Kedah,0,0,0
1/05/2023,Liberia,Sabah,0,0,0
1/05/2023,Liberia,Sarawak,0,0,0
1/05/2023,Liberia,Selangor,5,4,1
1/05/2023,Libya,Johor,1,1,0
1/05/2023,Libya,Kedah,0,0,0
1/05/2023,Libya,Perlis,0,0,0
1/05/2023,Libya,Pulau Pinang,1,1,0
1/05/2023,Libya,Sabah,1,1,0
1/05/2023,Libya,Sarawak,2,1,1
1/05/2023,Libya,Selangor,361,224,137
1/05/2023,Saint Lucia,Johor,11,11,0
1/05/2023,Saint Lucia,Kedah,0,0,0
1/05/2023,Saint Lucia,Pulau Pinang,0,0,0
1/05/2023,Saint Lucia,Sarawak,1,1,0
1/05/2023,Saint Lucia,Selangor,7,5,2
1/05/2023,Liechtenstein,Johor,1,1,0
1/05/2023,Liechtenstein,Kedah,0,0,0
1/05/2023,Liechtenstein,Perlis,0,0,0
1/05/2023,Liechtenstein,Pulau Pinang,0,0,0
1/05/2023,Liechtenstein,Sabah,0,0,0
1/05/2023,Liechtenstein,Sarawak,0,0,0
1/05/2023,Liechtenstein,Selangor,2,1,1
1/05/2023,LKA,Johor,1089,754,335
1/05/2023,LKA,Kedah,41,25,16
1/05/2023,LKA,Kelantan,8,7,1
1/05/2023,LKA,Melaka,0,0,0
1/05/2023,LKA,Pahang,0,0,0
1/05/2023,LKA,Perak,2,2,0
1/05/2023,LKA,Perlis,1,1,0
1/05/2023,LKA,Pulau Pinang,30,24,6
1/05/2023,LKA,Sabah,11,7,4
1/05/2023,LKA,Sarawak,25,17,8
1/05/2023,LKA,Selangor,3836,2679,1157
1/05/2023,LKA,W.P. Labuan,0,0,0
1/05/2023,Lesotho,Johor,0,0,0
1/05/2023,Lesotho,Kedah,0,0,0
1/05/2023,Lesotho,Pulau Pinang,0,0,0
1/05/2023,Lesotho,Sarawak,0,0,0
1/05/2023,Lesotho,Selangor,2,0,2
1/05/2023,Lithuania,Johor,44,16,28
1/05/2023,Lithuania,Kedah,17,8,9
1/05/2023,Lithuania,Kelantan,1,1,0
1/05/2023,Lithuania,Pahang,0,0,0
1/05/2023,Lithuania,Perak,0,0,0
1/05/2023,Lithuania,Perlis,2,1,1
1/05/2023,Lithuania,Pulau Pinang,6,5,1
1/05/2023,Lithuania,Sabah,0,0,0
1/05/2023,Lithuania,Sarawak,25,11,14
1/05/2023,Lithuania,Selangor,207,112,95
1/05/2023,Lithuania,W.P. Labuan,0,0,0
1/05/2023,Luxembourg,Johor,5,3,2
1/05/2023,Luxembourg,Kedah,9,4,5
1/05/2023,Luxembourg,Kelantan,0,0,0
1/05/2023,Luxembourg,Perak,0,0,0
1/05/2023,Luxembourg,Perlis,0,0,0
1/05/2023,Luxembourg,Pulau Pinang,4,2,2
1/05/2023,Luxembourg,Sabah,0,0,0
1/05/2023,Luxembourg,Sarawak,1,1,0
1/05/2023,Luxembourg,Selangor,38,26,12
1/05/2023,Latvia,Johor,19,7,12
1/05/2023,Latvia,Kedah,8,3,5
1/05/2023,Latvia,Kelantan,0,0,0
1/05/2023,Latvia,Pahang,0,0,0
1/05/2023,Latvia,Perak,2,0,2
1/05/2023,Latvia,Perlis,4,2,2
1/05/2023,Latvia,Pulau Pinang,2,0,2
1/05/2023,Latvia,Sabah,0,0,0
1/05/2023,Latvia,Sarawak,14,7,7
1/05/2023,Latvia,Selangor,79,41,38
1/05/2023,Latvia,W.P. Labuan,1,0,1
1/05/2023,Macao,Johor,1,0,1
1/05/2023,Macao,Pahang,0,0,0
1/05/2023,Macao,Perak,4,2,2
1/05/2023,Macao,Selangor,3,1,2
1/05/2023,Macao,W.P. Labuan,0,0,0
1/05/2023,Morocco,Johor,65,47,18
1/05/2023,Morocco,Kedah,15,12,3
1/05/2023,Morocco,Kelantan,0,0,0
1/05/2023,Morocco,Melaka,0,0,0
1/05/2023,Morocco,Pahang,0,0,0
1/05/2023,Morocco,Perak,0,0,0
1/05/2023,Morocco,Perlis,3,3,0
1/05/2023,Morocco,Pulau Pinang,6,4,2
1/05/2023,Morocco,Sabah,5,2,3
1/05/2023,Morocco,Sarawak,3,3,0
1/05/2023,Morocco,Selangor,807,416,391
1/05/2023,Morocco,W.P. Labuan,0,0,0
1/05/2023,Monaco,Johor,0,0,0
1/05/2023,Monaco,Kedah,0,0,0
1/05/2023,Monaco,Sabah,0,0,0
1/05/2023,Monaco,Selangor,1,0,1
1/05/2023,"Moldova, Republic of",Johor,9,4,5
1/05/2023,"Moldova, Republic of",Kedah,2,2,0
1/05/2023,"Moldova, Republic of",Kelantan,0,0,0
1/05/2023,"Moldova, Republic of",Negeri Sembilan,0,0,0
1/05/2023,"Moldova, Republic of",Perlis,1,0,1
1/05/2023,"Moldova, Republic of",Pulau Pinang,2,1,1
1/05/2023,"Moldova, Republic of",Sabah,0,0,0
1/05/2023,"Moldova, Republic of",Sarawak,0,0,0
1/05/2023,"Moldova, Republic of",Selangor,29,18,11
1/05/2023,Madagascar,Johor,7,1,6
1/05/2023,Madagascar,Kedah,2,0,2
1/05/2023,Madagascar,Perak,0,0,0
1/05/2023,Madagascar,Perlis,0,0,0
1/05/2023,Madagascar,Pulau Pinang,0,0,0
1/05/2023,Madagascar,Sabah,0,0,0
1/05/2023,Madagascar,Sarawak,0,0,0
1/05/2023,Madagascar,Selangor,55,27,28
1/05/2023,Maldives,Johor,91,48,43
1/05/2023,Maldives,Kedah,3,2,1
1/05/2023,Maldives,Kelantan,0,0,0
1/05/2023,Maldives,Perak,1,0,1
1/05/2023,Maldives,Perlis,0,0,0
1/05/2023,Maldives,Pulau Pinang,5,3,2
1/05/2023,Maldives,Sabah,3,3,0
1/05/2023,Maldives,Sarawak,5,3,2
1/05/2023,Maldives,Selangor,1785,1019,766
1/05/2023,Mexico,Johor,168,83,85
1/05/2023,Mexico,Kedah,6,4,2
1/05/2023,Mexico,Kelantan,0,0,0
1/05/2023,Mexico,Pahang,0,0,0
1/05/2023,Mexico,Perak,1,1,0
1/05/2023,Mexico,Perlis,0,0,0
1/05/2023,Mexico,Pulau Pinang,28,16,12
1/05/2023,Mexico,Sabah,7,2,5
1/05/2023,Mexico,Sarawak,7,4,3
1/05/2023,Mexico,Selangor,569,305,264
1/05/2023,Mexico,W.P. Labuan,0,0,0
1/05/2023,Marshall Islands,Johor,3,2,1
1/05/2023,Marshall Islands,Kedah,0,0,0
1/05/2023,Marshall Islands,Perak,0,0,0
1/05/2023,Marshall Islands,Pulau Pinang,0,0,0
1/05/2023,Marshall Islands,Sabah,0,0,0
1/05/2023,Marshall Islands,Selangor,2,2,0
1/05/2023,North Macedonia,Johor,11,5,6
1/05/2023,North Macedonia,Kedah,19,6,13
1/05/2023,North Macedonia,Perak,0,0,0
1/05/2023,North Macedonia,Pulau Pinang,0,0,0
1/05/2023,North Macedonia,Sabah,0,0,0
1/05/2023,North Macedonia,Sarawak,1,0,1
1/05/2023,North Macedonia,Selangor,38,23,15
1/05/2023,Mali,Johor,1,1,0
1/05/2023,Mali,Sabah,0,0,0
1/05/2023,Mali,Selangor,14,9,5
1/05/2023,Malta,Johor,4,4,0
1/05/2023,Malta,Kedah,1,1,0
1/05/2023,Malta,Kelantan,0,0,0
1/05/2023,Malta,Perak,0,0,0
1/05/2023,Malta,Perlis,2,1,1
1/05/2023,Malta,Pulau Pinang,1,1,0
1/05/2023,Malta,Sabah,0,0,0
1/05/2023,Malta,Sarawak,1,1,0
1/05/2023,Malta,Selangor,33,19,14
1/05/2023,Malta,W.P. Labuan,0,0,0
1/05/2023,Myanmar,Johor,4099,1217,2882
1/05/2023,Myanmar,Kedah,75,17,58
1/05/2023,Myanmar,Kelantan,4,0,4
1/05/2023,Myanmar,Negeri Sembilan,0,0,0
1/05/2023,Myanmar,Pahang,6,1,5
1/05/2023,Myanmar,Perak,25,4,21
1/05/2023,Myanmar,Perlis,4,0,4
1/05/2023,Myanmar,Pulau Pinang,357,210,147
1/05/2023,Myanmar,Sabah,23,8,15
1/05/2023,Myanmar,Sarawak,68,27,41
1/05/2023,Myanmar,Selangor,8848,6404,2444
1/05/2023,Myanmar,Terengganu,0,0,0
1/05/2023,Myanmar,W.P. Labuan,2,1,1
1/05/2023,Montenegro,Johor,2,2,0
1/05/2023,Montenegro,Kedah,0,0,0
1/05/2023,Montenegro,Pulau Pinang,0,0,0
1/05/2023,Montenegro,Sabah,0,0,0
1/05/2023,Montenegro,Sarawak,0,0,0
1/05/2023,Montenegro,Selangor,11,8,3
1/05/2023,Mongolia,Johor,125,44,81
1/05/2023,Mongolia,Kedah,8,6,2
1/05/2023,Mongolia,Kelantan,0,0,0
1/05/2023,Mongolia,Perak,0,0,0
1/05/2023,Mongolia,Perlis,7,5,2
1/05/2023,Mongolia,Pulau Pinang,4,0,4
1/05/2023,Mongolia,Sabah,10,3,7
1/05/2023,Mongolia,Sarawak,1,0,1
1/05/2023,Mongolia,Selangor,256,90,166
1/05/2023,Northern Mariana Islands,Selangor,0,0,0
1/05/2023,Mozambique,Johor,0,0,0
1/05/2023,Mozambique,Kedah,0,0,0
1/05/2023,Mozambique,Perak,0,0,0
1/05/2023,Mozambique,Pulau Pinang,0,0,0
1/05/2023,Mozambique,Sabah,0,0,0
1/05/2023,Mozambique,Sarawak,0,0,0
1/05/2023,Mozambique,Selangor,71,34,37
1/05/2023,Mauritania,Johor,2,2,0
1/05/2023,Mauritania,Kedah,0,0,0
1/05/2023,Mauritania,Pulau Pinang,0,0,0
1/05/2023,Mauritania,Sabah,0,0,0
1/05/2023,Mauritania,Sarawak,4,4,0
1/05/2023,Mauritania,Selangor,8,7,1
1/05/2023,Mauritius,Johor,142,76,66
1/05/2023,Mauritius,Kedah,5,4,1
1/05/2023,Mauritius,Kelantan,0,0,0
1/05/2023,Mauritius,Pahang,0,0,0
1/05/2023,Mauritius,Perak,0,0,0
1/05/2023,Mauritius,Perlis,0,0,0
1/05/2023,Mauritius,Pulau Pinang,7,6,1
1/05/2023,Mauritius,Sabah,1,1,0
1/05/2023,Mauritius,Sarawak,2,1,1
1/05/2023,Mauritius,Selangor,1332,749,583
1/05/2023,Malawi,Johor,0,0,0
1/05/2023,Malawi,Pulau Pinang,0,0,0
1/05/2023,Malawi,Sabah,0,0,0
1/05/2023,Malawi,Sarawak,2,0,2
1/05/2023,Malawi,Selangor,16,11,5
1/05/2023,Mayotte,Selangor,0,0,0
1/05/2023,Namibia,Johor,4,3,1
1/05/2023,Namibia,Kedah,0,0,0
1/05/2023,Namibia,Perak,0,0,0
1/05/2023,Namibia,Perlis,0,0,0
1/05/2023,Namibia,Pulau Pinang,0,0,0
1/05/2023,Namibia,Sabah,0,0,0
1/05/2023,Namibia,Sarawak,0,0,0
1/05/2023,Namibia,Selangor,20,3,17
1/05/2023,New Caledonia,Selangor,0,0,0
1/05/2023,Niger,Johor,1,1,0
1/05/2023,Niger,Sabah,0,0,0
1/05/2023,Niger,Selangor,5,4,1
1/05/2023,Nigeria,Johor,35,32,3
1/05/2023,Nigeria,Kedah,2,1,1
1/05/2023,Nigeria,Perlis,0,0,0
1/05/2023,Nigeria,Pulau Pinang,3,3,0
1/05/2023,Nigeria,Sabah,0,0,0
1/05/2023,Nigeria,Sarawak,3,2,1
1/05/2023,Nigeria,Selangor,517,399,118
1/05/2023,Nicaragua,Johor,0,0,0
1/05/2023,Nicaragua,Kedah,0,0,0
1/05/2023,Nicaragua,Pulau Pinang,0,0,0
1/05/2023,Nicaragua,Sabah,0,0,0
1/05/2023,Nicaragua,Selangor,3,1,2
1/05/2023,Netherlands,Johor,937,622,315
1/05/2023,Netherlands,Kedah,381,180,201
1/05/2023,Netherlands,Kelantan,3,2,1
1/05/2023,Netherlands,Melaka,0,0,0
1/05/2023,Netherlands,Negeri Sembilan,0,0,0
1/05/2023,Netherlands,Pahang,0,0,0
1/05/2023,Netherlands,Perak,13,6,7
1/05/2023,Netherlands,Perlis,28,17,11
1/05/2023,Netherlands,Pulau Pinang,264,176,88
1/05/2023,Netherlands,Sabah,102,51,51
1/05/2023,Netherlands,Sarawak,189,123,66
1/05/2023,Netherlands,Selangor,3927,2286,1641
1/05/2023,Netherlands,Terengganu,0,0,0
1/05/2023,Netherlands,W.P. Labuan,0,0,0
1/05/2023,Norway,Johor,110,74,36
1/05/2023,Norway,Kedah,31,16,15
1/05/2023,Norway,Kelantan,0,0,0
1/05/2023,Norway,Melaka,0,0,0
1/05/2023,Norway,Pahang,0,0,0
1/05/2023,Norway,Perak,1,1,0
1/05/2023,Norway,Perlis,6,2,4
1/05/2023,Norway,Pulau Pinang,17,10,7
1/05/2023,Norway,Sabah,6,4,2
1/05/2023,Norway,Sarawak,9,9,0
1/05/2023,Norway,Selangor,466,310,156
1/05/2023,Norway,W.P. Labuan,0,0,0
1/05/2023,Nepal,Johor,471,334,137
1/05/2023,Nepal,Kedah,10,5,5
1/05/2023,Nepal,Pahang,0,0,0
1/05/2023,Nepal,Perak,1,1,0
1/05/2023,Nepal,Perlis,0,0,0
1/05/2023,Nepal,Pulau Pinang,31,23,8
1/05/2023,Nepal,Sabah,4,3,1
1/05/2023,Nepal,Sarawak,255,170,85
1/05/2023,Nepal,Selangor,15437,14805,632
1/05/2023,Nepal,W.P. Labuan,54,50,4
1/05/2023,Nauru,Johor,1,0,1
1/05/2023,Nauru,Pulau Pinang,0,0,0
1/05/2023,Nauru,Selangor,2,2,0
1/05/2023,New Zealand,Johor,659,411,248
1/05/2023,New Zealand,Kedah,75,43,32
1/05/2023,New Zealand,Kelantan,0,0,0
1/05/2023,New Zealand,Melaka,1,1,0
1/05/2023,New Zealand,Negeri Sembilan,0,0,0
1/05/2023,New Zealand,Pahang,3,2,1
1/05/2023,New Zealand,Perak,20,12,8
1/05/2023,New Zealand,Perlis,7,5,2
1/05/2023,New Zealand,Pulau Pinang,199,122,77
1/05/2023,New Zealand,Sabah,90,46,44
1/05/2023,New Zealand,Sarawak,140,70,70
1/05/2023,New Zealand,Selangor,2377,1435,942
1/05/2023,New Zealand,Terengganu,0,0,0
1/05/2023,New Zealand,W.P. Labuan,1,1,0
1/05/2023,Oman,Johor,25,20,5
1/05/2023,Oman,Kedah,6,3,3
1/05/2023,Oman,Kelantan,0,0,0
1/05/2023,Oman,Melaka,0,0,0
1/05/2023,Oman,Perak,3,2,1
1/05/2023,Oman,Perlis,7,5,2
1/05/2023,Oman,Pulau Pinang,1,1,0
1/05/2023,Oman,Sabah,1,1,0
1/05/2023,Oman,Sarawak,15,8,7
1/05/2023,Oman,Selangor,801,494,307
1/05/2023,Pakistan,Johor,810,629,181
1/05/2023,Pakistan,Kedah,76,52,24
1/05/2023,Pakistan,Kelantan,4,4,0
1/05/2023,Pakistan,Melaka,0,0,0
1/05/2023,Pakistan,Negeri Sembilan,1,1,0
1/05/2023,Pakistan,Pahang,0,0,0
1/05/2023,Pakistan,Perak,18,18,0
1/05/2023,Pakistan,Perlis,25,22,3
1/05/2023,Pakistan,Pulau Pinang,133,119,14
1/05/2023,Pakistan,Sabah,13,12,1
1/05/2023,Pakistan,Sarawak,142,126,16
1/05/2023,Pakistan,Selangor,13691,12546,1145
1/05/2023,Pakistan,W.P. Labuan,0,0,0
1/05/2023,Panama,Johor,2,1,1
1/05/2023,Panama,Kedah,0,0,0
1/05/2023,Panama,Perak,2,2,0
1/05/2023,Panama,Perlis,0,0,0
1/05/2023,Panama,Pulau Pinang,0,0,0
1/05/2023,Panama,Sabah,0,0,0
1/05/2023,Panama,Sarawak,0,0,0
1/05/2023,Panama,Selangor,14,8,6
1/05/2023,Peru,Johor,20,16,4
1/05/2023,Peru,Kedah,5,2,3
1/05/2023,Peru,Kelantan,0,0,0
1/05/2023,Peru,Pahang,0,0,0
1/05/2023,Peru,Perak,0,0,0
1/05/2023,Peru,Perlis,0,0,0
1/05/2023,Peru,Pulau Pinang,2,0,2
1/05/2023,Peru,Sabah,1,0,1
1/05/2023,Peru,Sarawak,0,0,0
1/05/2023,Peru,Selangor,140,63,77
1/05/2023,Peru,W.P. Labuan,0,0,0
1/05/2023,Philippines,Johor,18515,5944,12571
1/05/2023,Philippines,Kedah,581,161,420
1/05/2023,Philippines,Kelantan,41,19,22
1/05/2023,Philippines,Melaka,0,0,0
1/05/2023,Philippines,Negeri Sembilan,0,0,0
1/05/2023,Philippines,Pahang,36,27,9
1/05/2023,Philippines,Perak,67,17,50
1/05/2023,Philippines,Perlis,84,30,54
1/05/2023,Philippines,Pulau Pinang,583,275,308
1/05/2023,Philippines,Sabah,1086,460,626
1/05/2023,Philippines,Sarawak,2556,999,1557
1/05/2023,Philippines,Selangor,15100,6180,8920
1/05/2023,Philippines,Terengganu,0,0,0
1/05/2023,Philippines,W.P. Labuan,96,23,73
1/05/2023,Palau,Johor,0,0,0
1/05/2023,Palau,Pulau Pinang,0,0,0
1/05/2023,Palau,Selangor,0,0,0
1/05/2023,Papua New Guinea,Johor,12,7,5
1/05/2023,Papua New Guinea,Kedah,2,1,1
1/05/2023,Papua New Guinea,Kelantan,0,0,0
1/05/2023,Papua New Guinea,Perak,0,0,0
1/05/2023,Papua New Guinea,Pulau Pinang,3,1,2
1/05/2023,Papua New Guinea,Sabah,0,0,0
1/05/2023,Papua New Guinea,Sarawak,3,1,2
1/05/2023,Papua New Guinea,Selangor,48,30,18
1/05/2023,Poland,Johor,247,146,101
1/05/2023,Poland,Kedah,57,33,24
1/05/2023,Poland,Kelantan,3,1,2
1/05/2023,Poland,Melaka,0,0,0
1/05/2023,Poland,Negeri Sembilan,0,0,0
1/05/2023,Poland,Pahang,1,1,0
1/05/2023,Poland,Perak,4,2,2
1/05/2023,Poland,Perlis,16,10,6
1/05/2023,Poland,Pulau Pinang,47,25,22
1/05/2023,Poland,Sabah,34,17,17
1/05/2023,Poland,Sarawak,55,23,32
1/05/2023,Poland,Selangor,950,537,413
1/05/2023,Poland,Terengganu,0,0,0
1/05/2023,Poland,W.P. Labuan,3,2,1
1/05/2023,"North Korea, Democratic People's Republic of",Selangor,0,0,0
1/05/2023,Portugal,Johor,131,85,46
1/05/2023,Portugal,Kedah,36,16,20
1/05/2023,Portugal,Kelantan,1,0,1
1/05/2023,Portugal,Melaka,0,0,0
1/05/2023,Portugal,Pahang,0,0,0
1/05/2023,Portugal,Perak,0,0,0
1/05/2023,Portugal,Perlis,6,5,1
1/05/2023,Portugal,Pulau Pinang,39,20,19
1/05/2023,Portugal,Sabah,9,8,1
1/05/2023,Portugal,Sarawak,23,11,12
1/05/2023,Portugal,Selangor,667,393,274
1/05/2023,Portugal,W.P. Labuan,2,1,1
1/05/2023,Paraguay,Johor,2,0,2
1/05/2023,Paraguay,Kedah,0,0,0
1/05/2023,Paraguay,Perak,0,0,0
1/05/2023,Paraguay,Perlis,0,0,0
1/05/2023,Paraguay,Pulau Pinang,0,0,0
1/05/2023,Paraguay,Sabah,0,0,0
1/05/2023,Paraguay,Sarawak,0,0,0
1/05/2023,Paraguay,Selangor,14,7,7
1/05/2023,"Palestine, State of",Johor,24,24,0
1/05/2023,"Palestine, State of",Kedah,1,1,0
1/05/2023,"Palestine, State of",Kelantan,0,0,0
1/05/2023,"Palestine, State of",Melaka,1,1,0
1/05/2023,"Palestine, State of",Perak,0,0,0
1/05/2023,"Palestine, State of",Perlis,0,0,0
1/05/2023,"Palestine, State of",Pulau Pinang,2,2,0
1/05/2023,"Palestine, State of",Sabah,1,1,0
1/05/2023,"Palestine, State of",Sarawak,2,1,1
1/05/2023,"Palestine, State of",Selangor,265,205,60
1/05/2023,Qatar,Johor,12,6,6
1/05/2023,Qatar,Kedah,2,1,1
1/05/2023,Qatar,Perlis,0,0,0
1/05/2023,Qatar,Pulau Pinang,0,0,0
1/05/2023,Qatar,Sabah,0,0,0
1/05/2023,Qatar,Sarawak,1,1,0
1/05/2023,Qatar,Selangor,108,75,33
1/05/2023,Réunion,Johor,0,0,0
1/05/2023,Réunion,Sarawak,0,0,0
1/05/2023,Romania,Johor,102,65,37
1/05/2023,Romania,Kedah,12,5,7
1/05/2023,Romania,Kelantan,0,0,0
1/05/2023,Romania,Negeri Sembilan,0,0,0
1/05/2023,Romania,Pahang,1,1,0
1/05/2023,Romania,Perak,1,1,0
1/05/2023,Romania,Perlis,6,3,3
1/05/2023,Romania,Pulau Pinang,26,15,11
1/05/2023,Romania,Sabah,2,1,1
1/05/2023,Romania,Sarawak,11,9,2
1/05/2023,Romania,Selangor,419,219,200
1/05/2023,Romania,W.P. Labuan,0,0,0
1/05/2023,Russian Federation (Russia),Johor,418,209,209
1/05/2023,Russian Federation (Russia),Kedah,692,410,282
1/05/2023,Russian Federation (Russia),Kelantan,72,43,29
1/05/2023,Russian Federation (Russia),Melaka,1,1,0
1/05/2023,Russian Federation (Russia),Negeri Sembilan,0,0,0
1/05/2023,Russian Federation (Russia),Pahang,7,6,1
1/05/2023,Russian Federation (Russia),Perak,7,4,3
1/05/2023,Russian Federation (Russia),Perlis,300,168,132
1/05/2023,Russian Federation (Russia),Pulau Pinang,160,78,82
1/05/2023,Russian Federation (Russia),Sabah,47,28,19
1/05/2023,Russian Federation (Russia),Sarawak,77,41,36
1/05/2023,Russian Federation (Russia),Selangor,8734,4583,4151
1/05/2023,Russian Federation (Russia),W.P. Labuan,6,4,2
1/05/2023,Rwanda,Johor,0,0,0
1/05/2023,Rwanda,Kedah,0,0,0
1/05/2023,Rwanda,Pulau Pinang,0,0,0
1/05/2023,Rwanda,Selangor,10,6,4
1/05/2023,Saudi Arabia,Johor,109,66,43
1/05/2023,Saudi Arabia,Kedah,12,6,6
1/05/2023,Saudi Arabia,Kelantan,11,5,6
1/05/2023,Saudi Arabia,Melaka,0,0,0
1/05/2023,Saudi Arabia,Perak,3,1,2
1/05/2023,Saudi Arabia,Perlis,7,2,5
1/05/2023,Saudi Arabia,Pulau Pinang,35,19,16
1/05/2023,Saudi Arabia,Sabah,0,0,0
1/05/2023,Saudi Arabia,Sarawak,9,6,3
1/05/2023,Saudi Arabia,Selangor,3381,2041,1340
1/05/2023,Saudi Arabia,W.P. Labuan,0,0,0
1/05/2023,Sudan,Johor,9,6,3
1/05/2023,Sudan,Kedah,0,0,0
1/05/2023,Sudan,Kelantan,0,0,0
1/05/2023,Sudan,Perlis,0,0,0
1/05/2023,Sudan,Pulau Pinang,0,0,0
1/05/2023,Sudan,Sabah,0,0,0
1/05/2023,Sudan,Sarawak,2,2,0
1/05/2023,Sudan,Selangor,434,273,161
1/05/2023,Sudan,W.P. Labuan,0,0,0
1/05/2023,Senegal,Johor,21,20,1
1/05/2023,Senegal,Kedah,1,0,1
1/05/2023,Senegal,Kelantan,0,0,0
1/05/2023,Senegal,Perak,0,0,0
1/05/2023,Senegal,Perlis,0,0,0
1/05/2023,Senegal,Pulau Pinang,2,1,1
1/05/2023,Senegal,Sabah,0,0,0
1/05/2023,Senegal,Sarawak,1,0,1
1/05/2023,Senegal,Selangor,69,49,20
1/05/2023,Singapore,Johor,1035130,606272,428858
1/05/2023,Singapore,Kedah,4658,2620,2038
1/05/2023,Singapore,Kelantan,52,39,13
1/05/2023,Singapore,Melaka,18,11,7
1/05/2023,Singapore,Negeri Sembilan,4,2,2
1/05/2023,Singapore,Pahang,521,268,253
1/05/2023,Singapore,Perak,5790,2691,3099
1/05/2023,Singapore,Perlis,182,95,87
1/05/2023,Singapore,Pulau Pinang,16984,8733,8251
1/05/2023,Singapore,Sabah,3478,1843,1635
1/05/2023,Singapore,Sarawak,4415,2542,1873
1/05/2023,Singapore,Selangor,48167,24682,23485
1/05/2023,Singapore,Terengganu,0,0,0
1/05/2023,Singapore,W.P. Labuan,13,13,0
1/05/2023,South Georgia and the South Sandwich Islands,Johor,0,0,0
1/05/2023,South Georgia and the South Sandwich Islands,Sabah,0,0,0
1/05/2023,South Georgia and the South Sandwich Islands,Selangor,0,0,0
1/05/2023,Saint Helena,Sarawak,0,0,0
1/05/2023,Solomon Islands,Johor,0,0,0
1/05/2023,Solomon Islands,Perlis,0,0,0
1/05/2023,Solomon Islands,Pulau Pinang,0,0,0
1/05/2023,Solomon Islands,Sabah,1,0,1
1/05/2023,Solomon Islands,Sarawak,3,1,2
1/05/2023,Solomon Islands,Selangor,15,3,12
1/05/2023,Solomon Islands,W.P. Labuan,0,0,0
1/05/2023,Sierra Leone,Johor,1,1,0
1/05/2023,Sierra Leone,Kedah,0,0,0
1/05/2023,Sierra Leone,Perak,0,0,0
1/05/2023,Sierra Leone,Pulau Pinang,0,0,0
1/05/2023,Sierra Leone,Sabah,0,0,0
1/05/2023,Sierra Leone,Selangor,11,8,3
1/05/2023,El Salvador,Johor,5,3,2
1/05/2023,El Salvador,Kedah,7,5,2
1/05/2023,El Salvador,Perak,0,0,0
1/05/2023,El Salvador,Perlis,0,0,0
1/05/2023,El Salvador,Pulau Pinang,0,0,0
1/05/2023,El Salvador,Sabah,0,0,0
1/05/2023,El Salvador,Selangor,18,10,8
1/05/2023,El Salvador,W.P. Labuan,0,0,0
1/05/2023,San Marino,Johor,0,0,0
1/05/2023,San Marino,Selangor,3,2,1
1/05/2023,Somalia,Johor,0,0,0
1/05/2023,Somalia,Kedah,0,0,0
1/05/2023,Somalia,Kelantan,0,0,0
1/05/2023,Somalia,Perlis,0,0,0
1/05/2023,Somalia,Sabah,0,0,0
1/05/2023,Somalia,Sarawak,0,0,0
1/05/2023,Somalia,Selangor,227,137,90
1/05/2023,Serbia,Johor,4,1,3
1/05/2023,Serbia,Kedah,0,0,0
1/05/2023,Serbia,Kelantan,0,0,0
1/05/2023,Serbia,Pahang,0,0,0
1/05/2023,Serbia,Perak,0,0,0
1/05/2023,Serbia,Perlis,0,0,0
1/05/2023,Serbia,Pulau Pinang,5,3,2
1/05/2023,Serbia,Sabah,1,0,1
1/05/2023,Serbia,Sarawak,1,1,0
1/05/2023,Serbia,Selangor,37,23,14
1/05/2023,South Sudan,Johor,0,0,0
1/05/2023,South Sudan,Kedah,0,0,0
1/05/2023,South Sudan,Sarawak,1,1,0
1/05/2023,South Sudan,Selangor,21,14,7
1/05/2023,South Sudan,W.P. Labuan,0,0,0
1/05/2023,Sao Tome and Principe,Selangor,4,4,0
1/05/2023,Suriname,Johor,10,2,8
1/05/2023,Suriname,Kedah,0,0,0
1/05/2023,Suriname,Kelantan,0,0,0
1/05/2023,Suriname,Perak,0,0,0
1/05/2023,Suriname,Perlis,0,0,0
1/05/2023,Suriname,Pulau Pinang,0,0,0
1/05/2023,Suriname,Sabah,0,0,0
1/05/2023,Suriname,Sarawak,0,0,0
1/05/2023,Suriname,Selangor,27,17,10
1/05/2023,Slovakia,Johor,36,20,16
1/05/2023,Slovakia,Kedah,37,15,22
1/05/2023,Slovakia,Kelantan,0,0,0
1/05/2023,Slovakia,Negeri Sembilan,0,0,0
1/05/2023,Slovakia,Pahang,0,0,0
1/05/2023,Slovakia,Perak,2,2,0
1/05/2023,Slovakia,Perlis,1,0,1
1/05/2023,Slovakia,Pulau Pinang,17,12,5
1/05/2023,Slovakia,Sabah,3,2,1
1/05/2023,Slovakia,Sarawak,1,1,0
1/05/2023,Slovakia,Selangor,263,162,101
1/05/2023,Slovakia,W.P. Labuan,1,1,0
1/05/2023,Slovenia,Johor,16,10,6
1/05/2023,Slovenia,Kedah,20,9,11
1/05/2023,Slovenia,Kelantan,0,0,0
1/05/2023,Slovenia,Perak,0,0,0
1/05/2023,Slovenia,Perlis,0,0,0
1/05/2023,Slovenia,Pulau Pinang,3,1,2
1/05/2023,Slovenia,Sabah,0,0,0
1/05/2023,Slovenia,Sarawak,0,0,0
1/05/2023,Slovenia,Selangor,57,41,16
1/05/2023,Slovenia,W.P. Labuan,0,0,0
1/05/2023,Sweden,Johor,224,144,80
1/05/2023,Sweden,Kedah,45,24,21
1/05/2023,Sweden,Kelantan,11,5,6
1/05/2023,Sweden,Melaka,0,0,0
1/05/2023,Sweden,Negeri Sembilan,0,0,0
1/05/2023,Sweden,Pahang,0,0,0
1/05/2023,Sweden,Perak,5,5,0
1/05/2023,Sweden,Perlis,17,13,4
1/05/2023,Sweden,Pulau Pinang,57,35,22
1/05/2023,Sweden,Sabah,12,4,8
1/05/2023,Sweden,Sarawak,26,15,11
1/05/2023,Sweden,Selangor,653,413,240
1/05/2023,Sweden,W.P. Labuan,2,2,0
1/05/2023,Eswatini,Johor,0,0,0
1/05/2023,Eswatini,Kedah,0,0,0
1/05/2023,Eswatini,Pulau Pinang,0,0,0
1/05/2023,Eswatini,Sabah,0,0,0
1/05/2023,Eswatini,Selangor,5,1,4
1/05/2023,Seychelles,Johor,5,0,5
1/05/2023,Seychelles,Kedah,1,1,0
1/05/2023,Seychelles,Pulau Pinang,0,0,0
1/05/2023,Seychelles,Sabah,1,1,0
1/05/2023,Seychelles,Sarawak,1,1,0
1/05/2023,Seychelles,Selangor,52,20,32
1/05/2023,Syrian Arab Republic,Johor,18,9,9
1/05/2023,Syrian Arab Republic,Kedah,2,2,0
1/05/2023,Syrian Arab Republic,Kelantan,0,0,0
1/05/2023,Syrian Arab Republic,Pahang,8,8,0
1/05/2023,Syrian Arab Republic,Perlis,1,1,0
1/05/2023,Syrian Arab Republic,Pulau Pinang,3,3,0
1/05/2023,Syrian Arab Republic,Sabah,1,1,0
1/05/2023,Syrian Arab Republic,Sarawak,4,3,1
1/05/2023,Syrian Arab Republic,Selangor,585,420,165
1/05/2023,Syrian Arab Republic,W.P. Labuan,0,0,0
1/05/2023,Turks and Caicos Islands,Perlis,0,0,0
1/05/2023,TCD,Johor,2,2,0
1/05/2023,TCD,Kedah,0,0,0
1/05/2023,TCD,Perlis,0,0,0
1/05/2023,TCD,Selangor,25,23,2
1/05/2023,Togo,Johor,0,0,0
1/05/2023,Togo,Perak,0,0,0
1/05/2023,Togo,Pulau Pinang,1,0,1
1/05/2023,Togo,Selangor,5,5,0
1/05/2023,Thailand,Johor,6574,1844,4730
1/05/2023,Thailand,Kedah,69698,39266,30432
1/05/2023,Thailand,Kelantan,50984,26984,24000
1/05/2023,Thailand,Melaka,1,1,0
1/05/2023,Thailand,Negeri Sembilan,0,0,0
1/05/2023,Thailand,Pahang,30,21,9
1/05/2023,Thailand,Perak,12545,5962,6583
1/05/2023,Thailand,Perlis,59332,35965,23367
1/05/2023,Thailand,Pulau Pinang,2280,979,1301
1/05/2023,Thailand,Sabah,30,11,19
1/05/2023,Thailand,Sarawak,449,180,269
1/05/2023,Thailand,Selangor,13273,5122,8151
1/05/2023,Thailand,Terengganu,0,0,0
1/05/2023,Thailand,W.P. Labuan,2,1,1
1/05/2023,Tajikistan,Johor,4,1,3
1/05/2023,Tajikistan,Kedah,2,1,1
1/05/2023,Tajikistan,Perlis,0,0,0
1/05/2023,Tajikistan,Pulau Pinang,0,0,0
1/05/2023,Tajikistan,Sabah,3,3,0
1/05/2023,Tajikistan,Selangor,85,62,23
1/05/2023,Tokelau,Selangor,0,0,0
1/05/2023,Turkmenistan,Johor,0,0,0
1/05/2023,Turkmenistan,Kedah,0,0,0
1/05/2023,Turkmenistan,Kelantan,0,0,0
1/05/2023,Turkmenistan,Perlis,0,0,0
1/05/2023,Turkmenistan,Pulau Pinang,0,0,0
1/05/2023,Turkmenistan,Sabah,0,0,0
1/05/2023,Turkmenistan,Sarawak,1,1,0
1/05/2023,Turkmenistan,Selangor,101,62,39
1/05/2023,Timor-Leste,Johor,10,2,8
1/05/2023,Timor-Leste,Kedah,0,0,0
1/05/2023,Timor-Leste,Perlis,0,0,0
1/05/2023,Timor-Leste,Pulau Pinang,3,3,0
1/05/2023,Timor-Leste,Sabah,0,0,0
1/05/2023,Timor-Leste,Sarawak,4,2,2
1/05/2023,Timor-Leste,Selangor,199,116,83
1/05/2023,Tonga,Johor,0,0,0
1/05/2023,Tonga,Pulau Pinang,1,0,1
1/05/2023,Tonga,Sarawak,0,0,0
1/05/2023,Tonga,Selangor,7,3,4
1/05/2023,Trinidad and Tobago,Johor,6,4,2
1/05/2023,Trinidad and Tobago,Kedah,3,1,2
1/05/2023,Trinidad and Tobago,Pahang,0,0,0
1/05/2023,Trinidad and Tobago,Pulau Pinang,1,1,0
1/05/2023,Trinidad and Tobago,Sabah,1,0,1
1/05/2023,Trinidad and Tobago,Sarawak,4,2,2
1/05/2023,Trinidad and Tobago,Selangor,41,23,18
1/05/2023,Tunisia,Johor,15,10,5
1/05/2023,Tunisia,Kedah,2,2,0
1/05/2023,Tunisia,Kelantan,1,1,0
1/05/2023,Tunisia,Melaka,0,0,0
1/05/2023,Tunisia,Perak,0,0,0
1/05/2023,Tunisia,Perlis,3,2,1
1/05/2023,Tunisia,Pulau Pinang,4,4,0
1/05/2023,Tunisia,Sabah,3,1,2
1/05/2023,Tunisia,Sarawak,0,0,0
1/05/2023,Tunisia,Selangor,651,344,307
1/05/2023,Tunisia,W.P. Labuan,0,0,0
1/05/2023,Türkiye,Johor,258,187,71
1/05/2023,Türkiye,Kedah,55,44,11
1/05/2023,Türkiye,Kelantan,4,4,0
1/05/2023,Türkiye,Melaka,3,3,0
1/05/2023,Türkiye,Negeri Sembilan,0,0,0
1/05/2023,Türkiye,Pahang,0,0,0
1/05/2023,Türkiye,Perak,4,3,1
1/05/2023,Türkiye,Perlis,28,22,6
1/05/2023,Türkiye,Pulau Pinang,24,18,6
1/05/2023,Türkiye,Sabah,6,4,2
1/05/2023,Türkiye,Sarawak,23,14,9
1/05/2023,Türkiye,Selangor,1290,930,360
1/05/2023,Türkiye,W.P. Labuan,0,0,0
1/05/2023,Tuvalu,Selangor,1,1,0
1/05/2023,"Taiwan, Province of China",Johor,4729,2017,2712
1/05/2023,"Taiwan, Province of China",Kedah,145,70,75
1/05/2023,"Taiwan, Province of China",Kelantan,1,0,1
1/05/2023,"Taiwan, Province of China",Melaka,8,5,3
1/05/2023,"Taiwan, Province of China",Negeri Sembilan,0,0,0
1/05/2023,"Taiwan, Province of China",Pahang,0,0,0
1/05/2023,"Taiwan, Province of China",Perak,55,26,29
1/05/2023,"Taiwan, Province of China",Perlis,24,6,18
1/05/2023,"Taiwan, Province of China",Pulau Pinang,3940,2040,1900
1/05/2023,"Taiwan, Province of China",Sabah,1221,606,615
1/05/2023,"Taiwan, Province of China",Sarawak,293,150,143
1/05/2023,"Taiwan, Province of China",Selangor,13399,6554,6845
1/05/2023,"Taiwan, Province of China",W.P. Labuan,8,6,2
1/05/2023,"Tanzania, United Republic of",Johor,17,14,3
1/05/2023,"Tanzania, United Republic of",Kedah,5,2,3
1/05/2023,"Tanzania, United Republic of",Perak,0,0,0
1/05/2023,"Tanzania, United Republic of",Perlis,0,0,0
1/05/2023,"Tanzania, United Republic of",Pulau Pinang,0,0,0
1/05/2023,"Tanzania, United Republic of",Sabah,0,0,0
1/05/2023,"Tanzania, United Republic of",Sarawak,3,3,0
1/05/2023,"Tanzania, United Republic of",Selangor,137,63,74
1/05/2023,Uganda,Johor,7,2,5
1/05/2023,Uganda,Kedah,1,0,1
1/05/2023,Uganda,Perak,0,0,0
1/05/2023,Uganda,Perlis,1,0,1
1/05/2023,Uganda,Pulau Pinang,3,1,2
1/05/2023,Uganda,Sabah,0,0,0
1/05/2023,Uganda,Sarawak,1,0,1
1/05/2023,Uganda,Selangor,111,64,47
1/05/2023,Ukraine,Johor,75,43,32
1/05/2023,Ukraine,Kedah,28,10,18
1/05/2023,Ukraine,Kelantan,0,0,0
1/05/2023,Ukraine,Melaka,0,0,0
1/05/2023,Ukraine,Negeri Sembilan,0,0,0
1/05/2023,Ukraine,Pahang,3,3,0
1/05/2023,Ukraine,Perak,0,0,0
1/05/2023,Ukraine,Perlis,8,4,4
1/05/2023,Ukraine,Pulau Pinang,31,17,14
1/05/2023,Ukraine,Sabah,5,3,2
1/05/2023,Ukraine,Sarawak,1,0,1
1/05/2023,Ukraine,Selangor,934,433,501
1/05/2023,Ukraine,W.P. Labuan,0,0,0
1/05/2023,Uruguay,Johor,24,12,12
1/05/2023,Uruguay,Kedah,0,0,0
1/05/2023,Uruguay,Kelantan,0,0,0
1/05/2023,Uruguay,Perak,0,0,0
1/05/2023,Uruguay,Perlis,0,0,0
1/05/2023,Uruguay,Pulau Pinang,1,1,0
1/05/2023,Uruguay,Sabah,0,0,0
1/05/2023,Uruguay,Sarawak,0,0,0
1/05/2023,Uruguay,Selangor,265,136,129
1/05/2023,Uruguay,W.P. Labuan,0,0,0
1/05/2023,United States of America,Johor,4050,2362,1688
1/05/2023,United States of America,Kedah,576,332,244
1/05/2023,United States of America,Kelantan,13,8,5
1/05/2023,United States of America,Melaka,1,0,1
1/05/2023,United States of America,Negeri Sembilan,1,0,1
1/05/2023,United States of America,Pahang,12,7,5
1/05/2023,United States of America,Perak,118,71,47
1/05/2023,United States of America,Perlis,91,54,37
1/05/2023,United States of America,Pulau Pinang,1815,1163,652
1/05/2023,United States of America,Sabah,357,187,170
1/05/2023,United States of America,Sarawak,352,200,152
1/05/2023,United States of America,Selangor,12392,7406,4986
1/05/2023,United States of America,Terengganu,0,0,0
1/05/2023,United States of America,W.P. Labuan,10,7,3
1/05/2023,Uzbekistan,Johor,111,99,12
1/05/2023,Uzbekistan,Kedah,11,9,2
1/05/2023,Uzbekistan,Kelantan,0,0,0
1/05/2023,Uzbekistan,Perak,0,0,0
1/05/2023,Uzbekistan,Perlis,1,1,0
1/05/2023,Uzbekistan,Pulau Pinang,10,2,8
1/05/2023,Uzbekistan,Sabah,9,7,2
1/05/2023,Uzbekistan,Sarawak,0,0,0
1/05/2023,Uzbekistan,Selangor,817,492,325
1/05/2023,Holy See,Johor,0,0,0
1/05/2023,Holy See,Sarawak,0,0,0
1/05/2023,Holy See,Selangor,1,1,0
1/05/2023,Saint Vincent and the Grenadines,Johor,1,1,0
1/05/2023,Saint Vincent and the Grenadines,Kedah,0,0,0
1/05/2023,Saint Vincent and the Grenadines,Pulau Pinang,0,0,0
1/05/2023,Saint Vincent and the Grenadines,Sarawak,0,0,0
1/05/2023,Saint Vincent and the Grenadines,Selangor,4,4,0
1/05/2023,"Venezuela, Bolivarian Republic of",Johor,16,11,5
1/05/2023,"Venezuela, Bolivarian Republic of",Kedah,2,0,2
1/05/2023,"Venezuela, Bolivarian Republic of",Kelantan,0,0,0
1/05/2023,"Venezuela, Bolivarian Republic of",Melaka,0,0,0
1/05/2023,"Venezuela, Bolivarian Republic of",Perak,0,0,0
1/05/2023,"Venezuela, Bolivarian Republic of",Perlis,0,0,0
1/05/2023,"Venezuela, Bolivarian Republic of",Pulau Pinang,2,2,0
1/05/2023,"Venezuela, Bolivarian Republic of",Sabah,5,3,2
1/05/2023,"Venezuela, Bolivarian Republic of",Sarawak,6,5,1
1/05/2023,"Venezuela, Bolivarian Republic of",Selangor,85,49,36
1/05/2023,"Venezuela, Bolivarian Republic of",W.P. Labuan,2,2,0
1/05/2023,Viet Nam,Johor,18818,5840,12978
1/05/2023,Viet Nam,Kedah,321,67,254
1/05/2023,Viet Nam,Kelantan,13,1,12
1/05/2023,Viet Nam,Melaka,0,0,0
1/05/2023,Viet Nam,Negeri Sembilan,0,0,0
1/05/2023,Viet Nam,Pahang,3,3,0
1/05/2023,Viet Nam,Perak,141,12,129
1/05/2023,Viet Nam,Perlis,233,24,209
1/05/2023,Viet Nam,Pulau Pinang,1554,465,1089
1/05/2023,Viet Nam,Sabah,22,5,17
1/05/2023,Viet Nam,Sarawak,256,50,206
1/05/2023,Viet Nam,Selangor,17961,6159,11802
1/05/2023,Viet Nam,Terengganu,0,0,0
1/05/2023,Viet Nam,W.P. Labuan,1,1,0
1/05/2023,Vanuatu,Johor,33,28,5
1/05/2023,Vanuatu,Kedah,0,0,0
1/05/2023,Vanuatu,Pulau Pinang,6,5,1
1/05/2023,Vanuatu,Sabah,0,0,0
1/05/2023,Vanuatu,Sarawak,0,0,0
1/05/2023,Vanuatu,Selangor,60,52,8
1/05/2023, Samoa,Johor,0,0,0
1/05/2023, Samoa,Sarawak,1,0,1
1/05/2023, Samoa,Selangor,1,0,1
1/05/2023,Yemen,Johor,23,17,6
1/05/2023,Yemen,Kedah,0,0,0
1/05/2023,Yemen,Kelantan,0,0,0
1/05/2023,Yemen,Melaka,0,0,0
1/05/2023,Yemen,Pahang,0,0,0
1/05/2023,Yemen,Perak,0,0,0
1/05/2023,Yemen,Perlis,0,0,0
1/05/2023,Yemen,Pulau Pinang,3,3,0
1/05/2023,Yemen,Sabah,0,0,0
1/05/2023,Yemen,Sarawak,4,1,3
1/05/2023,Yemen,Selangor,1201,833,368
1/05/2023,Yemen,W.P. Labuan,0,0,0
1/05/2023,South Africa,Johor,216,143,73
1/05/2023,South Africa,Kedah,33,21,12
1/05/2023,South Africa,Kelantan,3,2,1
1/05/2023,South Africa,Melaka,0,0,0
1/05/2023,South Africa,Pahang,0,0,0
1/05/2023,South Africa,Perak,1,0,1
1/05/2023,South Africa,Perlis,12,9,3
1/05/2023,South Africa,Pulau Pinang,35,21,14
1/05/2023,South Africa,Sabah,17,11,6
1/05/2023,South Africa,Sarawak,81,44,37
1/05/2023,South Africa,Selangor,768,443,325
1/05/2023,South Africa,Terengganu,0,0,0
1/05/2023,South Africa,W.P. Labuan,1,1,0
1/05/2023,ZAR,Selangor,0,0,0
1/05/2023,Zambia,Johor,2,2,0
1/05/2023,Zambia,Kedah,0,0,0
1/05/2023,Zambia,Perak,0,0,0
1/05/2023,Zambia,Perlis,0,0,0
1/05/2023,Zambia,Pulau Pinang,0,0,0
1/05/2023,Zambia,Sabah,0,0,0
1/05/2023,Zambia,Sarawak,1,1,0
1/05/2023,Zambia,Selangor,46,19,27
1/05/2023,Zimbabwe,Johor,17,10,7
1/05/2023,Zimbabwe,Kedah,2,1,1
1/05/2023,Zimbabwe,Kelantan,0,0,0
1/05/2023,Zimbabwe,Perak,0,0,0
1/05/2023,Zimbabwe,Perlis,1,1,0
1/05/2023,Zimbabwe,Pulau Pinang,0,0,0
1/05/2023,Zimbabwe,Sabah,0,0,0
1/05/2023,Zimbabwe,Sarawak,0,0,0
1/05/2023,Zimbabwe,Selangor,88,48,40
1/06/2023,Aruba,Kedah,0,0,0
1/06/2023,Aruba,Pulau Pinang,0,0,0
1/06/2023,Afghanistan,Johor,1,1,0
1/06/2023,Afghanistan,Kedah,0,0,0
1/06/2023,Afghanistan,Perlis,0,0,0
1/06/2023,Afghanistan,Pulau Pinang,0,0,0
1/06/2023,Afghanistan,Sarawak,0,0,0
1/06/2023,Afghanistan,Selangor,43,33,10
1/06/2023,Angola,Johor,0,0,0
1/06/2023,Angola,Kedah,0,0,0
1/06/2023,Angola,Sabah,0,0,0
1/06/2023,Angola,Selangor,12,8,4
1/06/2023,Anguilla,Selangor,0,0,0
1/06/2023,Albania,Johor,10,10,0
1/06/2023,Albania,Kedah,0,0,0
1/06/2023,Albania,Perak,0,0,0
1/06/2023,Albania,Perlis,0,0,0
1/06/2023,Albania,Pulau Pinang,0,0,0
1/06/2023,Albania,Sabah,0,0,0
1/06/2023,Albania,Sarawak,0,0,0
1/06/2023,Albania,Selangor,16,10,6
1/06/2023,Andorra,Johor,0,0,0
1/06/2023,Andorra,Kedah,0,0,0
1/06/2023,Andorra,Perlis,0,0,0
1/06/2023,Andorra,Pulau Pinang,0,0,0
1/06/2023,Andorra,Selangor,1,1,0
1/06/2023,Antigua and Barbuda,Selangor,0,0,0
1/06/2023,United Arab Emirates,Johor,23,16,7
1/06/2023,United Arab Emirates,Kedah,1,0,1
1/06/2023,United Arab Emirates,Kelantan,2,2,0
1/06/2023,United Arab Emirates,Perak,0,0,0
1/06/2023,United Arab Emirates,Perlis,4,4,0
1/06/2023,United Arab Emirates,Pulau Pinang,4,4,0
1/06/2023,United Arab Emirates,Sabah,0,0,0
1/06/2023,United Arab Emirates,Sarawak,0,0,0
1/06/2023,United Arab Emirates,Selangor,732,395,337
1/06/2023,Argentina,Johor,76,40,36
1/06/2023,Argentina,Kedah,4,4,0
1/06/2023,Argentina,Kelantan,0,0,0
1/06/2023,Argentina,Melaka,0,0,0
1/06/2023,Argentina,Perak,1,1,0
1/06/2023,Argentina,Perlis,3,2,1
1/06/2023,Argentina,Pulau Pinang,11,7,4
1/06/2023,Argentina,Sabah,1,1,0
1/06/2023,Argentina,Sarawak,1,1,0
1/06/2023,Argentina,Selangor,216,124,92
1/06/2023,Argentina,W.P. Labuan,0,0,0
1/06/2023,Armenia,Johor,9,5,4
1/06/2023,Armenia,Kedah,0,0,0
1/06/2023,Armenia,Kelantan,0,0,0
1/06/2023,Armenia,Perak,0,0,0
1/06/2023,Armenia,Perlis,0,0,0
1/06/2023,Armenia,Pulau Pinang,2,0,2
1/06/2023,Armenia,Sabah,0,0,0
1/06/2023,Armenia,Sarawak,0,0,0
1/06/2023,Armenia,Selangor,101,32,69
1/06/2023,Antarctica,Selangor,0,0,0
1/06/2023,Antigua and Barbuda,Johor,3,3,0
1/06/2023,Antigua and Barbuda,Kedah,0,0,0
1/06/2023,Antigua and Barbuda,Pulau Pinang,0,0,0
1/06/2023,Antigua and Barbuda,Sarawak,0,0,0
1/06/2023,Antigua and Barbuda,Selangor,15,11,4
1/06/2023,Australia,Johor,4705,2736,1969
1/06/2023,Australia,Kedah,593,310,283
1/06/2023,Australia,Kelantan,11,5,6
1/06/2023,Australia,Melaka,0,0,0
1/06/2023,Australia,Negeri Sembilan,0,0,0
1/06/2023,Australia,Pahang,32,16,16
1/06/2023,Australia,Perak,182,98,84
1/06/2023,Australia,Perlis,97,60,37
1/06/2023,Australia,Pulau Pinang,1961,1027,934
1/06/2023,Australia,Sabah,294,153,141
1/06/2023,Australia,Sarawak,523,305,218
1/06/2023,Australia,Selangor,17718,10048,7670
1/06/2023,Australia,Terengganu,0,0,0
1/06/2023,Australia,W.P. Labuan,21,17,4
1/06/2023,Austria,Johor,101,62,39
1/06/2023,Austria,Kedah,17,9,8
1/06/2023,Austria,Kelantan,3,3,0
1/06/2023,Austria,Melaka,1,1,0
1/06/2023,Austria,Negeri Sembilan,0,0,0
1/06/2023,Austria,Pahang,0,0,0
1/06/2023,Austria,Perak,1,1,0
1/06/2023,Austria,Perlis,5,4,1
1/06/2023,Austria,Pulau Pinang,60,48,12
1/06/2023,Austria,Sabah,9,6,3
1/06/2023,Austria,Sarawak,13,10,3
1/06/2023,Austria,Selangor,403,269,134
1/06/2023,Austria,Terengganu,0,0,0
1/06/2023,Austria,W.P. Labuan,0,0,0
1/06/2023,Azerbaijan,Johor,5,3,2
1/06/2023,Azerbaijan,Kedah,3,2,1
1/06/2023,Azerbaijan,Kelantan,0,0,0
1/06/2023,Azerbaijan,Melaka,0,0,0
1/06/2023,Azerbaijan,Perlis,0,0,0
1/06/2023,Azerbaijan,Pulau Pinang,0,0,0
1/06/2023,Azerbaijan,Sabah,0,0,0
1/06/2023,Azerbaijan,Sarawak,0,0,0
1/06/2023,Azerbaijan,Selangor,80,54,26
1/06/2023,Azerbaijan,W.P. Labuan,10,10,0
1/06/2023,Burundi,Pulau Pinang,0,0,0
1/06/2023,Burundi,Sarawak,0,0,0
1/06/2023,Burundi,Selangor,8,3,5
1/06/2023,Belgium,Johor,209,132,77
1/06/2023,Belgium,Kedah,29,13,16
1/06/2023,Belgium,Kelantan,3,2,1
1/06/2023,Belgium,Melaka,0,0,0
1/06/2023,Belgium,Negeri Sembilan,0,0,0
1/06/2023,Belgium,Pahang,2,2,0
1/06/2023,Belgium,Perak,3,1,2
1/06/2023,Belgium,Perlis,23,16,7
1/06/2023,Belgium,Pulau Pinang,35,28,7
1/06/2023,Belgium,Sabah,25,20,5
1/06/2023,Belgium,Sarawak,27,16,11
1/06/2023,Belgium,Selangor,826,490,336
1/06/2023,Belgium,W.P. Labuan,0,0,0
1/06/2023,Benin,Johor,0,0,0
1/06/2023,Benin,Kedah,0,0,0
1/06/2023,Benin,Perak,1,1,0
1/06/2023,Benin,Pulau Pinang,0,0,0
1/06/2023,Benin,Sabah,0,0,0
1/06/2023,Benin,Sarawak,0,0,0
1/06/2023,Benin,Selangor,9,7,2
1/06/2023,Burkina Faso,Perak,0,0,0
1/06/2023,Burkina Faso,Pulau Pinang,0,0,0
1/06/2023,Burkina Faso,Selangor,1,1,0
1/06/2023,Bangladesh,Johor,3887,3327,560
1/06/2023,Bangladesh,Kedah,110,65,45
1/06/2023,Bangladesh,Kelantan,3,3,0
1/06/2023,Bangladesh,Melaka,0,0,0
1/06/2023,Bangladesh,Negeri Sembilan,0,0,0
1/06/2023,Bangladesh,Pahang,0,0,0
1/06/2023,Bangladesh,Perak,4,2,2
1/06/2023,Bangladesh,Perlis,3,3,0
1/06/2023,Bangladesh,Pulau Pinang,308,288,20
1/06/2023,Bangladesh,Sabah,6,3,3
1/06/2023,Bangladesh,Sarawak,18,16,2
1/06/2023,Bangladesh,Selangor,47417,46058,1359
1/06/2023,Bangladesh,W.P. Labuan,12,12,0
1/06/2023,Bulgaria,Johor,25,14,11
1/06/2023,Bulgaria,Kedah,5,3,2
1/06/2023,Bulgaria,Kelantan,0,0,0
1/06/2023,Bulgaria,Pahang,0,0,0
1/06/2023,Bulgaria,Perak,1,0,1
1/06/2023,Bulgaria,Perlis,2,0,2
1/06/2023,Bulgaria,Pulau Pinang,3,3,0
1/06/2023,Bulgaria,Sabah,1,0,1
1/06/2023,Bulgaria,Sarawak,3,3,0
1/06/2023,Bulgaria,Selangor,112,58,54
1/06/2023,Bulgaria,W.P. Labuan,1,0,1
1/06/2023,Bahrain,Johor,14,8,6
1/06/2023,Bahrain,Kedah,4,2,2
1/06/2023,Bahrain,Kelantan,0,0,0
1/06/2023,Bahrain,Perlis,1,1,0
1/06/2023,Bahrain,Pulau Pinang,1,1,0
1/06/2023,Bahrain,Sabah,0,0,0
1/06/2023,Bahrain,Sarawak,1,0,1
1/06/2023,Bahrain,Selangor,254,138,116
1/06/2023,Bahamas,Johor,0,0,0
1/06/2023,Bahamas,Kedah,0,0,0
1/06/2023,Bahamas,Perak,0,0,0
1/06/2023,Bahamas,Sabah,0,0,0
1/06/2023,Bahamas,Sarawak,0,0,0
1/06/2023,Bahamas,Selangor,9,5,4
1/06/2023,Bosnia and Herzegovina,Johor,5,3,2
1/06/2023,Bosnia and Herzegovina,Kedah,0,0,0
1/06/2023,Bosnia and Herzegovina,Perlis,0,0,0
1/06/2023,Bosnia and Herzegovina,Pulau Pinang,1,1,0
1/06/2023,Bosnia and Herzegovina,Sabah,1,1,0
1/06/2023,Bosnia and Herzegovina,Sarawak,1,1,0
1/06/2023,Bosnia and Herzegovina,Selangor,32,21,11
1/06/2023,Belarus,Johor,26,9,17
1/06/2023,Belarus,Kedah,7,3,4
1/06/2023,Belarus,Kelantan,1,0,1
1/06/2023,Belarus,Pahang,0,0,0
1/06/2023,Belarus,Perak,0,0,0
1/06/2023,Belarus,Perlis,1,1,0
1/06/2023,Belarus,Pulau Pinang,9,5,4
1/06/2023,Belarus,Sabah,2,1,1
1/06/2023,Belarus,Sarawak,0,0,0
1/06/2023,Belarus,Selangor,184,71,113
1/06/2023,Belarus,W.P. Labuan,0,0,0
1/06/2023,Belize,Johor,1,1,0
1/06/2023,Belize,Pulau Pinang,0,0,0
1/06/2023,Belize,Sarawak,0,0,0
1/06/2023,Belize,Selangor,1,1,0
1/06/2023,Bermuda,Selangor,0,0,0
1/06/2023,Bolivia,Johor,3,2,1
1/06/2023,Bolivia,Kedah,1,0,1
1/06/2023,Bolivia,Melaka,0,0,0
1/06/2023,Bolivia,Perak,0,0,0
1/06/2023,Bolivia,Perlis,0,0,0
1/06/2023,Bolivia,Pulau Pinang,1,0,1
1/06/2023,Bolivia,Sabah,0,0,0
1/06/2023,Bolivia,Sarawak,0,0,0
1/06/2023,Bolivia,Selangor,4,1,3
1/06/2023,Brazil,Johor,237,136,101
1/06/2023,Brazil,Kedah,21,8,13
1/06/2023,Brazil,Kelantan,2,2,0
1/06/2023,Brazil,Melaka,0,0,0
1/06/2023,Brazil,Pahang,0,0,0
1/06/2023,Brazil,Perak,3,2,1
1/06/2023,Brazil,Perlis,1,1,0
1/06/2023,Brazil,Pulau Pinang,16,11,5
1/06/2023,Brazil,Sabah,5,1,4
1/06/2023,Brazil,Sarawak,10,7,3
1/06/2023,Brazil,Selangor,520,291,229
1/06/2023,Brazil,W.P. Labuan,0,0,0
1/06/2023,Barbados,Johor,6,2,4
1/06/2023,Barbados,Kedah,0,0,0
1/06/2023,Barbados,Perlis,0,0,0
1/06/2023,Barbados,Pulau Pinang,0,0,0
1/06/2023,Barbados,Selangor,9,5,4
1/06/2023,Brunei Darussalam,Johor,377,205,172
1/06/2023,Brunei Darussalam,Kedah,5,5,0
1/06/2023,Brunei Darussalam,Kelantan,10,7,3
1/06/2023,Brunei Darussalam,Melaka,0,0,0
1/06/2023,Brunei Darussalam,Pahang,0,0,0
1/06/2023,Brunei Darussalam,Perak,3,2,1
1/06/2023,Brunei Darussalam,Perlis,46,24,22
1/06/2023,Brunei Darussalam,Pulau Pinang,11,5,6
1/06/2023,Brunei Darussalam,Sabah,793,310,483
1/06/2023,Brunei Darussalam,Sarawak,71268,39748,31520
1/06/2023,Brunei Darussalam,Selangor,2820,1454,1366
1/06/2023,Brunei Darussalam,W.P. Labuan,1035,686,349
1/06/2023,Bhutan,Johor,12,7,5
1/06/2023,Bhutan,Kedah,0,0,0
1/06/2023,Bhutan,Perak,0,0,0
1/06/2023,Bhutan,Perlis,0,0,0
1/06/2023,Bhutan,Pulau Pinang,6,6,0
1/06/2023,Bhutan,Sabah,0,0,0
1/06/2023,Bhutan,Sarawak,0,0,0
1/06/2023,Bhutan,Selangor,17,9,8
1/06/2023,Botswana,Johor,3,2,1
1/06/2023,Botswana,Kedah,0,0,0
1/06/2023,Botswana,Perlis,0,0,0
1/06/2023,Botswana,Pulau Pinang,0,0,0
1/06/2023,Botswana,Sabah,0,0,0
1/06/2023,Botswana,Sarawak,0,0,0
1/06/2023,Botswana,Selangor,14,10,4
1/06/2023,Central African Republic,Kedah,0,0,0
1/06/2023,Central African Republic,Selangor,0,0,0
1/06/2023,Canada,Johor,1140,633,507
1/06/2023,Canada,Kedah,112,57,55
1/06/2023,Canada,Kelantan,1,1,0
1/06/2023,Canada,Melaka,2,1,1
1/06/2023,Canada,Negeri Sembilan,0,0,0
1/06/2023,Canada,Pahang,1,1,0
1/06/2023,Canada,Perak,38,24,14
1/06/2023,Canada,Perlis,35,19,16
1/06/2023,Canada,Pulau Pinang,409,201,208
1/06/2023,Canada,Sabah,67,36,31
1/06/2023,Canada,Sarawak,253,132,121
1/06/2023,Canada,Selangor,2375,1410,965
1/06/2023,Canada,Terengganu,0,0,0
1/06/2023,Canada,W.P. Labuan,1,1,0
1/06/2023,Cocos (Keeling) Islands,Selangor,0,0,0
1/06/2023,Switzerland,Johor,346,195,151
1/06/2023,Switzerland,Kedah,80,43,37
1/06/2023,Switzerland,Kelantan,2,2,0
1/06/2023,Switzerland,Melaka,2,1,1
1/06/2023,Switzerland,Negeri Sembilan,0,0,0
1/06/2023,Switzerland,Pahang,9,6,3
1/06/2023,Switzerland,Perak,5,4,1
1/06/2023,Switzerland,Perlis,15,7,8
1/06/2023,Switzerland,Pulau Pinang,76,47,29
1/06/2023,Switzerland,Sabah,19,10,9
1/06/2023,Switzerland,Sarawak,34,19,15
1/06/2023,Switzerland,Selangor,723,456,267
1/06/2023,Switzerland,W.P. Labuan,0,0,0
1/06/2023,Chile,Johor,18,11,7
1/06/2023,Chile,Kedah,6,3,3
1/06/2023,Chile,Kelantan,0,0,0
1/06/2023,Chile,Melaka,0,0,0
1/06/2023,Chile,Pahang,0,0,0
1/06/2023,Chile,Perak,0,0,0
1/06/2023,Chile,Perlis,7,5,2
1/06/2023,Chile,Pulau Pinang,12,6,6
1/06/2023,Chile,Sabah,1,1,0
1/06/2023,Chile,Sarawak,1,1,0
1/06/2023,Chile,Selangor,145,78,67
1/06/2023,China,Johor,41635,17973,23662
1/06/2023,China,Kedah,895,387,508
1/06/2023,China,Kelantan,3,1,2
1/06/2023,China,Melaka,2,1,1
1/06/2023,China,Pahang,21,6,15
1/06/2023,China,Perak,248,116,132
1/06/2023,China,Perlis,93,38,55
1/06/2023,China,Pulau Pinang,8331,4361,3970
1/06/2023,China,Sabah,5479,2637,2842
1/06/2023,China,Sarawak,741,349,392
1/06/2023,China,Selangor,52309,27061,25248
1/06/2023,China,Terengganu,0,0,0
1/06/2023,China,W.P. Labuan,58,48,10
1/06/2023,Côte d'Ivoire,Johor,2,0,2
1/06/2023,Côte d'Ivoire,Kedah,0,0,0
1/06/2023,Côte d'Ivoire,Pulau Pinang,0,0,0
1/06/2023,Côte d'Ivoire,Sabah,0,0,0
1/06/2023,Côte d'Ivoire,Sarawak,0,0,0
1/06/2023,Côte d'Ivoire,Selangor,15,13,2
1/06/2023,Cameroon,Johor,3,3,0
1/06/2023,Cameroon,Kedah,0,0,0
1/06/2023,Cameroon,Pulau Pinang,0,0,0
1/06/2023,Cameroon,Sabah,0,0,0
1/06/2023,Cameroon,Sarawak,0,0,0
1/06/2023,Cameroon,Selangor,19,15,4
1/06/2023,Congo,Johor,2,2,0
1/06/2023,Congo,Pulau Pinang,0,0,0
1/06/2023,Congo,Sarawak,0,0,0
1/06/2023,Congo,Selangor,15,12,3
1/06/2023,Congo,Johor,0,0,0
1/06/2023,Congo,Kedah,0,0,0
1/06/2023,Congo,Selangor,1,0,1
1/06/2023,Cook Islands,Selangor,0,0,0
1/06/2023,Colombia,Johor,27,13,14
1/06/2023,Colombia,Kedah,0,0,0
1/06/2023,Colombia,Perak,0,0,0
1/06/2023,Colombia,Pulau Pinang,5,3,2
1/06/2023,Colombia,Sabah,1,0,1
1/06/2023,Colombia,Sarawak,0,0,0
1/06/2023,Colombia,Selangor,152,69,83
1/06/2023,Colombia,W.P. Labuan,0,0,0
1/06/2023,Comoros,Johor,2,0,2
1/06/2023,Comoros,Kedah,0,0,0
1/06/2023,Comoros,Selangor,34,24,10
1/06/2023,Cabo Verde,Johor,0,0,0
1/06/2023,Cabo Verde,Kedah,0,0,0
1/06/2023,Cabo Verde,Pulau Pinang,0,0,0
1/06/2023,Cabo Verde,Sabah,0,0,0
1/06/2023,Cabo Verde,Selangor,2,2,0
1/06/2023,Costa Rica,Johor,9,6,3
1/06/2023,Costa Rica,Kedah,1,0,1
1/06/2023,Costa Rica,Perak,0,0,0
1/06/2023,Costa Rica,Perlis,0,0,0
1/06/2023,Costa Rica,Pulau Pinang,2,2,0
1/06/2023,Costa Rica,Sabah,3,2,1
1/06/2023,Costa Rica,Sarawak,0,0,0
1/06/2023,Costa Rica,Selangor,30,13,17
1/06/2023,Cuba,Johor,3,2,1
1/06/2023,Cuba,Kedah,0,0,0
1/06/2023,Cuba,Perlis,0,0,0
1/06/2023,Cuba,Pulau Pinang,1,0,1
1/06/2023,Cuba,Sabah,0,0,0
1/06/2023,Cuba,Sarawak,0,0,0
1/06/2023,Cuba,Selangor,21,12,9
1/06/2023,Cyprus,Johor,7,7,0
1/06/2023,Cyprus,Kedah,0,0,0
1/06/2023,Cyprus,Perak,0,0,0
1/06/2023,Cyprus,Perlis,0,0,0
1/06/2023,Cyprus,Pulau Pinang,2,1,1
1/06/2023,Cyprus,Sabah,0,0,0
1/06/2023,Cyprus,Sarawak,0,0,0
1/06/2023,Cyprus,Selangor,67,51,16
1/06/2023,Czechia,Johor,105,73,32
1/06/2023,Czechia,Kedah,19,11,8
1/06/2023,Czechia,Kelantan,0,0,0
1/06/2023,Czechia,Melaka,0,0,0
1/06/2023,Czechia,Negeri Sembilan,0,0,0
1/06/2023,Czechia,Perak,0,0,0
1/06/2023,Czechia,Perlis,2,2,0
1/06/2023,Czechia,Pulau Pinang,5,3,2
1/06/2023,Czechia,Sabah,7,3,4
1/06/2023,Czechia,Sarawak,13,9,4
1/06/2023,Czechia,Selangor,251,150,101
1/06/2023,Czechia,W.P. Labuan,1,1,0
1/06/2023,Germany,Johor,1893,1163,730
1/06/2023,Germany,Kedah,313,161,152
1/06/2023,Germany,Kelantan,13,10,3
1/06/2023,Germany,Melaka,10,5,5
1/06/2023,Germany,Negeri Sembilan,0,0,0
1/06/2023,Germany,Pahang,15,7,8
1/06/2023,Germany,Perak,32,19,13
1/06/2023,Germany,Perlis,80,49,31
1/06/2023,Germany,Pulau Pinang,510,383,127
1/06/2023,Germany,Sabah,134,83,51
1/06/2023,Germany,Sarawak,200,111,89
1/06/2023,Germany,Selangor,4102,2595,1507
1/06/2023,Germany,Terengganu,0,0,0
1/06/2023,Germany,W.P. Labuan,5,4,1
1/06/2023,Djibouti,Johor,0,0,0
1/06/2023,Djibouti,Selangor,8,7,1
1/06/2023,Dominica,Johor,9,9,0
1/06/2023,Dominica,Kedah,0,0,0
1/06/2023,Dominica,Pulau Pinang,0,0,0
1/06/2023,Dominica,Sabah,0,0,0
1/06/2023,Dominica,Sarawak,2,1,1
1/06/2023,Dominica,Selangor,37,30,7
1/06/2023,Dominica,W.P. Labuan,0,0,0
1/06/2023,Denmark,Johor,231,169,62
1/06/2023,Denmark,Kedah,16,11,5
1/06/2023,Denmark,Kelantan,6,5,1
1/06/2023,Denmark,Melaka,0,0,0
1/06/2023,Denmark,Negeri Sembilan,0,0,0
1/06/2023,Denmark,Pahang,0,0,0
1/06/2023,Denmark,Perak,8,5,3
1/06/2023,Denmark,Perlis,10,5,5
1/06/2023,Denmark,Pulau Pinang,50,37,13
1/06/2023,Denmark,Sabah,24,16,8
1/06/2023,Denmark,Sarawak,7,6,1
1/06/2023,Denmark,Selangor,673,389,284
1/06/2023,Denmark,W.P. Labuan,0,0,0
1/06/2023,Dominican Republic,Johor,2,0,2
1/06/2023,Dominican Republic,Kedah,1,0,1
1/06/2023,Dominican Republic,Perak,0,0,0
1/06/2023,Dominican Republic,Perlis,0,0,0
1/06/2023,Dominican Republic,Pulau Pinang,0,0,0
1/06/2023,Dominican Republic,Sabah,0,0,0
1/06/2023,Dominican Republic,Sarawak,0,0,0
1/06/2023,Dominican Republic,Selangor,18,13,5
1/06/2023,Algeria,Johor,18,16,2
1/06/2023,Algeria,Kedah,3,3,0
1/06/2023,Algeria,Kelantan,0,0,0
1/06/2023,Algeria,Melaka,0,0,0
1/06/2023,Algeria,Perak,1,1,0
1/06/2023,Algeria,Perlis,0,0,0
1/06/2023,Algeria,Pulau Pinang,5,3,2
1/06/2023,Algeria,Sabah,1,0,1
1/06/2023,Algeria,Sarawak,8,7,1
1/06/2023,Algeria,Selangor,467,305,162
1/06/2023,Algeria,W.P. Labuan,0,0,0
1/06/2023,Ecuador,Johor,16,5,11
1/06/2023,Ecuador,Kedah,0,0,0
1/06/2023,Ecuador,Perak,0,0,0
1/06/2023,Ecuador,Perlis,0,0,0
1/06/2023,Ecuador,Pulau Pinang,2,0,2
1/06/2023,Ecuador,Sabah,0,0,0
1/06/2023,Ecuador,Sarawak,0,0,0
1/06/2023,Ecuador,Selangor,46,17,29
1/06/2023,Egypt,Johor,228,176,52
1/06/2023,Egypt,Kedah,8,7,1
1/06/2023,Egypt,Kelantan,1,1,0
1/06/2023,Egypt,Melaka,0,0,0
1/06/2023,Egypt,Pahang,0,0,0
1/06/2023,Egypt,Perak,3,2,1
1/06/2023,Egypt,Perlis,6,3,3
1/06/2023,Egypt,Pulau Pinang,12,11,1
1/06/2023,Egypt,Sabah,5,5,0
1/06/2023,Egypt,Sarawak,105,74,31
1/06/2023,Egypt,Selangor,1495,1012,483
1/06/2023,Egypt,Terengganu,0,0,0
1/06/2023,Egypt,W.P. Labuan,1,1,0
1/06/2023,Eritrea,Johor,1,1,0
1/06/2023,Eritrea,Pulau Pinang,0,0,0
1/06/2023,Eritrea,Sabah,0,0,0
1/06/2023,Eritrea,Selangor,24,13,11
1/06/2023,Spain,Johor,476,316,160
1/06/2023,Spain,Kedah,59,28,31
1/06/2023,Spain,Kelantan,3,3,0
1/06/2023,Spain,Melaka,0,0,0
1/06/2023,Spain,Negeri Sembilan,0,0,0
1/06/2023,Spain,Pahang,0,0,0
1/06/2023,Spain,Perak,2,0,2
1/06/2023,Spain,Perlis,18,15,3
1/06/2023,Spain,Pulau Pinang,83,55,28
1/06/2023,Spain,Sabah,29,14,15
1/06/2023,Spain,Sarawak,42,26,16
1/06/2023,Spain,Selangor,1499,856,643
1/06/2023,Spain,W.P. Labuan,2,0,2
1/06/2023,Estonia,Johor,25,16,9
1/06/2023,Estonia,Kedah,2,0,2
1/06/2023,Estonia,Kelantan,0,0,0
1/06/2023,Estonia,Pahang,0,0,0
1/06/2023,Estonia,Perak,0,0,0
1/06/2023,Estonia,Perlis,1,0,1
1/06/2023,Estonia,Pulau Pinang,4,4,0
1/06/2023,Estonia,Sabah,0,0,0
1/06/2023,Estonia,Sarawak,2,1,1
1/06/2023,Estonia,Selangor,60,29,31
1/06/2023,Estonia,W.P. Labuan,1,0,1
1/06/2023,Ethiopia,Johor,1,0,1
1/06/2023,Ethiopia,Kedah,0,0,0
1/06/2023,Ethiopia,Pulau Pinang,0,0,0
1/06/2023,Ethiopia,Sarawak,0,0,0
1/06/2023,Ethiopia,Selangor,38,24,14
1/06/2023,Finland,Johor,148,83,65
1/06/2023,Finland,Kedah,19,10,9
1/06/2023,Finland,Kelantan,1,1,0
1/06/2023,Finland,Melaka,0,0,0
1/06/2023,Finland,Negeri Sembilan,0,0,0
1/06/2023,Finland,Pahang,0,0,0
1/06/2023,Finland,Perak,7,3,4
1/06/2023,Finland,Perlis,7,6,1
1/06/2023,Finland,Pulau Pinang,19,15,4
1/06/2023,Finland,Sabah,9,3,6
1/06/2023,Finland,Sarawak,9,5,4
1/06/2023,Finland,Selangor,266,159,107
1/06/2023,Finland,W.P. Labuan,0,0,0
1/06/2023,Fiji,Johor,71,27,44
1/06/2023,Fiji,Kedah,0,0,0
1/06/2023,Fiji,Kelantan,0,0,0
1/06/2023,Fiji,Perak,0,0,0
1/06/2023,Fiji,Perlis,0,0,0
1/06/2023,Fiji,Pulau Pinang,4,1,3
1/06/2023,Fiji,Sabah,0,0,0
1/06/2023,Fiji,Sarawak,1,0,1
1/06/2023,Fiji,Selangor,109,57,52
1/06/2023,France,Johor,1998,1171,827
1/06/2023,France,Kedah,295,173,122
1/06/2023,France,Kelantan,21,13,8
1/06/2023,France,Melaka,3,2,1
1/06/2023,France,Negeri Sembilan,0,0,0
1/06/2023,France,Pahang,20,13,7
1/06/2023,France,Perak,32,21,11
1/06/2023,France,Perlis,82,47,35
1/06/2023,France,Pulau Pinang,363,230,133
1/06/2023,France,Sabah,105,67,38
1/06/2023,France,Sarawak,126,78,48
1/06/2023,France,Selangor,5098,3025,2073
1/06/2023,France,Terengganu,0,0,0
1/06/2023,France,W.P. Labuan,0,0,0
1/06/2023,"Micronesia, Federated States of",Johor,0,0,0
1/06/2023,"Micronesia, Federated States of",Pulau Pinang,0,0,0
1/06/2023,"Micronesia, Federated States of",Selangor,2,1,1
1/06/2023,Gabon,Johor,2,0,2
1/06/2023,Gabon,Pulau Pinang,0,0,0
1/06/2023,Gabon,Sarawak,0,0,0
1/06/2023,Gabon,Selangor,7,3,4
1/06/2023,United Kingdom of Great Britain and Northern Ireland,Johor,4561,2911,1650
1/06/2023,United Kingdom of Great Britain and Northern Ireland,Kedah,671,367,304
1/06/2023,United Kingdom of Great Britain and Northern Ireland,Kelantan,16,10,6
1/06/2023,United Kingdom of Great Britain and Northern Ireland,Melaka,1,1,0
1/06/2023,United Kingdom of Great Britain and Northern Ireland,Negeri Sembilan,0,0,0
1/06/2023,United Kingdom of Great Britain and Northern Ireland,Pahang,14,10,4
1/06/2023,United Kingdom of Great Britain and Northern Ireland,Perak,87,59,28
1/06/2023,United Kingdom of Great Britain and Northern Ireland,Perlis,191,106,85
1/06/2023,United Kingdom of Great Britain and Northern Ireland,Pulau Pinang,1122,711,411
1/06/2023,United Kingdom of Great Britain and Northern Ireland,Sabah,391,231,160
1/06/2023,United Kingdom of Great Britain and Northern Ireland,Sarawak,961,583,378
1/06/2023,United Kingdom of Great Britain and Northern Ireland,Selangor,11393,6950,4443
1/06/2023,United Kingdom of Great Britain and Northern Ireland,Terengganu,0,0,0
1/06/2023,United Kingdom of Great Britain and Northern Ireland,W.P. Labuan,30,22,8
1/06/2023,Georgia,Johor,9,5,4
1/06/2023,Georgia,Kedah,2,1,1
1/06/2023,Georgia,Melaka,0,0,0
1/06/2023,Georgia,Perak,0,0,0
1/06/2023,Georgia,Perlis,1,1,0
1/06/2023,Georgia,Pulau Pinang,0,0,0
1/06/2023,Georgia,Sabah,1,1,0
1/06/2023,Georgia,Sarawak,0,0,0
1/06/2023,Georgia,Selangor,42,24,18
1/06/2023,Ghana,Johor,5,4,1
1/06/2023,Ghana,Kedah,0,0,0
1/06/2023,Ghana,Kelantan,0,0,0
1/06/2023,Ghana,Pulau Pinang,2,1,1
1/06/2023,Ghana,Sabah,2,1,1
1/06/2023,Ghana,Sarawak,0,0,0
1/06/2023,Ghana,Selangor,49,40,9
1/06/2023,Gibraltar,Johor,0,0,0
1/06/2023,Gibraltar,Sarawak,0,0,0
1/06/2023,Guinea,Johor,1,1,0
1/06/2023,Guinea,Kedah,0,0,0
1/06/2023,Guinea,Kelantan,0,0,0
1/06/2023,Guinea,Perlis,0,0,0
1/06/2023,Guinea,Pulau Pinang,0,0,0
1/06/2023,Guinea,Sabah,0,0,0
1/06/2023,Guinea,Sarawak,0,0,0
1/06/2023,Guinea,Selangor,41,26,15
1/06/2023,Guadeloupe,Selangor,0,0,0
1/06/2023,Gambia,Johor,1,1,0
1/06/2023,Gambia,Kedah,0,0,0
1/06/2023,Gambia,Kelantan,0,0,0
1/06/2023,Gambia,Pulau Pinang,0,0,0
1/06/2023,Gambia,Sabah,0,0,0
1/06/2023,Gambia,Sarawak,0,0,0
1/06/2023,Gambia,Selangor,25,18,7
1/06/2023,Guinea-Bissau,Johor,1,1,0
1/06/2023,Guinea-Bissau,Selangor,0,0,0
1/06/2023,Equatorial Guinea,Johor,0,0,0
1/06/2023,Equatorial Guinea,Selangor,1,1,0
1/06/2023,Greece,Johor,50,40,10
1/06/2023,Greece,Kedah,3,2,1
1/06/2023,Greece,Kelantan,0,0,0
1/06/2023,Greece,Melaka,0,0,0
1/06/2023,Greece,Negeri Sembilan,0,0,0
1/06/2023,Greece,Pahang,0,0,0
1/06/2023,Greece,Perak,0,0,0
1/06/2023,Greece,Perlis,2,2,0
1/06/2023,Greece,Pulau Pinang,4,3,1
1/06/2023,Greece,Sabah,12,7,5
1/06/2023,Greece,Sarawak,0,0,0
1/06/2023,Greece,Selangor,134,106,28
1/06/2023,Grenada,Johor,5,1,4
1/06/2023,Grenada,Kedah,3,0,3
1/06/2023,Grenada,Pulau Pinang,0,0,0
1/06/2023,Grenada,Sabah,0,0,0
1/06/2023,Grenada,Sarawak,0,0,0
1/06/2023,Grenada,Selangor,6,4,2
1/06/2023,Greenland,Johor,0,0,0
1/06/2023,Greenland,Selangor,0,0,0
1/06/2023,Guatemala,Johor,3,0,3
1/06/2023,Guatemala,Kedah,0,0,0
1/06/2023,Guatemala,Pahang,0,0,0
1/06/2023,Guatemala,Perak,0,0,0
1/06/2023,Guatemala,Pulau Pinang,1,1,0
1/06/2023,Guatemala,Sabah,0,0,0
1/06/2023,Guatemala,Sarawak,1,0,1
1/06/2023,Guatemala,Selangor,12,9,3
1/06/2023,Guatemala,W.P. Labuan,1,0,1
1/06/2023,Guyana,Johor,0,0,0
1/06/2023,Guyana,Kedah,0,0,0
1/06/2023,Guyana,Pulau Pinang,1,0,1
1/06/2023,Guyana,Sarawak,0,0,0
1/06/2023,Guyana,Selangor,3,2,1
1/06/2023,Hong Kong,Johor,2,2,0
1/06/2023,Hong Kong,Kedah,0,0,0
1/06/2023,Hong Kong,Kelantan,0,0,0
1/06/2023,Hong Kong,Pahang,0,0,0
1/06/2023,Hong Kong,Perak,51,12,39
1/06/2023,Hong Kong,Perlis,0,0,0
1/06/2023,Hong Kong,Pulau Pinang,0,0,0
1/06/2023,Hong Kong,Sabah,11,8,3
1/06/2023,Hong Kong,Sarawak,0,0,0
1/06/2023,Hong Kong,Selangor,7,1,6
1/06/2023,Hong Kong,Terengganu,0,0,0
1/06/2023,Heard Island and McDonald Islands,Johor,0,0,0
1/06/2023,Honduras,Johor,5,3,2
1/06/2023,Honduras,Kedah,1,1,0
1/06/2023,Honduras,Perak,0,0,0
1/06/2023,Honduras,Pulau Pinang,1,0,1
1/06/2023,Honduras,Sabah,0,0,0
1/06/2023,Honduras,Sarawak,0,0,0
1/06/2023,Honduras,Selangor,10,7,3
1/06/2023,Croatia,Johor,29,23,6
1/06/2023,Croatia,Kedah,2,1,1
1/06/2023,Croatia,Kelantan,0,0,0
1/06/2023,Croatia,Melaka,0,0,0
1/06/2023,Croatia,Pahang,0,0,0
1/06/2023,Croatia,Perak,0,0,0
1/06/2023,Croatia,Perlis,0,0,0
1/06/2023,Croatia,Pulau Pinang,2,2,0
1/06/2023,Croatia,Sabah,0,0,0
1/06/2023,Croatia,Sarawak,2,1,1
1/06/2023,Croatia,Selangor,85,58,27
1/06/2023,Haiti,Johor,0,0,0
1/06/2023,Haiti,Kedah,0,0,0
1/06/2023,Haiti,Kelantan,0,0,0
1/06/2023,Haiti,Perak,0,0,0
1/06/2023,Haiti,Pulau Pinang,0,0,0
1/06/2023,Haiti,Sabah,0,0,0
1/06/2023,Haiti,Selangor,2,2,0
1/06/2023,Hungary,Johor,60,36,24
1/06/2023,Hungary,Kedah,13,7,6
1/06/2023,Hungary,Kelantan,0,0,0
1/06/2023,Hungary,Pahang,0,0,0
1/06/2023,Hungary,Perak,3,1,2
1/06/2023,Hungary,Perlis,5,2,3
1/06/2023,Hungary,Pulau Pinang,18,14,4
1/06/2023,Hungary,Sabah,7,6,1
1/06/2023,Hungary,Sarawak,6,5,1
1/06/2023,Hungary,Selangor,254,148,106
1/06/2023,Hungary,W.P. Labuan,0,0,0
1/06/2023,Indonesia,Johor,101577,46878,54699
1/06/2023,Indonesia,Kedah,5320,1974,3346
1/06/2023,Indonesia,Kelantan,109,59,50
1/06/2023,Indonesia,Melaka,5091,2392,2699
1/06/2023,Indonesia,Negeri Sembilan,5032,3302,1730
1/06/2023,Indonesia,Pahang,28,18,10
1/06/2023,Indonesia,Perak,250,59,191
1/06/2023,Indonesia,Perlis,595,220,375
1/06/2023,Indonesia,Pulau Pinang,42475,17224,25251
1/06/2023,Indonesia,Sabah,4907,2323,2584
1/06/2023,Indonesia,Sarawak,34662,17072,17590
1/06/2023,Indonesia,Selangor,75546,35482,40064
1/06/2023,Indonesia,Terengganu,0,0,0
1/06/2023,Indonesia,W.P. Labuan,55,32,23
1/06/2023,India,Johor,28743,18283,10460
1/06/2023,India,Kedah,1697,881,816
1/06/2023,India,Kelantan,5,4,1
1/06/2023,India,Melaka,0,0,0
1/06/2023,India,Negeri Sembilan,0,0,0
1/06/2023,India,Pahang,5,5,0
1/06/2023,India,Perak,441,330,111
1/06/2023,India,Perlis,28,20,8
1/06/2023,India,Pulau Pinang,946,625,321
1/06/2023,India,Sabah,195,112,83
1/06/2023,India,Sarawak,1028,795,233
1/06/2023,India,Selangor,36628,24600,12028
1/06/2023,India,Terengganu,0,0,0
1/06/2023,India,W.P. Labuan,55,42,13
1/06/2023, British Indian Ocean Territory,Pulau Pinang,0,0,0
1/06/2023, British Indian Ocean Territory,Selangor,0,0,0
1/06/2023,Ireland,Johor,259,160,99
1/06/2023,Ireland,Kedah,65,33,32
1/06/2023,Ireland,Kelantan,0,0,0
1/06/2023,Ireland,Negeri Sembilan,0,0,0
1/06/2023,Ireland,Pahang,3,1,2
1/06/2023,Ireland,Perak,8,4,4
1/06/2023,Ireland,Perlis,14,8,6
1/06/2023,Ireland,Pulau Pinang,106,62,44
1/06/2023,Ireland,Sabah,22,15,7
1/06/2023,Ireland,Sarawak,49,24,25
1/06/2023,Ireland,Selangor,1087,645,442
1/06/2023,Ireland,Terengganu,0,0,0
1/06/2023,Ireland,W.P. Labuan,0,0,0
1/06/2023,"Iran, Islamic Republic of",Johor,182,103,79
1/06/2023,"Iran, Islamic Republic of",Kedah,7,5,2
1/06/2023,"Iran, Islamic Republic of",Kelantan,0,0,0
1/06/2023,"Iran, Islamic Republic of",Perak,0,0,0
1/06/2023,"Iran, Islamic Republic of",Perlis,0,0,0
1/06/2023,"Iran, Islamic Republic of",Pulau Pinang,3,2,1
1/06/2023,"Iran, Islamic Republic of",Sabah,0,0,0
1/06/2023,"Iran, Islamic Republic of",Sarawak,8,6,2
1/06/2023,"Iran, Islamic Republic of",Selangor,1119,593,526
1/06/2023,"Iran, Islamic Republic of",W.P. Labuan,0,0,0
1/06/2023,Iraq,Johor,28,20,8
1/06/2023,Iraq,Kedah,0,0,0
1/06/2023,Iraq,Kelantan,0,0,0
1/06/2023,Iraq,Melaka,0,0,0
1/06/2023,Iraq,Pahang,0,0,0
1/06/2023,Iraq,Perak,0,0,0
1/06/2023,Iraq,Perlis,0,0,0
1/06/2023,Iraq,Pulau Pinang,1,0,1
1/06/2023,Iraq,Sabah,0,0,0
1/06/2023,Iraq,Sarawak,0,0,0
1/06/2023,Iraq,Selangor,1349,838,511
1/06/2023,Iceland,Johor,1,0,1
1/06/2023,Iceland,Kedah,7,3,4
1/06/2023,Iceland,Kelantan,0,0,0
1/06/2023,Iceland,Perak,0,0,0
1/06/2023,Iceland,Perlis,0,0,0
1/06/2023,Iceland,Pulau Pinang,0,0,0
1/06/2023,Iceland,Sabah,0,0,0
1/06/2023,Iceland,Sarawak,0,0,0
1/06/2023,Iceland,Selangor,22,12,10
1/06/2023,Iceland,W.P. Labuan,0,0,0
1/06/2023,Israel,Pulau Pinang,0,0,0
1/06/2023,Italy,Johor,502,338,164
1/06/2023,Italy,Kedah,46,29,17
1/06/2023,Italy,Kelantan,2,1,1
1/06/2023,Italy,Melaka,0,0,0
1/06/2023,Italy,Negeri Sembilan,0,0,0
1/06/2023,Italy,Pahang,2,1,1
1/06/2023,Italy,Perak,4,1,3
1/06/2023,Italy,Perlis,19,10,9
1/06/2023,Italy,Pulau Pinang,104,75,29
1/06/2023,Italy,Sabah,16,11,5
1/06/2023,Italy,Sarawak,52,36,16
1/06/2023,Italy,Selangor,1743,1178,565
1/06/2023,Italy,W.P. Labuan,1,1,0
1/06/2023,Jamaica,Johor,2,1,1
1/06/2023,Jamaica,Kedah,1,1,0
1/06/2023,Jamaica,Perak,0,0,0
1/06/2023,Jamaica,Pulau Pinang,1,0,1
1/06/2023,Jamaica,Sabah,0,0,0
1/06/2023,Jamaica,Sarawak,0,0,0
1/06/2023,Jamaica,Selangor,25,13,12
1/06/2023,Jamaica,W.P. Labuan,2,1,1
1/06/2023,Jordan,Johor,14,8,6
1/06/2023,Jordan,Kedah,2,1,1
1/06/2023,Jordan,Kelantan,0,0,0
1/06/2023,Jordan,Melaka,0,0,0
1/06/2023,Jordan,Perlis,1,1,0
1/06/2023,Jordan,Pulau Pinang,9,6,3
1/06/2023,Jordan,Sabah,6,2,4
1/06/2023,Jordan,Sarawak,1,1,0
1/06/2023,Jordan,Selangor,1022,621,401
1/06/2023,Jordan,W.P. Labuan,0,0,0
1/06/2023,Japan,Johor,5269,3665,1604
1/06/2023,Japan,Kedah,130,75,55
1/06/2023,Japan,Kelantan,7,6,1
1/06/2023,Japan,Melaka,1,1,0
1/06/2023,Japan,Negeri Sembilan,0,0,0
1/06/2023,Japan,Pahang,4,2,2
1/06/2023,Japan,Perak,49,27,22
1/06/2023,Japan,Perlis,51,38,13
1/06/2023,Japan,Pulau Pinang,1071,771,300
1/06/2023,Japan,Sabah,151,75,76
1/06/2023,Japan,Sarawak,155,95,60
1/06/2023,Japan,Selangor,10682,7221,3461
1/06/2023,Japan,W.P. Labuan,15,8,7
1/06/2023,Kazakhstan,Johor,50,26,24
1/06/2023,Kazakhstan,Kedah,3,2,1
1/06/2023,Kazakhstan,Kelantan,1,0,1
1/06/2023,Kazakhstan,Melaka,0,0,0
1/06/2023,Kazakhstan,Perak,0,0,0
1/06/2023,Kazakhstan,Perlis,3,2,1
1/06/2023,Kazakhstan,Pulau Pinang,16,6,10
1/06/2023,Kazakhstan,Sabah,2,1,1
1/06/2023,Kazakhstan,Sarawak,1,0,1
1/06/2023,Kazakhstan,Selangor,556,231,325
1/06/2023,Kazakhstan,W.P. Labuan,0,0,0
1/06/2023,Kenya,Johor,55,28,27
1/06/2023,Kenya,Kedah,1,1,0
1/06/2023,Kenya,Kelantan,0,0,0
1/06/2023,Kenya,Perak,0,0,0
1/06/2023,Kenya,Perlis,0,0,0
1/06/2023,Kenya,Pulau Pinang,3,0,3
1/06/2023,Kenya,Sabah,5,2,3
1/06/2023,Kenya,Sarawak,0,0,0
1/06/2023,Kenya,Selangor,282,139,143
1/06/2023,Kyrgyzstan,Johor,14,7,7
1/06/2023,Kyrgyzstan,Kedah,0,0,0
1/06/2023,Kyrgyzstan,Kelantan,0,0,0
1/06/2023,Kyrgyzstan,Perak,0,0,0
1/06/2023,Kyrgyzstan,Perlis,0,0,0
1/06/2023,Kyrgyzstan,Pulau Pinang,1,0,1
1/06/2023,Kyrgyzstan,Sabah,1,0,1
1/06/2023,Kyrgyzstan,Sarawak,1,0,1
1/06/2023,Kyrgyzstan,Selangor,181,88,93
1/06/2023,Cambodia,Johor,1950,851,1099
1/06/2023,Cambodia,Kedah,104,66,38
1/06/2023,Cambodia,Kelantan,429,236,193
1/06/2023,Cambodia,Melaka,0,0,0
1/06/2023,Cambodia,Negeri Sembilan,0,0,0
1/06/2023,Cambodia,Pahang,0,0,0
1/06/2023,Cambodia,Perak,8,0,8
1/06/2023,Cambodia,Perlis,556,352,204
1/06/2023,Cambodia,Pulau Pinang,28,11,17
1/06/2023,Cambodia,Sabah,3,2,1
1/06/2023,Cambodia,Sarawak,3,1,2
1/06/2023,Cambodia,Selangor,1880,890,990
1/06/2023,Cambodia,W.P. Labuan,0,0,0
1/06/2023,Kiribati,Johor,0,0,0
1/06/2023,Kiribati,Sabah,0,0,0
1/06/2023,Kiribati,Selangor,0,0,0
1/06/2023,Saint Kitts and Nevis,Johor,20,13,7
1/06/2023,Saint Kitts and Nevis,Kedah,0,0,0
1/06/2023,Saint Kitts and Nevis,Perlis,0,0,0
1/06/2023,Saint Kitts and Nevis,Pulau Pinang,1,1,0
1/06/2023,Saint Kitts and Nevis,Sabah,2,2,0
1/06/2023,Saint Kitts and Nevis,Selangor,62,41,21
1/06/2023,Saint Kitts and Nevis,W.P. Labuan,1,1,0
1/06/2023,"Korea, Republic of",Johor,8116,4651,3465
1/06/2023,"Korea, Republic of",Kedah,105,70,35
1/06/2023,"Korea, Republic of",Kelantan,3,0,3
1/06/2023,"Korea, Republic of",Melaka,5,4,1
1/06/2023,"Korea, Republic of",Negeri Sembilan,0,0,0
1/06/2023,"Korea, Republic of",Pahang,1,0,1
1/06/2023,"Korea, Republic of",Perak,18,12,6
1/06/2023,"Korea, Republic of",Perlis,57,48,9
1/06/2023,"Korea, Republic of",Pulau Pinang,461,256,205
1/06/2023,"Korea, Republic of",Sabah,6271,2702,3569
1/06/2023,"Korea, Republic of",Sarawak,174,104,70
1/06/2023,"Korea, Republic of",Selangor,7908,4574,3334
1/06/2023,"Korea, Republic of",Terengganu,0,0,0
1/06/2023,"Korea, Republic of",W.P. Labuan,3,2,1
1/06/2023,Kuwait,Johor,88,41,47
1/06/2023,Kuwait,Kedah,24,13,11
1/06/2023,Kuwait,Kelantan,0,0,0
1/06/2023,Kuwait,Perak,0,0,0
1/06/2023,Kuwait,Perlis,0,0,0
1/06/2023,Kuwait,Pulau Pinang,22,12,10
1/06/2023,Kuwait,Sabah,0,0,0
1/06/2023,Kuwait,Sarawak,2,2,0
1/06/2023,Kuwait,Selangor,1312,652,660
1/06/2023,Kuwait,W.P. Labuan,0,0,0
1/06/2023, Lao People's Democratic Republic,Johor,130,36,94
1/06/2023, Lao People's Democratic Republic,Kedah,605,42,563
1/06/2023, Lao People's Democratic Republic,Kelantan,250,57,193
1/06/2023, Lao People's Democratic Republic,Melaka,0,0,0
1/06/2023, Lao People's Democratic Republic,Perak,28,3,25
1/06/2023, Lao People's Democratic Republic,Perlis,439,130,309
1/06/2023, Lao People's Democratic Republic,Pulau Pinang,8,2,6
1/06/2023, Lao People's Democratic Republic,Sabah,0,0,0
1/06/2023, Lao People's Democratic Republic,Sarawak,12,6,6
1/06/2023, Lao People's Democratic Republic,Selangor,138,47,91
1/06/2023, Lao People's Democratic Republic,W.P. Labuan,0,0,0
1/06/2023,Lebanon,Johor,13,9,4
1/06/2023,Lebanon,Kedah,0,0,0
1/06/2023,Lebanon,Kelantan,0,0,0
1/06/2023,Lebanon,Pahang,0,0,0
1/06/2023,Lebanon,Perak,0,0,0
1/06/2023,Lebanon,Perlis,0,0,0
1/06/2023,Lebanon,Pulau Pinang,2,2,0
1/06/2023,Lebanon,Sabah,0,0,0
1/06/2023,Lebanon,Sarawak,3,3,0
1/06/2023,Lebanon,Selangor,233,149,84
1/06/2023,Lebanon,W.P. Labuan,0,0,0
1/06/2023,Liberia,Johor,1,1,0
1/06/2023,Liberia,Kedah,0,0,0
1/06/2023,Liberia,Sabah,0,0,0
1/06/2023,Liberia,Sarawak,0,0,0
1/06/2023,Liberia,Selangor,7,5,2
1/06/2023,Libya,Johor,11,10,1
1/06/2023,Libya,Kedah,0,0,0
1/06/2023,Libya,Perlis,0,0,0
1/06/2023,Libya,Pulau Pinang,0,0,0
1/06/2023,Libya,Sabah,2,2,0
1/06/2023,Libya,Sarawak,0,0,0
1/06/2023,Libya,Selangor,253,167,86
1/06/2023,Saint Lucia,Johor,7,7,0
1/06/2023,Saint Lucia,Kedah,0,0,0
1/06/2023,Saint Lucia,Pulau Pinang,2,1,1
1/06/2023,Saint Lucia,Sarawak,0,0,0
1/06/2023,Saint Lucia,Selangor,4,3,1
1/06/2023,Liechtenstein,Johor,1,1,0
1/06/2023,Liechtenstein,Kedah,0,0,0
1/06/2023,Liechtenstein,Perlis,1,1,0
1/06/2023,Liechtenstein,Pulau Pinang,0,0,0
1/06/2023,Liechtenstein,Sabah,0,0,0
1/06/2023,Liechtenstein,Sarawak,0,0,0
1/06/2023,Liechtenstein,Selangor,4,1,3
1/06/2023,LKA,Johor,1365,883,482
1/06/2023,LKA,Kedah,42,23,19
1/06/2023,LKA,Kelantan,0,0,0
1/06/2023,LKA,Melaka,0,0,0
1/06/2023,LKA,Pahang,0,0,0
1/06/2023,LKA,Perak,4,1,3
1/06/2023,LKA,Perlis,1,1,0
1/06/2023,LKA,Pulau Pinang,58,44,14
1/06/2023,LKA,Sabah,10,9,1
1/06/2023,LKA,Sarawak,12,9,3
1/06/2023,LKA,Selangor,3254,2182,1072
1/06/2023,LKA,W.P. Labuan,1,1,0
1/06/2023,Lesotho,Johor,0,0,0
1/06/2023,Lesotho,Kedah,0,0,0
1/06/2023,Lesotho,Pulau Pinang,0,0,0
1/06/2023,Lesotho,Sarawak,0,0,0
1/06/2023,Lesotho,Selangor,0,0,0
1/06/2023,Lithuania,Johor,34,16,18
1/06/2023,Lithuania,Kedah,5,3,2
1/06/2023,Lithuania,Kelantan,1,1,0
1/06/2023,Lithuania,Pahang,1,1,0
1/06/2023,Lithuania,Perak,0,0,0
1/06/2023,Lithuania,Perlis,5,5,0
1/06/2023,Lithuania,Pulau Pinang,6,5,1
1/06/2023,Lithuania,Sabah,2,0,2
1/06/2023,Lithuania,Sarawak,3,2,1
1/06/2023,Lithuania,Selangor,109,65,44
1/06/2023,Lithuania,W.P. Labuan,0,0,0
1/06/2023,Luxembourg,Johor,10,6,4
1/06/2023,Luxembourg,Kedah,4,3,1
1/06/2023,Luxembourg,Kelantan,0,0,0
1/06/2023,Luxembourg,Perak,0,0,0
1/06/2023,Luxembourg,Perlis,0,0,0
1/06/2023,Luxembourg,Pulau Pinang,4,3,1
1/06/2023,Luxembourg,Sabah,0,0,0
1/06/2023,Luxembourg,Sarawak,0,0,0
1/06/2023,Luxembourg,Selangor,24,16,8
1/06/2023,Latvia,Johor,7,7,0
1/06/2023,Latvia,Kedah,2,1,1
1/06/2023,Latvia,Kelantan,1,0,1
1/06/2023,Latvia,Pahang,0,0,0
1/06/2023,Latvia,Perak,0,0,0
1/06/2023,Latvia,Perlis,3,3,0
1/06/2023,Latvia,Pulau Pinang,2,0,2
1/06/2023,Latvia,Sabah,0,0,0
1/06/2023,Latvia,Sarawak,2,1,1
1/06/2023,Latvia,Selangor,56,32,24
1/06/2023,Latvia,W.P. Labuan,0,0,0
1/06/2023,Macao,Johor,0,0,0
1/06/2023,Macao,Pahang,0,0,0
1/06/2023,Macao,Perak,2,1,1
1/06/2023,Macao,Selangor,2,1,1
1/06/2023,Macao,W.P. Labuan,0,0,0
1/06/2023,Morocco,Johor,65,43,22
1/06/2023,Morocco,Kedah,4,4,0
1/06/2023,Morocco,Kelantan,0,0,0
1/06/2023,Morocco,Melaka,0,0,0
1/06/2023,Morocco,Pahang,4,2,2
1/06/2023,Morocco,Perak,1,1,0
1/06/2023,Morocco,Perlis,3,3,0
1/06/2023,Morocco,Pulau Pinang,4,4,0
1/06/2023,Morocco,Sabah,1,1,0
1/06/2023,Morocco,Sarawak,4,3,1
1/06/2023,Morocco,Selangor,566,269,297
1/06/2023,Morocco,W.P. Labuan,0,0,0
1/06/2023,Monaco,Johor,0,0,0
1/06/2023,Monaco,Kedah,0,0,0
1/06/2023,Monaco,Sabah,0,0,0
1/06/2023,Monaco,Selangor,1,0,1
1/06/2023,"Moldova, Republic of",Johor,6,3,3
1/06/2023,"Moldova, Republic of",Kedah,5,3,2
1/06/2023,"Moldova, Republic of",Kelantan,0,0,0
1/06/2023,"Moldova, Republic of",Negeri Sembilan,0,0,0
1/06/2023,"Moldova, Republic of",Perlis,0,0,0
1/06/2023,"Moldova, Republic of",Pulau Pinang,0,0,0
1/06/2023,"Moldova, Republic of",Sabah,0,0,0
1/06/2023,"Moldova, Republic of",Sarawak,0,0,0
1/06/2023,"Moldova, Republic of",Selangor,22,11,11
1/06/2023,Madagascar,Johor,9,4,5
1/06/2023,Madagascar,Kedah,3,2,1
1/06/2023,Madagascar,Perak,0,0,0
1/06/2023,Madagascar,Perlis,0,0,0
1/06/2023,Madagascar,Pulau Pinang,0,0,0
1/06/2023,Madagascar,Sabah,1,0,1
1/06/2023,Madagascar,Sarawak,0,0,0
1/06/2023,Madagascar,Selangor,57,33,24
1/06/2023,Maldives,Johor,172,77,95
1/06/2023,Maldives,Kedah,7,4,3
1/06/2023,Maldives,Kelantan,2,1,1
1/06/2023,Maldives,Perak,0,0,0
1/06/2023,Maldives,Perlis,0,0,0
1/06/2023,Maldives,Pulau Pinang,14,9,5
1/06/2023,Maldives,Sabah,0,0,0
1/06/2023,Maldives,Sarawak,5,2,3
1/06/2023,Maldives,Selangor,2334,1194,1140
1/06/2023,Mexico,Johor,150,62,88
1/06/2023,Mexico,Kedah,14,5,9
1/06/2023,Mexico,Kelantan,0,0,0
1/06/2023,Mexico,Pahang,0,0,0
1/06/2023,Mexico,Perak,4,2,2
1/06/2023,Mexico,Perlis,6,3,3
1/06/2023,Mexico,Pulau Pinang,18,14,4
1/06/2023,Mexico,Sabah,9,4,5
1/06/2023,Mexico,Sarawak,6,3,3
1/06/2023,Mexico,Selangor,298,173,125
1/06/2023,Mexico,W.P. Labuan,0,0,0
1/06/2023,Marshall Islands,Johor,0,0,0
1/06/2023,Marshall Islands,Kedah,0,0,0
1/06/2023,Marshall Islands,Perak,0,0,0
1/06/2023,Marshall Islands,Pulau Pinang,0,0,0
1/06/2023,Marshall Islands,Sabah,0,0,0
1/06/2023,Marshall Islands,Selangor,0,0,0
1/06/2023,North Macedonia,Johor,3,2,1
1/06/2023,North Macedonia,Kedah,0,0,0
1/06/2023,North Macedonia,Perak,0,0,0
1/06/2023,North Macedonia,Pulau Pinang,0,0,0
1/06/2023,North Macedonia,Sabah,0,0,0
1/06/2023,North Macedonia,Sarawak,0,0,0
1/06/2023,North Macedonia,Selangor,25,16,9
1/06/2023,Mali,Johor,4,4,0
1/06/2023,Mali,Sabah,0,0,0
1/06/2023,Mali,Selangor,9,5,4
1/06/2023,Malta,Johor,7,5,2
1/06/2023,Malta,Kedah,0,0,0
1/06/2023,Malta,Kelantan,0,0,0
1/06/2023,Malta,Perak,0,0,0
1/06/2023,Malta,Perlis,0,0,0
1/06/2023,Malta,Pulau Pinang,1,1,0
1/06/2023,Malta,Sabah,0,0,0
1/06/2023,Malta,Sarawak,0,0,0
1/06/2023,Malta,Selangor,29,20,9
1/06/2023,Malta,W.P. Labuan,0,0,0
1/06/2023,Myanmar,Johor,6439,1876,4563
1/06/2023,Myanmar,Kedah,85,19,66
1/06/2023,Myanmar,Kelantan,5,4,1
1/06/2023,Myanmar,Negeri Sembilan,0,0,0
1/06/2023,Myanmar,Pahang,7,3,4
1/06/2023,Myanmar,Perak,35,7,28
1/06/2023,Myanmar,Perlis,5,0,5
1/06/2023,Myanmar,Pulau Pinang,287,109,178
1/06/2023,Myanmar,Sabah,22,10,12
1/06/2023,Myanmar,Sarawak,77,37,40
1/06/2023,Myanmar,Selangor,5749,4225,1524
1/06/2023,Myanmar,Terengganu,1,1,0
1/06/2023,Myanmar,W.P. Labuan,0,0,0
1/06/2023,Montenegro,Johor,7,7,0
1/06/2023,Montenegro,Kedah,0,0,0
1/06/2023,Montenegro,Pulau Pinang,0,0,0
1/06/2023,Montenegro,Sabah,0,0,0
1/06/2023,Montenegro,Sarawak,0,0,0
1/06/2023,Montenegro,Selangor,7,5,2
1/06/2023,Mongolia,Johor,161,63,98
1/06/2023,Mongolia,Kedah,0,0,0
1/06/2023,Mongolia,Kelantan,5,1,4
1/06/2023,Mongolia,Perak,1,1,0
1/06/2023,Mongolia,Perlis,1,0,1
1/06/2023,Mongolia,Pulau Pinang,21,11,10
1/06/2023,Mongolia,Sabah,3,0,3
1/06/2023,Mongolia,Sarawak,0,0,0
1/06/2023,Mongolia,Selangor,170,74,96
1/06/2023,Northern Mariana Islands,Selangor,0,0,0
1/06/2023,Mozambique,Johor,0,0,0
1/06/2023,Mozambique,Kedah,0,0,0
1/06/2023,Mozambique,Perak,0,0,0
1/06/2023,Mozambique,Pulau Pinang,0,0,0
1/06/2023,Mozambique,Sabah,0,0,0
1/06/2023,Mozambique,Sarawak,0,0,0
1/06/2023,Mozambique,Selangor,17,8,9
1/06/2023,Mauritania,Johor,5,5,0
1/06/2023,Mauritania,Kedah,0,0,0
1/06/2023,Mauritania,Pulau Pinang,0,0,0
1/06/2023,Mauritania,Sabah,0,0,0
1/06/2023,Mauritania,Sarawak,2,2,0
1/06/2023,Mauritania,Selangor,4,4,0
1/06/2023,Mauritius,Johor,184,94,90
1/06/2023,Mauritius,Kedah,4,2,2
1/06/2023,Mauritius,Kelantan,0,0,0
1/06/2023,Mauritius,Pahang,0,0,0
1/06/2023,Mauritius,Perak,0,0,0
1/06/2023,Mauritius,Perlis,0,0,0
1/06/2023,Mauritius,Pulau Pinang,4,2,2
1/06/2023,Mauritius,Sabah,2,0,2
1/06/2023,Mauritius,Sarawak,0,0,0
1/06/2023,Mauritius,Selangor,891,458,433
1/06/2023,Malawi,Johor,0,0,0
1/06/2023,Malawi,Pulau Pinang,0,0,0
1/06/2023,Malawi,Sabah,0,0,0
1/06/2023,Malawi,Sarawak,0,0,0
1/06/2023,Malawi,Selangor,12,7,5
1/06/2023,Mayotte,Selangor,0,0,0
1/06/2023,Namibia,Johor,0,0,0
1/06/2023,Namibia,Kedah,1,0,1
1/06/2023,Namibia,Perak,0,0,0
1/06/2023,Namibia,Perlis,0,0,0
1/06/2023,Namibia,Pulau Pinang,0,0,0
1/06/2023,Namibia,Sabah,0,0,0
1/06/2023,Namibia,Sarawak,0,0,0
1/06/2023,Namibia,Selangor,37,22,15
1/06/2023,New Caledonia,Selangor,0,0,0
1/06/2023,Niger,Johor,0,0,0
1/06/2023,Niger,Sabah,0,0,0
1/06/2023,Niger,Selangor,3,2,1
1/06/2023,Nigeria,Johor,47,44,3
1/06/2023,Nigeria,Kedah,1,0,1
1/06/2023,Nigeria,Perlis,0,0,0
1/06/2023,Nigeria,Pulau Pinang,0,0,0
1/06/2023,Nigeria,Sabah,0,0,0
1/06/2023,Nigeria,Sarawak,2,2,0
1/06/2023,Nigeria,Selangor,334,257,77
1/06/2023,Nicaragua,Johor,1,1,0
1/06/2023,Nicaragua,Kedah,3,1,2
1/06/2023,Nicaragua,Pulau Pinang,0,0,0
1/06/2023,Nicaragua,Sabah,0,0,0
1/06/2023,Nicaragua,Selangor,3,3,0
1/06/2023,Netherlands,Johor,854,561,293
1/06/2023,Netherlands,Kedah,158,86,72
1/06/2023,Netherlands,Kelantan,1,1,0
1/06/2023,Netherlands,Melaka,1,1,0
1/06/2023,Netherlands,Negeri Sembilan,0,0,0
1/06/2023,Netherlands,Pahang,5,2,3
1/06/2023,Netherlands,Perak,16,9,7
1/06/2023,Netherlands,Perlis,48,29,19
1/06/2023,Netherlands,Pulau Pinang,203,123,80
1/06/2023,Netherlands,Sabah,71,38,33
1/06/2023,Netherlands,Sarawak,116,76,40
1/06/2023,Netherlands,Selangor,2705,1661,1044
1/06/2023,Netherlands,Terengganu,0,0,0
1/06/2023,Netherlands,W.P. Labuan,4,2,2
1/06/2023,Norway,Johor,180,111,69
1/06/2023,Norway,Kedah,13,9,4
1/06/2023,Norway,Kelantan,1,1,0
1/06/2023,Norway,Melaka,0,0,0
1/06/2023,Norway,Pahang,0,0,0
1/06/2023,Norway,Perak,0,0,0
1/06/2023,Norway,Perlis,11,6,5
1/06/2023,Norway,Pulau Pinang,24,13,11
1/06/2023,Norway,Sabah,8,6,2
1/06/2023,Norway,Sarawak,23,13,10
1/06/2023,Norway,Selangor,517,313,204
1/06/2023,Norway,W.P. Labuan,1,1,0
1/06/2023,Nepal,Johor,702,508,194
1/06/2023,Nepal,Kedah,28,25,3
1/06/2023,Nepal,Pahang,0,0,0
1/06/2023,Nepal,Perak,0,0,0
1/06/2023,Nepal,Perlis,0,0,0
1/06/2023,Nepal,Pulau Pinang,17,13,4
1/06/2023,Nepal,Sabah,3,3,0
1/06/2023,Nepal,Sarawak,195,142,53
1/06/2023,Nepal,Selangor,12311,11693,618
1/06/2023,Nepal,W.P. Labuan,103,101,2
1/06/2023,Nauru,Johor,0,0,0
1/06/2023,Nauru,Pulau Pinang,0,0,0
1/06/2023,Nauru,Selangor,0,0,0
1/06/2023,New Zealand,Johor,818,492,326
1/06/2023,New Zealand,Kedah,81,40,41
1/06/2023,New Zealand,Kelantan,2,2,0
1/06/2023,New Zealand,Melaka,0,0,0
1/06/2023,New Zealand,Negeri Sembilan,0,0,0
1/06/2023,New Zealand,Pahang,6,2,4
1/06/2023,New Zealand,Perak,28,12,16
1/06/2023,New Zealand,Perlis,31,18,13
1/06/2023,New Zealand,Pulau Pinang,219,132,87
1/06/2023,New Zealand,Sabah,39,23,16
1/06/2023,New Zealand,Sarawak,113,66,47
1/06/2023,New Zealand,Selangor,2198,1285,913
1/06/2023,New Zealand,Terengganu,0,0,0
1/06/2023,New Zealand,W.P. Labuan,6,3,3
1/06/2023,Oman,Johor,80,39,41
1/06/2023,Oman,Kedah,9,3,6
1/06/2023,Oman,Kelantan,0,0,0
1/06/2023,Oman,Melaka,0,0,0
1/06/2023,Oman,Perak,0,0,0
1/06/2023,Oman,Perlis,0,0,0
1/06/2023,Oman,Pulau Pinang,9,6,3
1/06/2023,Oman,Sabah,0,0,0
1/06/2023,Oman,Sarawak,5,2,3
1/06/2023,Oman,Selangor,1296,700,596
1/06/2023,Pakistan,Johor,1163,805,358
1/06/2023,Pakistan,Kedah,144,108,36
1/06/2023,Pakistan,Kelantan,7,7,0
1/06/2023,Pakistan,Melaka,0,0,0
1/06/2023,Pakistan,Negeri Sembilan,0,0,0
1/06/2023,Pakistan,Pahang,0,0,0
1/06/2023,Pakistan,Perak,15,11,4
1/06/2023,Pakistan,Perlis,23,23,0
1/06/2023,Pakistan,Pulau Pinang,90,77,13
1/06/2023,Pakistan,Sabah,13,13,0
1/06/2023,Pakistan,Sarawak,156,135,21
1/06/2023,Pakistan,Selangor,10745,9160,1585
1/06/2023,Pakistan,W.P. Labuan,1,1,0
1/06/2023,Panama,Johor,0,0,0
1/06/2023,Panama,Kedah,0,0,0
1/06/2023,Panama,Perak,0,0,0
1/06/2023,Panama,Perlis,0,0,0
1/06/2023,Panama,Pulau Pinang,1,0,1
1/06/2023,Panama,Sabah,0,0,0
1/06/2023,Panama,Sarawak,0,0,0
1/06/2023,Panama,Selangor,6,4,2
1/06/2023,Peru,Johor,19,12,7
1/06/2023,Peru,Kedah,4,3,1
1/06/2023,Peru,Kelantan,0,0,0
1/06/2023,Peru,Pahang,1,1,0
1/06/2023,Peru,Perak,0,0,0
1/06/2023,Peru,Perlis,2,0,2
1/06/2023,Peru,Pulau Pinang,5,3,2
1/06/2023,Peru,Sabah,2,0,2
1/06/2023,Peru,Sarawak,1,1,0
1/06/2023,Peru,Selangor,90,43,47
1/06/2023,Peru,W.P. Labuan,0,0,0
1/06/2023,Philippines,Johor,24673,7915,16758
1/06/2023,Philippines,Kedah,510,158,352
1/06/2023,Philippines,Kelantan,45,25,20
1/06/2023,Philippines,Melaka,1,0,1
1/06/2023,Philippines,Negeri Sembilan,0,0,0
1/06/2023,Philippines,Pahang,24,20,4
1/06/2023,Philippines,Perak,93,38,55
1/06/2023,Philippines,Perlis,78,18,60
1/06/2023,Philippines,Pulau Pinang,625,208,417
1/06/2023,Philippines,Sabah,748,331,417
1/06/2023,Philippines,Sarawak,1987,725,1262
1/06/2023,Philippines,Selangor,7912,3472,4440
1/06/2023,Philippines,Terengganu,0,0,0
1/06/2023,Philippines,W.P. Labuan,117,23,94
1/06/2023,Palau,Johor,3,3,0
1/06/2023,Palau,Pulau Pinang,1,1,0
1/06/2023,Palau,Selangor,2,1,1
1/06/2023,Papua New Guinea,Johor,28,17,11
1/06/2023,Papua New Guinea,Kedah,0,0,0
1/06/2023,Papua New Guinea,Kelantan,0,0,0
1/06/2023,Papua New Guinea,Perak,0,0,0
1/06/2023,Papua New Guinea,Pulau Pinang,0,0,0
1/06/2023,Papua New Guinea,Sabah,1,1,0
1/06/2023,Papua New Guinea,Sarawak,11,8,3
1/06/2023,Papua New Guinea,Selangor,95,68,27
1/06/2023,Poland,Johor,252,141,111
1/06/2023,Poland,Kedah,39,19,20
1/06/2023,Poland,Kelantan,2,2,0
1/06/2023,Poland,Melaka,0,0,0
1/06/2023,Poland,Negeri Sembilan,0,0,0
1/06/2023,Poland,Pahang,7,4,3
1/06/2023,Poland,Perak,4,3,1
1/06/2023,Poland,Perlis,13,7,6
1/06/2023,Poland,Pulau Pinang,34,20,14
1/06/2023,Poland,Sabah,14,6,8
1/06/2023,Poland,Sarawak,80,40,40
1/06/2023,Poland,Selangor,661,359,302
1/06/2023,Poland,Terengganu,0,0,0
1/06/2023,Poland,W.P. Labuan,0,0,0
1/06/2023,"North Korea, Democratic People's Republic of",Selangor,0,0,0
1/06/2023,Portugal,Johor,138,76,62
1/06/2023,Portugal,Kedah,20,7,13
1/06/2023,Portugal,Kelantan,1,1,0
1/06/2023,Portugal,Melaka,0,0,0
1/06/2023,Portugal,Pahang,0,0,0
1/06/2023,Portugal,Perak,1,1,0
1/06/2023,Portugal,Perlis,14,9,5
1/06/2023,Portugal,Pulau Pinang,44,26,18
1/06/2023,Portugal,Sabah,14,8,6
1/06/2023,Portugal,Sarawak,7,5,2
1/06/2023,Portugal,Selangor,400,250,150
1/06/2023,Portugal,W.P. Labuan,0,0,0
1/06/2023,Paraguay,Johor,2,0,2
1/06/2023,Paraguay,Kedah,0,0,0
1/06/2023,Paraguay,Perak,0,0,0
1/06/2023,Paraguay,Perlis,0,0,0
1/06/2023,Paraguay,Pulau Pinang,0,0,0
1/06/2023,Paraguay,Sabah,0,0,0
1/06/2023,Paraguay,Sarawak,0,0,0
1/06/2023,Paraguay,Selangor,9,5,4
1/06/2023,"Palestine, State of",Johor,24,20,4
1/06/2023,"Palestine, State of",Kedah,0,0,0
1/06/2023,"Palestine, State of",Kelantan,3,3,0
1/06/2023,"Palestine, State of",Melaka,1,1,0
1/06/2023,"Palestine, State of",Perak,0,0,0
1/06/2023,"Palestine, State of",Perlis,0,0,0
1/06/2023,"Palestine, State of",Pulau Pinang,0,0,0
1/06/2023,"Palestine, State of",Sabah,0,0,0
1/06/2023,"Palestine, State of",Sarawak,5,5,0
1/06/2023,"Palestine, State of",Selangor,409,261,148
1/06/2023,Qatar,Johor,29,17,12
1/06/2023,Qatar,Kedah,0,0,0
1/06/2023,Qatar,Perlis,0,0,0
1/06/2023,Qatar,Pulau Pinang,9,7,2
1/06/2023,Qatar,Sabah,0,0,0
1/06/2023,Qatar,Sarawak,0,0,0
1/06/2023,Qatar,Selangor,304,171,133
1/06/2023,Réunion,Johor,0,0,0
1/06/2023,Réunion,Sarawak,1,1,0
1/06/2023,Romania,Johor,93,58,35
1/06/2023,Romania,Kedah,10,2,8
1/06/2023,Romania,Kelantan,0,0,0
1/06/2023,Romania,Negeri Sembilan,0,0,0
1/06/2023,Romania,Pahang,0,0,0
1/06/2023,Romania,Perak,1,0,1
1/06/2023,Romania,Perlis,4,3,1
1/06/2023,Romania,Pulau Pinang,14,5,9
1/06/2023,Romania,Sabah,4,1,3
1/06/2023,Romania,Sarawak,5,4,1
1/06/2023,Romania,Selangor,336,188,148
1/06/2023,Romania,W.P. Labuan,0,0,0
1/06/2023,Russian Federation (Russia),Johor,445,219,226
1/06/2023,Russian Federation (Russia),Kedah,313,158,155
1/06/2023,Russian Federation (Russia),Kelantan,50,31,19
1/06/2023,Russian Federation (Russia),Melaka,0,0,0
1/06/2023,Russian Federation (Russia),Negeri Sembilan,0,0,0
1/06/2023,Russian Federation (Russia),Pahang,0,0,0
1/06/2023,Russian Federation (Russia),Perak,3,3,0
1/06/2023,Russian Federation (Russia),Perlis,334,204,130
1/06/2023,Russian Federation (Russia),Pulau Pinang,132,75,57
1/06/2023,Russian Federation (Russia),Sabah,20,9,11
1/06/2023,Russian Federation (Russia),Sarawak,39,20,19
1/06/2023,Russian Federation (Russia),Selangor,4266,2221,2045
1/06/2023,Russian Federation (Russia),W.P. Labuan,2,1,1
1/06/2023,Rwanda,Johor,0,0,0
1/06/2023,Rwanda,Kedah,0,0,0
1/06/2023,Rwanda,Pulau Pinang,0,0,0
1/06/2023,Rwanda,Selangor,30,23,7
1/06/2023,Saudi Arabia,Johor,281,175,106
1/06/2023,Saudi Arabia,Kedah,43,21,22
1/06/2023,Saudi Arabia,Kelantan,2,1,1
1/06/2023,Saudi Arabia,Melaka,0,0,0
1/06/2023,Saudi Arabia,Perak,0,0,0
1/06/2023,Saudi Arabia,Perlis,5,3,2
1/06/2023,Saudi Arabia,Pulau Pinang,78,41,37
1/06/2023,Saudi Arabia,Sabah,2,1,1
1/06/2023,Saudi Arabia,Sarawak,8,8,0
1/06/2023,Saudi Arabia,Selangor,5466,2954,2512
1/06/2023,Saudi Arabia,W.P. Labuan,0,0,0
1/06/2023,Sudan,Johor,6,6,0
1/06/2023,Sudan,Kedah,0,0,0
1/06/2023,Sudan,Kelantan,0,0,0
1/06/2023,Sudan,Perlis,0,0,0
1/06/2023,Sudan,Pulau Pinang,0,0,0
1/06/2023,Sudan,Sabah,0,0,0
1/06/2023,Sudan,Sarawak,10,4,6
1/06/2023,Sudan,Selangor,851,476,375
1/06/2023,Sudan,W.P. Labuan,0,0,0
1/06/2023,Senegal,Johor,3,3,0
1/06/2023,Senegal,Kedah,1,1,0
1/06/2023,Senegal,Kelantan,0,0,0
1/06/2023,Senegal,Perak,0,0,0
1/06/2023,Senegal,Perlis,0,0,0
1/06/2023,Senegal,Pulau Pinang,0,0,0
1/06/2023,Senegal,Sabah,0,0,0
1/06/2023,Senegal,Sarawak,0,0,0
1/06/2023,Senegal,Selangor,43,34,9
1/06/2023,Singapore,Johor,1224502,684070,540432
1/06/2023,Singapore,Kedah,9489,4711,4778
1/06/2023,Singapore,Kelantan,175,114,61
1/06/2023,Singapore,Melaka,24,18,6
1/06/2023,Singapore,Negeri Sembilan,1,1,0
1/06/2023,Singapore,Pahang,721,355,366
1/06/2023,Singapore,Perak,7970,3718,4252
1/06/2023,Singapore,Perlis,519,265,254
1/06/2023,Singapore,Pulau Pinang,29639,14323,15316
1/06/2023,Singapore,Sabah,4139,2095,2044
1/06/2023,Singapore,Sarawak,5720,3085,2635
1/06/2023,Singapore,Selangor,35275,17545,17730
1/06/2023,Singapore,Terengganu,0,0,0
1/06/2023,Singapore,W.P. Labuan,9,4,5
1/06/2023,South Georgia and the South Sandwich Islands,Johor,0,0,0
1/06/2023,South Georgia and the South Sandwich Islands,Sabah,0,0,0
1/06/2023,South Georgia and the South Sandwich Islands,Selangor,0,0,0
1/06/2023,Saint Helena,Sarawak,0,0,0
1/06/2023,Solomon Islands,Johor,29,29,0
1/06/2023,Solomon Islands,Perlis,0,0,0
1/06/2023,Solomon Islands,Pulau Pinang,0,0,0
1/06/2023,Solomon Islands,Sabah,0,0,0
1/06/2023,Solomon Islands,Sarawak,2,1,1
1/06/2023,Solomon Islands,Selangor,1,1,0
1/06/2023,Solomon Islands,W.P. Labuan,0,0,0
1/06/2023,Sierra Leone,Johor,0,0,0
1/06/2023,Sierra Leone,Kedah,0,0,0
1/06/2023,Sierra Leone,Perak,0,0,0
1/06/2023,Sierra Leone,Pulau Pinang,0,0,0
1/06/2023,Sierra Leone,Sabah,0,0,0
1/06/2023,Sierra Leone,Selangor,9,4,5
1/06/2023,El Salvador,Johor,4,3,1
1/06/2023,El Salvador,Kedah,0,0,0
1/06/2023,El Salvador,Perak,0,0,0
1/06/2023,El Salvador,Perlis,0,0,0
1/06/2023,El Salvador,Pulau Pinang,0,0,0
1/06/2023,El Salvador,Sabah,1,1,0
1/06/2023,El Salvador,Selangor,15,10,5
1/06/2023,El Salvador,W.P. Labuan,0,0,0
1/06/2023,San Marino,Johor,0,0,0
1/06/2023,San Marino,Selangor,1,1,0
1/06/2023,Somalia,Johor,0,0,0
1/06/2023,Somalia,Kedah,0,0,0
1/06/2023,Somalia,Kelantan,0,0,0
1/06/2023,Somalia,Perlis,1,0,1
1/06/2023,Somalia,Sabah,0,0,0
1/06/2023,Somalia,Sarawak,0,0,0
1/06/2023,Somalia,Selangor,170,100,70
1/06/2023,Serbia,Johor,12,5,7
1/06/2023,Serbia,Kedah,3,3,0
1/06/2023,Serbia,Kelantan,0,0,0
1/06/2023,Serbia,Pahang,0,0,0
1/06/2023,Serbia,Perak,0,0,0
1/06/2023,Serbia,Perlis,0,0,0
1/06/2023,Serbia,Pulau Pinang,6,3,3
1/06/2023,Serbia,Sabah,0,0,0
1/06/2023,Serbia,Sarawak,0,0,0
1/06/2023,Serbia,Selangor,31,17,14
1/06/2023,South Sudan,Johor,0,0,0
1/06/2023,South Sudan,Kedah,0,0,0
1/06/2023,South Sudan,Sarawak,0,0,0
1/06/2023,South Sudan,Selangor,14,9,5
1/06/2023,South Sudan,W.P. Labuan,0,0,0
1/06/2023,Sao Tome and Principe,Selangor,0,0,0
1/06/2023,Suriname,Johor,4,2,2
1/06/2023,Suriname,Kedah,0,0,0
1/06/2023,Suriname,Kelantan,0,0,0
1/06/2023,Suriname,Perak,0,0,0
1/06/2023,Suriname,Perlis,0,0,0
1/06/2023,Suriname,Pulau Pinang,3,3,0
1/06/2023,Suriname,Sabah,0,0,0
1/06/2023,Suriname,Sarawak,0,0,0
1/06/2023,Suriname,Selangor,17,11,6
1/06/2023,Slovakia,Johor,30,17,13
1/06/2023,Slovakia,Kedah,18,11,7
1/06/2023,Slovakia,Kelantan,0,0,0
1/06/2023,Slovakia,Negeri Sembilan,0,0,0
1/06/2023,Slovakia,Pahang,0,0,0
1/06/2023,Slovakia,Perak,2,0,2
1/06/2023,Slovakia,Perlis,0,0,0
1/06/2023,Slovakia,Pulau Pinang,8,6,2
1/06/2023,Slovakia,Sabah,1,1,0
1/06/2023,Slovakia,Sarawak,5,3,2
1/06/2023,Slovakia,Selangor,119,67,52
1/06/2023,Slovakia,W.P. Labuan,0,0,0
1/06/2023,Slovenia,Johor,12,4,8
1/06/2023,Slovenia,Kedah,4,2,2
1/06/2023,Slovenia,Kelantan,0,0,0
1/06/2023,Slovenia,Perak,0,0,0
1/06/2023,Slovenia,Perlis,4,2,2
1/06/2023,Slovenia,Pulau Pinang,4,2,2
1/06/2023,Slovenia,Sabah,1,0,1
1/06/2023,Slovenia,Sarawak,1,0,1
1/06/2023,Slovenia,Selangor,70,47,23
1/06/2023,Slovenia,W.P. Labuan,0,0,0
1/06/2023,Sweden,Johor,250,152,98
1/06/2023,Sweden,Kedah,25,11,14
1/06/2023,Sweden,Kelantan,4,3,1
1/06/2023,Sweden,Melaka,0,0,0
1/06/2023,Sweden,Negeri Sembilan,0,0,0
1/06/2023,Sweden,Pahang,1,1,0
1/06/2023,Sweden,Perak,4,2,2
1/06/2023,Sweden,Perlis,13,10,3
1/06/2023,Sweden,Pulau Pinang,63,44,19
1/06/2023,Sweden,Sabah,11,6,5
1/06/2023,Sweden,Sarawak,15,12,3
1/06/2023,Sweden,Selangor,728,457,271
1/06/2023,Sweden,W.P. Labuan,0,0,0
1/06/2023,Eswatini,Johor,0,0,0
1/06/2023,Eswatini,Kedah,0,0,0
1/06/2023,Eswatini,Pulau Pinang,0,0,0
1/06/2023,Eswatini,Sabah,0,0,0
1/06/2023,Eswatini,Selangor,17,7,10
1/06/2023,Seychelles,Johor,3,1,2
1/06/2023,Seychelles,Kedah,0,0,0
1/06/2023,Seychelles,Pulau Pinang,0,0,0
1/06/2023,Seychelles,Sabah,0,0,0
1/06/2023,Seychelles,Sarawak,1,1,0
1/06/2023,Seychelles,Selangor,48,16,32
1/06/2023,Syrian Arab Republic,Johor,12,7,5
1/06/2023,Syrian Arab Republic,Kedah,0,0,0
1/06/2023,Syrian Arab Republic,Kelantan,0,0,0
1/06/2023,Syrian Arab Republic,Pahang,0,0,0
1/06/2023,Syrian Arab Republic,Perlis,0,0,0
1/06/2023,Syrian Arab Republic,Pulau Pinang,1,1,0
1/06/2023,Syrian Arab Republic,Sabah,0,0,0
1/06/2023,Syrian Arab Republic,Sarawak,1,1,0
1/06/2023,Syrian Arab Republic,Selangor,670,383,287
1/06/2023,Syrian Arab Republic,W.P. Labuan,1,1,0
1/06/2023,Turks and Caicos Islands,Perlis,0,0,0
1/06/2023,TCD,Johor,0,0,0
1/06/2023,TCD,Kedah,0,0,0
1/06/2023,TCD,Perlis,0,0,0
1/06/2023,TCD,Selangor,26,18,8
1/06/2023,Togo,Johor,0,0,0
1/06/2023,Togo,Perak,1,1,0
1/06/2023,Togo,Pulau Pinang,1,1,0
1/06/2023,Togo,Selangor,2,2,0
1/06/2023,Thailand,Johor,5129,1309,3820
1/06/2023,Thailand,Kedah,53478,30729,22749
1/06/2023,Thailand,Kelantan,35495,18643,16852
1/06/2023,Thailand,Melaka,57,24,33
1/06/2023,Thailand,Negeri Sembilan,1,0,1
1/06/2023,Thailand,Pahang,25,20,5
1/06/2023,Thailand,Perak,8447,3837,4610
1/06/2023,Thailand,Perlis,42362,24786,17576
1/06/2023,Thailand,Pulau Pinang,2023,841,1182
1/06/2023,Thailand,Sabah,16,7,9
1/06/2023,Thailand,Sarawak,326,103,223
1/06/2023,Thailand,Selangor,6857,2750,4107
1/06/2023,Thailand,Terengganu,0,0,0
1/06/2023,Thailand,W.P. Labuan,3,1,2
1/06/2023,Tajikistan,Johor,4,3,1
1/06/2023,Tajikistan,Kedah,0,0,0
1/06/2023,Tajikistan,Perlis,0,0,0
1/06/2023,Tajikistan,Pulau Pinang,1,0,1
1/06/2023,Tajikistan,Sabah,1,0,1
1/06/2023,Tajikistan,Selangor,83,60,23
1/06/2023,Tokelau,Selangor,0,0,0
1/06/2023,Turkmenistan,Johor,4,2,2
1/06/2023,Turkmenistan,Kedah,1,1,0
1/06/2023,Turkmenistan,Kelantan,0,0,0
1/06/2023,Turkmenistan,Perlis,0,0,0
1/06/2023,Turkmenistan,Pulau Pinang,1,1,0
1/06/2023,Turkmenistan,Sabah,0,0,0
1/06/2023,Turkmenistan,Sarawak,0,0,0
1/06/2023,Turkmenistan,Selangor,92,60,32
1/06/2023,Timor-Leste,Johor,2,0,2
1/06/2023,Timor-Leste,Kedah,0,0,0
1/06/2023,Timor-Leste,Perlis,0,0,0
1/06/2023,Timor-Leste,Pulau Pinang,6,2,4
1/06/2023,Timor-Leste,Sabah,2,0,2
1/06/2023,Timor-Leste,Sarawak,4,1,3
1/06/2023,Timor-Leste,Selangor,138,90,48
1/06/2023,Tonga,Johor,0,0,0
1/06/2023,Tonga,Pulau Pinang,3,1,2
1/06/2023,Tonga,Sarawak,0,0,0
1/06/2023,Tonga,Selangor,3,1,2
1/06/2023,Trinidad and Tobago,Johor,3,2,1
1/06/2023,Trinidad and Tobago,Kedah,0,0,0
1/06/2023,Trinidad and Tobago,Pahang,0,0,0
1/06/2023,Trinidad and Tobago,Pulau Pinang,1,1,0
1/06/2023,Trinidad and Tobago,Sabah,0,0,0
1/06/2023,Trinidad and Tobago,Sarawak,0,0,0
1/06/2023,Trinidad and Tobago,Selangor,29,18,11
1/06/2023,Tunisia,Johor,13,7,6
1/06/2023,Tunisia,Kedah,1,0,1
1/06/2023,Tunisia,Kelantan,0,0,0
1/06/2023,Tunisia,Melaka,0,0,0
1/06/2023,Tunisia,Perak,0,0,0
1/06/2023,Tunisia,Perlis,0,0,0
1/06/2023,Tunisia,Pulau Pinang,2,1,1
1/06/2023,Tunisia,Sabah,1,0,1
1/06/2023,Tunisia,Sarawak,1,0,1
1/06/2023,Tunisia,Selangor,344,170,174
1/06/2023,Tunisia,W.P. Labuan,0,0,0
1/06/2023,Türkiye,Johor,323,230,93
1/06/2023,Türkiye,Kedah,32,24,8
1/06/2023,Türkiye,Kelantan,1,1,0
1/06/2023,Türkiye,Melaka,0,0,0
1/06/2023,Türkiye,Negeri Sembilan,0,0,0
1/06/2023,Türkiye,Pahang,2,2,0
1/06/2023,Türkiye,Perak,2,1,1
1/06/2023,Türkiye,Perlis,20,15,5
1/06/2023,Türkiye,Pulau Pinang,27,21,6
1/06/2023,Türkiye,Sabah,6,3,3
1/06/2023,Türkiye,Sarawak,22,14,8
1/06/2023,Türkiye,Selangor,1164,797,367
1/06/2023,Türkiye,W.P. Labuan,0,0,0
1/06/2023,Tuvalu,Selangor,0,0,0
1/06/2023,"Taiwan, Province of China",Johor,6594,2943,3651
1/06/2023,"Taiwan, Province of China",Kedah,190,108,82
1/06/2023,"Taiwan, Province of China",Kelantan,0,0,0
1/06/2023,"Taiwan, Province of China",Melaka,6,2,4
1/06/2023,"Taiwan, Province of China",Negeri Sembilan,0,0,0
1/06/2023,"Taiwan, Province of China",Pahang,8,2,6
1/06/2023,"Taiwan, Province of China",Perak,65,39,26
1/06/2023,"Taiwan, Province of China",Perlis,24,10,14
1/06/2023,"Taiwan, Province of China",Pulau Pinang,5861,2718,3143
1/06/2023,"Taiwan, Province of China",Sabah,967,477,490
1/06/2023,"Taiwan, Province of China",Sarawak,265,142,123
1/06/2023,"Taiwan, Province of China",Selangor,13914,6292,7622
1/06/2023,"Taiwan, Province of China",W.P. Labuan,6,3,3
1/06/2023,"Tanzania, United Republic of",Johor,19,11,8
1/06/2023,"Tanzania, United Republic of",Kedah,1,1,0
1/06/2023,"Tanzania, United Republic of",Perak,0,0,0
1/06/2023,"Tanzania, United Republic of",Perlis,0,0,0
1/06/2023,"Tanzania, United Republic of",Pulau Pinang,0,0,0
1/06/2023,"Tanzania, United Republic of",Sabah,0,0,0
1/06/2023,"Tanzania, United Republic of",Sarawak,6,5,1
1/06/2023,"Tanzania, United Republic of",Selangor,135,68,67
1/06/2023,Uganda,Johor,15,5,10
1/06/2023,Uganda,Kedah,2,1,1
1/06/2023,Uganda,Perak,0,0,0
1/06/2023,Uganda,Perlis,0,0,0
1/06/2023,Uganda,Pulau Pinang,3,3,0
1/06/2023,Uganda,Sabah,0,0,0
1/06/2023,Uganda,Sarawak,0,0,0
1/06/2023,Uganda,Selangor,107,53,54
1/06/2023,Ukraine,Johor,132,84,48
1/06/2023,Ukraine,Kedah,15,4,11
1/06/2023,Ukraine,Kelantan,4,3,1
1/06/2023,Ukraine,Melaka,4,4,0
1/06/2023,Ukraine,Negeri Sembilan,0,0,0
1/06/2023,Ukraine,Pahang,3,3,0
1/06/2023,Ukraine,Perak,0,0,0
1/06/2023,Ukraine,Perlis,6,4,2
1/06/2023,Ukraine,Pulau Pinang,17,10,7
1/06/2023,Ukraine,Sabah,3,1,2
1/06/2023,Ukraine,Sarawak,4,3,1
1/06/2023,Ukraine,Selangor,525,276,249
1/06/2023,Ukraine,W.P. Labuan,0,0,0
1/06/2023,Uruguay,Johor,7,3,4
1/06/2023,Uruguay,Kedah,1,1,0
1/06/2023,Uruguay,Kelantan,0,0,0
1/06/2023,Uruguay,Perak,0,0,0
1/06/2023,Uruguay,Perlis,0,0,0
1/06/2023,Uruguay,Pulau Pinang,0,0,0
1/06/2023,Uruguay,Sabah,0,0,0
1/06/2023,Uruguay,Sarawak,1,0,1
1/06/2023,Uruguay,Selangor,37,19,18
1/06/2023,Uruguay,W.P. Labuan,0,0,0
1/06/2023,United States of America,Johor,4955,2834,2121
1/06/2023,United States of America,Kedah,457,258,199
1/06/2023,United States of America,Kelantan,18,12,6
1/06/2023,United States of America,Melaka,2,2,0
1/06/2023,United States of America,Negeri Sembilan,0,0,0
1/06/2023,United States of America,Pahang,21,14,7
1/06/2023,United States of America,Perak,192,105,87
1/06/2023,United States of America,Perlis,139,90,49
1/06/2023,United States of America,Pulau Pinang,2245,1318,927
1/06/2023,United States of America,Sabah,252,149,103
1/06/2023,United States of America,Sarawak,302,181,121
1/06/2023,United States of America,Selangor,11853,6854,4999
1/06/2023,United States of America,Terengganu,0,0,0
1/06/2023,United States of America,W.P. Labuan,4,3,1
1/06/2023,Uzbekistan,Johor,107,81,26
1/06/2023,Uzbekistan,Kedah,5,4,1
1/06/2023,Uzbekistan,Kelantan,0,0,0
1/06/2023,Uzbekistan,Perak,0,0,0
1/06/2023,Uzbekistan,Perlis,2,2,0
1/06/2023,Uzbekistan,Pulau Pinang,18,7,11
1/06/2023,Uzbekistan,Sabah,3,2,1
1/06/2023,Uzbekistan,Sarawak,0,0,0
1/06/2023,Uzbekistan,Selangor,823,478,345
1/06/2023,Holy See,Johor,0,0,0
1/06/2023,Holy See,Sarawak,0,0,0
1/06/2023,Holy See,Selangor,0,0,0
1/06/2023,Saint Vincent and the Grenadines,Johor,3,1,2
1/06/2023,Saint Vincent and the Grenadines,Kedah,1,1,0
1/06/2023,Saint Vincent and the Grenadines,Pulau Pinang,1,0,1
1/06/2023,Saint Vincent and the Grenadines,Sarawak,0,0,0
1/06/2023,Saint Vincent and the Grenadines,Selangor,9,2,7
1/06/2023,"Venezuela, Bolivarian Republic of",Johor,12,10,2
1/06/2023,"Venezuela, Bolivarian Republic of",Kedah,0,0,0
1/06/2023,"Venezuela, Bolivarian Republic of",Kelantan,0,0,0
1/06/2023,"Venezuela, Bolivarian Republic of",Melaka,0,0,0
1/06/2023,"Venezuela, Bolivarian Republic of",Perak,0,0,0
1/06/2023,"Venezuela, Bolivarian Republic of",Perlis,0,0,0
1/06/2023,"Venezuela, Bolivarian Republic of",Pulau Pinang,5,3,2
1/06/2023,"Venezuela, Bolivarian Republic of",Sabah,5,2,3
1/06/2023,"Venezuela, Bolivarian Republic of",Sarawak,1,1,0
1/06/2023,"Venezuela, Bolivarian Republic of",Selangor,62,35,27
1/06/2023,"Venezuela, Bolivarian Republic of",W.P. Labuan,0,0,0
1/06/2023,Viet Nam,Johor,19318,6651,12667
1/06/2023,Viet Nam,Kedah,316,63,253
1/06/2023,Viet Nam,Kelantan,22,10,12
1/06/2023,Viet Nam,Melaka,0,0,0
1/06/2023,Viet Nam,Negeri Sembilan,0,0,0
1/06/2023,Viet Nam,Pahang,2,1,1
1/06/2023,Viet Nam,Perak,152,16,136
1/06/2023,Viet Nam,Perlis,278,38,240
1/06/2023,Viet Nam,Pulau Pinang,1904,541,1363
1/06/2023,Viet Nam,Sabah,31,10,21
1/06/2023,Viet Nam,Sarawak,207,47,160
1/06/2023,Viet Nam,Selangor,12279,4633,7646
1/06/2023,Viet Nam,Terengganu,2,2,0
1/06/2023,Viet Nam,W.P. Labuan,4,1,3
1/06/2023,Vanuatu,Johor,46,31,15
1/06/2023,Vanuatu,Kedah,0,0,0
1/06/2023,Vanuatu,Pulau Pinang,1,1,0
1/06/2023,Vanuatu,Sabah,0,0,0
1/06/2023,Vanuatu,Sarawak,0,0,0
1/06/2023,Vanuatu,Selangor,40,37,3
1/06/2023, Samoa,Johor,0,0,0
1/06/2023, Samoa,Sarawak,0,0,0
1/06/2023, Samoa,Selangor,4,3,1
1/06/2023,Yemen,Johor,43,32,11
1/06/2023,Yemen,Kedah,2,2,0
1/06/2023,Yemen,Kelantan,0,0,0
1/06/2023,Yemen,Melaka,4,2,2
1/06/2023,Yemen,Pahang,1,1,0
1/06/2023,Yemen,Perak,1,1,0
1/06/2023,Yemen,Perlis,0,0,0
1/06/2023,Yemen,Pulau Pinang,4,4,0
1/06/2023,Yemen,Sabah,0,0,0
1/06/2023,Yemen,Sarawak,3,1,2
1/06/2023,Yemen,Selangor,1533,924,609
1/06/2023,Yemen,W.P. Labuan,0,0,0
1/06/2023,South Africa,Johor,270,167,103
1/06/2023,South Africa,Kedah,26,14,12
1/06/2023,South Africa,Kelantan,7,5,2
1/06/2023,South Africa,Melaka,0,0,0
1/06/2023,South Africa,Pahang,2,1,1
1/06/2023,South Africa,Perak,3,2,1
1/06/2023,South Africa,Perlis,28,19,9
1/06/2023,South Africa,Pulau Pinang,54,34,20
1/06/2023,South Africa,Sabah,27,12,15
1/06/2023,South Africa,Sarawak,69,29,40
1/06/2023,South Africa,Selangor,765,428,337
1/06/2023,South Africa,Terengganu,0,0,0
1/06/2023,South Africa,W.P. Labuan,14,7,7
1/06/2023,ZAR,Selangor,0,0,0
1/06/2023,Zambia,Johor,9,1,8
1/06/2023,Zambia,Kedah,0,0,0
1/06/2023,Zambia,Perak,0,0,0
1/06/2023,Zambia,Perlis,0,0,0
1/06/2023,Zambia,Pulau Pinang,0,0,0
1/06/2023,Zambia,Sabah,0,0,0
1/06/2023,Zambia,Sarawak,0,0,0
1/06/2023,Zambia,Selangor,78,42,36
1/06/2023,Zimbabwe,Johor,2,1,1
1/06/2023,Zimbabwe,Kedah,1,1,0
1/06/2023,Zimbabwe,Kelantan,0,0,0
1/06/2023,Zimbabwe,Perak,0,0,0
1/06/2023,Zimbabwe,Perlis,0,0,0
1/06/2023,Zimbabwe,Pulau Pinang,2,1,1
1/06/2023,Zimbabwe,Sabah,0,0,0
1/06/2023,Zimbabwe,Sarawak,0,0,0
1/06/2023,Zimbabwe,Selangor,151,71,80
1/07/2023,Aruba,Kedah,0,0,0
1/07/2023,Aruba,Pulau Pinang,0,0,0
1/07/2023,Afghanistan,Johor,0,0,0
1/07/2023,Afghanistan,Kedah,0,0,0
1/07/2023,Afghanistan,Perlis,3,3,0
1/07/2023,Afghanistan,Pulau Pinang,0,0,0
1/07/2023,Afghanistan,Sarawak,0,0,0
1/07/2023,Afghanistan,Selangor,68,39,29
1/07/2023,Angola,Johor,0,0,0
1/07/2023,Angola,Kedah,0,0,0
1/07/2023,Angola,Sabah,0,0,0
1/07/2023,Angola,Selangor,8,8,0
1/07/2023,Anguilla,Selangor,0,0,0
1/07/2023,Albania,Johor,20,16,4
1/07/2023,Albania,Kedah,0,0,0
1/07/2023,Albania,Perak,0,0,0
1/07/2023,Albania,Perlis,0,0,0
1/07/2023,Albania,Pulau Pinang,1,1,0
1/07/2023,Albania,Sabah,0,0,0
1/07/2023,Albania,Sarawak,1,1,0
1/07/2023,Albania,Selangor,25,12,13
1/07/2023,Andorra,Johor,0,0,0
1/07/2023,Andorra,Kedah,0,0,0
1/07/2023,Andorra,Perlis,0,0,0
1/07/2023,Andorra,Pulau Pinang,0,0,0
1/07/2023,Andorra,Selangor,7,3,4
1/07/2023,Antigua and Barbuda,Selangor,0,0,0
1/07/2023,United Arab Emirates,Johor,106,58,48
1/07/2023,United Arab Emirates,Kedah,27,13,14
1/07/2023,United Arab Emirates,Kelantan,0,0,0
1/07/2023,United Arab Emirates,Perak,0,0,0
1/07/2023,United Arab Emirates,Perlis,3,1,2
1/07/2023,United Arab Emirates,Pulau Pinang,9,3,6
1/07/2023,United Arab Emirates,Sabah,0,0,0
1/07/2023,United Arab Emirates,Sarawak,0,0,0
1/07/2023,United Arab Emirates,Selangor,2070,1023,1047
1/07/2023,Argentina,Johor,105,64,41
1/07/2023,Argentina,Kedah,11,5,6
1/07/2023,Argentina,Kelantan,0,0,0
1/07/2023,Argentina,Melaka,0,0,0
1/07/2023,Argentina,Perak,0,0,0
1/07/2023,Argentina,Perlis,4,2,2
1/07/2023,Argentina,Pulau Pinang,13,9,4
1/07/2023,Argentina,Sabah,1,0,1
1/07/2023,Argentina,Sarawak,1,1,0
1/07/2023,Argentina,Selangor,368,185,183
1/07/2023,Argentina,W.P. Labuan,0,0,0
1/07/2023,Armenia,Johor,4,1,3
1/07/2023,Armenia,Kedah,0,0,0
1/07/2023,Armenia,Kelantan,0,0,0
1/07/2023,Armenia,Perak,0,0,0
1/07/2023,Armenia,Perlis,0,0,0
1/07/2023,Armenia,Pulau Pinang,0,0,0
1/07/2023,Armenia,Sabah,0,0,0
1/07/2023,Armenia,Sarawak,1,1,0
1/07/2023,Armenia,Selangor,130,50,80
1/07/2023,Antarctica,Selangor,0,0,0
1/07/2023,Antigua and Barbuda,Johor,8,8,0
1/07/2023,Antigua and Barbuda,Kedah,0,0,0
1/07/2023,Antigua and Barbuda,Pulau Pinang,2,0,2
1/07/2023,Antigua and Barbuda,Sarawak,0,0,0
1/07/2023,Antigua and Barbuda,Selangor,23,19,4
1/07/2023,Australia,Johor,5848,3444,2404
1/07/2023,Australia,Kedah,629,340,289
1/07/2023,Australia,Kelantan,9,5,4
1/07/2023,Australia,Melaka,5,3,2
1/07/2023,Australia,Negeri Sembilan,1,1,0
1/07/2023,Australia,Pahang,18,7,11
1/07/2023,Australia,Perak,263,135,128
1/07/2023,Australia,Perlis,113,67,46
1/07/2023,Australia,Pulau Pinang,2182,1120,1062
1/07/2023,Australia,Sabah,305,174,131
1/07/2023,Australia,Sarawak,563,321,242
1/07/2023,Australia,Selangor,29346,16481,12865
1/07/2023,Australia,Terengganu,0,0,0
1/07/2023,Australia,W.P. Labuan,9,6,3
1/07/2023,Austria,Johor,228,158,70
1/07/2023,Austria,Kedah,47,24,23
1/07/2023,Austria,Kelantan,3,2,1
1/07/2023,Austria,Melaka,0,0,0
1/07/2023,Austria,Negeri Sembilan,0,0,0
1/07/2023,Austria,Pahang,0,0,0
1/07/2023,Austria,Perak,1,1,0
1/07/2023,Austria,Perlis,14,9,5
1/07/2023,Austria,Pulau Pinang,84,52,32
1/07/2023,Austria,Sabah,10,6,4
1/07/2023,Austria,Sarawak,17,9,8
1/07/2023,Austria,Selangor,987,532,455
1/07/2023,Austria,Terengganu,0,0,0
1/07/2023,Austria,W.P. Labuan,0,0,0
1/07/2023,Azerbaijan,Johor,3,2,1
1/07/2023,Azerbaijan,Kedah,2,1,1
1/07/2023,Azerbaijan,Kelantan,0,0,0
1/07/2023,Azerbaijan,Melaka,0,0,0
1/07/2023,Azerbaijan,Perlis,0,0,0
1/07/2023,Azerbaijan,Pulau Pinang,1,0,1
1/07/2023,Azerbaijan,Sabah,0,0,0
1/07/2023,Azerbaijan,Sarawak,1,1,0
1/07/2023,Azerbaijan,Selangor,159,88,71
1/07/2023,Azerbaijan,W.P. Labuan,0,0,0
1/07/2023,Burundi,Pulau Pinang,0,0,0
1/07/2023,Burundi,Sarawak,0,0,0
1/07/2023,Burundi,Selangor,3,2,1
1/07/2023,Belgium,Johor,465,263,202
1/07/2023,Belgium,Kedah,105,53,52
1/07/2023,Belgium,Kelantan,1,1,0
1/07/2023,Belgium,Melaka,0,0,0
1/07/2023,Belgium,Negeri Sembilan,0,0,0
1/07/2023,Belgium,Pahang,1,1,0
1/07/2023,Belgium,Perak,2,1,1
1/07/2023,Belgium,Perlis,10,10,0
1/07/2023,Belgium,Pulau Pinang,81,49,32
1/07/2023,Belgium,Sabah,29,16,13
1/07/2023,Belgium,Sarawak,49,29,20
1/07/2023,Belgium,Selangor,2618,1401,1217
1/07/2023,Belgium,W.P. Labuan,4,1,3
1/07/2023,Benin,Johor,0,0,0
1/07/2023,Benin,Kedah,5,1,4
1/07/2023,Benin,Perak,0,0,0
1/07/2023,Benin,Pulau Pinang,0,0,0
1/07/2023,Benin,Sabah,0,0,0
1/07/2023,Benin,Sarawak,0,0,0
1/07/2023,Benin,Selangor,18,15,3
1/07/2023,Burkina Faso,Perak,0,0,0
1/07/2023,Burkina Faso,Pulau Pinang,0,0,0
1/07/2023,Burkina Faso,Selangor,7,7,0
1/07/2023,Bangladesh,Johor,3183,2587,596
1/07/2023,Bangladesh,Kedah,214,123,91
1/07/2023,Bangladesh,Kelantan,3,3,0
1/07/2023,Bangladesh,Melaka,0,0,0
1/07/2023,Bangladesh,Negeri Sembilan,0,0,0
1/07/2023,Bangladesh,Pahang,2,2,0
1/07/2023,Bangladesh,Perak,6,4,2
1/07/2023,Bangladesh,Perlis,2,2,0
1/07/2023,Bangladesh,Pulau Pinang,603,541,62
1/07/2023,Bangladesh,Sabah,3,3,0
1/07/2023,Bangladesh,Sarawak,23,21,2
1/07/2023,Bangladesh,Selangor,57489,54806,2683
1/07/2023,Bangladesh,W.P. Labuan,9,8,1
1/07/2023,Bulgaria,Johor,22,5,17
1/07/2023,Bulgaria,Kedah,0,0,0
1/07/2023,Bulgaria,Kelantan,1,0,1
1/07/2023,Bulgaria,Pahang,0,0,0
1/07/2023,Bulgaria,Perak,0,0,0
1/07/2023,Bulgaria,Perlis,0,0,0
1/07/2023,Bulgaria,Pulau Pinang,11,7,4
1/07/2023,Bulgaria,Sabah,3,2,1
1/07/2023,Bulgaria,Sarawak,2,2,0
1/07/2023,Bulgaria,Selangor,138,79,59
1/07/2023,Bulgaria,W.P. Labuan,0,0,0
1/07/2023,Bahrain,Johor,57,22,35
1/07/2023,Bahrain,Kedah,1,1,0
1/07/2023,Bahrain,Kelantan,0,0,0
1/07/2023,Bahrain,Perlis,2,2,0
1/07/2023,Bahrain,Pulau Pinang,2,1,1
1/07/2023,Bahrain,Sabah,0,0,0
1/07/2023,Bahrain,Sarawak,0,0,0
1/07/2023,Bahrain,Selangor,514,254,260
1/07/2023,Bahamas,Johor,0,0,0
1/07/2023,Bahamas,Kedah,0,0,0
1/07/2023,Bahamas,Perak,0,0,0
1/07/2023,Bahamas,Sabah,0,0,0
1/07/2023,Bahamas,Sarawak,0,0,0
1/07/2023,Bahamas,Selangor,7,5,2
1/07/2023,Bosnia and Herzegovina,Johor,16,6,10
1/07/2023,Bosnia and Herzegovina,Kedah,0,0,0
1/07/2023,Bosnia and Herzegovina,Perlis,2,2,0
1/07/2023,Bosnia and Herzegovina,Pulau Pinang,0,0,0
1/07/2023,Bosnia and Herzegovina,Sabah,0,0,0
1/07/2023,Bosnia and Herzegovina,Sarawak,0,0,0
1/07/2023,Bosnia and Herzegovina,Selangor,42,22,20
1/07/2023,Belarus,Johor,6,2,4
1/07/2023,Belarus,Kedah,16,5,11
1/07/2023,Belarus,Kelantan,2,1,1
1/07/2023,Belarus,Pahang,0,0,0
1/07/2023,Belarus,Perak,1,0,1
1/07/2023,Belarus,Perlis,1,1,0
1/07/2023,Belarus,Pulau Pinang,5,3,2
1/07/2023,Belarus,Sabah,1,0,1
1/07/2023,Belarus,Sarawak,1,1,0
1/07/2023,Belarus,Selangor,308,150,158
1/07/2023,Belarus,W.P. Labuan,0,0,0
1/07/2023,Belize,Johor,4,2,2
1/07/2023,Belize,Pulau Pinang,0,0,0
1/07/2023,Belize,Sarawak,0,0,0
1/07/2023,Belize,Selangor,14,9,5
1/07/2023,Bermuda,Selangor,0,0,0
1/07/2023,Bolivia,Johor,10,8,2
1/07/2023,Bolivia,Kedah,0,0,0
1/07/2023,Bolivia,Melaka,0,0,0
1/07/2023,Bolivia,Perak,0,0,0
1/07/2023,Bolivia,Perlis,0,0,0
1/07/2023,Bolivia,Pulau Pinang,0,0,0
1/07/2023,Bolivia,Sabah,1,0,1
1/07/2023,Bolivia,Sarawak,0,0,0
1/07/2023,Bolivia,Selangor,40,22,18
1/07/2023,Brazil,Johor,207,113,94
1/07/2023,Brazil,Kedah,19,7,12
1/07/2023,Brazil,Kelantan,1,1,0
1/07/2023,Brazil,Melaka,1,0,1
1/07/2023,Brazil,Pahang,0,0,0
1/07/2023,Brazil,Perak,6,3,3
1/07/2023,Brazil,Perlis,9,5,4
1/07/2023,Brazil,Pulau Pinang,28,18,10
1/07/2023,Brazil,Sabah,3,2,1
1/07/2023,Brazil,Sarawak,13,7,6
1/07/2023,Brazil,Selangor,980,541,439
1/07/2023,Brazil,W.P. Labuan,1,1,0
1/07/2023,Barbados,Johor,2,2,0
1/07/2023,Barbados,Kedah,0,0,0
1/07/2023,Barbados,Perlis,0,0,0
1/07/2023,Barbados,Pulau Pinang,2,0,2
1/07/2023,Barbados,Selangor,3,1,2
1/07/2023,Brunei Darussalam,Johor,436,234,202
1/07/2023,Brunei Darussalam,Kedah,34,18,16
1/07/2023,Brunei Darussalam,Kelantan,23,11,12
1/07/2023,Brunei Darussalam,Melaka,0,0,0
1/07/2023,Brunei Darussalam,Pahang,0,0,0
1/07/2023,Brunei Darussalam,Perak,3,2,1
1/07/2023,Brunei Darussalam,Perlis,18,3,15
1/07/2023,Brunei Darussalam,Pulau Pinang,22,11,11
1/07/2023,Brunei Darussalam,Sabah,435,177,258
1/07/2023,Brunei Darussalam,Sarawak,78969,43184,35785
1/07/2023,Brunei Darussalam,Selangor,4956,2422,2534
1/07/2023,Brunei Darussalam,W.P. Labuan,817,622,195
1/07/2023,Bhutan,Johor,7,7,0
1/07/2023,Bhutan,Kedah,0,0,0
1/07/2023,Bhutan,Perak,0,0,0
1/07/2023,Bhutan,Perlis,0,0,0
1/07/2023,Bhutan,Pulau Pinang,4,3,1
1/07/2023,Bhutan,Sabah,0,0,0
1/07/2023,Bhutan,Sarawak,0,0,0
1/07/2023,Bhutan,Selangor,63,48,15
1/07/2023,Botswana,Johor,2,2,0
1/07/2023,Botswana,Kedah,0,0,0
1/07/2023,Botswana,Perlis,0,0,0
1/07/2023,Botswana,Pulau Pinang,0,0,0
1/07/2023,Botswana,Sabah,0,0,0
1/07/2023,Botswana,Sarawak,0,0,0
1/07/2023,Botswana,Selangor,6,1,5
1/07/2023,Central African Republic,Kedah,0,0,0
1/07/2023,Central African Republic,Selangor,0,0,0
1/07/2023,Canada,Johor,1496,842,654
1/07/2023,Canada,Kedah,136,75,61
1/07/2023,Canada,Kelantan,6,3,3
1/07/2023,Canada,Melaka,1,1,0
1/07/2023,Canada,Negeri Sembilan,0,0,0
1/07/2023,Canada,Pahang,1,1,0
1/07/2023,Canada,Perak,39,21,18
1/07/2023,Canada,Perlis,34,20,14
1/07/2023,Canada,Pulau Pinang,515,283,232
1/07/2023,Canada,Sabah,83,41,42
1/07/2023,Canada,Sarawak,243,124,119
1/07/2023,Canada,Selangor,4568,2583,1985
1/07/2023,Canada,Terengganu,0,0,0
1/07/2023,Canada,W.P. Labuan,16,12,4
1/07/2023,Cocos (Keeling) Islands,Selangor,0,0,0
1/07/2023,Switzerland,Johor,717,397,320
1/07/2023,Switzerland,Kedah,86,46,40
1/07/2023,Switzerland,Kelantan,6,3,3
1/07/2023,Switzerland,Melaka,0,0,0
1/07/2023,Switzerland,Negeri Sembilan,0,0,0
1/07/2023,Switzerland,Pahang,1,0,1
1/07/2023,Switzerland,Perak,13,10,3
1/07/2023,Switzerland,Perlis,45,26,19
1/07/2023,Switzerland,Pulau Pinang,157,93,64
1/07/2023,Switzerland,Sabah,44,21,23
1/07/2023,Switzerland,Sarawak,52,27,25
1/07/2023,Switzerland,Selangor,2693,1445,1248
1/07/2023,Switzerland,W.P. Labuan,2,1,1
1/07/2023,Chile,Johor,33,24,9
1/07/2023,Chile,Kedah,14,9,5
1/07/2023,Chile,Kelantan,1,1,0
1/07/2023,Chile,Melaka,0,0,0
1/07/2023,Chile,Pahang,0,0,0
1/07/2023,Chile,Perak,1,1,0
1/07/2023,Chile,Perlis,7,6,1
1/07/2023,Chile,Pulau Pinang,8,5,3
1/07/2023,Chile,Sabah,0,0,0
1/07/2023,Chile,Sarawak,1,1,0
1/07/2023,Chile,Selangor,203,97,106
1/07/2023,China,Johor,51990,22144,29846
1/07/2023,China,Kedah,1955,792,1163
1/07/2023,China,Kelantan,5,2,3
1/07/2023,China,Melaka,3,2,1
1/07/2023,China,Pahang,41,18,23
1/07/2023,China,Perak,275,122,153
1/07/2023,China,Perlis,146,73,73
1/07/2023,China,Pulau Pinang,10737,5492,5245
1/07/2023,China,Sabah,11535,5247,6288
1/07/2023,China,Sarawak,871,413,458
1/07/2023,China,Selangor,134932,63626,71306
1/07/2023,China,Terengganu,0,0,0
1/07/2023,China,W.P. Labuan,56,48,8
1/07/2023,Côte d'Ivoire,Johor,0,0,0
1/07/2023,Côte d'Ivoire,Kedah,0,0,0
1/07/2023,Côte d'Ivoire,Pulau Pinang,0,0,0
1/07/2023,Côte d'Ivoire,Sabah,0,0,0
1/07/2023,Côte d'Ivoire,Sarawak,0,0,0
1/07/2023,Côte d'Ivoire,Selangor,15,11,4
1/07/2023,Cameroon,Johor,3,3,0
1/07/2023,Cameroon,Kedah,0,0,0
1/07/2023,Cameroon,Pulau Pinang,1,0,1
1/07/2023,Cameroon,Sabah,1,1,0
1/07/2023,Cameroon,Sarawak,0,0,0
1/07/2023,Cameroon,Selangor,21,12,9
1/07/2023,Congo,Johor,3,3,0
1/07/2023,Congo,Pulau Pinang,0,0,0
1/07/2023,Congo,Sarawak,0,0,0
1/07/2023,Congo,Selangor,12,8,4
1/07/2023,Congo,Johor,0,0,0
1/07/2023,Congo,Kedah,0,0,0
1/07/2023,Congo,Selangor,8,6,2
1/07/2023,Cook Islands,Selangor,1,1,0
1/07/2023,Colombia,Johor,34,20,14
1/07/2023,Colombia,Kedah,2,2,0
1/07/2023,Colombia,Perak,0,0,0
1/07/2023,Colombia,Pulau Pinang,0,0,0
1/07/2023,Colombia,Sabah,1,0,1
1/07/2023,Colombia,Sarawak,0,0,0
1/07/2023,Colombia,Selangor,214,105,109
1/07/2023,Colombia,W.P. Labuan,0,0,0
1/07/2023,Comoros,Johor,3,0,3
1/07/2023,Comoros,Kedah,0,0,0
1/07/2023,Comoros,Selangor,36,17,19
1/07/2023,Cabo Verde,Johor,0,0,0
1/07/2023,Cabo Verde,Kedah,0,0,0
1/07/2023,Cabo Verde,Pulau Pinang,0,0,0
1/07/2023,Cabo Verde,Sabah,0,0,0
1/07/2023,Cabo Verde,Selangor,3,2,1
1/07/2023,Costa Rica,Johor,32,15,17
1/07/2023,Costa Rica,Kedah,1,1,0
1/07/2023,Costa Rica,Perak,0,0,0
1/07/2023,Costa Rica,Perlis,0,0,0
1/07/2023,Costa Rica,Pulau Pinang,5,4,1
1/07/2023,Costa Rica,Sabah,0,0,0
1/07/2023,Costa Rica,Sarawak,0,0,0
1/07/2023,Costa Rica,Selangor,56,34,22
1/07/2023,Cuba,Johor,4,4,0
1/07/2023,Cuba,Kedah,1,0,1
1/07/2023,Cuba,Perlis,0,0,0
1/07/2023,Cuba,Pulau Pinang,1,1,0
1/07/2023,Cuba,Sabah,0,0,0
1/07/2023,Cuba,Sarawak,0,0,0
1/07/2023,Cuba,Selangor,33,21,12
1/07/2023,Cyprus,Johor,12,7,5
1/07/2023,Cyprus,Kedah,0,0,0
1/07/2023,Cyprus,Perak,0,0,0
1/07/2023,Cyprus,Perlis,0,0,0
1/07/2023,Cyprus,Pulau Pinang,2,2,0
1/07/2023,Cyprus,Sabah,1,0,1
1/07/2023,Cyprus,Sarawak,0,0,0
1/07/2023,Cyprus,Selangor,124,73,51
1/07/2023,Czechia,Johor,150,81,69
1/07/2023,Czechia,Kedah,67,30,37
1/07/2023,Czechia,Kelantan,2,0,2
1/07/2023,Czechia,Melaka,0,0,0
1/07/2023,Czechia,Negeri Sembilan,0,0,0
1/07/2023,Czechia,Perak,1,1,0
1/07/2023,Czechia,Perlis,6,4,2
1/07/2023,Czechia,Pulau Pinang,16,6,10
1/07/2023,Czechia,Sabah,8,3,5
1/07/2023,Czechia,Sarawak,19,5,14
1/07/2023,Czechia,Selangor,654,372,282
1/07/2023,Czechia,W.P. Labuan,4,2,2
1/07/2023,Germany,Johor,2379,1419,960
1/07/2023,Germany,Kedah,357,195,162
1/07/2023,Germany,Kelantan,15,10,5
1/07/2023,Germany,Melaka,2,2,0
1/07/2023,Germany,Negeri Sembilan,1,0,1
1/07/2023,Germany,Pahang,4,3,1
1/07/2023,Germany,Perak,42,31,11
1/07/2023,Germany,Perlis,137,81,56
1/07/2023,Germany,Pulau Pinang,763,515,248
1/07/2023,Germany,Sabah,102,64,38
1/07/2023,Germany,Sarawak,202,117,85
1/07/2023,Germany,Selangor,7898,4700,3198
1/07/2023,Germany,Terengganu,0,0,0
1/07/2023,Germany,W.P. Labuan,9,8,1
1/07/2023,Djibouti,Johor,0,0,0
1/07/2023,Djibouti,Selangor,2,2,0
1/07/2023,Dominica,Johor,5,5,0
1/07/2023,Dominica,Kedah,0,0,0
1/07/2023,Dominica,Pulau Pinang,0,0,0
1/07/2023,Dominica,Sabah,0,0,0
1/07/2023,Dominica,Sarawak,0,0,0
1/07/2023,Dominica,Selangor,61,42,19
1/07/2023,Dominica,W.P. Labuan,0,0,0
1/07/2023,Denmark,Johor,312,207,105
1/07/2023,Denmark,Kedah,54,32,22
1/07/2023,Denmark,Kelantan,0,0,0
1/07/2023,Denmark,Melaka,0,0,0
1/07/2023,Denmark,Negeri Sembilan,0,0,0
1/07/2023,Denmark,Pahang,0,0,0
1/07/2023,Denmark,Perak,4,2,2
1/07/2023,Denmark,Perlis,14,11,3
1/07/2023,Denmark,Pulau Pinang,64,36,28
1/07/2023,Denmark,Sabah,26,12,14
1/07/2023,Denmark,Sarawak,44,22,22
1/07/2023,Denmark,Selangor,1844,1007,837
1/07/2023,Denmark,W.P. Labuan,0,0,0
1/07/2023,Dominican Republic,Johor,1,0,1
1/07/2023,Dominican Republic,Kedah,0,0,0
1/07/2023,Dominican Republic,Perak,0,0,0
1/07/2023,Dominican Republic,Perlis,0,0,0
1/07/2023,Dominican Republic,Pulau Pinang,1,1,0
1/07/2023,Dominican Republic,Sabah,0,0,0
1/07/2023,Dominican Republic,Sarawak,0,0,0
1/07/2023,Dominican Republic,Selangor,16,8,8
1/07/2023,Algeria,Johor,26,21,5
1/07/2023,Algeria,Kedah,3,3,0
1/07/2023,Algeria,Kelantan,0,0,0
1/07/2023,Algeria,Melaka,0,0,0
1/07/2023,Algeria,Perak,0,0,0
1/07/2023,Algeria,Perlis,4,1,3
1/07/2023,Algeria,Pulau Pinang,5,3,2
1/07/2023,Algeria,Sabah,0,0,0
1/07/2023,Algeria,Sarawak,0,0,0
1/07/2023,Algeria,Selangor,1134,613,521
1/07/2023,Algeria,W.P. Labuan,0,0,0
1/07/2023,Ecuador,Johor,11,10,1
1/07/2023,Ecuador,Kedah,3,1,2
1/07/2023,Ecuador,Perak,0,0,0
1/07/2023,Ecuador,Perlis,0,0,0
1/07/2023,Ecuador,Pulau Pinang,1,0,1
1/07/2023,Ecuador,Sabah,1,1,0
1/07/2023,Ecuador,Sarawak,0,0,0
1/07/2023,Ecuador,Selangor,72,35,37
1/07/2023,Egypt,Johor,247,190,57
1/07/2023,Egypt,Kedah,5,4,1
1/07/2023,Egypt,Kelantan,1,1,0
1/07/2023,Egypt,Melaka,2,2,0
1/07/2023,Egypt,Pahang,0,0,0
1/07/2023,Egypt,Perak,0,0,0
1/07/2023,Egypt,Perlis,0,0,0
1/07/2023,Egypt,Pulau Pinang,7,7,0
1/07/2023,Egypt,Sabah,2,2,0
1/07/2023,Egypt,Sarawak,92,64,28
1/07/2023,Egypt,Selangor,1964,1188,776
1/07/2023,Egypt,Terengganu,0,0,0
1/07/2023,Egypt,W.P. Labuan,0,0,0
1/07/2023,Eritrea,Johor,1,0,1
1/07/2023,Eritrea,Pulau Pinang,0,0,0
1/07/2023,Eritrea,Sabah,0,0,0
1/07/2023,Eritrea,Selangor,12,11,1
1/07/2023,Spain,Johor,627,360,267
1/07/2023,Spain,Kedah,116,58,58
1/07/2023,Spain,Kelantan,14,6,8
1/07/2023,Spain,Melaka,0,0,0
1/07/2023,Spain,Negeri Sembilan,0,0,0
1/07/2023,Spain,Pahang,0,0,0
1/07/2023,Spain,Perak,17,7,10
1/07/2023,Spain,Perlis,18,11,7
1/07/2023,Spain,Pulau Pinang,200,103,97
1/07/2023,Spain,Sabah,47,32,15
1/07/2023,Spain,Sarawak,92,54,38
1/07/2023,Spain,Selangor,5115,2558,2557
1/07/2023,Spain,W.P. Labuan,6,4,2
1/07/2023,Estonia,Johor,19,8,11
1/07/2023,Estonia,Kedah,9,5,4
1/07/2023,Estonia,Kelantan,0,0,0
1/07/2023,Estonia,Pahang,0,0,0
1/07/2023,Estonia,Perak,0,0,0
1/07/2023,Estonia,Perlis,0,0,0
1/07/2023,Estonia,Pulau Pinang,7,4,3
1/07/2023,Estonia,Sabah,1,0,1
1/07/2023,Estonia,Sarawak,0,0,0
1/07/2023,Estonia,Selangor,90,48,42
1/07/2023,Estonia,W.P. Labuan,0,0,0
1/07/2023,Ethiopia,Johor,0,0,0
1/07/2023,Ethiopia,Kedah,0,0,0
1/07/2023,Ethiopia,Pulau Pinang,0,0,0
1/07/2023,Ethiopia,Sarawak,1,1,0
1/07/2023,Ethiopia,Selangor,53,24,29
1/07/2023,Finland,Johor,112,66,46
1/07/2023,Finland,Kedah,20,10,10
1/07/2023,Finland,Kelantan,2,1,1
1/07/2023,Finland,Melaka,0,0,0
1/07/2023,Finland,Negeri Sembilan,0,0,0
1/07/2023,Finland,Pahang,0,0,0
1/07/2023,Finland,Perak,0,0,0
1/07/2023,Finland,Perlis,21,13,8
1/07/2023,Finland,Pulau Pinang,33,19,14
1/07/2023,Finland,Sabah,9,3,6
1/07/2023,Finland,Sarawak,4,1,3
1/07/2023,Finland,Selangor,399,226,173
1/07/2023,Finland,W.P. Labuan,2,1,1
1/07/2023,Fiji,Johor,64,33,31
1/07/2023,Fiji,Kedah,1,1,0
1/07/2023,Fiji,Kelantan,0,0,0
1/07/2023,Fiji,Perak,0,0,0
1/07/2023,Fiji,Perlis,0,0,0
1/07/2023,Fiji,Pulau Pinang,4,0,4
1/07/2023,Fiji,Sabah,1,1,0
1/07/2023,Fiji,Sarawak,4,4,0
1/07/2023,Fiji,Selangor,141,78,63
1/07/2023,France,Johor,3199,1804,1395
1/07/2023,France,Kedah,382,217,165
1/07/2023,France,Kelantan,32,17,15
1/07/2023,France,Melaka,7,6,1
1/07/2023,France,Negeri Sembilan,1,1,0
1/07/2023,France,Pahang,10,6,4
1/07/2023,France,Perak,46,32,14
1/07/2023,France,Perlis,79,45,34
1/07/2023,France,Pulau Pinang,482,284,198
1/07/2023,France,Sabah,107,72,35
1/07/2023,France,Sarawak,170,105,65
1/07/2023,France,Selangor,14425,7767,6658
1/07/2023,France,Terengganu,0,0,0
1/07/2023,France,W.P. Labuan,5,3,2
1/07/2023,"Micronesia, Federated States of",Johor,0,0,0
1/07/2023,"Micronesia, Federated States of",Pulau Pinang,0,0,0
1/07/2023,"Micronesia, Federated States of",Selangor,0,0,0
1/07/2023,Gabon,Johor,2,2,0
1/07/2023,Gabon,Pulau Pinang,0,0,0
1/07/2023,Gabon,Sarawak,1,0,1
1/07/2023,Gabon,Selangor,5,4,1
1/07/2023,United Kingdom of Great Britain and Northern Ireland,Johor,5000,3130,1870
1/07/2023,United Kingdom of Great Britain and Northern Ireland,Kedah,948,540,408
1/07/2023,United Kingdom of Great Britain and Northern Ireland,Kelantan,15,14,1
1/07/2023,United Kingdom of Great Britain and Northern Ireland,Melaka,4,2,2
1/07/2023,United Kingdom of Great Britain and Northern Ireland,Negeri Sembilan,1,1,0
1/07/2023,United Kingdom of Great Britain and Northern Ireland,Pahang,10,8,2
1/07/2023,United Kingdom of Great Britain and Northern Ireland,Perak,137,72,65
1/07/2023,United Kingdom of Great Britain and Northern Ireland,Perlis,193,116,77
1/07/2023,United Kingdom of Great Britain and Northern Ireland,Pulau Pinang,1796,998,798
1/07/2023,United Kingdom of Great Britain and Northern Ireland,Sabah,464,248,216
1/07/2023,United Kingdom of Great Britain and Northern Ireland,Sarawak,1048,621,427
1/07/2023,United Kingdom of Great Britain and Northern Ireland,Selangor,23629,13369,10260
1/07/2023,United Kingdom of Great Britain and Northern Ireland,Terengganu,0,0,0
1/07/2023,United Kingdom of Great Britain and Northern Ireland,W.P. Labuan,25,17,8
1/07/2023,Georgia,Johor,11,11,0
1/07/2023,Georgia,Kedah,0,0,0
1/07/2023,Georgia,Melaka,0,0,0
1/07/2023,Georgia,Perak,0,0,0
1/07/2023,Georgia,Perlis,1,0,1
1/07/2023,Georgia,Pulau Pinang,1,0,1
1/07/2023,Georgia,Sabah,0,0,0
1/07/2023,Georgia,Sarawak,0,0,0
1/07/2023,Georgia,Selangor,43,28,15
1/07/2023,Ghana,Johor,10,9,1
1/07/2023,Ghana,Kedah,1,1,0
1/07/2023,Ghana,Kelantan,0,0,0
1/07/2023,Ghana,Pulau Pinang,0,0,0
1/07/2023,Ghana,Sabah,0,0,0
1/07/2023,Ghana,Sarawak,0,0,0
1/07/2023,Ghana,Selangor,58,44,14
1/07/2023,Gibraltar,Johor,0,0,0
1/07/2023,Gibraltar,Sarawak,0,0,0
1/07/2023,Guinea,Johor,7,7,0
1/07/2023,Guinea,Kedah,1,1,0
1/07/2023,Guinea,Kelantan,0,0,0
1/07/2023,Guinea,Perlis,0,0,0
1/07/2023,Guinea,Pulau Pinang,0,0,0
1/07/2023,Guinea,Sabah,0,0,0
1/07/2023,Guinea,Sarawak,0,0,0
1/07/2023,Guinea,Selangor,53,36,17
1/07/2023,Guadeloupe,Selangor,0,0,0
1/07/2023,Gambia,Johor,10,9,1
1/07/2023,Gambia,Kedah,0,0,0
1/07/2023,Gambia,Kelantan,0,0,0
1/07/2023,Gambia,Pulau Pinang,0,0,0
1/07/2023,Gambia,Sabah,0,0,0
1/07/2023,Gambia,Sarawak,0,0,0
1/07/2023,Gambia,Selangor,28,26,2
1/07/2023,Guinea-Bissau,Johor,0,0,0
1/07/2023,Guinea-Bissau,Selangor,0,0,0
1/07/2023,Equatorial Guinea,Johor,0,0,0
1/07/2023,Equatorial Guinea,Selangor,3,0,3
1/07/2023,Greece,Johor,42,31,11
1/07/2023,Greece,Kedah,3,2,1
1/07/2023,Greece,Kelantan,0,0,0
1/07/2023,Greece,Melaka,0,0,0
1/07/2023,Greece,Negeri Sembilan,0,0,0
1/07/2023,Greece,Pahang,0,0,0
1/07/2023,Greece,Perak,1,1,0
1/07/2023,Greece,Perlis,3,1,2
1/07/2023,Greece,Pulau Pinang,8,3,5
1/07/2023,Greece,Sabah,1,1,0
1/07/2023,Greece,Sarawak,6,4,2
1/07/2023,Greece,Selangor,190,135,55
1/07/2023,Grenada,Johor,12,5,7
1/07/2023,Grenada,Kedah,1,1,0
1/07/2023,Grenada,Pulau Pinang,1,0,1
1/07/2023,Grenada,Sabah,0,0,0
1/07/2023,Grenada,Sarawak,0,0,0
1/07/2023,Grenada,Selangor,12,9,3
1/07/2023,Greenland,Johor,1,1,0
1/07/2023,Greenland,Selangor,0,0,0
1/07/2023,Guatemala,Johor,5,5,0
1/07/2023,Guatemala,Kedah,0,0,0
1/07/2023,Guatemala,Pahang,0,0,0
1/07/2023,Guatemala,Perak,0,0,0
1/07/2023,Guatemala,Pulau Pinang,0,0,0
1/07/2023,Guatemala,Sabah,0,0,0
1/07/2023,Guatemala,Sarawak,0,0,0
1/07/2023,Guatemala,Selangor,19,15,4
1/07/2023,Guatemala,W.P. Labuan,0,0,0
1/07/2023,Guyana,Johor,0,0,0
1/07/2023,Guyana,Kedah,0,0,0
1/07/2023,Guyana,Pulau Pinang,0,0,0
1/07/2023,Guyana,Sarawak,1,0,1
1/07/2023,Guyana,Selangor,4,1,3
1/07/2023,Hong Kong,Johor,4,4,0
1/07/2023,Hong Kong,Kedah,0,0,0
1/07/2023,Hong Kong,Kelantan,1,1,0
1/07/2023,Hong Kong,Pahang,3,2,1
1/07/2023,Hong Kong,Perak,91,49,42
1/07/2023,Hong Kong,Perlis,1,0,1
1/07/2023,Hong Kong,Pulau Pinang,0,0,0
1/07/2023,Hong Kong,Sabah,0,0,0
1/07/2023,Hong Kong,Sarawak,0,0,0
1/07/2023,Hong Kong,Selangor,7,6,1
1/07/2023,Hong Kong,Terengganu,0,0,0
1/07/2023,Heard Island and McDonald Islands,Johor,0,0,0
1/07/2023,Honduras,Johor,9,7,2
1/07/2023,Honduras,Kedah,0,0,0
1/07/2023,Honduras,Perak,0,0,0
1/07/2023,Honduras,Pulau Pinang,0,0,0
1/07/2023,Honduras,Sabah,0,0,0
1/07/2023,Honduras,Sarawak,0,0,0
1/07/2023,Honduras,Selangor,15,14,1
1/07/2023,Croatia,Johor,25,16,9
1/07/2023,Croatia,Kedah,1,1,0
1/07/2023,Croatia,Kelantan,0,0,0
1/07/2023,Croatia,Melaka,0,0,0
1/07/2023,Croatia,Pahang,0,0,0
1/07/2023,Croatia,Perak,0,0,0
1/07/2023,Croatia,Perlis,0,0,0
1/07/2023,Croatia,Pulau Pinang,1,0,1
1/07/2023,Croatia,Sabah,1,1,0
1/07/2023,Croatia,Sarawak,2,2,0
1/07/2023,Croatia,Selangor,150,105,45
1/07/2023,Haiti,Johor,0,0,0
1/07/2023,Haiti,Kedah,0,0,0
1/07/2023,Haiti,Kelantan,0,0,0
1/07/2023,Haiti,Perak,0,0,0
1/07/2023,Haiti,Pulau Pinang,0,0,0
1/07/2023,Haiti,Sabah,0,0,0
1/07/2023,Haiti,Selangor,9,4,5
1/07/2023,Hungary,Johor,104,59,45
1/07/2023,Hungary,Kedah,14,6,8
1/07/2023,Hungary,Kelantan,0,0,0
1/07/2023,Hungary,Pahang,0,0,0
1/07/2023,Hungary,Perak,0,0,0
1/07/2023,Hungary,Perlis,7,4,3
1/07/2023,Hungary,Pulau Pinang,10,6,4
1/07/2023,Hungary,Sabah,3,2,1
1/07/2023,Hungary,Sarawak,18,5,13
1/07/2023,Hungary,Selangor,465,253,212
1/07/2023,Hungary,W.P. Labuan,0,0,0
1/07/2023,Indonesia,Johor,110963,52035,58928
1/07/2023,Indonesia,Kedah,7844,2720,5124
1/07/2023,Indonesia,Kelantan,206,100,106
1/07/2023,Indonesia,Melaka,5206,2314,2892
1/07/2023,Indonesia,Negeri Sembilan,6484,4492,1992
1/07/2023,Indonesia,Pahang,18,13,5
1/07/2023,Indonesia,Perak,323,170,153
1/07/2023,Indonesia,Perlis,681,266,415
1/07/2023,Indonesia,Pulau Pinang,40973,16180,24793
1/07/2023,Indonesia,Sabah,4863,2329,2534
1/07/2023,Indonesia,Sarawak,36328,18358,17970
1/07/2023,Indonesia,Selangor,130764,61675,69089
1/07/2023,Indonesia,Terengganu,1,1,0
1/07/2023,Indonesia,W.P. Labuan,106,42,64
1/07/2023,India,Johor,22725,15889,6836
1/07/2023,India,Kedah,1141,637,504
1/07/2023,India,Kelantan,6,6,0
1/07/2023,India,Melaka,3,2,1
1/07/2023,India,Negeri Sembilan,0,0,0
1/07/2023,India,Pahang,9,8,1
1/07/2023,India,Perak,269,181,88
1/07/2023,India,Perlis,35,30,5
1/07/2023,India,Pulau Pinang,1108,776,332
1/07/2023,India,Sabah,151,108,43
1/07/2023,India,Sarawak,1048,846,202
1/07/2023,India,Selangor,52105,37815,14290
1/07/2023,India,Terengganu,0,0,0
1/07/2023,India,W.P. Labuan,81,62,19
1/07/2023, British Indian Ocean Territory,Pulau Pinang,0,0,0
1/07/2023, British Indian Ocean Territory,Selangor,0,0,0
1/07/2023,Ireland,Johor,315,180,135
1/07/2023,Ireland,Kedah,80,50,30
1/07/2023,Ireland,Kelantan,0,0,0
1/07/2023,Ireland,Negeri Sembilan,1,0,1
1/07/2023,Ireland,Pahang,0,0,0
1/07/2023,Ireland,Perak,19,13,6
1/07/2023,Ireland,Perlis,17,11,6
1/07/2023,Ireland,Pulau Pinang,137,79,58
1/07/2023,Ireland,Sabah,16,8,8
1/07/2023,Ireland,Sarawak,26,11,15
1/07/2023,Ireland,Selangor,1791,975,816
1/07/2023,Ireland,Terengganu,0,0,0
1/07/2023,Ireland,W.P. Labuan,1,1,0
1/07/2023,"Iran, Islamic Republic of",Johor,177,100,77
1/07/2023,"Iran, Islamic Republic of",Kedah,12,7,5
1/07/2023,"Iran, Islamic Republic of",Kelantan,0,0,0
1/07/2023,"Iran, Islamic Republic of",Perak,0,0,0
1/07/2023,"Iran, Islamic Republic of",Perlis,9,6,3
1/07/2023,"Iran, Islamic Republic of",Pulau Pinang,8,4,4
1/07/2023,"Iran, Islamic Republic of",Sabah,2,1,1
1/07/2023,"Iran, Islamic Republic of",Sarawak,3,2,1
1/07/2023,"Iran, Islamic Republic of",Selangor,1488,823,665
1/07/2023,"Iran, Islamic Republic of",W.P. Labuan,0,0,0
1/07/2023,Iraq,Johor,47,30,17
1/07/2023,Iraq,Kedah,2,2,0
1/07/2023,Iraq,Kelantan,1,1,0
1/07/2023,Iraq,Melaka,0,0,0
1/07/2023,Iraq,Pahang,0,0,0
1/07/2023,Iraq,Perak,0,0,0
1/07/2023,Iraq,Perlis,0,0,0
1/07/2023,Iraq,Pulau Pinang,3,2,1
1/07/2023,Iraq,Sabah,0,0,0
1/07/2023,Iraq,Sarawak,0,0,0
1/07/2023,Iraq,Selangor,1191,711,480
1/07/2023,Iceland,Johor,12,4,8
1/07/2023,Iceland,Kedah,2,1,1
1/07/2023,Iceland,Kelantan,0,0,0
1/07/2023,Iceland,Perak,4,2,2
1/07/2023,Iceland,Perlis,0,0,0
1/07/2023,Iceland,Pulau Pinang,0,0,0
1/07/2023,Iceland,Sabah,0,0,0
1/07/2023,Iceland,Sarawak,0,0,0
1/07/2023,Iceland,Selangor,41,24,17
1/07/2023,Iceland,W.P. Labuan,0,0,0
1/07/2023,Israel,Pulau Pinang,0,0,0
1/07/2023,Italy,Johor,763,468,295
1/07/2023,Italy,Kedah,57,38,19
1/07/2023,Italy,Kelantan,3,2,1
1/07/2023,Italy,Melaka,1,1,0
1/07/2023,Italy,Negeri Sembilan,0,0,0
1/07/2023,Italy,Pahang,1,1,0
1/07/2023,Italy,Perak,8,3,5
1/07/2023,Italy,Perlis,25,14,11
1/07/2023,Italy,Pulau Pinang,165,120,45
1/07/2023,Italy,Sabah,41,24,17
1/07/2023,Italy,Sarawak,111,62,49
1/07/2023,Italy,Selangor,4711,2671,2040
1/07/2023,Italy,W.P. Labuan,1,1,0
1/07/2023,Jamaica,Johor,4,1,3
1/07/2023,Jamaica,Kedah,0,0,0
1/07/2023,Jamaica,Perak,0,0,0
1/07/2023,Jamaica,Pulau Pinang,2,1,1
1/07/2023,Jamaica,Sabah,0,0,0
1/07/2023,Jamaica,Sarawak,0,0,0
1/07/2023,Jamaica,Selangor,27,9,18
1/07/2023,Jamaica,W.P. Labuan,0,0,0
1/07/2023,Jordan,Johor,40,26,14
1/07/2023,Jordan,Kedah,6,3,3
1/07/2023,Jordan,Kelantan,0,0,0
1/07/2023,Jordan,Melaka,0,0,0
1/07/2023,Jordan,Perlis,0,0,0
1/07/2023,Jordan,Pulau Pinang,18,11,7
1/07/2023,Jordan,Sabah,1,1,0
1/07/2023,Jordan,Sarawak,0,0,0
1/07/2023,Jordan,Selangor,1371,749,622
1/07/2023,Jordan,W.P. Labuan,0,0,0
1/07/2023,Japan,Johor,6456,4146,2310
1/07/2023,Japan,Kedah,209,100,109
1/07/2023,Japan,Kelantan,16,10,6
1/07/2023,Japan,Melaka,1,1,0
1/07/2023,Japan,Negeri Sembilan,0,0,0
1/07/2023,Japan,Pahang,1,0,1
1/07/2023,Japan,Perak,79,57,22
1/07/2023,Japan,Perlis,70,54,16
1/07/2023,Japan,Pulau Pinang,1541,1051,490
1/07/2023,Japan,Sabah,121,76,45
1/07/2023,Japan,Sarawak,191,137,54
1/07/2023,Japan,Selangor,21617,12766,8851
1/07/2023,Japan,W.P. Labuan,10,6,4
1/07/2023,Kazakhstan,Johor,87,45,42
1/07/2023,Kazakhstan,Kedah,18,5,13
1/07/2023,Kazakhstan,Kelantan,1,1,0
1/07/2023,Kazakhstan,Melaka,0,0,0
1/07/2023,Kazakhstan,Perak,1,1,0
1/07/2023,Kazakhstan,Perlis,3,0,3
1/07/2023,Kazakhstan,Pulau Pinang,7,5,2
1/07/2023,Kazakhstan,Sabah,5,2,3
1/07/2023,Kazakhstan,Sarawak,7,0,7
1/07/2023,Kazakhstan,Selangor,966,417,549
1/07/2023,Kazakhstan,W.P. Labuan,0,0,0
1/07/2023,Kenya,Johor,79,41,38
1/07/2023,Kenya,Kedah,8,3,5
1/07/2023,Kenya,Kelantan,0,0,0
1/07/2023,Kenya,Perak,0,0,0
1/07/2023,Kenya,Perlis,1,0,1
1/07/2023,Kenya,Pulau Pinang,2,1,1
1/07/2023,Kenya,Sabah,0,0,0
1/07/2023,Kenya,Sarawak,0,0,0
1/07/2023,Kenya,Selangor,395,203,192
1/07/2023,Kyrgyzstan,Johor,30,18,12
1/07/2023,Kyrgyzstan,Kedah,3,2,1
1/07/2023,Kyrgyzstan,Kelantan,0,0,0
1/07/2023,Kyrgyzstan,Perak,0,0,0
1/07/2023,Kyrgyzstan,Perlis,1,0,1
1/07/2023,Kyrgyzstan,Pulau Pinang,11,6,5
1/07/2023,Kyrgyzstan,Sabah,0,0,0
1/07/2023,Kyrgyzstan,Sarawak,0,0,0
1/07/2023,Kyrgyzstan,Selangor,222,98,124
1/07/2023,Cambodia,Johor,2372,1067,1305
1/07/2023,Cambodia,Kedah,106,63,43
1/07/2023,Cambodia,Kelantan,565,314,251
1/07/2023,Cambodia,Melaka,0,0,0
1/07/2023,Cambodia,Negeri Sembilan,0,0,0
1/07/2023,Cambodia,Pahang,0,0,0
1/07/2023,Cambodia,Perak,11,2,9
1/07/2023,Cambodia,Perlis,858,529,329
1/07/2023,Cambodia,Pulau Pinang,51,23,28
1/07/2023,Cambodia,Sabah,0,0,0
1/07/2023,Cambodia,Sarawak,11,4,7
1/07/2023,Cambodia,Selangor,4326,2043,2283
1/07/2023,Cambodia,W.P. Labuan,0,0,0
1/07/2023,Kiribati,Johor,0,0,0
1/07/2023,Kiribati,Sabah,0,0,0
1/07/2023,Kiribati,Selangor,2,1,1
1/07/2023,Saint Kitts and Nevis,Johor,24,14,10
1/07/2023,Saint Kitts and Nevis,Kedah,0,0,0
1/07/2023,Saint Kitts and Nevis,Perlis,0,0,0
1/07/2023,Saint Kitts and Nevis,Pulau Pinang,0,0,0
1/07/2023,Saint Kitts and Nevis,Sabah,2,0,2
1/07/2023,Saint Kitts and Nevis,Selangor,98,68,30
1/07/2023,Saint Kitts and Nevis,W.P. Labuan,0,0,0
1/07/2023,"Korea, Republic of",Johor,15171,7790,7381
1/07/2023,"Korea, Republic of",Kedah,183,101,82
1/07/2023,"Korea, Republic of",Kelantan,1,0,1
1/07/2023,"Korea, Republic of",Melaka,3,2,1
1/07/2023,"Korea, Republic of",Negeri Sembilan,0,0,0
1/07/2023,"Korea, Republic of",Pahang,2,0,2
1/07/2023,"Korea, Republic of",Perak,16,10,6
1/07/2023,"Korea, Republic of",Perlis,60,41,19
1/07/2023,"Korea, Republic of",Pulau Pinang,741,393,348
1/07/2023,"Korea, Republic of",Sabah,7839,3327,4512
1/07/2023,"Korea, Republic of",Sarawak,229,125,104
1/07/2023,"Korea, Republic of",Selangor,21820,10908,10912
1/07/2023,"Korea, Republic of",Terengganu,0,0,0
1/07/2023,"Korea, Republic of",W.P. Labuan,3,2,1
1/07/2023,Kuwait,Johor,104,64,40
1/07/2023,Kuwait,Kedah,30,9,21
1/07/2023,Kuwait,Kelantan,0,0,0
1/07/2023,Kuwait,Perak,1,0,1
1/07/2023,Kuwait,Perlis,2,1,1
1/07/2023,Kuwait,Pulau Pinang,10,3,7
1/07/2023,Kuwait,Sabah,2,1,1
1/07/2023,Kuwait,Sarawak,0,0,0
1/07/2023,Kuwait,Selangor,2585,1351,1234
1/07/2023,Kuwait,W.P. Labuan,1,1,0
1/07/2023, Lao People's Democratic Republic,Johor,206,66,140
1/07/2023, Lao People's Democratic Republic,Kedah,292,24,268
1/07/2023, Lao People's Democratic Republic,Kelantan,144,59,85
1/07/2023, Lao People's Democratic Republic,Melaka,0,0,0
1/07/2023, Lao People's Democratic Republic,Perak,35,2,33
1/07/2023, Lao People's Democratic Republic,Perlis,535,115,420
1/07/2023, Lao People's Democratic Republic,Pulau Pinang,22,5,17
1/07/2023, Lao People's Democratic Republic,Sabah,2,0,2
1/07/2023, Lao People's Democratic Republic,Sarawak,8,5,3
1/07/2023, Lao People's Democratic Republic,Selangor,309,106,203
1/07/2023, Lao People's Democratic Republic,W.P. Labuan,0,0,0
1/07/2023,Lebanon,Johor,12,6,6
1/07/2023,Lebanon,Kedah,1,0,1
1/07/2023,Lebanon,Kelantan,0,0,0
1/07/2023,Lebanon,Pahang,0,0,0
1/07/2023,Lebanon,Perak,0,0,0
1/07/2023,Lebanon,Perlis,0,0,0
1/07/2023,Lebanon,Pulau Pinang,3,2,1
1/07/2023,Lebanon,Sabah,0,0,0
1/07/2023,Lebanon,Sarawak,1,1,0
1/07/2023,Lebanon,Selangor,299,177,122
1/07/2023,Lebanon,W.P. Labuan,0,0,0
1/07/2023,Liberia,Johor,0,0,0
1/07/2023,Liberia,Kedah,0,0,0
1/07/2023,Liberia,Sabah,0,0,0
1/07/2023,Liberia,Sarawak,0,0,0
1/07/2023,Liberia,Selangor,4,2,2
1/07/2023,Libya,Johor,1,1,0
1/07/2023,Libya,Kedah,0,0,0
1/07/2023,Libya,Perlis,0,0,0
1/07/2023,Libya,Pulau Pinang,0,0,0
1/07/2023,Libya,Sabah,1,1,0
1/07/2023,Libya,Sarawak,3,2,1
1/07/2023,Libya,Selangor,333,242,91
1/07/2023,Saint Lucia,Johor,6,4,2
1/07/2023,Saint Lucia,Kedah,0,0,0
1/07/2023,Saint Lucia,Pulau Pinang,0,0,0
1/07/2023,Saint Lucia,Sarawak,1,1,0
1/07/2023,Saint Lucia,Selangor,11,8,3
1/07/2023,Liechtenstein,Johor,1,1,0
1/07/2023,Liechtenstein,Kedah,0,0,0
1/07/2023,Liechtenstein,Perlis,1,1,0
1/07/2023,Liechtenstein,Pulau Pinang,0,0,0
1/07/2023,Liechtenstein,Sabah,0,0,0
1/07/2023,Liechtenstein,Sarawak,1,1,0
1/07/2023,Liechtenstein,Selangor,17,8,9
1/07/2023,LKA,Johor,1119,743,376
1/07/2023,LKA,Kedah,43,20,23
1/07/2023,LKA,Kelantan,0,0,0
1/07/2023,LKA,Melaka,0,0,0
1/07/2023,LKA,Pahang,0,0,0
1/07/2023,LKA,Perak,0,0,0
1/07/2023,LKA,Perlis,0,0,0
1/07/2023,LKA,Pulau Pinang,37,21,16
1/07/2023,LKA,Sabah,3,1,2
1/07/2023,LKA,Sarawak,27,19,8
1/07/2023,LKA,Selangor,4693,3011,1682
1/07/2023,LKA,W.P. Labuan,0,0,0
1/07/2023,Lesotho,Johor,1,1,0
1/07/2023,Lesotho,Kedah,0,0,0
1/07/2023,Lesotho,Pulau Pinang,0,0,0
1/07/2023,Lesotho,Sarawak,0,0,0
1/07/2023,Lesotho,Selangor,8,3,5
1/07/2023,Lithuania,Johor,35,14,21
1/07/2023,Lithuania,Kedah,8,2,6
1/07/2023,Lithuania,Kelantan,1,0,1
1/07/2023,Lithuania,Pahang,0,0,0
1/07/2023,Lithuania,Perak,0,0,0
1/07/2023,Lithuania,Perlis,3,3,0
1/07/2023,Lithuania,Pulau Pinang,3,2,1
1/07/2023,Lithuania,Sabah,7,4,3
1/07/2023,Lithuania,Sarawak,1,1,0
1/07/2023,Lithuania,Selangor,238,113,125
1/07/2023,Lithuania,W.P. Labuan,0,0,0
1/07/2023,Luxembourg,Johor,10,4,6
1/07/2023,Luxembourg,Kedah,3,1,2
1/07/2023,Luxembourg,Kelantan,0,0,0
1/07/2023,Luxembourg,Perak,0,0,0
1/07/2023,Luxembourg,Perlis,0,0,0
1/07/2023,Luxembourg,Pulau Pinang,3,1,2
1/07/2023,Luxembourg,Sabah,4,2,2
1/07/2023,Luxembourg,Sarawak,2,2,0
1/07/2023,Luxembourg,Selangor,60,36,24
1/07/2023,Latvia,Johor,12,7,5
1/07/2023,Latvia,Kedah,3,1,2
1/07/2023,Latvia,Kelantan,0,0,0
1/07/2023,Latvia,Pahang,0,0,0
1/07/2023,Latvia,Perak,1,1,0
1/07/2023,Latvia,Perlis,0,0,0
1/07/2023,Latvia,Pulau Pinang,0,0,0
1/07/2023,Latvia,Sabah,1,0,1
1/07/2023,Latvia,Sarawak,1,0,1
1/07/2023,Latvia,Selangor,108,67,41
1/07/2023,Latvia,W.P. Labuan,0,0,0
1/07/2023,Macao,Johor,0,0,0
1/07/2023,Macao,Pahang,0,0,0
1/07/2023,Macao,Perak,4,3,1
1/07/2023,Macao,Selangor,0,0,0
1/07/2023,Macao,W.P. Labuan,0,0,0
1/07/2023,Morocco,Johor,75,43,32
1/07/2023,Morocco,Kedah,8,4,4
1/07/2023,Morocco,Kelantan,2,1,1
1/07/2023,Morocco,Melaka,0,0,0
1/07/2023,Morocco,Pahang,0,0,0
1/07/2023,Morocco,Perak,1,1,0
1/07/2023,Morocco,Perlis,3,2,1
1/07/2023,Morocco,Pulau Pinang,18,9,9
1/07/2023,Morocco,Sabah,2,2,0
1/07/2023,Morocco,Sarawak,8,6,2
1/07/2023,Morocco,Selangor,1180,590,590
1/07/2023,Morocco,W.P. Labuan,0,0,0
1/07/2023,Monaco,Johor,0,0,0
1/07/2023,Monaco,Kedah,0,0,0
1/07/2023,Monaco,Sabah,0,0,0
1/07/2023,Monaco,Selangor,3,0,3
1/07/2023,"Moldova, Republic of",Johor,3,2,1
1/07/2023,"Moldova, Republic of",Kedah,0,0,0
1/07/2023,"Moldova, Republic of",Kelantan,0,0,0
1/07/2023,"Moldova, Republic of",Negeri Sembilan,0,0,0
1/07/2023,"Moldova, Republic of",Perlis,1,1,0
1/07/2023,"Moldova, Republic of",Pulau Pinang,1,1,0
1/07/2023,"Moldova, Republic of",Sabah,0,0,0
1/07/2023,"Moldova, Republic of",Sarawak,1,0,1
1/07/2023,"Moldova, Republic of",Selangor,27,17,10
1/07/2023,Madagascar,Johor,14,6,8
1/07/2023,Madagascar,Kedah,0,0,0
1/07/2023,Madagascar,Perak,0,0,0
1/07/2023,Madagascar,Perlis,0,0,0
1/07/2023,Madagascar,Pulau Pinang,1,0,1
1/07/2023,Madagascar,Sabah,2,0,2
1/07/2023,Madagascar,Sarawak,0,0,0
1/07/2023,Madagascar,Selangor,105,47,58
1/07/2023,Maldives,Johor,714,355,359
1/07/2023,Maldives,Kedah,6,4,2
1/07/2023,Maldives,Kelantan,2,2,0
1/07/2023,Maldives,Perak,1,1,0
1/07/2023,Maldives,Perlis,2,2,0
1/07/2023,Maldives,Pulau Pinang,4,2,2
1/07/2023,Maldives,Sabah,6,3,3
1/07/2023,Maldives,Sarawak,4,2,2
1/07/2023,Maldives,Selangor,5552,2707,2845
1/07/2023,Mexico,Johor,222,101,121
1/07/2023,Mexico,Kedah,5,3,2
1/07/2023,Mexico,Kelantan,0,0,0
1/07/2023,Mexico,Pahang,3,2,1
1/07/2023,Mexico,Perak,1,0,1
1/07/2023,Mexico,Perlis,0,0,0
1/07/2023,Mexico,Pulau Pinang,49,20,29
1/07/2023,Mexico,Sabah,1,1,0
1/07/2023,Mexico,Sarawak,8,4,4
1/07/2023,Mexico,Selangor,862,451,411
1/07/2023,Mexico,W.P. Labuan,0,0,0
1/07/2023,Marshall Islands,Johor,1,1,0
1/07/2023,Marshall Islands,Kedah,0,0,0
1/07/2023,Marshall Islands,Perak,0,0,0
1/07/2023,Marshall Islands,Pulau Pinang,0,0,0
1/07/2023,Marshall Islands,Sabah,0,0,0
1/07/2023,Marshall Islands,Selangor,3,3,0
1/07/2023,North Macedonia,Johor,5,3,2
1/07/2023,North Macedonia,Kedah,2,1,1
1/07/2023,North Macedonia,Perak,0,0,0
1/07/2023,North Macedonia,Pulau Pinang,0,0,0
1/07/2023,North Macedonia,Sabah,0,0,0
1/07/2023,North Macedonia,Sarawak,1,0,1
1/07/2023,North Macedonia,Selangor,27,11,16
1/07/2023,Mali,Johor,5,5,0
1/07/2023,Mali,Sabah,0,0,0
1/07/2023,Mali,Selangor,15,11,4
1/07/2023,Malta,Johor,7,4,3
1/07/2023,Malta,Kedah,0,0,0
1/07/2023,Malta,Kelantan,0,0,0
1/07/2023,Malta,Perak,0,0,0
1/07/2023,Malta,Perlis,0,0,0
1/07/2023,Malta,Pulau Pinang,3,2,1
1/07/2023,Malta,Sabah,0,0,0
1/07/2023,Malta,Sarawak,0,0,0
1/07/2023,Malta,Selangor,66,36,30
1/07/2023,Malta,W.P. Labuan,0,0,0
1/07/2023,Myanmar,Johor,5534,1782,3752
1/07/2023,Myanmar,Kedah,60,10,50
1/07/2023,Myanmar,Kelantan,2,0,2
1/07/2023,Myanmar,Negeri Sembilan,0,0,0
1/07/2023,Myanmar,Pahang,2,0,2
1/07/2023,Myanmar,Perak,22,4,18
1/07/2023,Myanmar,Perlis,4,0,4
1/07/2023,Myanmar,Pulau Pinang,350,177,173
1/07/2023,Myanmar,Sabah,8,2,6
1/07/2023,Myanmar,Sarawak,93,44,49
1/07/2023,Myanmar,Selangor,7517,5327,2190
1/07/2023,Myanmar,Terengganu,0,0,0
1/07/2023,Myanmar,W.P. Labuan,1,0,1
1/07/2023,Montenegro,Johor,2,1,1
1/07/2023,Montenegro,Kedah,0,0,0
1/07/2023,Montenegro,Pulau Pinang,0,0,0
1/07/2023,Montenegro,Sabah,0,0,0
1/07/2023,Montenegro,Sarawak,0,0,0
1/07/2023,Montenegro,Selangor,12,12,0
1/07/2023,Mongolia,Johor,143,49,94
1/07/2023,Mongolia,Kedah,1,0,1
1/07/2023,Mongolia,Kelantan,2,1,1
1/07/2023,Mongolia,Perak,2,0,2
1/07/2023,Mongolia,Perlis,0,0,0
1/07/2023,Mongolia,Pulau Pinang,11,4,7
1/07/2023,Mongolia,Sabah,10,5,5
1/07/2023,Mongolia,Sarawak,0,0,0
1/07/2023,Mongolia,Selangor,361,150,211
1/07/2023,Northern Mariana Islands,Selangor,0,0,0
1/07/2023,Mozambique,Johor,0,0,0
1/07/2023,Mozambique,Kedah,0,0,0
1/07/2023,Mozambique,Perak,0,0,0
1/07/2023,Mozambique,Pulau Pinang,0,0,0
1/07/2023,Mozambique,Sabah,0,0,0
1/07/2023,Mozambique,Sarawak,0,0,0
1/07/2023,Mozambique,Selangor,25,12,13
1/07/2023,Mauritania,Johor,4,4,0
1/07/2023,Mauritania,Kedah,0,0,0
1/07/2023,Mauritania,Pulau Pinang,0,0,0
1/07/2023,Mauritania,Sabah,0,0,0
1/07/2023,Mauritania,Sarawak,0,0,0
1/07/2023,Mauritania,Selangor,18,13,5
1/07/2023,Mauritius,Johor,152,85,67
1/07/2023,Mauritius,Kedah,6,2,4
1/07/2023,Mauritius,Kelantan,0,0,0
1/07/2023,Mauritius,Pahang,0,0,0
1/07/2023,Mauritius,Perak,1,0,1
1/07/2023,Mauritius,Perlis,4,2,2
1/07/2023,Mauritius,Pulau Pinang,6,5,1
1/07/2023,Mauritius,Sabah,0,0,0
1/07/2023,Mauritius,Sarawak,0,0,0
1/07/2023,Mauritius,Selangor,1358,696,662
1/07/2023,Malawi,Johor,3,3,0
1/07/2023,Malawi,Pulau Pinang,0,0,0
1/07/2023,Malawi,Sabah,0,0,0
1/07/2023,Malawi,Sarawak,1,0,1
1/07/2023,Malawi,Selangor,11,4,7
1/07/2023,Mayotte,Selangor,0,0,0
1/07/2023,Namibia,Johor,20,14,6
1/07/2023,Namibia,Kedah,0,0,0
1/07/2023,Namibia,Perak,0,0,0
1/07/2023,Namibia,Perlis,0,0,0
1/07/2023,Namibia,Pulau Pinang,1,1,0
1/07/2023,Namibia,Sabah,0,0,0
1/07/2023,Namibia,Sarawak,0,0,0
1/07/2023,Namibia,Selangor,19,9,10
1/07/2023,New Caledonia,Selangor,0,0,0
1/07/2023,Niger,Johor,0,0,0
1/07/2023,Niger,Sabah,0,0,0
1/07/2023,Niger,Selangor,4,2,2
1/07/2023,Nigeria,Johor,34,32,2
1/07/2023,Nigeria,Kedah,1,1,0
1/07/2023,Nigeria,Perlis,0,0,0
1/07/2023,Nigeria,Pulau Pinang,3,2,1
1/07/2023,Nigeria,Sabah,1,1,0
1/07/2023,Nigeria,Sarawak,11,8,3
1/07/2023,Nigeria,Selangor,313,238,75
1/07/2023,Nicaragua,Johor,2,0,2
1/07/2023,Nicaragua,Kedah,0,0,0
1/07/2023,Nicaragua,Pulau Pinang,1,0,1
1/07/2023,Nicaragua,Sabah,1,1,0
1/07/2023,Nicaragua,Selangor,6,3,3
1/07/2023,Netherlands,Johor,1759,1022,737
1/07/2023,Netherlands,Kedah,339,174,165
1/07/2023,Netherlands,Kelantan,10,5,5
1/07/2023,Netherlands,Melaka,0,0,0
1/07/2023,Netherlands,Negeri Sembilan,1,0,1
1/07/2023,Netherlands,Pahang,1,1,0
1/07/2023,Netherlands,Perak,15,8,7
1/07/2023,Netherlands,Perlis,58,35,23
1/07/2023,Netherlands,Pulau Pinang,325,174,151
1/07/2023,Netherlands,Sabah,66,30,36
1/07/2023,Netherlands,Sarawak,182,104,78
1/07/2023,Netherlands,Selangor,9860,5216,4644
1/07/2023,Netherlands,Terengganu,0,0,0
1/07/2023,Netherlands,W.P. Labuan,3,2,1
1/07/2023,Norway,Johor,302,157,145
1/07/2023,Norway,Kedah,81,38,43
1/07/2023,Norway,Kelantan,0,0,0
1/07/2023,Norway,Melaka,0,0,0
1/07/2023,Norway,Pahang,0,0,0
1/07/2023,Norway,Perak,3,2,1
1/07/2023,Norway,Perlis,16,9,7
1/07/2023,Norway,Pulau Pinang,59,35,24
1/07/2023,Norway,Sabah,7,5,2
1/07/2023,Norway,Sarawak,26,19,7
1/07/2023,Norway,Selangor,1162,619,543
1/07/2023,Norway,W.P. Labuan,0,0,0
1/07/2023,Nepal,Johor,529,374,155
1/07/2023,Nepal,Kedah,23,8,15
1/07/2023,Nepal,Pahang,0,0,0
1/07/2023,Nepal,Perak,1,1,0
1/07/2023,Nepal,Perlis,4,3,1
1/07/2023,Nepal,Pulau Pinang,17,13,4
1/07/2023,Nepal,Sabah,5,4,1
1/07/2023,Nepal,Sarawak,232,159,73
1/07/2023,Nepal,Selangor,12190,11633,557
1/07/2023,Nepal,W.P. Labuan,24,23,1
1/07/2023,Nauru,Johor,2,0,2
1/07/2023,Nauru,Pulau Pinang,0,0,0
1/07/2023,Nauru,Selangor,0,0,0
1/07/2023,New Zealand,Johor,941,551,390
1/07/2023,New Zealand,Kedah,116,63,53
1/07/2023,New Zealand,Kelantan,8,5,3
1/07/2023,New Zealand,Melaka,0,0,0
1/07/2023,New Zealand,Negeri Sembilan,2,1,1
1/07/2023,New Zealand,Pahang,5,2,3
1/07/2023,New Zealand,Perak,39,20,19
1/07/2023,New Zealand,Perlis,16,8,8
1/07/2023,New Zealand,Pulau Pinang,340,180,160
1/07/2023,New Zealand,Sabah,68,36,32
1/07/2023,New Zealand,Sarawak,163,98,65
1/07/2023,New Zealand,Selangor,3921,2208,1713
1/07/2023,New Zealand,Terengganu,0,0,0
1/07/2023,New Zealand,W.P. Labuan,2,1,1
1/07/2023,Oman,Johor,245,101,144
1/07/2023,Oman,Kedah,24,15,9
1/07/2023,Oman,Kelantan,5,5,0
1/07/2023,Oman,Melaka,1,1,0
1/07/2023,Oman,Perak,3,2,1
1/07/2023,Oman,Perlis,5,5,0
1/07/2023,Oman,Pulau Pinang,107,57,50
1/07/2023,Oman,Sabah,0,0,0
1/07/2023,Oman,Sarawak,6,3,3
1/07/2023,Oman,Selangor,4665,2428,2237
1/07/2023,Pakistan,Johor,1236,847,389
1/07/2023,Pakistan,Kedah,230,114,116
1/07/2023,Pakistan,Kelantan,11,11,0
1/07/2023,Pakistan,Melaka,1,1,0
1/07/2023,Pakistan,Negeri Sembilan,0,0,0
1/07/2023,Pakistan,Pahang,1,1,0
1/07/2023,Pakistan,Perak,21,20,1
1/07/2023,Pakistan,Perlis,19,18,1
1/07/2023,Pakistan,Pulau Pinang,78,67,11
1/07/2023,Pakistan,Sabah,9,7,2
1/07/2023,Pakistan,Sarawak,127,102,25
1/07/2023,Pakistan,Selangor,10693,8441,2252
1/07/2023,Pakistan,W.P. Labuan,1,1,0
1/07/2023,Panama,Johor,4,1,3
1/07/2023,Panama,Kedah,0,0,0
1/07/2023,Panama,Perak,0,0,0
1/07/2023,Panama,Perlis,0,0,0
1/07/2023,Panama,Pulau Pinang,3,3,0
1/07/2023,Panama,Sabah,2,0,2
1/07/2023,Panama,Sarawak,0,0,0
1/07/2023,Panama,Selangor,46,23,23
1/07/2023,Peru,Johor,34,16,18
1/07/2023,Peru,Kedah,9,4,5
1/07/2023,Peru,Kelantan,0,0,0
1/07/2023,Peru,Pahang,0,0,0
1/07/2023,Peru,Perak,0,0,0
1/07/2023,Peru,Perlis,4,3,1
1/07/2023,Peru,Pulau Pinang,5,4,1
1/07/2023,Peru,Sabah,0,0,0
1/07/2023,Peru,Sarawak,0,0,0
1/07/2023,Peru,Selangor,144,79,65
1/07/2023,Peru,W.P. Labuan,0,0,0
1/07/2023,Philippines,Johor,26964,9160,17804
1/07/2023,Philippines,Kedah,492,157,335
1/07/2023,Philippines,Kelantan,21,13,8
1/07/2023,Philippines,Melaka,4,2,2
1/07/2023,Philippines,Negeri Sembilan,3,3,0
1/07/2023,Philippines,Pahang,23,19,4
1/07/2023,Philippines,Perak,69,17,52
1/07/2023,Philippines,Perlis,192,50,142
1/07/2023,Philippines,Pulau Pinang,716,285,431
1/07/2023,Philippines,Sabah,1015,471,544
1/07/2023,Philippines,Sarawak,2283,847,1436
1/07/2023,Philippines,Selangor,21286,8208,13078
1/07/2023,Philippines,Terengganu,0,0,0
1/07/2023,Philippines,W.P. Labuan,104,30,74
1/07/2023,Palau,Johor,0,0,0
1/07/2023,Palau,Pulau Pinang,0,0,0
1/07/2023,Palau,Selangor,3,1,2
1/07/2023,Papua New Guinea,Johor,26,18,8
1/07/2023,Papua New Guinea,Kedah,1,0,1
1/07/2023,Papua New Guinea,Kelantan,0,0,0
1/07/2023,Papua New Guinea,Perak,1,1,0
1/07/2023,Papua New Guinea,Pulau Pinang,1,0,1
1/07/2023,Papua New Guinea,Sabah,0,0,0
1/07/2023,Papua New Guinea,Sarawak,4,2,2
1/07/2023,Papua New Guinea,Selangor,68,44,24
1/07/2023,Poland,Johor,478,251,227
1/07/2023,Poland,Kedah,46,19,27
1/07/2023,Poland,Kelantan,1,1,0
1/07/2023,Poland,Melaka,0,0,0
1/07/2023,Poland,Negeri Sembilan,0,0,0
1/07/2023,Poland,Pahang,4,4,0
1/07/2023,Poland,Perak,6,3,3
1/07/2023,Poland,Perlis,13,7,6
1/07/2023,Poland,Pulau Pinang,60,30,30
1/07/2023,Poland,Sabah,35,16,19
1/07/2023,Poland,Sarawak,70,38,32
1/07/2023,Poland,Selangor,1349,700,649
1/07/2023,Poland,Terengganu,0,0,0
1/07/2023,Poland,W.P. Labuan,0,0,0
1/07/2023,"North Korea, Democratic People's Republic of",Selangor,0,0,0
1/07/2023,Portugal,Johor,222,131,91
1/07/2023,Portugal,Kedah,19,7,12
1/07/2023,Portugal,Kelantan,0,0,0
1/07/2023,Portugal,Melaka,0,0,0
1/07/2023,Portugal,Pahang,1,0,1
1/07/2023,Portugal,Perak,2,1,1
1/07/2023,Portugal,Perlis,6,3,3
1/07/2023,Portugal,Pulau Pinang,34,21,13
1/07/2023,Portugal,Sabah,15,11,4
1/07/2023,Portugal,Sarawak,9,5,4
1/07/2023,Portugal,Selangor,724,420,304
1/07/2023,Portugal,W.P. Labuan,0,0,0
1/07/2023,Paraguay,Johor,4,3,1
1/07/2023,Paraguay,Kedah,0,0,0
1/07/2023,Paraguay,Perak,0,0,0
1/07/2023,Paraguay,Perlis,0,0,0
1/07/2023,Paraguay,Pulau Pinang,1,0,1
1/07/2023,Paraguay,Sabah,0,0,0
1/07/2023,Paraguay,Sarawak,0,0,0
1/07/2023,Paraguay,Selangor,12,5,7
1/07/2023,"Palestine, State of",Johor,28,25,3
1/07/2023,"Palestine, State of",Kedah,1,1,0
1/07/2023,"Palestine, State of",Kelantan,0,0,0
1/07/2023,"Palestine, State of",Melaka,0,0,0
1/07/2023,"Palestine, State of",Perak,0,0,0
1/07/2023,"Palestine, State of",Perlis,0,0,0
1/07/2023,"Palestine, State of",Pulau Pinang,1,1,0
1/07/2023,"Palestine, State of",Sabah,0,0,0
1/07/2023,"Palestine, State of",Sarawak,0,0,0
1/07/2023,"Palestine, State of",Selangor,478,290,188
1/07/2023,Qatar,Johor,74,42,32
1/07/2023,Qatar,Kedah,8,5,3
1/07/2023,Qatar,Perlis,0,0,0
1/07/2023,Qatar,Pulau Pinang,13,2,11
1/07/2023,Qatar,Sabah,0,0,0
1/07/2023,Qatar,Sarawak,0,0,0
1/07/2023,Qatar,Selangor,747,386,361
1/07/2023,Réunion,Johor,0,0,0
1/07/2023,Réunion,Sarawak,0,0,0
1/07/2023,Romania,Johor,132,71,61
1/07/2023,Romania,Kedah,8,4,4
1/07/2023,Romania,Kelantan,1,0,1
1/07/2023,Romania,Negeri Sembilan,0,0,0
1/07/2023,Romania,Pahang,0,0,0
1/07/2023,Romania,Perak,0,0,0
1/07/2023,Romania,Perlis,0,0,0
1/07/2023,Romania,Pulau Pinang,20,9,11
1/07/2023,Romania,Sabah,2,1,1
1/07/2023,Romania,Sarawak,6,5,1
1/07/2023,Romania,Selangor,570,268,302
1/07/2023,Romania,W.P. Labuan,0,0,0
1/07/2023,Russian Federation (Russia),Johor,511,251,260
1/07/2023,Russian Federation (Russia),Kedah,352,189,163
1/07/2023,Russian Federation (Russia),Kelantan,31,21,10
1/07/2023,Russian Federation (Russia),Melaka,0,0,0
1/07/2023,Russian Federation (Russia),Negeri Sembilan,0,0,0
1/07/2023,Russian Federation (Russia),Pahang,5,2,3
1/07/2023,Russian Federation (Russia),Perak,8,3,5
1/07/2023,Russian Federation (Russia),Perlis,330,203,127
1/07/2023,Russian Federation (Russia),Pulau Pinang,124,67,57
1/07/2023,Russian Federation (Russia),Sabah,27,14,13
1/07/2023,Russian Federation (Russia),Sarawak,46,20,26
1/07/2023,Russian Federation (Russia),Selangor,7902,3979,3923
1/07/2023,Russian Federation (Russia),W.P. Labuan,9,4,5
1/07/2023,Rwanda,Johor,3,1,2
1/07/2023,Rwanda,Kedah,0,0,0
1/07/2023,Rwanda,Pulau Pinang,2,2,0
1/07/2023,Rwanda,Selangor,11,6,5
1/07/2023,Saudi Arabia,Johor,706,373,333
1/07/2023,Saudi Arabia,Kedah,241,126,115
1/07/2023,Saudi Arabia,Kelantan,28,14,14
1/07/2023,Saudi Arabia,Melaka,0,0,0
1/07/2023,Saudi Arabia,Perak,6,5,1
1/07/2023,Saudi Arabia,Perlis,24,12,12
1/07/2023,Saudi Arabia,Pulau Pinang,209,109,100
1/07/2023,Saudi Arabia,Sabah,2,1,1
1/07/2023,Saudi Arabia,Sarawak,19,13,6
1/07/2023,Saudi Arabia,Selangor,10164,5390,4774
1/07/2023,Saudi Arabia,W.P. Labuan,0,0,0
1/07/2023,Sudan,Johor,11,6,5
1/07/2023,Sudan,Kedah,0,0,0
1/07/2023,Sudan,Kelantan,0,0,0
1/07/2023,Sudan,Perlis,0,0,0
1/07/2023,Sudan,Pulau Pinang,0,0,0
1/07/2023,Sudan,Sabah,0,0,0
1/07/2023,Sudan,Sarawak,1,1,0
1/07/2023,Sudan,Selangor,1226,651,575
1/07/2023,Sudan,W.P. Labuan,0,0,0
1/07/2023,Senegal,Johor,7,5,2
1/07/2023,Senegal,Kedah,1,0,1
1/07/2023,Senegal,Kelantan,0,0,0
1/07/2023,Senegal,Perak,0,0,0
1/07/2023,Senegal,Perlis,0,0,0
1/07/2023,Senegal,Pulau Pinang,0,0,0
1/07/2023,Senegal,Sabah,1,1,0
1/07/2023,Senegal,Sarawak,0,0,0
1/07/2023,Senegal,Selangor,56,37,19
1/07/2023,Singapore,Johor,1217340,694189,523151
1/07/2023,Singapore,Kedah,4811,2470,2341
1/07/2023,Singapore,Kelantan,117,72,45
1/07/2023,Singapore,Melaka,6,5,1
1/07/2023,Singapore,Negeri Sembilan,2,0,2
1/07/2023,Singapore,Pahang,508,264,244
1/07/2023,Singapore,Perak,6463,2854,3609
1/07/2023,Singapore,Perlis,196,102,94
1/07/2023,Singapore,Pulau Pinang,19079,9039,10040
1/07/2023,Singapore,Sabah,1773,922,851
1/07/2023,Singapore,Sarawak,3348,1882,1466
1/07/2023,Singapore,Selangor,41414,21825,19589
1/07/2023,Singapore,Terengganu,0,0,0
1/07/2023,Singapore,W.P. Labuan,10,9,1
1/07/2023,South Georgia and the South Sandwich Islands,Johor,0,0,0
1/07/2023,South Georgia and the South Sandwich Islands,Sabah,0,0,0
1/07/2023,South Georgia and the South Sandwich Islands,Selangor,0,0,0
1/07/2023,Saint Helena,Sarawak,0,0,0
1/07/2023,Solomon Islands,Johor,0,0,0
1/07/2023,Solomon Islands,Perlis,0,0,0
1/07/2023,Solomon Islands,Pulau Pinang,0,0,0
1/07/2023,Solomon Islands,Sabah,0,0,0
1/07/2023,Solomon Islands,Sarawak,0,0,0
1/07/2023,Solomon Islands,Selangor,6,3,3
1/07/2023,Solomon Islands,W.P. Labuan,1,0,1
1/07/2023,Sierra Leone,Johor,2,2,0
1/07/2023,Sierra Leone,Kedah,0,0,0
1/07/2023,Sierra Leone,Perak,0,0,0
1/07/2023,Sierra Leone,Pulau Pinang,0,0,0
1/07/2023,Sierra Leone,Sabah,0,0,0
1/07/2023,Sierra Leone,Selangor,31,13,18
1/07/2023,El Salvador,Johor,1,0,1
1/07/2023,El Salvador,Kedah,0,0,0
1/07/2023,El Salvador,Perak,0,0,0
1/07/2023,El Salvador,Perlis,0,0,0
1/07/2023,El Salvador,Pulau Pinang,5,3,2
1/07/2023,El Salvador,Sabah,0,0,0
1/07/2023,El Salvador,Selangor,16,8,8
1/07/2023,El Salvador,W.P. Labuan,0,0,0
1/07/2023,San Marino,Johor,2,1,1
1/07/2023,San Marino,Selangor,2,2,0
1/07/2023,Somalia,Johor,0,0,0
1/07/2023,Somalia,Kedah,0,0,0
1/07/2023,Somalia,Kelantan,0,0,0
1/07/2023,Somalia,Perlis,0,0,0
1/07/2023,Somalia,Sabah,0,0,0
1/07/2023,Somalia,Sarawak,0,0,0
1/07/2023,Somalia,Selangor,181,108,73
1/07/2023,Serbia,Johor,9,3,6
1/07/2023,Serbia,Kedah,0,0,0
1/07/2023,Serbia,Kelantan,0,0,0
1/07/2023,Serbia,Pahang,0,0,0
1/07/2023,Serbia,Perak,0,0,0
1/07/2023,Serbia,Perlis,0,0,0
1/07/2023,Serbia,Pulau Pinang,1,1,0
1/07/2023,Serbia,Sabah,0,0,0
1/07/2023,Serbia,Sarawak,0,0,0
1/07/2023,Serbia,Selangor,75,43,32
1/07/2023,South Sudan,Johor,0,0,0
1/07/2023,South Sudan,Kedah,0,0,0
1/07/2023,South Sudan,Sarawak,2,2,0
1/07/2023,South Sudan,Selangor,26,13,13
1/07/2023,South Sudan,W.P. Labuan,0,0,0
1/07/2023,Sao Tome and Principe,Selangor,1,1,0
1/07/2023,Suriname,Johor,4,2,2
1/07/2023,Suriname,Kedah,0,0,0
1/07/2023,Suriname,Kelantan,0,0,0
1/07/2023,Suriname,Perak,1,1,0
1/07/2023,Suriname,Perlis,0,0,0
1/07/2023,Suriname,Pulau Pinang,1,1,0
1/07/2023,Suriname,Sabah,1,0,1
1/07/2023,Suriname,Sarawak,0,0,0
1/07/2023,Suriname,Selangor,21,16,5
1/07/2023,Slovakia,Johor,50,25,25
1/07/2023,Slovakia,Kedah,55,29,26
1/07/2023,Slovakia,Kelantan,2,2,0
1/07/2023,Slovakia,Negeri Sembilan,1,1,0
1/07/2023,Slovakia,Pahang,0,0,0
1/07/2023,Slovakia,Perak,0,0,0
1/07/2023,Slovakia,Perlis,1,1,0
1/07/2023,Slovakia,Pulau Pinang,13,10,3
1/07/2023,Slovakia,Sabah,0,0,0
1/07/2023,Slovakia,Sarawak,3,1,2
1/07/2023,Slovakia,Selangor,323,168,155
1/07/2023,Slovakia,W.P. Labuan,9,4,5
1/07/2023,Slovenia,Johor,25,13,12
1/07/2023,Slovenia,Kedah,10,4,6
1/07/2023,Slovenia,Kelantan,0,0,0
1/07/2023,Slovenia,Perak,1,1,0
1/07/2023,Slovenia,Perlis,0,0,0
1/07/2023,Slovenia,Pulau Pinang,1,0,1
1/07/2023,Slovenia,Sabah,12,7,5
1/07/2023,Slovenia,Sarawak,1,1,0
1/07/2023,Slovenia,Selangor,193,95,98
1/07/2023,Slovenia,W.P. Labuan,0,0,0
1/07/2023,Sweden,Johor,270,154,116
1/07/2023,Sweden,Kedah,42,26,16
1/07/2023,Sweden,Kelantan,29,22,7
1/07/2023,Sweden,Melaka,0,0,0
1/07/2023,Sweden,Negeri Sembilan,0,0,0
1/07/2023,Sweden,Pahang,0,0,0
1/07/2023,Sweden,Perak,11,7,4
1/07/2023,Sweden,Perlis,7,1,6
1/07/2023,Sweden,Pulau Pinang,57,36,21
1/07/2023,Sweden,Sabah,8,4,4
1/07/2023,Sweden,Sarawak,19,11,8
1/07/2023,Sweden,Selangor,1048,639,409
1/07/2023,Sweden,W.P. Labuan,1,1,0
1/07/2023,Eswatini,Johor,6,0,6
1/07/2023,Eswatini,Kedah,0,0,0
1/07/2023,Eswatini,Pulau Pinang,0,0,0
1/07/2023,Eswatini,Sabah,0,0,0
1/07/2023,Eswatini,Selangor,26,14,12
1/07/2023,Seychelles,Johor,10,4,6
1/07/2023,Seychelles,Kedah,0,0,0
1/07/2023,Seychelles,Pulau Pinang,1,1,0
1/07/2023,Seychelles,Sabah,0,0,0
1/07/2023,Seychelles,Sarawak,0,0,0
1/07/2023,Seychelles,Selangor,43,15,28
1/07/2023,Syrian Arab Republic,Johor,7,5,2
1/07/2023,Syrian Arab Republic,Kedah,2,2,0
1/07/2023,Syrian Arab Republic,Kelantan,0,0,0
1/07/2023,Syrian Arab Republic,Pahang,0,0,0
1/07/2023,Syrian Arab Republic,Perlis,1,1,0
1/07/2023,Syrian Arab Republic,Pulau Pinang,2,2,0
1/07/2023,Syrian Arab Republic,Sabah,0,0,0
1/07/2023,Syrian Arab Republic,Sarawak,1,1,0
1/07/2023,Syrian Arab Republic,Selangor,821,482,339
1/07/2023,Syrian Arab Republic,W.P. Labuan,0,0,0
1/07/2023,Turks and Caicos Islands,Perlis,0,0,0
1/07/2023,TCD,Johor,14,12,2
1/07/2023,TCD,Kedah,0,0,0
1/07/2023,TCD,Perlis,0,0,0
1/07/2023,TCD,Selangor,20,13,7
1/07/2023,Togo,Johor,0,0,0
1/07/2023,Togo,Perak,0,0,0
1/07/2023,Togo,Pulau Pinang,0,0,0
1/07/2023,Togo,Selangor,12,8,4
1/07/2023,Thailand,Johor,6728,1755,4973
1/07/2023,Thailand,Kedah,62029,36453,25576
1/07/2023,Thailand,Kelantan,48622,26002,22620
1/07/2023,Thailand,Melaka,1,1,0
1/07/2023,Thailand,Negeri Sembilan,1,1,0
1/07/2023,Thailand,Pahang,16,13,3
1/07/2023,Thailand,Perak,12551,5742,6809
1/07/2023,Thailand,Perlis,60902,36177,24725
1/07/2023,Thailand,Pulau Pinang,2341,933,1408
1/07/2023,Thailand,Sabah,35,22,13
1/07/2023,Thailand,Sarawak,358,145,213
1/07/2023,Thailand,Selangor,17209,6989,10220
1/07/2023,Thailand,Terengganu,0,0,0
1/07/2023,Thailand,W.P. Labuan,3,0,3
1/07/2023,Tajikistan,Johor,7,5,2
1/07/2023,Tajikistan,Kedah,1,0,1
1/07/2023,Tajikistan,Perlis,2,2,0
1/07/2023,Tajikistan,Pulau Pinang,0,0,0
1/07/2023,Tajikistan,Sabah,1,1,0
1/07/2023,Tajikistan,Selangor,128,86,42
1/07/2023,Tokelau,Selangor,0,0,0
1/07/2023,Turkmenistan,Johor,1,1,0
1/07/2023,Turkmenistan,Kedah,2,2,0
1/07/2023,Turkmenistan,Kelantan,0,0,0
1/07/2023,Turkmenistan,Perlis,0,0,0
1/07/2023,Turkmenistan,Pulau Pinang,0,0,0
1/07/2023,Turkmenistan,Sabah,2,0,2
1/07/2023,Turkmenistan,Sarawak,2,2,0
1/07/2023,Turkmenistan,Selangor,142,83,59
1/07/2023,Timor-Leste,Johor,9,3,6
1/07/2023,Timor-Leste,Kedah,3,1,2
1/07/2023,Timor-Leste,Perlis,1,1,0
1/07/2023,Timor-Leste,Pulau Pinang,7,1,6
1/07/2023,Timor-Leste,Sabah,0,0,0
1/07/2023,Timor-Leste,Sarawak,3,1,2
1/07/2023,Timor-Leste,Selangor,255,154,101
1/07/2023,Tonga,Johor,0,0,0
1/07/2023,Tonga,Pulau Pinang,1,0,1
1/07/2023,Tonga,Sarawak,0,0,0
1/07/2023,Tonga,Selangor,9,7,2
1/07/2023,Trinidad and Tobago,Johor,9,5,4
1/07/2023,Trinidad and Tobago,Kedah,0,0,0
1/07/2023,Trinidad and Tobago,Pahang,2,1,1
1/07/2023,Trinidad and Tobago,Pulau Pinang,3,1,2
1/07/2023,Trinidad and Tobago,Sabah,1,0,1
1/07/2023,Trinidad and Tobago,Sarawak,5,3,2
1/07/2023,Trinidad and Tobago,Selangor,56,28,28
1/07/2023,Tunisia,Johor,12,9,3
1/07/2023,Tunisia,Kedah,5,4,1
1/07/2023,Tunisia,Kelantan,0,0,0
1/07/2023,Tunisia,Melaka,0,0,0
1/07/2023,Tunisia,Perak,0,0,0
1/07/2023,Tunisia,Perlis,0,0,0
1/07/2023,Tunisia,Pulau Pinang,7,3,4
1/07/2023,Tunisia,Sabah,0,0,0
1/07/2023,Tunisia,Sarawak,0,0,0
1/07/2023,Tunisia,Selangor,1070,511,559
1/07/2023,Tunisia,W.P. Labuan,0,0,0
1/07/2023,Türkiye,Johor,312,210,102
1/07/2023,Türkiye,Kedah,51,31,20
1/07/2023,Türkiye,Kelantan,6,5,1
1/07/2023,Türkiye,Melaka,1,1,0
1/07/2023,Türkiye,Negeri Sembilan,0,0,0
1/07/2023,Türkiye,Pahang,1,1,0
1/07/2023,Türkiye,Perak,2,2,0
1/07/2023,Türkiye,Perlis,19,16,3
1/07/2023,Türkiye,Pulau Pinang,47,33,14
1/07/2023,Türkiye,Sabah,4,3,1
1/07/2023,Türkiye,Sarawak,21,19,2
1/07/2023,Türkiye,Selangor,1401,914,487
1/07/2023,Türkiye,W.P. Labuan,0,0,0
1/07/2023,Tuvalu,Selangor,0,0,0
1/07/2023,"Taiwan, Province of China",Johor,9966,4342,5624
1/07/2023,"Taiwan, Province of China",Kedah,253,124,129
1/07/2023,"Taiwan, Province of China",Kelantan,0,0,0
1/07/2023,"Taiwan, Province of China",Melaka,4,2,2
1/07/2023,"Taiwan, Province of China",Negeri Sembilan,0,0,0
1/07/2023,"Taiwan, Province of China",Pahang,5,4,1
1/07/2023,"Taiwan, Province of China",Perak,98,52,46
1/07/2023,"Taiwan, Province of China",Perlis,19,7,12
1/07/2023,"Taiwan, Province of China",Pulau Pinang,4955,2365,2590
1/07/2023,"Taiwan, Province of China",Sabah,1614,781,833
1/07/2023,"Taiwan, Province of China",Sarawak,343,147,196
1/07/2023,"Taiwan, Province of China",Selangor,21828,10362,11466
1/07/2023,"Taiwan, Province of China",W.P. Labuan,8,4,4
1/07/2023,"Tanzania, United Republic of",Johor,40,24,16
1/07/2023,"Tanzania, United Republic of",Kedah,2,1,1
1/07/2023,"Tanzania, United Republic of",Perak,0,0,0
1/07/2023,"Tanzania, United Republic of",Perlis,0,0,0
1/07/2023,"Tanzania, United Republic of",Pulau Pinang,0,0,0
1/07/2023,"Tanzania, United Republic of",Sabah,0,0,0
1/07/2023,"Tanzania, United Republic of",Sarawak,4,4,0
1/07/2023,"Tanzania, United Republic of",Selangor,209,103,106
1/07/2023,Uganda,Johor,12,5,7
1/07/2023,Uganda,Kedah,3,1,2
1/07/2023,Uganda,Perak,0,0,0
1/07/2023,Uganda,Perlis,0,0,0
1/07/2023,Uganda,Pulau Pinang,2,1,1
1/07/2023,Uganda,Sabah,0,0,0
1/07/2023,Uganda,Sarawak,0,0,0
1/07/2023,Uganda,Selangor,134,70,64
1/07/2023,Ukraine,Johor,121,73,48
1/07/2023,Ukraine,Kedah,15,7,8
1/07/2023,Ukraine,Kelantan,2,1,1
1/07/2023,Ukraine,Melaka,0,0,0
1/07/2023,Ukraine,Negeri Sembilan,0,0,0
1/07/2023,Ukraine,Pahang,2,2,0
1/07/2023,Ukraine,Perak,0,0,0
1/07/2023,Ukraine,Perlis,1,0,1
1/07/2023,Ukraine,Pulau Pinang,29,16,13
1/07/2023,Ukraine,Sabah,4,2,2
1/07/2023,Ukraine,Sarawak,1,0,1
1/07/2023,Ukraine,Selangor,841,438,403
1/07/2023,Ukraine,W.P. Labuan,0,0,0
1/07/2023,Uruguay,Johor,4,0,4
1/07/2023,Uruguay,Kedah,1,1,0
1/07/2023,Uruguay,Kelantan,0,0,0
1/07/2023,Uruguay,Perak,0,0,0
1/07/2023,Uruguay,Perlis,0,0,0
1/07/2023,Uruguay,Pulau Pinang,2,0,2
1/07/2023,Uruguay,Sabah,0,0,0
1/07/2023,Uruguay,Sarawak,4,1,3
1/07/2023,Uruguay,Selangor,34,20,14
1/07/2023,Uruguay,W.P. Labuan,4,2,2
1/07/2023,United States of America,Johor,5734,3183,2551
1/07/2023,United States of America,Kedah,511,269,242
1/07/2023,United States of America,Kelantan,12,7,5
1/07/2023,United States of America,Melaka,1,1,0
1/07/2023,United States of America,Negeri Sembilan,0,0,0
1/07/2023,United States of America,Pahang,11,8,3
1/07/2023,United States of America,Perak,195,90,105
1/07/2023,United States of America,Perlis,145,91,54
1/07/2023,United States of America,Pulau Pinang,2791,1564,1227
1/07/2023,United States of America,Sabah,243,132,111
1/07/2023,United States of America,Sarawak,304,176,128
1/07/2023,United States of America,Selangor,18311,10343,7968
1/07/2023,United States of America,Terengganu,0,0,0
1/07/2023,United States of America,W.P. Labuan,5,1,4
1/07/2023,Uzbekistan,Johor,101,79,22
1/07/2023,Uzbekistan,Kedah,9,5,4
1/07/2023,Uzbekistan,Kelantan,1,1,0
1/07/2023,Uzbekistan,Perak,0,0,0
1/07/2023,Uzbekistan,Perlis,1,1,0
1/07/2023,Uzbekistan,Pulau Pinang,8,2,6
1/07/2023,Uzbekistan,Sabah,5,5,0
1/07/2023,Uzbekistan,Sarawak,4,2,2
1/07/2023,Uzbekistan,Selangor,1554,915,639
1/07/2023,Holy See,Johor,0,0,0
1/07/2023,Holy See,Sarawak,0,0,0
1/07/2023,Holy See,Selangor,0,0,0
1/07/2023,Saint Vincent and the Grenadines,Johor,1,0,1
1/07/2023,Saint Vincent and the Grenadines,Kedah,0,0,0
1/07/2023,Saint Vincent and the Grenadines,Pulau Pinang,0,0,0
1/07/2023,Saint Vincent and the Grenadines,Sarawak,0,0,0
1/07/2023,Saint Vincent and the Grenadines,Selangor,4,0,4
1/07/2023,"Venezuela, Bolivarian Republic of",Johor,20,9,11
1/07/2023,"Venezuela, Bolivarian Republic of",Kedah,3,1,2
1/07/2023,"Venezuela, Bolivarian Republic of",Kelantan,0,0,0
1/07/2023,"Venezuela, Bolivarian Republic of",Melaka,0,0,0
1/07/2023,"Venezuela, Bolivarian Republic of",Perak,0,0,0
1/07/2023,"Venezuela, Bolivarian Republic of",Perlis,0,0,0
1/07/2023,"Venezuela, Bolivarian Republic of",Pulau Pinang,1,1,0
1/07/2023,"Venezuela, Bolivarian Republic of",Sabah,2,1,1
1/07/2023,"Venezuela, Bolivarian Republic of",Sarawak,1,1,0
1/07/2023,"Venezuela, Bolivarian Republic of",Selangor,108,58,50
1/07/2023,"Venezuela, Bolivarian Republic of",W.P. Labuan,0,0,0
1/07/2023,Viet Nam,Johor,25253,9424,15829
1/07/2023,Viet Nam,Kedah,318,67,251
1/07/2023,Viet Nam,Kelantan,13,5,8
1/07/2023,Viet Nam,Melaka,3,0,3
1/07/2023,Viet Nam,Negeri Sembilan,0,0,0
1/07/2023,Viet Nam,Pahang,1,0,1
1/07/2023,Viet Nam,Perak,199,13,186
1/07/2023,Viet Nam,Perlis,233,23,210
1/07/2023,Viet Nam,Pulau Pinang,1975,632,1343
1/07/2023,Viet Nam,Sabah,15,6,9
1/07/2023,Viet Nam,Sarawak,197,45,152
1/07/2023,Viet Nam,Selangor,21579,8159,13420
1/07/2023,Viet Nam,Terengganu,0,0,0
1/07/2023,Viet Nam,W.P. Labuan,6,2,4
1/07/2023,Vanuatu,Johor,38,30,8
1/07/2023,Vanuatu,Kedah,0,0,0
1/07/2023,Vanuatu,Pulau Pinang,4,3,1
1/07/2023,Vanuatu,Sabah,0,0,0
1/07/2023,Vanuatu,Sarawak,1,0,1
1/07/2023,Vanuatu,Selangor,59,46,13
1/07/2023, Samoa,Johor,3,3,0
1/07/2023, Samoa,Sarawak,0,0,0
1/07/2023, Samoa,Selangor,6,0,6
1/07/2023,Yemen,Johor,37,22,15
1/07/2023,Yemen,Kedah,2,1,1
1/07/2023,Yemen,Kelantan,1,1,0
1/07/2023,Yemen,Melaka,0,0,0
1/07/2023,Yemen,Pahang,0,0,0
1/07/2023,Yemen,Perak,0,0,0
1/07/2023,Yemen,Perlis,2,2,0
1/07/2023,Yemen,Pulau Pinang,1,1,0
1/07/2023,Yemen,Sabah,0,0,0
1/07/2023,Yemen,Sarawak,2,0,2
1/07/2023,Yemen,Selangor,1570,991,579
1/07/2023,Yemen,W.P. Labuan,0,0,0
1/07/2023,South Africa,Johor,317,172,145
1/07/2023,South Africa,Kedah,36,19,17
1/07/2023,South Africa,Kelantan,0,0,0
1/07/2023,South Africa,Melaka,0,0,0
1/07/2023,South Africa,Pahang,3,2,1
1/07/2023,South Africa,Perak,2,2,0
1/07/2023,South Africa,Perlis,17,14,3
1/07/2023,South Africa,Pulau Pinang,67,32,35
1/07/2023,South Africa,Sabah,15,8,7
1/07/2023,South Africa,Sarawak,80,42,38
1/07/2023,South Africa,Selangor,1235,706,529
1/07/2023,South Africa,Terengganu,0,0,0
1/07/2023,South Africa,W.P. Labuan,1,1,0
1/07/2023,ZAR,Selangor,1,1,0
1/07/2023,Zambia,Johor,3,2,1
1/07/2023,Zambia,Kedah,5,3,2
1/07/2023,Zambia,Perak,0,0,0
1/07/2023,Zambia,Perlis,0,0,0
1/07/2023,Zambia,Pulau Pinang,0,0,0
1/07/2023,Zambia,Sabah,0,0,0
1/07/2023,Zambia,Sarawak,0,0,0
1/07/2023,Zambia,Selangor,51,28,23
1/07/2023,Zimbabwe,Johor,17,7,10
1/07/2023,Zimbabwe,Kedah,3,2,1
1/07/2023,Zimbabwe,Kelantan,0,0,0
1/07/2023,Zimbabwe,Perak,0,0,0
1/07/2023,Zimbabwe,Perlis,0,0,0
1/07/2023,Zimbabwe,Pulau Pinang,0,0,0
1/07/2023,Zimbabwe,Sabah,1,1,0
1/07/2023,Zimbabwe,Sarawak,1,1,0
1/07/2023,Zimbabwe,Selangor,209,88,121
1/08/2023,Aruba,Kedah,0,0,0
1/08/2023,Aruba,Pulau Pinang,0,0,0
1/08/2023,Afghanistan,Johor,0,0,0
1/08/2023,Afghanistan,Kedah,0,0,0
1/08/2023,Afghanistan,Perlis,0,0,0
1/08/2023,Afghanistan,Pulau Pinang,0,0,0
1/08/2023,Afghanistan,Sarawak,1,1,0
1/08/2023,Afghanistan,Selangor,93,62,31
1/08/2023,Angola,Johor,0,0,0
1/08/2023,Angola,Kedah,0,0,0
1/08/2023,Angola,Sabah,0,0,0
1/08/2023,Angola,Selangor,4,3,1
1/08/2023,Anguilla,Selangor,0,0,0
1/08/2023,Albania,Johor,18,14,4
1/08/2023,Albania,Kedah,0,0,0
1/08/2023,Albania,Perak,1,1,0
1/08/2023,Albania,Perlis,0,0,0
1/08/2023,Albania,Pulau Pinang,0,0,0
1/08/2023,Albania,Sabah,0,0,0
1/08/2023,Albania,Sarawak,0,0,0
1/08/2023,Albania,Selangor,49,27,22
1/08/2023,Andorra,Johor,1,0,1
1/08/2023,Andorra,Kedah,1,0,1
1/08/2023,Andorra,Perlis,0,0,0
1/08/2023,Andorra,Pulau Pinang,1,1,0
1/08/2023,Andorra,Selangor,14,7,7
1/08/2023,Antigua and Barbuda,Selangor,0,0,0
1/08/2023,United Arab Emirates,Johor,73,34,39
1/08/2023,United Arab Emirates,Kedah,21,10,11
1/08/2023,United Arab Emirates,Kelantan,0,0,0
1/08/2023,United Arab Emirates,Perak,0,0,0
1/08/2023,United Arab Emirates,Perlis,0,0,0
1/08/2023,United Arab Emirates,Pulau Pinang,16,6,10
1/08/2023,United Arab Emirates,Sabah,0,0,0
1/08/2023,United Arab Emirates,Sarawak,0,0,0
1/08/2023,United Arab Emirates,Selangor,1408,741,667
1/08/2023,Argentina,Johor,98,59,39
1/08/2023,Argentina,Kedah,14,8,6
1/08/2023,Argentina,Kelantan,0,0,0
1/08/2023,Argentina,Melaka,0,0,0
1/08/2023,Argentina,Perak,2,1,1
1/08/2023,Argentina,Perlis,3,0,3
1/08/2023,Argentina,Pulau Pinang,12,9,3
1/08/2023,Argentina,Sabah,0,0,0
1/08/2023,Argentina,Sarawak,2,2,0
1/08/2023,Argentina,Selangor,353,177,176
1/08/2023,Argentina,W.P. Labuan,0,0,0
1/08/2023,Armenia,Johor,1,0,1
1/08/2023,Armenia,Kedah,1,1,0
1/08/2023,Armenia,Kelantan,0,0,0
1/08/2023,Armenia,Perak,0,0,0
1/08/2023,Armenia,Perlis,0,0,0
1/08/2023,Armenia,Pulau Pinang,3,1,2
1/08/2023,Armenia,Sabah,0,0,0
1/08/2023,Armenia,Sarawak,0,0,0
1/08/2023,Armenia,Selangor,49,25,24
1/08/2023,Antarctica,Selangor,0,0,0
1/08/2023,Antigua and Barbuda,Johor,12,7,5
1/08/2023,Antigua and Barbuda,Kedah,0,0,0
1/08/2023,Antigua and Barbuda,Pulau Pinang,0,0,0
1/08/2023,Antigua and Barbuda,Sarawak,0,0,0
1/08/2023,Antigua and Barbuda,Selangor,26,14,12
1/08/2023,Australia,Johor,4669,2730,1939
1/08/2023,Australia,Kedah,454,247,207
1/08/2023,Australia,Kelantan,6,3,3
1/08/2023,Australia,Melaka,1,1,0
1/08/2023,Australia,Negeri Sembilan,1,1,0
1/08/2023,Australia,Pahang,19,13,6
1/08/2023,Australia,Perak,205,105,100
1/08/2023,Australia,Perlis,183,143,40
1/08/2023,Australia,Pulau Pinang,1896,1014,882
1/08/2023,Australia,Sabah,50,30,20
1/08/2023,Australia,Sarawak,452,278,174
1/08/2023,Australia,Selangor,20995,12471,8524
1/08/2023,Australia,Terengganu,0,0,0
1/08/2023,Australia,W.P. Labuan,9,6,3
1/08/2023,Austria,Johor,288,185,103
1/08/2023,Austria,Kedah,56,32,24
1/08/2023,Austria,Kelantan,2,2,0
1/08/2023,Austria,Melaka,0,0,0
1/08/2023,Austria,Negeri Sembilan,0,0,0
1/08/2023,Austria,Pahang,1,1,0
1/08/2023,Austria,Perak,4,3,1
1/08/2023,Austria,Perlis,23,9,14
1/08/2023,Austria,Pulau Pinang,80,53,27
1/08/2023,Austria,Sabah,5,3,2
1/08/2023,Austria,Sarawak,20,10,10
1/08/2023,Austria,Selangor,1087,649,438
1/08/2023,Austria,Terengganu,0,0,0
1/08/2023,Austria,W.P. Labuan,1,1,0
1/08/2023,Azerbaijan,Johor,3,0,3
1/08/2023,Azerbaijan,Kedah,3,2,1
1/08/2023,Azerbaijan,Kelantan,1,1,0
1/08/2023,Azerbaijan,Melaka,0,0,0
1/08/2023,Azerbaijan,Perlis,0,0,0
1/08/2023,Azerbaijan,Pulau Pinang,0,0,0
1/08/2023,Azerbaijan,Sabah,0,0,0
1/08/2023,Azerbaijan,Sarawak,2,1,1
1/08/2023,Azerbaijan,Selangor,130,70,60
1/08/2023,Azerbaijan,W.P. Labuan,0,0,0
1/08/2023,Burundi,Pulau Pinang,0,0,0
1/08/2023,Burundi,Sarawak,0,0,0
1/08/2023,Burundi,Selangor,3,1,2
1/08/2023,Belgium,Johor,350,193,157
1/08/2023,Belgium,Kedah,44,19,25
1/08/2023,Belgium,Kelantan,2,1,1
1/08/2023,Belgium,Melaka,0,0,0
1/08/2023,Belgium,Negeri Sembilan,0,0,0
1/08/2023,Belgium,Pahang,1,1,0
1/08/2023,Belgium,Perak,10,1,9
1/08/2023,Belgium,Perlis,19,13,6
1/08/2023,Belgium,Pulau Pinang,79,55,24
1/08/2023,Belgium,Sabah,10,5,5
1/08/2023,Belgium,Sarawak,35,19,16
1/08/2023,Belgium,Selangor,1787,961,826
1/08/2023,Belgium,W.P. Labuan,0,0,0
1/08/2023,Benin,Johor,0,0,0
1/08/2023,Benin,Kedah,0,0,0
1/08/2023,Benin,Perak,0,0,0
1/08/2023,Benin,Pulau Pinang,1,1,0
1/08/2023,Benin,Sabah,0,0,0
1/08/2023,Benin,Sarawak,0,0,0
1/08/2023,Benin,Selangor,7,6,1
1/08/2023,Burkina Faso,Perak,0,0,0
1/08/2023,Burkina Faso,Pulau Pinang,0,0,0
1/08/2023,Burkina Faso,Selangor,8,7,1
1/08/2023,Bangladesh,Johor,3822,3262,560
1/08/2023,Bangladesh,Kedah,108,70,38
1/08/2023,Bangladesh,Kelantan,8,8,0
1/08/2023,Bangladesh,Melaka,0,0,0
1/08/2023,Bangladesh,Negeri Sembilan,0,0,0
1/08/2023,Bangladesh,Pahang,0,0,0
1/08/2023,Bangladesh,Perak,4,3,1
1/08/2023,Bangladesh,Perlis,3,3,0
1/08/2023,Bangladesh,Pulau Pinang,688,646,42
1/08/2023,Bangladesh,Sabah,0,0,0
1/08/2023,Bangladesh,Sarawak,61,51,10
1/08/2023,Bangladesh,Selangor,70816,68473,2343
1/08/2023,Bangladesh,W.P. Labuan,4,4,0
1/08/2023,Bulgaria,Johor,42,24,18
1/08/2023,Bulgaria,Kedah,8,4,4
1/08/2023,Bulgaria,Kelantan,0,0,0
1/08/2023,Bulgaria,Pahang,0,0,0
1/08/2023,Bulgaria,Perak,0,0,0
1/08/2023,Bulgaria,Perlis,0,0,0
1/08/2023,Bulgaria,Pulau Pinang,6,3,3
1/08/2023,Bulgaria,Sabah,0,0,0
1/08/2023,Bulgaria,Sarawak,0,0,0
1/08/2023,Bulgaria,Selangor,193,105,88
1/08/2023,Bulgaria,W.P. Labuan,0,0,0
1/08/2023,Bahrain,Johor,52,17,35
1/08/2023,Bahrain,Kedah,3,2,1
1/08/2023,Bahrain,Kelantan,0,0,0
1/08/2023,Bahrain,Perlis,1,1,0
1/08/2023,Bahrain,Pulau Pinang,9,5,4
1/08/2023,Bahrain,Sabah,0,0,0
1/08/2023,Bahrain,Sarawak,1,1,0
1/08/2023,Bahrain,Selangor,542,273,269
1/08/2023,Bahamas,Johor,1,1,0
1/08/2023,Bahamas,Kedah,0,0,0
1/08/2023,Bahamas,Perak,0,0,0
1/08/2023,Bahamas,Sabah,0,0,0
1/08/2023,Bahamas,Sarawak,0,0,0
1/08/2023,Bahamas,Selangor,2,0,2
1/08/2023,Bosnia and Herzegovina,Johor,4,2,2
1/08/2023,Bosnia and Herzegovina,Kedah,1,0,1
1/08/2023,Bosnia and Herzegovina,Perlis,0,0,0
1/08/2023,Bosnia and Herzegovina,Pulau Pinang,0,0,0
1/08/2023,Bosnia and Herzegovina,Sabah,0,0,0
1/08/2023,Bosnia and Herzegovina,Sarawak,1,1,0
1/08/2023,Bosnia and Herzegovina,Selangor,46,30,16
1/08/2023,Belarus,Johor,22,10,12
1/08/2023,Belarus,Kedah,8,5,3
1/08/2023,Belarus,Kelantan,1,0,1
1/08/2023,Belarus,Pahang,0,0,0
1/08/2023,Belarus,Perak,0,0,0
1/08/2023,Belarus,Perlis,0,0,0
1/08/2023,Belarus,Pulau Pinang,5,2,3
1/08/2023,Belarus,Sabah,0,0,0
1/08/2023,Belarus,Sarawak,3,1,2
1/08/2023,Belarus,Selangor,243,109,134
1/08/2023,Belarus,W.P. Labuan,0,0,0
1/08/2023,Belize,Johor,1,0,1
1/08/2023,Belize,Pulau Pinang,0,0,0
1/08/2023,Belize,Sarawak,0,0,0
1/08/2023,Belize,Selangor,14,8,6
1/08/2023,Bermuda,Selangor,1,0,1
1/08/2023,Bolivia,Johor,13,6,7
1/08/2023,Bolivia,Kedah,2,0,2
1/08/2023,Bolivia,Melaka,0,0,0
1/08/2023,Bolivia,Perak,0,0,0
1/08/2023,Bolivia,Perlis,0,0,0
1/08/2023,Bolivia,Pulau Pinang,0,0,0
1/08/2023,Bolivia,Sabah,0,0,0
1/08/2023,Bolivia,Sarawak,1,1,0
1/08/2023,Bolivia,Selangor,24,12,12
1/08/2023,Brazil,Johor,308,177,131
1/08/2023,Brazil,Kedah,35,18,17
1/08/2023,Brazil,Kelantan,0,0,0
1/08/2023,Brazil,Melaka,2,2,0
1/08/2023,Brazil,Pahang,0,0,0
1/08/2023,Brazil,Perak,2,1,1
1/08/2023,Brazil,Perlis,5,1,4
1/08/2023,Brazil,Pulau Pinang,24,15,9
1/08/2023,Brazil,Sabah,4,3,1
1/08/2023,Brazil,Sarawak,10,5,5
1/08/2023,Brazil,Selangor,914,519,395
1/08/2023,Brazil,W.P. Labuan,0,0,0
1/08/2023,Barbados,Johor,0,0,0
1/08/2023,Barbados,Kedah,0,0,0
1/08/2023,Barbados,Perlis,0,0,0
1/08/2023,Barbados,Pulau Pinang,0,0,0
1/08/2023,Barbados,Selangor,5,3,2
1/08/2023,Brunei Darussalam,Johor,790,379,411
1/08/2023,Brunei Darussalam,Kedah,58,24,34
1/08/2023,Brunei Darussalam,Kelantan,15,12,3
1/08/2023,Brunei Darussalam,Melaka,0,0,0
1/08/2023,Brunei Darussalam,Pahang,1,1,0
1/08/2023,Brunei Darussalam,Perak,1,1,0
1/08/2023,Brunei Darussalam,Perlis,38,23,15
1/08/2023,Brunei Darussalam,Pulau Pinang,9,3,6
1/08/2023,Brunei Darussalam,Sabah,180,82,98
1/08/2023,Brunei Darussalam,Sarawak,67279,36829,30450
1/08/2023,Brunei Darussalam,Selangor,6508,3205,3303
1/08/2023,Brunei Darussalam,W.P. Labuan,1791,1120,671
1/08/2023,Bhutan,Johor,14,9,5
1/08/2023,Bhutan,Kedah,0,0,0
1/08/2023,Bhutan,Perak,1,1,0
1/08/2023,Bhutan,Perlis,2,1,1
1/08/2023,Bhutan,Pulau Pinang,0,0,0
1/08/2023,Bhutan,Sabah,0,0,0
1/08/2023,Bhutan,Sarawak,1,1,0
1/08/2023,Bhutan,Selangor,73,36,37
1/08/2023,Botswana,Johor,0,0,0
1/08/2023,Botswana,Kedah,4,2,2
1/08/2023,Botswana,Perlis,0,0,0
1/08/2023,Botswana,Pulau Pinang,0,0,0
1/08/2023,Botswana,Sabah,0,0,0
1/08/2023,Botswana,Sarawak,0,0,0
1/08/2023,Botswana,Selangor,11,4,7
1/08/2023,Central African Republic,Kedah,0,0,0
1/08/2023,Central African Republic,Selangor,4,3,1
1/08/2023,Canada,Johor,1600,892,708
1/08/2023,Canada,Kedah,129,77,52
1/08/2023,Canada,Kelantan,4,3,1
1/08/2023,Canada,Melaka,0,0,0
1/08/2023,Canada,Negeri Sembilan,0,0,0
1/08/2023,Canada,Pahang,2,1,1
1/08/2023,Canada,Perak,59,33,26
1/08/2023,Canada,Perlis,29,18,11
1/08/2023,Canada,Pulau Pinang,484,271,213
1/08/2023,Canada,Sabah,29,20,9
1/08/2023,Canada,Sarawak,204,119,85
1/08/2023,Canada,Selangor,4144,2374,1770
1/08/2023,Canada,Terengganu,0,0,0
1/08/2023,Canada,W.P. Labuan,2,2,0
1/08/2023,Cocos (Keeling) Islands,Selangor,0,0,0
1/08/2023,Switzerland,Johor,514,288,226
1/08/2023,Switzerland,Kedah,76,40,36
1/08/2023,Switzerland,Kelantan,8,4,4
1/08/2023,Switzerland,Melaka,0,0,0
1/08/2023,Switzerland,Negeri Sembilan,1,1,0
1/08/2023,Switzerland,Pahang,1,1,0
1/08/2023,Switzerland,Perak,3,3,0
1/08/2023,Switzerland,Perlis,39,26,13
1/08/2023,Switzerland,Pulau Pinang,103,63,40
1/08/2023,Switzerland,Sabah,18,13,5
1/08/2023,Switzerland,Sarawak,26,13,13
1/08/2023,Switzerland,Selangor,1612,935,677
1/08/2023,Switzerland,W.P. Labuan,2,1,1
1/08/2023,Chile,Johor,50,29,21
1/08/2023,Chile,Kedah,15,9,6
1/08/2023,Chile,Kelantan,2,1,1
1/08/2023,Chile,Melaka,0,0,0
1/08/2023,Chile,Pahang,0,0,0
1/08/2023,Chile,Perak,0,0,0
1/08/2023,Chile,Perlis,4,4,0
1/08/2023,Chile,Pulau Pinang,6,3,3
1/08/2023,Chile,Sabah,0,0,0
1/08/2023,Chile,Sarawak,2,1,1
1/08/2023,Chile,Selangor,294,147,147
1/08/2023,China,Johor,58998,25424,33574
1/08/2023,China,Kedah,1902,827,1075
1/08/2023,China,Kelantan,3,1,2
1/08/2023,China,Melaka,4,4,0
1/08/2023,China,Pahang,36,25,11
1/08/2023,China,Perak,282,123,159
1/08/2023,China,Perlis,140,56,84
1/08/2023,China,Pulau Pinang,10924,5864,5060
1/08/2023,China,Sabah,2288,1075,1213
1/08/2023,China,Sarawak,1048,497,551
1/08/2023,China,Selangor,130284,63643,66641
1/08/2023,China,Terengganu,0,0,0
1/08/2023,China,W.P. Labuan,33,26,7
1/08/2023,Côte d'Ivoire,Johor,6,6,0
1/08/2023,Côte d'Ivoire,Kedah,0,0,0
1/08/2023,Côte d'Ivoire,Pulau Pinang,0,0,0
1/08/2023,Côte d'Ivoire,Sabah,0,0,0
1/08/2023,Côte d'Ivoire,Sarawak,0,0,0
1/08/2023,Côte d'Ivoire,Selangor,38,27,11
1/08/2023,Cameroon,Johor,0,0,0
1/08/2023,Cameroon,Kedah,6,3,3
1/08/2023,Cameroon,Pulau Pinang,2,1,1
1/08/2023,Cameroon,Sabah,0,0,0
1/08/2023,Cameroon,Sarawak,0,0,0
1/08/2023,Cameroon,Selangor,28,16,12
1/08/2023,Congo,Johor,1,1,0
1/08/2023,Congo,Pulau Pinang,0,0,0
1/08/2023,Congo,Sarawak,0,0,0
1/08/2023,Congo,Selangor,15,9,6
1/08/2023,Congo,Johor,0,0,0
1/08/2023,Congo,Kedah,0,0,0
1/08/2023,Congo,Selangor,4,2,2
1/08/2023,Cook Islands,Selangor,0,0,0
1/08/2023,Colombia,Johor,43,20,23
1/08/2023,Colombia,Kedah,0,0,0
1/08/2023,Colombia,Perak,1,0,1
1/08/2023,Colombia,Pulau Pinang,6,2,4
1/08/2023,Colombia,Sabah,2,1,1
1/08/2023,Colombia,Sarawak,5,4,1
1/08/2023,Colombia,Selangor,184,102,82
1/08/2023,Colombia,W.P. Labuan,0,0,0
1/08/2023,Comoros,Johor,2,2,0
1/08/2023,Comoros,Kedah,0,0,0
1/08/2023,Comoros,Selangor,20,10,10
1/08/2023,Cabo Verde,Johor,0,0,0
1/08/2023,Cabo Verde,Kedah,0,0,0
1/08/2023,Cabo Verde,Pulau Pinang,0,0,0
1/08/2023,Cabo Verde,Sabah,0,0,0
1/08/2023,Cabo Verde,Selangor,7,4,3
1/08/2023,Costa Rica,Johor,15,9,6
1/08/2023,Costa Rica,Kedah,0,0,0
1/08/2023,Costa Rica,Perak,0,0,0
1/08/2023,Costa Rica,Perlis,0,0,0
1/08/2023,Costa Rica,Pulau Pinang,8,6,2
1/08/2023,Costa Rica,Sabah,0,0,0
1/08/2023,Costa Rica,Sarawak,1,1,0
1/08/2023,Costa Rica,Selangor,58,34,24
1/08/2023,Cuba,Johor,9,8,1
1/08/2023,Cuba,Kedah,0,0,0
1/08/2023,Cuba,Perlis,0,0,0
1/08/2023,Cuba,Pulau Pinang,0,0,0
1/08/2023,Cuba,Sabah,0,0,0
1/08/2023,Cuba,Sarawak,0,0,0
1/08/2023,Cuba,Selangor,24,14,10
1/08/2023,Cyprus,Johor,11,7,4
1/08/2023,Cyprus,Kedah,6,4,2
1/08/2023,Cyprus,Perak,0,0,0
1/08/2023,Cyprus,Perlis,0,0,0
1/08/2023,Cyprus,Pulau Pinang,1,0,1
1/08/2023,Cyprus,Sabah,0,0,0
1/08/2023,Cyprus,Sarawak,0,0,0
1/08/2023,Cyprus,Selangor,125,78,47
1/08/2023,Czechia,Johor,119,62,57
1/08/2023,Czechia,Kedah,24,11,13
1/08/2023,Czechia,Kelantan,2,2,0
1/08/2023,Czechia,Melaka,0,0,0
1/08/2023,Czechia,Negeri Sembilan,0,0,0
1/08/2023,Czechia,Perak,6,3,3
1/08/2023,Czechia,Perlis,5,2,3
1/08/2023,Czechia,Pulau Pinang,13,8,5
1/08/2023,Czechia,Sabah,3,2,1
1/08/2023,Czechia,Sarawak,20,10,10
1/08/2023,Czechia,Selangor,479,250,229
1/08/2023,Czechia,W.P. Labuan,0,0,0
1/08/2023,Germany,Johor,2781,1665,1116
1/08/2023,Germany,Kedah,378,200,178
1/08/2023,Germany,Kelantan,10,8,2
1/08/2023,Germany,Melaka,6,1,5
1/08/2023,Germany,Negeri Sembilan,1,0,1
1/08/2023,Germany,Pahang,16,11,5
1/08/2023,Germany,Perak,41,23,18
1/08/2023,Germany,Perlis,115,59,56
1/08/2023,Germany,Pulau Pinang,833,537,296
1/08/2023,Germany,Sabah,31,17,14
1/08/2023,Germany,Sarawak,294,165,129
1/08/2023,Germany,Selangor,8639,4935,3704
1/08/2023,Germany,Terengganu,0,0,0
1/08/2023,Germany,W.P. Labuan,7,4,3
1/08/2023,Djibouti,Johor,0,0,0
1/08/2023,Djibouti,Selangor,10,5,5
1/08/2023,Dominica,Johor,10,7,3
1/08/2023,Dominica,Kedah,0,0,0
1/08/2023,Dominica,Pulau Pinang,1,1,0
1/08/2023,Dominica,Sabah,0,0,0
1/08/2023,Dominica,Sarawak,0,0,0
1/08/2023,Dominica,Selangor,46,32,14
1/08/2023,Dominica,W.P. Labuan,0,0,0
1/08/2023,Denmark,Johor,265,190,75
1/08/2023,Denmark,Kedah,32,18,14
1/08/2023,Denmark,Kelantan,2,1,1
1/08/2023,Denmark,Melaka,0,0,0
1/08/2023,Denmark,Negeri Sembilan,0,0,0
1/08/2023,Denmark,Pahang,0,0,0
1/08/2023,Denmark,Perak,1,1,0
1/08/2023,Denmark,Perlis,2,2,0
1/08/2023,Denmark,Pulau Pinang,41,29,12
1/08/2023,Denmark,Sabah,4,3,1
1/08/2023,Denmark,Sarawak,23,13,10
1/08/2023,Denmark,Selangor,824,482,342
1/08/2023,Denmark,W.P. Labuan,0,0,0
1/08/2023,Dominican Republic,Johor,2,1,1
1/08/2023,Dominican Republic,Kedah,1,0,1
1/08/2023,Dominican Republic,Perak,0,0,0
1/08/2023,Dominican Republic,Perlis,0,0,0
1/08/2023,Dominican Republic,Pulau Pinang,0,0,0
1/08/2023,Dominican Republic,Sabah,0,0,0
1/08/2023,Dominican Republic,Sarawak,0,0,0
1/08/2023,Dominican Republic,Selangor,16,10,6
1/08/2023,Algeria,Johor,124,56,68
1/08/2023,Algeria,Kedah,5,3,2
1/08/2023,Algeria,Kelantan,0,0,0
1/08/2023,Algeria,Melaka,0,0,0
1/08/2023,Algeria,Perak,0,0,0
1/08/2023,Algeria,Perlis,1,1,0
1/08/2023,Algeria,Pulau Pinang,3,2,1
1/08/2023,Algeria,Sabah,1,0,1
1/08/2023,Algeria,Sarawak,3,3,0
1/08/2023,Algeria,Selangor,3055,1543,1512
1/08/2023,Algeria,W.P. Labuan,0,0,0
1/08/2023,Ecuador,Johor,15,8,7
1/08/2023,Ecuador,Kedah,3,1,2
1/08/2023,Ecuador,Perak,0,0,0
1/08/2023,Ecuador,Perlis,0,0,0
1/08/2023,Ecuador,Pulau Pinang,1,0,1
1/08/2023,Ecuador,Sabah,0,0,0
1/08/2023,Ecuador,Sarawak,0,0,0
1/08/2023,Ecuador,Selangor,83,31,52
1/08/2023,Egypt,Johor,171,142,29
1/08/2023,Egypt,Kedah,12,4,8
1/08/2023,Egypt,Kelantan,1,1,0
1/08/2023,Egypt,Melaka,0,0,0
1/08/2023,Egypt,Pahang,0,0,0
1/08/2023,Egypt,Perak,0,0,0
1/08/2023,Egypt,Perlis,1,1,0
1/08/2023,Egypt,Pulau Pinang,17,11,6
1/08/2023,Egypt,Sabah,2,2,0
1/08/2023,Egypt,Sarawak,76,60,16
1/08/2023,Egypt,Selangor,2548,1601,947
1/08/2023,Egypt,Terengganu,0,0,0
1/08/2023,Egypt,W.P. Labuan,0,0,0
1/08/2023,Eritrea,Johor,0,0,0
1/08/2023,Eritrea,Pulau Pinang,2,1,1
1/08/2023,Eritrea,Sabah,0,0,0
1/08/2023,Eritrea,Selangor,33,17,16
1/08/2023,Spain,Johor,1307,695,612
1/08/2023,Spain,Kedah,131,60,71
1/08/2023,Spain,Kelantan,8,5,3
1/08/2023,Spain,Melaka,1,1,0
1/08/2023,Spain,Negeri Sembilan,0,0,0
1/08/2023,Spain,Pahang,0,0,0
1/08/2023,Spain,Perak,12,4,8
1/08/2023,Spain,Perlis,25,15,10
1/08/2023,Spain,Pulau Pinang,322,155,167
1/08/2023,Spain,Sabah,23,11,12
1/08/2023,Spain,Sarawak,145,86,59
1/08/2023,Spain,Selangor,8140,4112,4028
1/08/2023,Spain,W.P. Labuan,10,7,3
1/08/2023,Estonia,Johor,31,17,14
1/08/2023,Estonia,Kedah,5,3,2
1/08/2023,Estonia,Kelantan,0,0,0
1/08/2023,Estonia,Pahang,1,1,0
1/08/2023,Estonia,Perak,0,0,0
1/08/2023,Estonia,Perlis,1,0,1
1/08/2023,Estonia,Pulau Pinang,5,3,2
1/08/2023,Estonia,Sabah,0,0,0
1/08/2023,Estonia,Sarawak,0,0,0
1/08/2023,Estonia,Selangor,74,32,42
1/08/2023,Estonia,W.P. Labuan,0,0,0
1/08/2023,Ethiopia,Johor,0,0,0
1/08/2023,Ethiopia,Kedah,0,0,0
1/08/2023,Ethiopia,Pulau Pinang,0,0,0
1/08/2023,Ethiopia,Sarawak,0,0,0
1/08/2023,Ethiopia,Selangor,50,25,25
1/08/2023,Finland,Johor,86,58,28
1/08/2023,Finland,Kedah,6,3,3
1/08/2023,Finland,Kelantan,1,1,0
1/08/2023,Finland,Melaka,0,0,0
1/08/2023,Finland,Negeri Sembilan,0,0,0
1/08/2023,Finland,Pahang,0,0,0
1/08/2023,Finland,Perak,0,0,0
1/08/2023,Finland,Perlis,3,0,3
1/08/2023,Finland,Pulau Pinang,23,13,10
1/08/2023,Finland,Sabah,1,1,0
1/08/2023,Finland,Sarawak,9,6,3
1/08/2023,Finland,Selangor,377,227,150
1/08/2023,Finland,W.P. Labuan,0,0,0
1/08/2023,Fiji,Johor,85,46,39
1/08/2023,Fiji,Kedah,0,0,0
1/08/2023,Fiji,Kelantan,0,0,0
1/08/2023,Fiji,Perak,0,0,0
1/08/2023,Fiji,Perlis,0,0,0
1/08/2023,Fiji,Pulau Pinang,1,1,0
1/08/2023,Fiji,Sabah,0,0,0
1/08/2023,Fiji,Sarawak,0,0,0
1/08/2023,Fiji,Selangor,170,98,72
1/08/2023,France,Johor,3410,1930,1480
1/08/2023,France,Kedah,302,167,135
1/08/2023,France,Kelantan,27,15,12
1/08/2023,France,Melaka,3,2,1
1/08/2023,France,Negeri Sembilan,2,1,1
1/08/2023,France,Pahang,18,9,9
1/08/2023,France,Perak,24,16,8
1/08/2023,France,Perlis,75,50,25
1/08/2023,France,Pulau Pinang,542,312,230
1/08/2023,France,Sabah,31,19,12
1/08/2023,France,Sarawak,212,120,92
1/08/2023,France,Selangor,15193,8035,7158
1/08/2023,France,Terengganu,0,0,0
1/08/2023,France,W.P. Labuan,1,1,0
1/08/2023,"Micronesia, Federated States of",Johor,0,0,0
1/08/2023,"Micronesia, Federated States of",Pulau Pinang,0,0,0
1/08/2023,"Micronesia, Federated States of",Selangor,0,0,0
1/08/2023,Gabon,Johor,2,0,2
1/08/2023,Gabon,Pulau Pinang,0,0,0
1/08/2023,Gabon,Sarawak,0,0,0
1/08/2023,Gabon,Selangor,7,3,4
1/08/2023,United Kingdom of Great Britain and Northern Ireland,Johor,5811,3632,2179
1/08/2023,United Kingdom of Great Britain and Northern Ireland,Kedah,950,504,446
1/08/2023,United Kingdom of Great Britain and Northern Ireland,Kelantan,25,17,8
1/08/2023,United Kingdom of Great Britain and Northern Ireland,Melaka,1,0,1
1/08/2023,United Kingdom of Great Britain and Northern Ireland,Negeri Sembilan,0,0,0
1/08/2023,United Kingdom of Great Britain and Northern Ireland,Pahang,37,20,17
1/08/2023,United Kingdom of Great Britain and Northern Ireland,Perak,177,98,79
1/08/2023,United Kingdom of Great Britain and Northern Ireland,Perlis,177,102,75
1/08/2023,United Kingdom of Great Britain and Northern Ireland,Pulau Pinang,1823,1016,807
1/08/2023,United Kingdom of Great Britain and Northern Ireland,Sabah,135,82,53
1/08/2023,United Kingdom of Great Britain and Northern Ireland,Sarawak,884,538,346
1/08/2023,United Kingdom of Great Britain and Northern Ireland,Selangor,23299,13135,10164
1/08/2023,United Kingdom of Great Britain and Northern Ireland,Terengganu,0,0,0
1/08/2023,United Kingdom of Great Britain and Northern Ireland,W.P. Labuan,26,20,6
1/08/2023,Georgia,Johor,5,3,2
1/08/2023,Georgia,Kedah,2,1,1
1/08/2023,Georgia,Melaka,0,0,0
1/08/2023,Georgia,Perak,0,0,0
1/08/2023,Georgia,Perlis,0,0,0
1/08/2023,Georgia,Pulau Pinang,1,0,1
1/08/2023,Georgia,Sabah,2,2,0
1/08/2023,Georgia,Sarawak,0,0,0
1/08/2023,Georgia,Selangor,49,28,21
1/08/2023,Ghana,Johor,12,9,3
1/08/2023,Ghana,Kedah,1,0,1
1/08/2023,Ghana,Kelantan,0,0,0
1/08/2023,Ghana,Pulau Pinang,0,0,0
1/08/2023,Ghana,Sabah,0,0,0
1/08/2023,Ghana,Sarawak,0,0,0
1/08/2023,Ghana,Selangor,126,78,48
1/08/2023,Gibraltar,Johor,0,0,0
1/08/2023,Gibraltar,Sarawak,0,0,0
1/08/2023,Guinea,Johor,14,9,5
1/08/2023,Guinea,Kedah,1,1,0
1/08/2023,Guinea,Kelantan,0,0,0
1/08/2023,Guinea,Perlis,0,0,0
1/08/2023,Guinea,Pulau Pinang,0,0,0
1/08/2023,Guinea,Sabah,0,0,0
1/08/2023,Guinea,Sarawak,0,0,0
1/08/2023,Guinea,Selangor,51,38,13
1/08/2023,Guadeloupe,Selangor,0,0,0
1/08/2023,Gambia,Johor,6,6,0
1/08/2023,Gambia,Kedah,0,0,0
1/08/2023,Gambia,Kelantan,0,0,0
1/08/2023,Gambia,Pulau Pinang,0,0,0
1/08/2023,Gambia,Sabah,0,0,0
1/08/2023,Gambia,Sarawak,1,1,0
1/08/2023,Gambia,Selangor,35,23,12
1/08/2023,Guinea-Bissau,Johor,0,0,0
1/08/2023,Guinea-Bissau,Selangor,1,1,0
1/08/2023,Equatorial Guinea,Johor,0,0,0
1/08/2023,Equatorial Guinea,Selangor,2,1,1
1/08/2023,Greece,Johor,52,34,18
1/08/2023,Greece,Kedah,10,4,6
1/08/2023,Greece,Kelantan,3,1,2
1/08/2023,Greece,Melaka,0,0,0
1/08/2023,Greece,Negeri Sembilan,1,1,0
1/08/2023,Greece,Pahang,0,0,0
1/08/2023,Greece,Perak,0,0,0
1/08/2023,Greece,Perlis,2,2,0
1/08/2023,Greece,Pulau Pinang,8,5,3
1/08/2023,Greece,Sabah,1,1,0
1/08/2023,Greece,Sarawak,21,7,14
1/08/2023,Greece,Selangor,409,267,142
1/08/2023,Grenada,Johor,9,6,3
1/08/2023,Grenada,Kedah,0,0,0
1/08/2023,Grenada,Pulau Pinang,0,0,0
1/08/2023,Grenada,Sabah,0,0,0
1/08/2023,Grenada,Sarawak,0,0,0
1/08/2023,Grenada,Selangor,22,16,6
1/08/2023,Greenland,Johor,0,0,0
1/08/2023,Greenland,Selangor,0,0,0
1/08/2023,Guatemala,Johor,3,1,2
1/08/2023,Guatemala,Kedah,0,0,0
1/08/2023,Guatemala,Pahang,0,0,0
1/08/2023,Guatemala,Perak,0,0,0
1/08/2023,Guatemala,Pulau Pinang,1,1,0
1/08/2023,Guatemala,Sabah,0,0,0
1/08/2023,Guatemala,Sarawak,0,0,0
1/08/2023,Guatemala,Selangor,19,11,8
1/08/2023,Guatemala,W.P. Labuan,0,0,0
1/08/2023,Guyana,Johor,1,1,0
1/08/2023,Guyana,Kedah,0,0,0
1/08/2023,Guyana,Pulau Pinang,0,0,0
1/08/2023,Guyana,Sarawak,0,0,0
1/08/2023,Guyana,Selangor,8,4,4
1/08/2023,Hong Kong,Johor,9,6,3
1/08/2023,Hong Kong,Kedah,1,1,0
1/08/2023,Hong Kong,Kelantan,0,0,0
1/08/2023,Hong Kong,Pahang,1,1,0
1/08/2023,Hong Kong,Perak,30,12,18
1/08/2023,Hong Kong,Perlis,1,1,0
1/08/2023,Hong Kong,Pulau Pinang,0,0,0
1/08/2023,Hong Kong,Sabah,0,0,0
1/08/2023,Hong Kong,Sarawak,2,1,1
1/08/2023,Hong Kong,Selangor,13,7,6
1/08/2023,Hong Kong,Terengganu,0,0,0
1/08/2023,Heard Island and McDonald Islands,Johor,1,0,1
1/08/2023,Honduras,Johor,7,4,3
1/08/2023,Honduras,Kedah,0,0,0
1/08/2023,Honduras,Perak,0,0,0
1/08/2023,Honduras,Pulau Pinang,0,0,0
1/08/2023,Honduras,Sabah,0,0,0
1/08/2023,Honduras,Sarawak,0,0,0
1/08/2023,Honduras,Selangor,12,6,6
1/08/2023,Croatia,Johor,50,41,9
1/08/2023,Croatia,Kedah,0,0,0
1/08/2023,Croatia,Kelantan,0,0,0
1/08/2023,Croatia,Melaka,0,0,0
1/08/2023,Croatia,Pahang,0,0,0
1/08/2023,Croatia,Perak,0,0,0
1/08/2023,Croatia,Perlis,0,0,0
1/08/2023,Croatia,Pulau Pinang,1,1,0
1/08/2023,Croatia,Sabah,0,0,0
1/08/2023,Croatia,Sarawak,0,0,0
1/08/2023,Croatia,Selangor,238,125,113
1/08/2023,Haiti,Johor,1,1,0
1/08/2023,Haiti,Kedah,0,0,0
1/08/2023,Haiti,Kelantan,0,0,0
1/08/2023,Haiti,Perak,0,0,0
1/08/2023,Haiti,Pulau Pinang,0,0,0
1/08/2023,Haiti,Sabah,0,0,0
1/08/2023,Haiti,Selangor,3,2,1
1/08/2023,Hungary,Johor,96,61,35
1/08/2023,Hungary,Kedah,13,5,8
1/08/2023,Hungary,Kelantan,0,0,0
1/08/2023,Hungary,Pahang,0,0,0
1/08/2023,Hungary,Perak,0,0,0
1/08/2023,Hungary,Perlis,0,0,0
1/08/2023,Hungary,Pulau Pinang,20,11,9
1/08/2023,Hungary,Sabah,1,1,0
1/08/2023,Hungary,Sarawak,7,4,3
1/08/2023,Hungary,Selangor,518,267,251
1/08/2023,Hungary,W.P. Labuan,0,0,0
1/08/2023,Indonesia,Johor,89381,42360,47021
1/08/2023,Indonesia,Kedah,4629,1647,2982
1/08/2023,Indonesia,Kelantan,149,94,55
1/08/2023,Indonesia,Melaka,3374,1618,1756
1/08/2023,Indonesia,Negeri Sembilan,7265,4703,2562
1/08/2023,Indonesia,Pahang,23,17,6
1/08/2023,Indonesia,Perak,297,126,171
1/08/2023,Indonesia,Perlis,514,255,259
1/08/2023,Indonesia,Pulau Pinang,37925,15355,22570
1/08/2023,Indonesia,Sabah,4260,2007,2253
1/08/2023,Indonesia,Sarawak,31604,16820,14784
1/08/2023,Indonesia,Selangor,115655,55363,60292
1/08/2023,Indonesia,Terengganu,0,0,0
1/08/2023,Indonesia,W.P. Labuan,56,28,28
1/08/2023,India,Johor,25130,17609,7521
1/08/2023,India,Kedah,1154,624,530
1/08/2023,India,Kelantan,1,1,0
1/08/2023,India,Melaka,1,1,0
1/08/2023,India,Negeri Sembilan,0,0,0
1/08/2023,India,Pahang,26,20,6
1/08/2023,India,Perak,213,146,67
1/08/2023,India,Perlis,31,22,9
1/08/2023,India,Pulau Pinang,1011,667,344
1/08/2023,India,Sabah,77,61,16
1/08/2023,India,Sarawak,979,814,165
1/08/2023,India,Selangor,53686,37829,15857
1/08/2023,India,Terengganu,0,0,0
1/08/2023,India,W.P. Labuan,76,61,15
1/08/2023, British Indian Ocean Territory,Pulau Pinang,0,0,0
1/08/2023, British Indian Ocean Territory,Selangor,0,0,0
1/08/2023,Ireland,Johor,297,178,119
1/08/2023,Ireland,Kedah,42,24,18
1/08/2023,Ireland,Kelantan,0,0,0
1/08/2023,Ireland,Negeri Sembilan,0,0,0
1/08/2023,Ireland,Pahang,0,0,0
1/08/2023,Ireland,Perak,9,7,2
1/08/2023,Ireland,Perlis,13,5,8
1/08/2023,Ireland,Pulau Pinang,128,77,51
1/08/2023,Ireland,Sabah,2,0,2
1/08/2023,Ireland,Sarawak,23,16,7
1/08/2023,Ireland,Selangor,1651,944,707
1/08/2023,Ireland,Terengganu,0,0,0
1/08/2023,Ireland,W.P. Labuan,0,0,0
1/08/2023,"Iran, Islamic Republic of",Johor,204,116,88
1/08/2023,"Iran, Islamic Republic of",Kedah,11,6,5
1/08/2023,"Iran, Islamic Republic of",Kelantan,0,0,0
1/08/2023,"Iran, Islamic Republic of",Perak,0,0,0
1/08/2023,"Iran, Islamic Republic of",Perlis,0,0,0
1/08/2023,"Iran, Islamic Republic of",Pulau Pinang,4,0,4
1/08/2023,"Iran, Islamic Republic of",Sabah,1,1,0
1/08/2023,"Iran, Islamic Republic of",Sarawak,1,0,1
1/08/2023,"Iran, Islamic Republic of",Selangor,2006,1017,989
1/08/2023,"Iran, Islamic Republic of",W.P. Labuan,0,0,0
1/08/2023,Iraq,Johor,68,35,33
1/08/2023,Iraq,Kedah,0,0,0
1/08/2023,Iraq,Kelantan,0,0,0
1/08/2023,Iraq,Melaka,0,0,0
1/08/2023,Iraq,Pahang,0,0,0
1/08/2023,Iraq,Perak,0,0,0
1/08/2023,Iraq,Perlis,0,0,0
1/08/2023,Iraq,Pulau Pinang,7,5,2
1/08/2023,Iraq,Sabah,0,0,0
1/08/2023,Iraq,Sarawak,2,1,1
1/08/2023,Iraq,Selangor,1324,775,549
1/08/2023,Iceland,Johor,23,10,13
1/08/2023,Iceland,Kedah,4,1,3
1/08/2023,Iceland,Kelantan,0,0,0
1/08/2023,Iceland,Perak,1,1,0
1/08/2023,Iceland,Perlis,0,0,0
1/08/2023,Iceland,Pulau Pinang,0,0,0
1/08/2023,Iceland,Sabah,0,0,0
1/08/2023,Iceland,Sarawak,4,1,3
1/08/2023,Iceland,Selangor,20,12,8
1/08/2023,Iceland,W.P. Labuan,0,0,0
1/08/2023,Israel,Pulau Pinang,0,0,0
1/08/2023,Italy,Johor,2138,1138,1000
1/08/2023,Italy,Kedah,139,77,62
1/08/2023,Italy,Kelantan,8,7,1
1/08/2023,Italy,Melaka,3,1,2
1/08/2023,Italy,Negeri Sembilan,0,0,0
1/08/2023,Italy,Pahang,7,5,2
1/08/2023,Italy,Perak,20,11,9
1/08/2023,Italy,Perlis,39,21,18
1/08/2023,Italy,Pulau Pinang,264,164,100
1/08/2023,Italy,Sabah,67,37,30
1/08/2023,Italy,Sarawak,425,231,194
1/08/2023,Italy,Selangor,12253,6534,5719
1/08/2023,Italy,W.P. Labuan,7,5,2
1/08/2023,Jamaica,Johor,6,3,3
1/08/2023,Jamaica,Kedah,0,0,0
1/08/2023,Jamaica,Perak,0,0,0
1/08/2023,Jamaica,Pulau Pinang,1,1,0
1/08/2023,Jamaica,Sabah,0,0,0
1/08/2023,Jamaica,Sarawak,0,0,0
1/08/2023,Jamaica,Selangor,29,6,23
1/08/2023,Jamaica,W.P. Labuan,1,0,1
1/08/2023,Jordan,Johor,9,6,3
1/08/2023,Jordan,Kedah,7,4,3
1/08/2023,Jordan,Kelantan,0,0,0
1/08/2023,Jordan,Melaka,0,0,0
1/08/2023,Jordan,Perlis,0,0,0
1/08/2023,Jordan,Pulau Pinang,13,11,2
1/08/2023,Jordan,Sabah,1,1,0
1/08/2023,Jordan,Sarawak,4,2,2
1/08/2023,Jordan,Selangor,1148,631,517
1/08/2023,Jordan,W.P. Labuan,0,0,0
1/08/2023,Japan,Johor,7505,4742,2763
1/08/2023,Japan,Kedah,289,147,142
1/08/2023,Japan,Kelantan,20,11,9
1/08/2023,Japan,Melaka,1,1,0
1/08/2023,Japan,Negeri Sembilan,0,0,0
1/08/2023,Japan,Pahang,10,6,4
1/08/2023,Japan,Perak,94,62,32
1/08/2023,Japan,Perlis,110,86,24
1/08/2023,Japan,Pulau Pinang,1973,1225,748
1/08/2023,Japan,Sabah,104,58,46
1/08/2023,Japan,Sarawak,222,128,94
1/08/2023,Japan,Selangor,31511,17150,14361
1/08/2023,Japan,W.P. Labuan,15,9,6
1/08/2023,Kazakhstan,Johor,81,29,52
1/08/2023,Kazakhstan,Kedah,7,4,3
1/08/2023,Kazakhstan,Kelantan,0,0,0
1/08/2023,Kazakhstan,Melaka,0,0,0
1/08/2023,Kazakhstan,Perak,0,0,0
1/08/2023,Kazakhstan,Perlis,8,3,5
1/08/2023,Kazakhstan,Pulau Pinang,1,1,0
1/08/2023,Kazakhstan,Sabah,1,0,1
1/08/2023,Kazakhstan,Sarawak,2,1,1
1/08/2023,Kazakhstan,Selangor,940,407,533
1/08/2023,Kazakhstan,W.P. Labuan,1,0,1
1/08/2023,Kenya,Johor,159,65,94
1/08/2023,Kenya,Kedah,4,2,2
1/08/2023,Kenya,Kelantan,0,0,0
1/08/2023,Kenya,Perak,0,0,0
1/08/2023,Kenya,Perlis,1,1,0
1/08/2023,Kenya,Pulau Pinang,7,1,6
1/08/2023,Kenya,Sabah,4,3,1
1/08/2023,Kenya,Sarawak,5,2,3
1/08/2023,Kenya,Selangor,478,208,270
1/08/2023,Kyrgyzstan,Johor,24,13,11
1/08/2023,Kyrgyzstan,Kedah,2,1,1
1/08/2023,Kyrgyzstan,Kelantan,0,0,0
1/08/2023,Kyrgyzstan,Perak,0,0,0
1/08/2023,Kyrgyzstan,Perlis,0,0,0
1/08/2023,Kyrgyzstan,Pulau Pinang,1,1,0
1/08/2023,Kyrgyzstan,Sabah,0,0,0
1/08/2023,Kyrgyzstan,Sarawak,0,0,0
1/08/2023,Kyrgyzstan,Selangor,264,136,128
1/08/2023,Cambodia,Johor,2600,1118,1482
1/08/2023,Cambodia,Kedah,71,29,42
1/08/2023,Cambodia,Kelantan,525,292,233
1/08/2023,Cambodia,Melaka,0,0,0
1/08/2023,Cambodia,Negeri Sembilan,0,0,0
1/08/2023,Cambodia,Pahang,0,0,0
1/08/2023,Cambodia,Perak,6,2,4
1/08/2023,Cambodia,Perlis,688,423,265
1/08/2023,Cambodia,Pulau Pinang,39,7,32
1/08/2023,Cambodia,Sabah,4,3,1
1/08/2023,Cambodia,Sarawak,9,3,6
1/08/2023,Cambodia,Selangor,5480,2927,2553
1/08/2023,Cambodia,W.P. Labuan,0,0,0
1/08/2023,Kiribati,Johor,0,0,0
1/08/2023,Kiribati,Sabah,0,0,0
1/08/2023,Kiribati,Selangor,0,0,0
1/08/2023,Saint Kitts and Nevis,Johor,47,34,13
1/08/2023,Saint Kitts and Nevis,Kedah,0,0,0
1/08/2023,Saint Kitts and Nevis,Perlis,0,0,0
1/08/2023,Saint Kitts and Nevis,Pulau Pinang,4,4,0
1/08/2023,Saint Kitts and Nevis,Sabah,1,1,0
1/08/2023,Saint Kitts and Nevis,Selangor,73,57,16
1/08/2023,Saint Kitts and Nevis,W.P. Labuan,0,0,0
1/08/2023,"Korea, Republic of",Johor,14489,7505,6984
1/08/2023,"Korea, Republic of",Kedah,154,75,79
1/08/2023,"Korea, Republic of",Kelantan,2,1,1
1/08/2023,"Korea, Republic of",Melaka,24,15,9
1/08/2023,"Korea, Republic of",Negeri Sembilan,0,0,0
1/08/2023,"Korea, Republic of",Pahang,2,1,1
1/08/2023,"Korea, Republic of",Perak,12,9,3
1/08/2023,"Korea, Republic of",Perlis,72,47,25
1/08/2023,"Korea, Republic of",Pulau Pinang,740,389,351
1/08/2023,"Korea, Republic of",Sabah,753,360,393
1/08/2023,"Korea, Republic of",Sarawak,226,154,72
1/08/2023,"Korea, Republic of",Selangor,19550,10173,9377
1/08/2023,"Korea, Republic of",Terengganu,0,0,0
1/08/2023,"Korea, Republic of",W.P. Labuan,11,6,5
1/08/2023,Kuwait,Johor,320,165,155
1/08/2023,Kuwait,Kedah,23,10,13
1/08/2023,Kuwait,Kelantan,1,0,1
1/08/2023,Kuwait,Perak,0,0,0
1/08/2023,Kuwait,Perlis,0,0,0
1/08/2023,Kuwait,Pulau Pinang,47,22,25
1/08/2023,Kuwait,Sabah,0,0,0
1/08/2023,Kuwait,Sarawak,0,0,0
1/08/2023,Kuwait,Selangor,3652,1771,1881
1/08/2023,Kuwait,W.P. Labuan,0,0,0
1/08/2023, Lao People's Democratic Republic,Johor,384,125,259
1/08/2023, Lao People's Democratic Republic,Kedah,363,37,326
1/08/2023, Lao People's Democratic Republic,Kelantan,149,43,106
1/08/2023, Lao People's Democratic Republic,Melaka,0,0,0
1/08/2023, Lao People's Democratic Republic,Perak,36,3,33
1/08/2023, Lao People's Democratic Republic,Perlis,377,117,260
1/08/2023, Lao People's Democratic Republic,Pulau Pinang,25,13,12
1/08/2023, Lao People's Democratic Republic,Sabah,0,0,0
1/08/2023, Lao People's Democratic Republic,Sarawak,4,1,3
1/08/2023, Lao People's Democratic Republic,Selangor,575,217,358
1/08/2023, Lao People's Democratic Republic,W.P. Labuan,0,0,0
1/08/2023,Lebanon,Johor,10,6,4
1/08/2023,Lebanon,Kedah,2,0,2
1/08/2023,Lebanon,Kelantan,0,0,0
1/08/2023,Lebanon,Pahang,0,0,0
1/08/2023,Lebanon,Perak,0,0,0
1/08/2023,Lebanon,Perlis,0,0,0
1/08/2023,Lebanon,Pulau Pinang,0,0,0
1/08/2023,Lebanon,Sabah,0,0,0
1/08/2023,Lebanon,Sarawak,5,5,0
1/08/2023,Lebanon,Selangor,279,160,119
1/08/2023,Lebanon,W.P. Labuan,0,0,0
1/08/2023,Liberia,Johor,2,2,0
1/08/2023,Liberia,Kedah,0,0,0
1/08/2023,Liberia,Sabah,0,0,0
1/08/2023,Liberia,Sarawak,1,1,0
1/08/2023,Liberia,Selangor,8,5,3
1/08/2023,Libya,Johor,3,3,0
1/08/2023,Libya,Kedah,2,2,0
1/08/2023,Libya,Perlis,1,1,0
1/08/2023,Libya,Pulau Pinang,6,2,4
1/08/2023,Libya,Sabah,0,0,0
1/08/2023,Libya,Sarawak,0,0,0
1/08/2023,Libya,Selangor,564,395,169
1/08/2023,Saint Lucia,Johor,8,7,1
1/08/2023,Saint Lucia,Kedah,1,0,1
1/08/2023,Saint Lucia,Pulau Pinang,1,1,0
1/08/2023,Saint Lucia,Sarawak,3,2,1
1/08/2023,Saint Lucia,Selangor,10,9,1
1/08/2023,Liechtenstein,Johor,0,0,0
1/08/2023,Liechtenstein,Kedah,1,0,1
1/08/2023,Liechtenstein,Perlis,0,0,0
1/08/2023,Liechtenstein,Pulau Pinang,0,0,0
1/08/2023,Liechtenstein,Sabah,0,0,0
1/08/2023,Liechtenstein,Sarawak,0,0,0
1/08/2023,Liechtenstein,Selangor,4,3,1
1/08/2023,LKA,Johor,1545,990,555
1/08/2023,LKA,Kedah,60,30,30
1/08/2023,LKA,Kelantan,0,0,0
1/08/2023,LKA,Melaka,0,0,0
1/08/2023,LKA,Pahang,1,1,0
1/08/2023,LKA,Perak,6,4,2
1/08/2023,LKA,Perlis,2,1,1
1/08/2023,LKA,Pulau Pinang,45,17,28
1/08/2023,LKA,Sabah,5,4,1
1/08/2023,LKA,Sarawak,25,17,8
1/08/2023,LKA,Selangor,5524,3532,1992
1/08/2023,LKA,W.P. Labuan,1,1,0
1/08/2023,Lesotho,Johor,1,1,0
1/08/2023,Lesotho,Kedah,0,0,0
1/08/2023,Lesotho,Pulau Pinang,0,0,0
1/08/2023,Lesotho,Sarawak,1,1,0
1/08/2023,Lesotho,Selangor,4,1,3
1/08/2023,Lithuania,Johor,38,16,22
1/08/2023,Lithuania,Kedah,6,3,3
1/08/2023,Lithuania,Kelantan,1,1,0
1/08/2023,Lithuania,Pahang,0,0,0
1/08/2023,Lithuania,Perak,0,0,0
1/08/2023,Lithuania,Perlis,7,5,2
1/08/2023,Lithuania,Pulau Pinang,4,1,3
1/08/2023,Lithuania,Sabah,1,0,1
1/08/2023,Lithuania,Sarawak,6,2,4
1/08/2023,Lithuania,Selangor,209,109,100
1/08/2023,Lithuania,W.P. Labuan,0,0,0
1/08/2023,Luxembourg,Johor,28,17,11
1/08/2023,Luxembourg,Kedah,3,2,1
1/08/2023,Luxembourg,Kelantan,0,0,0
1/08/2023,Luxembourg,Perak,0,0,0
1/08/2023,Luxembourg,Perlis,4,2,2
1/08/2023,Luxembourg,Pulau Pinang,3,2,1
1/08/2023,Luxembourg,Sabah,0,0,0
1/08/2023,Luxembourg,Sarawak,0,0,0
1/08/2023,Luxembourg,Selangor,127,73,54
1/08/2023,Latvia,Johor,9,5,4
1/08/2023,Latvia,Kedah,0,0,0
1/08/2023,Latvia,Kelantan,0,0,0
1/08/2023,Latvia,Pahang,0,0,0
1/08/2023,Latvia,Perak,0,0,0
1/08/2023,Latvia,Perlis,1,1,0
1/08/2023,Latvia,Pulau Pinang,1,1,0
1/08/2023,Latvia,Sabah,1,1,0
1/08/2023,Latvia,Sarawak,2,1,1
1/08/2023,Latvia,Selangor,125,69,56
1/08/2023,Latvia,W.P. Labuan,0,0,0
1/08/2023,Macao,Johor,4,3,1
1/08/2023,Macao,Pahang,1,1,0
1/08/2023,Macao,Perak,0,0,0
1/08/2023,Macao,Selangor,7,3,4
1/08/2023,Macao,W.P. Labuan,0,0,0
1/08/2023,Morocco,Johor,102,58,44
1/08/2023,Morocco,Kedah,15,9,6
1/08/2023,Morocco,Kelantan,1,0,1
1/08/2023,Morocco,Melaka,0,0,0
1/08/2023,Morocco,Pahang,0,0,0
1/08/2023,Morocco,Perak,0,0,0
1/08/2023,Morocco,Perlis,4,4,0
1/08/2023,Morocco,Pulau Pinang,15,11,4
1/08/2023,Morocco,Sabah,0,0,0
1/08/2023,Morocco,Sarawak,6,6,0
1/08/2023,Morocco,Selangor,2751,1190,1561
1/08/2023,Morocco,W.P. Labuan,1,1,0
1/08/2023,Monaco,Johor,0,0,0
1/08/2023,Monaco,Kedah,0,0,0
1/08/2023,Monaco,Sabah,0,0,0
1/08/2023,Monaco,Selangor,4,2,2
1/08/2023,"Moldova, Republic of",Johor,5,2,3
1/08/2023,"Moldova, Republic of",Kedah,0,0,0
1/08/2023,"Moldova, Republic of",Kelantan,0,0,0
1/08/2023,"Moldova, Republic of",Negeri Sembilan,0,0,0
1/08/2023,"Moldova, Republic of",Perlis,0,0,0
1/08/2023,"Moldova, Republic of",Pulau Pinang,1,0,1
1/08/2023,"Moldova, Republic of",Sabah,0,0,0
1/08/2023,"Moldova, Republic of",Sarawak,0,0,0
1/08/2023,"Moldova, Republic of",Selangor,38,24,14
1/08/2023,Madagascar,Johor,19,8,11
1/08/2023,Madagascar,Kedah,2,0,2
1/08/2023,Madagascar,Perak,0,0,0
1/08/2023,Madagascar,Perlis,1,0,1
1/08/2023,Madagascar,Pulau Pinang,0,0,0
1/08/2023,Madagascar,Sabah,0,0,0
1/08/2023,Madagascar,Sarawak,1,0,1
1/08/2023,Madagascar,Selangor,318,120,198
1/08/2023,Maldives,Johor,121,73,48
1/08/2023,Maldives,Kedah,11,6,5
1/08/2023,Maldives,Kelantan,0,0,0
1/08/2023,Maldives,Perak,0,0,0
1/08/2023,Maldives,Perlis,0,0,0
1/08/2023,Maldives,Pulau Pinang,12,7,5
1/08/2023,Maldives,Sabah,1,1,0
1/08/2023,Maldives,Sarawak,1,0,1
1/08/2023,Maldives,Selangor,2222,1164,1058
1/08/2023,Mexico,Johor,155,70,85
1/08/2023,Mexico,Kedah,5,3,2
1/08/2023,Mexico,Kelantan,0,0,0
1/08/2023,Mexico,Pahang,0,0,0
1/08/2023,Mexico,Perak,1,1,0
1/08/2023,Mexico,Perlis,1,0,1
1/08/2023,Mexico,Pulau Pinang,27,18,9
1/08/2023,Mexico,Sabah,2,0,2
1/08/2023,Mexico,Sarawak,6,4,2
1/08/2023,Mexico,Selangor,499,266,233
1/08/2023,Mexico,W.P. Labuan,0,0,0
1/08/2023,Marshall Islands,Johor,1,1,0
1/08/2023,Marshall Islands,Kedah,0,0,0
1/08/2023,Marshall Islands,Perak,0,0,0
1/08/2023,Marshall Islands,Pulau Pinang,0,0,0
1/08/2023,Marshall Islands,Sabah,0,0,0
1/08/2023,Marshall Islands,Selangor,6,5,1
1/08/2023,North Macedonia,Johor,1,1,0
1/08/2023,North Macedonia,Kedah,1,1,0
1/08/2023,North Macedonia,Perak,0,0,0
1/08/2023,North Macedonia,Pulau Pinang,0,0,0
1/08/2023,North Macedonia,Sabah,0,0,0
1/08/2023,North Macedonia,Sarawak,0,0,0
1/08/2023,North Macedonia,Selangor,55,27,28
1/08/2023,Mali,Johor,3,3,0
1/08/2023,Mali,Sabah,0,0,0
1/08/2023,Mali,Selangor,12,9,3
1/08/2023,Malta,Johor,15,9,6
1/08/2023,Malta,Kedah,0,0,0
1/08/2023,Malta,Kelantan,0,0,0
1/08/2023,Malta,Perak,0,0,0
1/08/2023,Malta,Perlis,2,1,1
1/08/2023,Malta,Pulau Pinang,3,3,0
1/08/2023,Malta,Sabah,2,1,1
1/08/2023,Malta,Sarawak,0,0,0
1/08/2023,Malta,Selangor,90,51,39
1/08/2023,Malta,W.P. Labuan,0,0,0
1/08/2023,Myanmar,Johor,5709,1831,3878
1/08/2023,Myanmar,Kedah,96,26,70
1/08/2023,Myanmar,Kelantan,1,0,1
1/08/2023,Myanmar,Negeri Sembilan,1,1,0
1/08/2023,Myanmar,Pahang,2,0,2
1/08/2023,Myanmar,Perak,29,9,20
1/08/2023,Myanmar,Perlis,6,2,4
1/08/2023,Myanmar,Pulau Pinang,459,246,213
1/08/2023,Myanmar,Sabah,7,5,2
1/08/2023,Myanmar,Sarawak,75,29,46
1/08/2023,Myanmar,Selangor,7597,5249,2348
1/08/2023,Myanmar,Terengganu,0,0,0
1/08/2023,Myanmar,W.P. Labuan,0,0,0
1/08/2023,Montenegro,Johor,4,4,0
1/08/2023,Montenegro,Kedah,0,0,0
1/08/2023,Montenegro,Pulau Pinang,0,0,0
1/08/2023,Montenegro,Sabah,0,0,0
1/08/2023,Montenegro,Sarawak,0,0,0
1/08/2023,Montenegro,Selangor,17,10,7
1/08/2023,Mongolia,Johor,117,43,74
1/08/2023,Mongolia,Kedah,7,1,6
1/08/2023,Mongolia,Kelantan,0,0,0
1/08/2023,Mongolia,Perak,0,0,0
1/08/2023,Mongolia,Perlis,5,3,2
1/08/2023,Mongolia,Pulau Pinang,6,4,2
1/08/2023,Mongolia,Sabah,1,0,1
1/08/2023,Mongolia,Sarawak,0,0,0
1/08/2023,Mongolia,Selangor,320,144,176
1/08/2023,Northern Mariana Islands,Selangor,0,0,0
1/08/2023,Mozambique,Johor,0,0,0
1/08/2023,Mozambique,Kedah,0,0,0
1/08/2023,Mozambique,Perak,0,0,0
1/08/2023,Mozambique,Pulau Pinang,1,0,1
1/08/2023,Mozambique,Sabah,0,0,0
1/08/2023,Mozambique,Sarawak,0,0,0
1/08/2023,Mozambique,Selangor,31,13,18
1/08/2023,Mauritania,Johor,4,4,0
1/08/2023,Mauritania,Kedah,0,0,0
1/08/2023,Mauritania,Pulau Pinang,0,0,0
1/08/2023,Mauritania,Sabah,0,0,0
1/08/2023,Mauritania,Sarawak,0,0,0
1/08/2023,Mauritania,Selangor,26,20,6
1/08/2023,Mauritius,Johor,152,67,85
1/08/2023,Mauritius,Kedah,25,7,18
1/08/2023,Mauritius,Kelantan,0,0,0
1/08/2023,Mauritius,Pahang,0,0,0
1/08/2023,Mauritius,Perak,0,0,0
1/08/2023,Mauritius,Perlis,6,6,0
1/08/2023,Mauritius,Pulau Pinang,17,11,6
1/08/2023,Mauritius,Sabah,0,0,0
1/08/2023,Mauritius,Sarawak,1,0,1
1/08/2023,Mauritius,Selangor,1535,791,744
1/08/2023,Malawi,Johor,1,1,0
1/08/2023,Malawi,Pulau Pinang,0,0,0
1/08/2023,Malawi,Sabah,0,0,0
1/08/2023,Malawi,Sarawak,0,0,0
1/08/2023,Malawi,Selangor,24,7,17
1/08/2023,Mayotte,Selangor,0,0,0
1/08/2023,Namibia,Johor,1,0,1
1/08/2023,Namibia,Kedah,0,0,0
1/08/2023,Namibia,Perak,0,0,0
1/08/2023,Namibia,Perlis,0,0,0
1/08/2023,Namibia,Pulau Pinang,0,0,0
1/08/2023,Namibia,Sabah,0,0,0
1/08/2023,Namibia,Sarawak,0,0,0
1/08/2023,Namibia,Selangor,22,16,6
1/08/2023,New Caledonia,Selangor,0,0,0
1/08/2023,Niger,Johor,0,0,0
1/08/2023,Niger,Sabah,0,0,0
1/08/2023,Niger,Selangor,5,2,3
1/08/2023,Nigeria,Johor,39,34,5
1/08/2023,Nigeria,Kedah,2,0,2
1/08/2023,Nigeria,Perlis,0,0,0
1/08/2023,Nigeria,Pulau Pinang,4,4,0
1/08/2023,Nigeria,Sabah,0,0,0
1/08/2023,Nigeria,Sarawak,10,4,6
1/08/2023,Nigeria,Selangor,488,365,123
1/08/2023,Nicaragua,Johor,3,0,3
1/08/2023,Nicaragua,Kedah,2,0,2
1/08/2023,Nicaragua,Pulau Pinang,0,0,0
1/08/2023,Nicaragua,Sabah,0,0,0
1/08/2023,Nicaragua,Selangor,5,2,3
1/08/2023,Netherlands,Johor,1630,1012,618
1/08/2023,Netherlands,Kedah,273,148,125
1/08/2023,Netherlands,Kelantan,4,3,1
1/08/2023,Netherlands,Melaka,3,3,0
1/08/2023,Netherlands,Negeri Sembilan,0,0,0
1/08/2023,Netherlands,Pahang,0,0,0
1/08/2023,Netherlands,Perak,20,14,6
1/08/2023,Netherlands,Perlis,73,41,32
1/08/2023,Netherlands,Pulau Pinang,316,194,122
1/08/2023,Netherlands,Sabah,44,26,18
1/08/2023,Netherlands,Sarawak,175,112,63
1/08/2023,Netherlands,Selangor,7406,4046,3360
1/08/2023,Netherlands,Terengganu,0,0,0
1/08/2023,Netherlands,W.P. Labuan,5,3,2
1/08/2023,Norway,Johor,126,92,34
1/08/2023,Norway,Kedah,12,6,6
1/08/2023,Norway,Kelantan,1,1,0
1/08/2023,Norway,Melaka,0,0,0
1/08/2023,Norway,Pahang,0,0,0
1/08/2023,Norway,Perak,1,1,0
1/08/2023,Norway,Perlis,4,2,2
1/08/2023,Norway,Pulau Pinang,15,6,9
1/08/2023,Norway,Sabah,1,1,0
1/08/2023,Norway,Sarawak,9,6,3
1/08/2023,Norway,Selangor,521,303,218
1/08/2023,Norway,W.P. Labuan,1,0,1
1/08/2023,Nepal,Johor,874,629,245
1/08/2023,Nepal,Kedah,7,6,1
1/08/2023,Nepal,Pahang,0,0,0
1/08/2023,Nepal,Perak,0,0,0
1/08/2023,Nepal,Perlis,1,1,0
1/08/2023,Nepal,Pulau Pinang,11,8,3
1/08/2023,Nepal,Sabah,1,0,1
1/08/2023,Nepal,Sarawak,269,188,81
1/08/2023,Nepal,Selangor,10412,9927,485
1/08/2023,Nepal,W.P. Labuan,30,29,1
1/08/2023,Nauru,Johor,41,25,16
1/08/2023,Nauru,Pulau Pinang,0,0,0
1/08/2023,Nauru,Selangor,8,6,2
1/08/2023,New Zealand,Johor,726,445,281
1/08/2023,New Zealand,Kedah,55,34,21
1/08/2023,New Zealand,Kelantan,5,3,2
1/08/2023,New Zealand,Melaka,0,0,0
1/08/2023,New Zealand,Negeri Sembilan,0,0,0
1/08/2023,New Zealand,Pahang,6,4,2
1/08/2023,New Zealand,Perak,30,22,8
1/08/2023,New Zealand,Perlis,22,17,5
1/08/2023,New Zealand,Pulau Pinang,224,124,100
1/08/2023,New Zealand,Sabah,20,10,10
1/08/2023,New Zealand,Sarawak,149,91,58
1/08/2023,New Zealand,Selangor,2726,1646,1080
1/08/2023,New Zealand,Terengganu,0,0,0
1/08/2023,New Zealand,W.P. Labuan,2,2,0
1/08/2023,Oman,Johor,180,81,99
1/08/2023,Oman,Kedah,13,7,6
1/08/2023,Oman,Kelantan,0,0,0
1/08/2023,Oman,Melaka,0,0,0
1/08/2023,Oman,Perak,6,3,3
1/08/2023,Oman,Perlis,5,2,3
1/08/2023,Oman,Pulau Pinang,12,6,6
1/08/2023,Oman,Sabah,0,0,0
1/08/2023,Oman,Sarawak,16,10,6
1/08/2023,Oman,Selangor,3188,1603,1585
1/08/2023,Pakistan,Johor,1162,820,342
1/08/2023,Pakistan,Kedah,156,104,52
1/08/2023,Pakistan,Kelantan,13,11,2
1/08/2023,Pakistan,Melaka,0,0,0
1/08/2023,Pakistan,Negeri Sembilan,0,0,0
1/08/2023,Pakistan,Pahang,0,0,0
1/08/2023,Pakistan,Perak,10,10,0
1/08/2023,Pakistan,Perlis,15,15,0
1/08/2023,Pakistan,Pulau Pinang,82,66,16
1/08/2023,Pakistan,Sabah,20,20,0
1/08/2023,Pakistan,Sarawak,167,128,39
1/08/2023,Pakistan,Selangor,12841,10878,1963
1/08/2023,Pakistan,W.P. Labuan,3,2,1
1/08/2023,Panama,Johor,8,5,3
1/08/2023,Panama,Kedah,0,0,0
1/08/2023,Panama,Perak,0,0,0
1/08/2023,Panama,Perlis,0,0,0
1/08/2023,Panama,Pulau Pinang,0,0,0
1/08/2023,Panama,Sabah,0,0,0
1/08/2023,Panama,Sarawak,0,0,0
1/08/2023,Panama,Selangor,30,18,12
1/08/2023,Peru,Johor,40,20,20
1/08/2023,Peru,Kedah,1,1,0
1/08/2023,Peru,Kelantan,0,0,0
1/08/2023,Peru,Pahang,1,1,0
1/08/2023,Peru,Perak,0,0,0
1/08/2023,Peru,Perlis,0,0,0
1/08/2023,Peru,Pulau Pinang,3,0,3
1/08/2023,Peru,Sabah,0,0,0
1/08/2023,Peru,Sarawak,2,2,0
1/08/2023,Peru,Selangor,134,72,62
1/08/2023,Peru,W.P. Labuan,0,0,0
1/08/2023,Philippines,Johor,24915,8236,16679
1/08/2023,Philippines,Kedah,392,134,258
1/08/2023,Philippines,Kelantan,23,15,8
1/08/2023,Philippines,Melaka,0,0,0
1/08/2023,Philippines,Negeri Sembilan,0,0,0
1/08/2023,Philippines,Pahang,29,25,4
1/08/2023,Philippines,Perak,59,24,35
1/08/2023,Philippines,Perlis,168,48,120
1/08/2023,Philippines,Pulau Pinang,655,257,398
1/08/2023,Philippines,Sabah,616,356,260
1/08/2023,Philippines,Sarawak,1941,751,1190
1/08/2023,Philippines,Selangor,19043,7691,11352
1/08/2023,Philippines,Terengganu,0,0,0
1/08/2023,Philippines,W.P. Labuan,125,44,81
1/08/2023,Palau,Johor,1,1,0
1/08/2023,Palau,Pulau Pinang,0,0,0
1/08/2023,Palau,Selangor,0,0,0
1/08/2023,Papua New Guinea,Johor,8,1,7
1/08/2023,Papua New Guinea,Kedah,0,0,0
1/08/2023,Papua New Guinea,Kelantan,0,0,0
1/08/2023,Papua New Guinea,Perak,0,0,0
1/08/2023,Papua New Guinea,Pulau Pinang,1,0,1
1/08/2023,Papua New Guinea,Sabah,0,0,0
1/08/2023,Papua New Guinea,Sarawak,6,4,2
1/08/2023,Papua New Guinea,Selangor,29,16,13
1/08/2023,Poland,Johor,292,169,123
1/08/2023,Poland,Kedah,43,14,29
1/08/2023,Poland,Kelantan,0,0,0
1/08/2023,Poland,Melaka,0,0,0
1/08/2023,Poland,Negeri Sembilan,0,0,0
1/08/2023,Poland,Pahang,0,0,0
1/08/2023,Poland,Perak,0,0,0
1/08/2023,Poland,Perlis,4,1,3
1/08/2023,Poland,Pulau Pinang,62,38,24
1/08/2023,Poland,Sabah,16,9,7
1/08/2023,Poland,Sarawak,80,39,41
1/08/2023,Poland,Selangor,1397,662,735
1/08/2023,Poland,Terengganu,0,0,0
1/08/2023,Poland,W.P. Labuan,0,0,0
1/08/2023,"North Korea, Democratic People's Republic of",Selangor,0,0,0
1/08/2023,Portugal,Johor,238,127,111
1/08/2023,Portugal,Kedah,44,24,20
1/08/2023,Portugal,Kelantan,1,1,0
1/08/2023,Portugal,Melaka,0,0,0
1/08/2023,Portugal,Pahang,0,0,0
1/08/2023,Portugal,Perak,1,1,0
1/08/2023,Portugal,Perlis,7,6,1
1/08/2023,Portugal,Pulau Pinang,64,30,34
1/08/2023,Portugal,Sabah,10,7,3
1/08/2023,Portugal,Sarawak,14,8,6
1/08/2023,Portugal,Selangor,1146,607,539
1/08/2023,Portugal,W.P. Labuan,1,1,0
1/08/2023,Paraguay,Johor,2,2,0
1/08/2023,Paraguay,Kedah,0,0,0
1/08/2023,Paraguay,Perak,0,0,0
1/08/2023,Paraguay,Perlis,0,0,0
1/08/2023,Paraguay,Pulau Pinang,2,1,1
1/08/2023,Paraguay,Sabah,0,0,0
1/08/2023,Paraguay,Sarawak,1,1,0
1/08/2023,Paraguay,Selangor,14,11,3
1/08/2023,"Palestine, State of",Johor,30,27,3
1/08/2023,"Palestine, State of",Kedah,0,0,0
1/08/2023,"Palestine, State of",Kelantan,0,0,0
1/08/2023,"Palestine, State of",Melaka,0,0,0
1/08/2023,"Palestine, State of",Perak,0,0,0
1/08/2023,"Palestine, State of",Perlis,0,0,0
1/08/2023,"Palestine, State of",Pulau Pinang,1,1,0
1/08/2023,"Palestine, State of",Sabah,0,0,0
1/08/2023,"Palestine, State of",Sarawak,1,1,0
1/08/2023,"Palestine, State of",Selangor,537,326,211
1/08/2023,Qatar,Johor,77,34,43
1/08/2023,Qatar,Kedah,5,3,2
1/08/2023,Qatar,Perlis,0,0,0
1/08/2023,Qatar,Pulau Pinang,0,0,0
1/08/2023,Qatar,Sabah,0,0,0
1/08/2023,Qatar,Sarawak,1,0,1
1/08/2023,Qatar,Selangor,338,190,148
1/08/2023,Réunion,Johor,0,0,0
1/08/2023,Réunion,Sarawak,0,0,0
1/08/2023,Romania,Johor,137,82,55
1/08/2023,Romania,Kedah,5,4,1
1/08/2023,Romania,Kelantan,1,1,0
1/08/2023,Romania,Negeri Sembilan,0,0,0
1/08/2023,Romania,Pahang,0,0,0
1/08/2023,Romania,Perak,3,1,2
1/08/2023,Romania,Perlis,4,1,3
1/08/2023,Romania,Pulau Pinang,15,12,3
1/08/2023,Romania,Sabah,1,0,1
1/08/2023,Romania,Sarawak,10,6,4
1/08/2023,Romania,Selangor,667,313,354
1/08/2023,Romania,W.P. Labuan,0,0,0
1/08/2023,Russian Federation (Russia),Johor,483,235,248
1/08/2023,Russian Federation (Russia),Kedah,264,138,126
1/08/2023,Russian Federation (Russia),Kelantan,41,26,15
1/08/2023,Russian Federation (Russia),Melaka,0,0,0
1/08/2023,Russian Federation (Russia),Negeri Sembilan,1,1,0
1/08/2023,Russian Federation (Russia),Pahang,2,1,1
1/08/2023,Russian Federation (Russia),Perak,1,0,1
1/08/2023,Russian Federation (Russia),Perlis,215,123,92
1/08/2023,Russian Federation (Russia),Pulau Pinang,141,65,76
1/08/2023,Russian Federation (Russia),Sabah,17,8,9
1/08/2023,Russian Federation (Russia),Sarawak,27,15,12
1/08/2023,Russian Federation (Russia),Selangor,7069,3601,3468
1/08/2023,Russian Federation (Russia),W.P. Labuan,7,5,2
1/08/2023,Rwanda,Johor,4,2,2
1/08/2023,Rwanda,Kedah,0,0,0
1/08/2023,Rwanda,Pulau Pinang,1,1,0
1/08/2023,Rwanda,Selangor,15,9,6
1/08/2023,Saudi Arabia,Johor,482,224,258
1/08/2023,Saudi Arabia,Kedah,84,43,41
1/08/2023,Saudi Arabia,Kelantan,23,13,10
1/08/2023,Saudi Arabia,Melaka,0,0,0
1/08/2023,Saudi Arabia,Perak,10,5,5
1/08/2023,Saudi Arabia,Perlis,3,3,0
1/08/2023,Saudi Arabia,Pulau Pinang,85,45,40
1/08/2023,Saudi Arabia,Sabah,4,2,2
1/08/2023,Saudi Arabia,Sarawak,3,3,0
1/08/2023,Saudi Arabia,Selangor,7361,3893,3468
1/08/2023,Saudi Arabia,W.P. Labuan,0,0,0
1/08/2023,Sudan,Johor,12,8,4
1/08/2023,Sudan,Kedah,1,1,0
1/08/2023,Sudan,Kelantan,0,0,0
1/08/2023,Sudan,Perlis,0,0,0
1/08/2023,Sudan,Pulau Pinang,2,1,1
1/08/2023,Sudan,Sabah,0,0,0
1/08/2023,Sudan,Sarawak,0,0,0
1/08/2023,Sudan,Selangor,1464,783,681
1/08/2023,Sudan,W.P. Labuan,1,1,0
1/08/2023,Senegal,Johor,7,5,2
1/08/2023,Senegal,Kedah,1,1,0
1/08/2023,Senegal,Kelantan,0,0,0
1/08/2023,Senegal,Perak,0,0,0
1/08/2023,Senegal,Perlis,0,0,0
1/08/2023,Senegal,Pulau Pinang,0,0,0
1/08/2023,Senegal,Sabah,0,0,0
1/08/2023,Senegal,Sarawak,0,0,0
1/08/2023,Senegal,Selangor,137,74,63
1/08/2023,Singapore,Johor,1198428,694040,504388
1/08/2023,Singapore,Kedah,4225,2203,2022
1/08/2023,Singapore,Kelantan,67,52,15
1/08/2023,Singapore,Melaka,36,24,12
1/08/2023,Singapore,Negeri Sembilan,0,0,0
1/08/2023,Singapore,Pahang,468,239,229
1/08/2023,Singapore,Perak,5898,2601,3297
1/08/2023,Singapore,Perlis,192,123,69
1/08/2023,Singapore,Pulau Pinang,18427,8890,9537
1/08/2023,Singapore,Sabah,610,330,280
1/08/2023,Singapore,Sarawak,3789,2226,1563
1/08/2023,Singapore,Selangor,43929,22787,21142
1/08/2023,Singapore,Terengganu,0,0,0
1/08/2023,Singapore,W.P. Labuan,11,11,0
1/08/2023,South Georgia and the South Sandwich Islands,Johor,0,0,0
1/08/2023,South Georgia and the South Sandwich Islands,Sabah,0,0,0
1/08/2023,South Georgia and the South Sandwich Islands,Selangor,0,0,0
1/08/2023,Saint Helena,Sarawak,0,0,0
1/08/2023,Solomon Islands,Johor,1,1,0
1/08/2023,Solomon Islands,Perlis,0,0,0
1/08/2023,Solomon Islands,Pulau Pinang,1,1,0
1/08/2023,Solomon Islands,Sabah,0,0,0
1/08/2023,Solomon Islands,Sarawak,1,1,0
1/08/2023,Solomon Islands,Selangor,4,3,1
1/08/2023,Solomon Islands,W.P. Labuan,0,0,0
1/08/2023,Sierra Leone,Johor,4,3,1
1/08/2023,Sierra Leone,Kedah,0,0,0
1/08/2023,Sierra Leone,Perak,0,0,0
1/08/2023,Sierra Leone,Pulau Pinang,0,0,0
1/08/2023,Sierra Leone,Sabah,0,0,0
1/08/2023,Sierra Leone,Selangor,15,12,3
1/08/2023,El Salvador,Johor,3,0,3
1/08/2023,El Salvador,Kedah,0,0,0
1/08/2023,El Salvador,Perak,1,0,1
1/08/2023,El Salvador,Perlis,0,0,0
1/08/2023,El Salvador,Pulau Pinang,0,0,0
1/08/2023,El Salvador,Sabah,1,1,0
1/08/2023,El Salvador,Selangor,18,6,12
1/08/2023,El Salvador,W.P. Labuan,0,0,0
1/08/2023,San Marino,Johor,0,0,0
1/08/2023,San Marino,Selangor,4,2,2
1/08/2023,Somalia,Johor,0,0,0
1/08/2023,Somalia,Kedah,0,0,0
1/08/2023,Somalia,Kelantan,0,0,0
1/08/2023,Somalia,Perlis,0,0,0
1/08/2023,Somalia,Sabah,0,0,0
1/08/2023,Somalia,Sarawak,0,0,0
1/08/2023,Somalia,Selangor,248,139,109
1/08/2023,Serbia,Johor,17,13,4
1/08/2023,Serbia,Kedah,0,0,0
1/08/2023,Serbia,Kelantan,1,1,0
1/08/2023,Serbia,Pahang,0,0,0
1/08/2023,Serbia,Perak,0,0,0
1/08/2023,Serbia,Perlis,0,0,0
1/08/2023,Serbia,Pulau Pinang,1,1,0
1/08/2023,Serbia,Sabah,0,0,0
1/08/2023,Serbia,Sarawak,0,0,0
1/08/2023,Serbia,Selangor,81,38,43
1/08/2023,South Sudan,Johor,10,7,3
1/08/2023,South Sudan,Kedah,0,0,0
1/08/2023,South Sudan,Sarawak,1,1,0
1/08/2023,South Sudan,Selangor,59,37,22
1/08/2023,South Sudan,W.P. Labuan,0,0,0
1/08/2023,Sao Tome and Principe,Selangor,2,2,0
1/08/2023,Suriname,Johor,4,2,2
1/08/2023,Suriname,Kedah,0,0,0
1/08/2023,Suriname,Kelantan,0,0,0
1/08/2023,Suriname,Perak,0,0,0
1/08/2023,Suriname,Perlis,0,0,0
1/08/2023,Suriname,Pulau Pinang,0,0,0
1/08/2023,Suriname,Sabah,0,0,0
1/08/2023,Suriname,Sarawak,0,0,0
1/08/2023,Suriname,Selangor,38,23,15
1/08/2023,Slovakia,Johor,49,23,26
1/08/2023,Slovakia,Kedah,25,10,15
1/08/2023,Slovakia,Kelantan,2,2,0
1/08/2023,Slovakia,Negeri Sembilan,0,0,0
1/08/2023,Slovakia,Pahang,0,0,0
1/08/2023,Slovakia,Perak,0,0,0
1/08/2023,Slovakia,Perlis,2,1,1
1/08/2023,Slovakia,Pulau Pinang,20,13,7
1/08/2023,Slovakia,Sabah,1,1,0
1/08/2023,Slovakia,Sarawak,7,4,3
1/08/2023,Slovakia,Selangor,231,119,112
1/08/2023,Slovakia,W.P. Labuan,0,0,0
1/08/2023,Slovenia,Johor,24,8,16
1/08/2023,Slovenia,Kedah,4,3,1
1/08/2023,Slovenia,Kelantan,0,0,0
1/08/2023,Slovenia,Perak,0,0,0
1/08/2023,Slovenia,Perlis,1,1,0
1/08/2023,Slovenia,Pulau Pinang,2,1,1
1/08/2023,Slovenia,Sabah,1,0,1
1/08/2023,Slovenia,Sarawak,6,4,2
1/08/2023,Slovenia,Selangor,151,80,71
1/08/2023,Slovenia,W.P. Labuan,0,0,0
1/08/2023,Sweden,Johor,219,142,77
1/08/2023,Sweden,Kedah,35,26,9
1/08/2023,Sweden,Kelantan,14,8,6
1/08/2023,Sweden,Melaka,0,0,0
1/08/2023,Sweden,Negeri Sembilan,0,0,0
1/08/2023,Sweden,Pahang,0,0,0
1/08/2023,Sweden,Perak,3,3,0
1/08/2023,Sweden,Perlis,8,7,1
1/08/2023,Sweden,Pulau Pinang,50,31,19
1/08/2023,Sweden,Sabah,3,0,3
1/08/2023,Sweden,Sarawak,49,32,17
1/08/2023,Sweden,Selangor,818,525,293
1/08/2023,Sweden,W.P. Labuan,0,0,0
1/08/2023,Eswatini,Johor,0,0,0
1/08/2023,Eswatini,Kedah,1,0,1
1/08/2023,Eswatini,Pulau Pinang,0,0,0
1/08/2023,Eswatini,Sabah,0,0,0
1/08/2023,Eswatini,Selangor,25,12,13
1/08/2023,Seychelles,Johor,7,4,3
1/08/2023,Seychelles,Kedah,0,0,0
1/08/2023,Seychelles,Pulau Pinang,0,0,0
1/08/2023,Seychelles,Sabah,1,1,0
1/08/2023,Seychelles,Sarawak,0,0,0
1/08/2023,Seychelles,Selangor,106,45,61
1/08/2023,Syrian Arab Republic,Johor,16,12,4
1/08/2023,Syrian Arab Republic,Kedah,1,1,0
1/08/2023,Syrian Arab Republic,Kelantan,0,0,0
1/08/2023,Syrian Arab Republic,Pahang,0,0,0
1/08/2023,Syrian Arab Republic,Perlis,0,0,0
1/08/2023,Syrian Arab Republic,Pulau Pinang,8,5,3
1/08/2023,Syrian Arab Republic,Sabah,0,0,0
1/08/2023,Syrian Arab Republic,Sarawak,2,2,0
1/08/2023,Syrian Arab Republic,Selangor,895,486,409
1/08/2023,Syrian Arab Republic,W.P. Labuan,0,0,0
1/08/2023,Turks and Caicos Islands,Perlis,0,0,0
1/08/2023,TCD,Johor,4,2,2
1/08/2023,TCD,Kedah,0,0,0
1/08/2023,TCD,Perlis,0,0,0
1/08/2023,TCD,Selangor,18,14,4
1/08/2023,Togo,Johor,3,2,1
1/08/2023,Togo,Perak,0,0,0
1/08/2023,Togo,Pulau Pinang,0,0,0
1/08/2023,Togo,Selangor,14,11,3
1/08/2023,Thailand,Johor,6278,1612,4666
1/08/2023,Thailand,Kedah,58229,34008,24221
1/08/2023,Thailand,Kelantan,34580,18957,15623
1/08/2023,Thailand,Melaka,1,1,0
1/08/2023,Thailand,Negeri Sembilan,0,0,0
1/08/2023,Thailand,Pahang,16,8,8
1/08/2023,Thailand,Perak,11287,5454,5833
1/08/2023,Thailand,Perlis,44145,25712,18433
1/08/2023,Thailand,Pulau Pinang,2014,821,1193
1/08/2023,Thailand,Sabah,8,5,3
1/08/2023,Thailand,Sarawak,322,108,214
1/08/2023,Thailand,Selangor,14524,5963,8561
1/08/2023,Thailand,Terengganu,0,0,0
1/08/2023,Thailand,W.P. Labuan,13,4,9
1/08/2023,Tajikistan,Johor,2,1,1
1/08/2023,Tajikistan,Kedah,1,0,1
1/08/2023,Tajikistan,Perlis,0,0,0
1/08/2023,Tajikistan,Pulau Pinang,5,2,3
1/08/2023,Tajikistan,Sabah,1,1,0
1/08/2023,Tajikistan,Selangor,118,93,25
1/08/2023,Tokelau,Selangor,0,0,0
1/08/2023,Turkmenistan,Johor,4,2,2
1/08/2023,Turkmenistan,Kedah,0,0,0
1/08/2023,Turkmenistan,Kelantan,0,0,0
1/08/2023,Turkmenistan,Perlis,0,0,0
1/08/2023,Turkmenistan,Pulau Pinang,1,1,0
1/08/2023,Turkmenistan,Sabah,1,1,0
1/08/2023,Turkmenistan,Sarawak,0,0,0
1/08/2023,Turkmenistan,Selangor,205,112,93
1/08/2023,Timor-Leste,Johor,4,0,4
1/08/2023,Timor-Leste,Kedah,0,0,0
1/08/2023,Timor-Leste,Perlis,0,0,0
1/08/2023,Timor-Leste,Pulau Pinang,12,7,5
1/08/2023,Timor-Leste,Sabah,0,0,0
1/08/2023,Timor-Leste,Sarawak,5,4,1
1/08/2023,Timor-Leste,Selangor,270,151,119
1/08/2023,Tonga,Johor,0,0,0
1/08/2023,Tonga,Pulau Pinang,2,0,2
1/08/2023,Tonga,Sarawak,0,0,0
1/08/2023,Tonga,Selangor,10,3,7
1/08/2023,Trinidad and Tobago,Johor,5,2,3
1/08/2023,Trinidad and Tobago,Kedah,0,0,0
1/08/2023,Trinidad and Tobago,Pahang,0,0,0
1/08/2023,Trinidad and Tobago,Pulau Pinang,4,2,2
1/08/2023,Trinidad and Tobago,Sabah,0,0,0
1/08/2023,Trinidad and Tobago,Sarawak,1,0,1
1/08/2023,Trinidad and Tobago,Selangor,50,27,23
1/08/2023,Tunisia,Johor,10,9,1
1/08/2023,Tunisia,Kedah,4,3,1
1/08/2023,Tunisia,Kelantan,2,2,0
1/08/2023,Tunisia,Melaka,0,0,0
1/08/2023,Tunisia,Perak,0,0,0
1/08/2023,Tunisia,Perlis,0,0,0
1/08/2023,Tunisia,Pulau Pinang,1,1,0
1/08/2023,Tunisia,Sabah,1,0,1
1/08/2023,Tunisia,Sarawak,3,3,0
1/08/2023,Tunisia,Selangor,2252,1014,1238
1/08/2023,Tunisia,W.P. Labuan,0,0,0
1/08/2023,Türkiye,Johor,376,271,105
1/08/2023,Türkiye,Kedah,56,33,23
1/08/2023,Türkiye,Kelantan,2,2,0
1/08/2023,Türkiye,Melaka,0,0,0
1/08/2023,Türkiye,Negeri Sembilan,2,1,1
1/08/2023,Türkiye,Pahang,0,0,0
1/08/2023,Türkiye,Perak,1,1,0
1/08/2023,Türkiye,Perlis,30,27,3
1/08/2023,Türkiye,Pulau Pinang,27,22,5
1/08/2023,Türkiye,Sabah,4,2,2
1/08/2023,Türkiye,Sarawak,23,18,5
1/08/2023,Türkiye,Selangor,1498,1014,484
1/08/2023,Türkiye,W.P. Labuan,1,1,0
1/08/2023,Tuvalu,Selangor,0,0,0
1/08/2023,"Taiwan, Province of China",Johor,9321,4190,5131
1/08/2023,"Taiwan, Province of China",Kedah,159,75,84
1/08/2023,"Taiwan, Province of China",Kelantan,0,0,0
1/08/2023,"Taiwan, Province of China",Melaka,4,3,1
1/08/2023,"Taiwan, Province of China",Negeri Sembilan,0,0,0
1/08/2023,"Taiwan, Province of China",Pahang,8,3,5
1/08/2023,"Taiwan, Province of China",Perak,59,35,24
1/08/2023,"Taiwan, Province of China",Perlis,33,17,16
1/08/2023,"Taiwan, Province of China",Pulau Pinang,4854,2338,2516
1/08/2023,"Taiwan, Province of China",Sabah,241,144,97
1/08/2023,"Taiwan, Province of China",Sarawak,338,156,182
1/08/2023,"Taiwan, Province of China",Selangor,20807,10105,10702
1/08/2023,"Taiwan, Province of China",W.P. Labuan,3,2,1
1/08/2023,"Tanzania, United Republic of",Johor,43,24,19
1/08/2023,"Tanzania, United Republic of",Kedah,0,0,0
1/08/2023,"Tanzania, United Republic of",Perak,0,0,0
1/08/2023,"Tanzania, United Republic of",Perlis,0,0,0
1/08/2023,"Tanzania, United Republic of",Pulau Pinang,0,0,0
1/08/2023,"Tanzania, United Republic of",Sabah,0,0,0
1/08/2023,"Tanzania, United Republic of",Sarawak,4,4,0
1/08/2023,"Tanzania, United Republic of",Selangor,201,107,94
1/08/2023,Uganda,Johor,22,8,14
1/08/2023,Uganda,Kedah,2,0,2
1/08/2023,Uganda,Perak,0,0,0
1/08/2023,Uganda,Perlis,0,0,0
1/08/2023,Uganda,Pulau Pinang,2,1,1
1/08/2023,Uganda,Sabah,0,0,0
1/08/2023,Uganda,Sarawak,0,0,0
1/08/2023,Uganda,Selangor,112,45,67
1/08/2023,Ukraine,Johor,122,69,53
1/08/2023,Ukraine,Kedah,17,8,9
1/08/2023,Ukraine,Kelantan,1,1,0
1/08/2023,Ukraine,Melaka,0,0,0
1/08/2023,Ukraine,Negeri Sembilan,0,0,0
1/08/2023,Ukraine,Pahang,3,3,0
1/08/2023,Ukraine,Perak,0,0,0
1/08/2023,Ukraine,Perlis,7,3,4
1/08/2023,Ukraine,Pulau Pinang,17,6,11
1/08/2023,Ukraine,Sabah,1,1,0
1/08/2023,Ukraine,Sarawak,10,3,7
1/08/2023,Ukraine,Selangor,950,471,479
1/08/2023,Ukraine,W.P. Labuan,0,0,0
1/08/2023,Uruguay,Johor,4,2,2
1/08/2023,Uruguay,Kedah,1,1,0
1/08/2023,Uruguay,Kelantan,0,0,0
1/08/2023,Uruguay,Perak,0,0,0
1/08/2023,Uruguay,Perlis,0,0,0
1/08/2023,Uruguay,Pulau Pinang,0,0,0
1/08/2023,Uruguay,Sabah,0,0,0
1/08/2023,Uruguay,Sarawak,1,1,0
1/08/2023,Uruguay,Selangor,78,49,29
1/08/2023,Uruguay,W.P. Labuan,0,0,0
1/08/2023,United States of America,Johor,4514,2677,1837
1/08/2023,United States of America,Kedah,389,217,172
1/08/2023,United States of America,Kelantan,7,5,2
1/08/2023,United States of America,Melaka,1,0,1
1/08/2023,United States of America,Negeri Sembilan,0,0,0
1/08/2023,United States of America,Pahang,13,8,5
1/08/2023,United States of America,Perak,229,115,114
1/08/2023,United States of America,Perlis,95,60,35
1/08/2023,United States of America,Pulau Pinang,2069,1247,822
1/08/2023,United States of America,Sabah,57,34,23
1/08/2023,United States of America,Sarawak,282,162,120
1/08/2023,United States of America,Selangor,14499,8628,5871
1/08/2023,United States of America,Terengganu,0,0,0
1/08/2023,United States of America,W.P. Labuan,13,9,4
1/08/2023,Uzbekistan,Johor,82,59,23
1/08/2023,Uzbekistan,Kedah,5,0,5
1/08/2023,Uzbekistan,Kelantan,0,0,0
1/08/2023,Uzbekistan,Perak,0,0,0
1/08/2023,Uzbekistan,Perlis,1,1,0
1/08/2023,Uzbekistan,Pulau Pinang,27,9,18
1/08/2023,Uzbekistan,Sabah,3,2,1
1/08/2023,Uzbekistan,Sarawak,3,0,3
1/08/2023,Uzbekistan,Selangor,1280,773,507
1/08/2023,Holy See,Johor,0,0,0
1/08/2023,Holy See,Sarawak,0,0,0
1/08/2023,Holy See,Selangor,0,0,0
1/08/2023,Saint Vincent and the Grenadines,Johor,0,0,0
1/08/2023,Saint Vincent and the Grenadines,Kedah,0,0,0
1/08/2023,Saint Vincent and the Grenadines,Pulau Pinang,0,0,0
1/08/2023,Saint Vincent and the Grenadines,Sarawak,0,0,0
1/08/2023,Saint Vincent and the Grenadines,Selangor,1,1,0
1/08/2023,"Venezuela, Bolivarian Republic of",Johor,17,9,8
1/08/2023,"Venezuela, Bolivarian Republic of",Kedah,4,3,1
1/08/2023,"Venezuela, Bolivarian Republic of",Kelantan,0,0,0
1/08/2023,"Venezuela, Bolivarian Republic of",Melaka,0,0,0
1/08/2023,"Venezuela, Bolivarian Republic of",Perak,0,0,0
1/08/2023,"Venezuela, Bolivarian Republic of",Perlis,0,0,0
1/08/2023,"Venezuela, Bolivarian Republic of",Pulau Pinang,0,0,0
1/08/2023,"Venezuela, Bolivarian Republic of",Sabah,0,0,0
1/08/2023,"Venezuela, Bolivarian Republic of",Sarawak,0,0,0
1/08/2023,"Venezuela, Bolivarian Republic of",Selangor,91,53,38
1/08/2023,"Venezuela, Bolivarian Republic of",W.P. Labuan,0,0,0
1/08/2023,Viet Nam,Johor,21679,7775,13904
1/08/2023,Viet Nam,Kedah,241,39,202
1/08/2023,Viet Nam,Kelantan,18,14,4
1/08/2023,Viet Nam,Melaka,0,0,0
1/08/2023,Viet Nam,Negeri Sembilan,0,0,0
1/08/2023,Viet Nam,Pahang,0,0,0
1/08/2023,Viet Nam,Perak,85,9,76
1/08/2023,Viet Nam,Perlis,283,25,258
1/08/2023,Viet Nam,Pulau Pinang,1724,554,1170
1/08/2023,Viet Nam,Sabah,8,5,3
1/08/2023,Viet Nam,Sarawak,135,35,100
1/08/2023,Viet Nam,Selangor,19361,7455,11906
1/08/2023,Viet Nam,Terengganu,0,0,0
1/08/2023,Viet Nam,W.P. Labuan,3,2,1
1/08/2023,Vanuatu,Johor,73,58,15
1/08/2023,Vanuatu,Kedah,0,0,0
1/08/2023,Vanuatu,Pulau Pinang,6,3,3
1/08/2023,Vanuatu,Sabah,2,2,0
1/08/2023,Vanuatu,Sarawak,1,1,0
1/08/2023,Vanuatu,Selangor,83,64,19
1/08/2023, Samoa,Johor,2,0,2
1/08/2023, Samoa,Sarawak,0,0,0
1/08/2023, Samoa,Selangor,1,0,1
1/08/2023,Yemen,Johor,51,34,17
1/08/2023,Yemen,Kedah,1,1,0
1/08/2023,Yemen,Kelantan,1,1,0
1/08/2023,Yemen,Melaka,0,0,0
1/08/2023,Yemen,Pahang,0,0,0
1/08/2023,Yemen,Perak,0,0,0
1/08/2023,Yemen,Perlis,1,1,0
1/08/2023,Yemen,Pulau Pinang,8,6,2
1/08/2023,Yemen,Sabah,0,0,0
1/08/2023,Yemen,Sarawak,1,0,1
1/08/2023,Yemen,Selangor,1707,1107,600
1/08/2023,Yemen,W.P. Labuan,0,0,0
1/08/2023,South Africa,Johor,243,143,100
1/08/2023,South Africa,Kedah,23,14,9
1/08/2023,South Africa,Kelantan,2,2,0
1/08/2023,South Africa,Melaka,0,0,0
1/08/2023,South Africa,Pahang,0,0,0
1/08/2023,South Africa,Perak,3,2,1
1/08/2023,South Africa,Perlis,18,9,9
1/08/2023,South Africa,Pulau Pinang,67,37,30
1/08/2023,South Africa,Sabah,8,5,3
1/08/2023,South Africa,Sarawak,112,52,60
1/08/2023,South Africa,Selangor,914,512,402
1/08/2023,South Africa,Terengganu,0,0,0
1/08/2023,South Africa,W.P. Labuan,13,5,8
1/08/2023,ZAR,Selangor,0,0,0
1/08/2023,Zambia,Johor,2,1,1
1/08/2023,Zambia,Kedah,0,0,0
1/08/2023,Zambia,Perak,0,0,0
1/08/2023,Zambia,Perlis,0,0,0
1/08/2023,Zambia,Pulau Pinang,0,0,0
1/08/2023,Zambia,Sabah,0,0,0
1/08/2023,Zambia,Sarawak,1,0,1
1/08/2023,Zambia,Selangor,77,45,32
1/08/2023,Zimbabwe,Johor,3,0,3
1/08/2023,Zimbabwe,Kedah,1,0,1
1/08/2023,Zimbabwe,Kelantan,0,0,0
1/08/2023,Zimbabwe,Perak,0,0,0
1/08/2023,Zimbabwe,Perlis,0,0,0
1/08/2023,Zimbabwe,Pulau Pinang,13,7,6
1/08/2023,Zimbabwe,Sabah,1,1,0
1/08/2023,Zimbabwe,Sarawak,1,1,0
1/08/2023,Zimbabwe,Selangor,179,82,97
1/09/2023,Aruba,Kedah,0,0,0
1/09/2023,Aruba,Pulau Pinang,0,0,0
1/09/2023,Afghanistan,Johor,2,2,0
1/09/2023,Afghanistan,Kedah,2,2,0
1/09/2023,Afghanistan,Perlis,0,0,0
1/09/2023,Afghanistan,Pulau Pinang,0,0,0
1/09/2023,Afghanistan,Sarawak,0,0,0
1/09/2023,Afghanistan,Selangor,62,50,12
1/09/2023,Angola,Johor,0,0,0
1/09/2023,Angola,Kedah,0,0,0
1/09/2023,Angola,Sabah,0,0,0
1/09/2023,Angola,Selangor,7,3,4
1/09/2023,Anguilla,Selangor,0,0,0
1/09/2023,Albania,Johor,25,19,6
1/09/2023,Albania,Kedah,1,1,0
1/09/2023,Albania,Perak,0,0,0
1/09/2023,Albania,Perlis,0,0,0
1/09/2023,Albania,Pulau Pinang,0,0,0
1/09/2023,Albania,Sabah,0,0,0
1/09/2023,Albania,Sarawak,0,0,0
1/09/2023,Albania,Selangor,34,17,17
1/09/2023,Andorra,Johor,1,1,0
1/09/2023,Andorra,Kedah,0,0,0
1/09/2023,Andorra,Perlis,0,0,0
1/09/2023,Andorra,Pulau Pinang,0,0,0
1/09/2023,Andorra,Selangor,7,3,4
1/09/2023,Antigua and Barbuda,Selangor,0,0,0
1/09/2023,United Arab Emirates,Johor,8,5,3
1/09/2023,United Arab Emirates,Kedah,4,1,3
1/09/2023,United Arab Emirates,Kelantan,0,0,0
1/09/2023,United Arab Emirates,Perak,0,0,0
1/09/2023,United Arab Emirates,Perlis,0,0,0
1/09/2023,United Arab Emirates,Pulau Pinang,6,4,2
1/09/2023,United Arab Emirates,Sabah,0,0,0
1/09/2023,United Arab Emirates,Sarawak,0,0,0
1/09/2023,United Arab Emirates,Selangor,361,243,118
1/09/2023,Argentina,Johor,51,27,24
1/09/2023,Argentina,Kedah,11,5,6
1/09/2023,Argentina,Kelantan,4,2,2
1/09/2023,Argentina,Melaka,0,0,0
1/09/2023,Argentina,Perak,0,0,0
1/09/2023,Argentina,Perlis,3,2,1
1/09/2023,Argentina,Pulau Pinang,1,0,1
1/09/2023,Argentina,Sabah,1,1,0
1/09/2023,Argentina,Sarawak,1,1,0
1/09/2023,Argentina,Selangor,409,231,178
1/09/2023,Argentina,W.P. Labuan,3,1,2
1/09/2023,Armenia,Johor,0,0,0
1/09/2023,Armenia,Kedah,0,0,0
1/09/2023,Armenia,Kelantan,0,0,0
1/09/2023,Armenia,Perak,0,0,0
1/09/2023,Armenia,Perlis,0,0,0
1/09/2023,Armenia,Pulau Pinang,2,0,2
1/09/2023,Armenia,Sabah,0,0,0
1/09/2023,Armenia,Sarawak,0,0,0
1/09/2023,Armenia,Selangor,58,35,23
1/09/2023,Antarctica,Selangor,0,0,0
1/09/2023,Antigua and Barbuda,Johor,6,3,3
1/09/2023,Antigua and Barbuda,Kedah,0,0,0
1/09/2023,Antigua and Barbuda,Pulau Pinang,0,0,0
1/09/2023,Antigua and Barbuda,Sarawak,0,0,0
1/09/2023,Antigua and Barbuda,Selangor,19,12,7
1/09/2023,Australia,Johor,5978,3502,2476
1/09/2023,Australia,Kedah,537,273,264
1/09/2023,Australia,Kelantan,3,3,0
1/09/2023,Australia,Melaka,1,1,0
1/09/2023,Australia,Negeri Sembilan,2,2,0
1/09/2023,Australia,Pahang,21,11,10
1/09/2023,Australia,Perak,221,117,104
1/09/2023,Australia,Perlis,67,47,20
1/09/2023,Australia,Pulau Pinang,2032,1123,909
1/09/2023,Australia,Sabah,116,65,51
1/09/2023,Australia,Sarawak,580,305,275
1/09/2023,Australia,Selangor,29390,16640,12750
1/09/2023,Australia,Terengganu,1,1,0
1/09/2023,Australia,W.P. Labuan,3,2,1
1/09/2023,Austria,Johor,203,144,59
1/09/2023,Austria,Kedah,29,12,17
1/09/2023,Austria,Kelantan,3,2,1
1/09/2023,Austria,Melaka,0,0,0
1/09/2023,Austria,Negeri Sembilan,0,0,0
1/09/2023,Austria,Pahang,0,0,0
1/09/2023,Austria,Perak,2,2,0
1/09/2023,Austria,Perlis,1,0,1
1/09/2023,Austria,Pulau Pinang,66,41,25
1/09/2023,Austria,Sabah,0,0,0
1/09/2023,Austria,Sarawak,16,7,9
1/09/2023,Austria,Selangor,810,481,329
1/09/2023,Austria,Terengganu,0,0,0
1/09/2023,Austria,W.P. Labuan,0,0,0
1/09/2023,Azerbaijan,Johor,4,3,1
1/09/2023,Azerbaijan,Kedah,0,0,0
1/09/2023,Azerbaijan,Kelantan,0,0,0
1/09/2023,Azerbaijan,Melaka,0,0,0
1/09/2023,Azerbaijan,Perlis,0,0,0
1/09/2023,Azerbaijan,Pulau Pinang,4,2,2
1/09/2023,Azerbaijan,Sabah,0,0,0
1/09/2023,Azerbaijan,Sarawak,6,1,5
1/09/2023,Azerbaijan,Selangor,138,84,54
1/09/2023,Azerbaijan,W.P. Labuan,5,5,0
1/09/2023,Burundi,Pulau Pinang,1,0,1
1/09/2023,Burundi,Sarawak,0,0,0
1/09/2023,Burundi,Selangor,31,9,22
1/09/2023,Belgium,Johor,387,217,170
1/09/2023,Belgium,Kedah,41,25,16
1/09/2023,Belgium,Kelantan,1,1,0
1/09/2023,Belgium,Melaka,0,0,0
1/09/2023,Belgium,Negeri Sembilan,0,0,0
1/09/2023,Belgium,Pahang,6,3,3
1/09/2023,Belgium,Perak,2,1,1
1/09/2023,Belgium,Perlis,11,6,5
1/09/2023,Belgium,Pulau Pinang,69,47,22
1/09/2023,Belgium,Sabah,11,6,5
1/09/2023,Belgium,Sarawak,25,12,13
1/09/2023,Belgium,Selangor,1655,909,746
1/09/2023,Belgium,W.P. Labuan,0,0,0
1/09/2023,Benin,Johor,2,2,0
1/09/2023,Benin,Kedah,0,0,0
1/09/2023,Benin,Perak,0,0,0
1/09/2023,Benin,Pulau Pinang,0,0,0
1/09/2023,Benin,Sabah,0,0,0
1/09/2023,Benin,Sarawak,0,0,0
1/09/2023,Benin,Selangor,23,17,6
1/09/2023,Burkina Faso,Perak,0,0,0
1/09/2023,Burkina Faso,Pulau Pinang,1,1,0
1/09/2023,Burkina Faso,Selangor,26,22,4
1/09/2023,Bangladesh,Johor,3848,3272,576
1/09/2023,Bangladesh,Kedah,117,67,50
1/09/2023,Bangladesh,Kelantan,1,1,0
1/09/2023,Bangladesh,Melaka,0,0,0
1/09/2023,Bangladesh,Negeri Sembilan,0,0,0
1/09/2023,Bangladesh,Pahang,2,0,2
1/09/2023,Bangladesh,Perak,3,2,1
1/09/2023,Bangladesh,Perlis,9,6,3
1/09/2023,Bangladesh,Pulau Pinang,413,394,19
1/09/2023,Bangladesh,Sabah,1,0,1
1/09/2023,Bangladesh,Sarawak,49,37,12
1/09/2023,Bangladesh,Selangor,51900,50055,1845
1/09/2023,Bangladesh,W.P. Labuan,3,3,0
1/09/2023,Bulgaria,Johor,44,24,20
1/09/2023,Bulgaria,Kedah,4,4,0
1/09/2023,Bulgaria,Kelantan,0,0,0
1/09/2023,Bulgaria,Pahang,0,0,0
1/09/2023,Bulgaria,Perak,0,0,0
1/09/2023,Bulgaria,Perlis,0,0,0
1/09/2023,Bulgaria,Pulau Pinang,3,1,2
1/09/2023,Bulgaria,Sabah,2,1,1
1/09/2023,Bulgaria,Sarawak,1,1,0
1/09/2023,Bulgaria,Selangor,223,132,91
1/09/2023,Bulgaria,W.P. Labuan,0,0,0
1/09/2023,Bahrain,Johor,13,7,6
1/09/2023,Bahrain,Kedah,1,1,0
1/09/2023,Bahrain,Kelantan,0,0,0
1/09/2023,Bahrain,Perlis,0,0,0
1/09/2023,Bahrain,Pulau Pinang,9,5,4
1/09/2023,Bahrain,Sabah,0,0,0
1/09/2023,Bahrain,Sarawak,1,1,0
1/09/2023,Bahrain,Selangor,167,92,75
1/09/2023,Bahamas,Johor,0,0,0
1/09/2023,Bahamas,Kedah,0,0,0
1/09/2023,Bahamas,Perak,0,0,0
1/09/2023,Bahamas,Sabah,0,0,0
1/09/2023,Bahamas,Sarawak,0,0,0
1/09/2023,Bahamas,Selangor,6,3,3
1/09/2023,Bosnia and Herzegovina,Johor,11,7,4
1/09/2023,Bosnia and Herzegovina,Kedah,1,0,1
1/09/2023,Bosnia and Herzegovina,Perlis,0,0,0
1/09/2023,Bosnia and Herzegovina,Pulau Pinang,2,2,0
1/09/2023,Bosnia and Herzegovina,Sabah,0,0,0
1/09/2023,Bosnia and Herzegovina,Sarawak,1,1,0
1/09/2023,Bosnia and Herzegovina,Selangor,90,65,25
1/09/2023,Belarus,Johor,12,7,5
1/09/2023,Belarus,Kedah,2,2,0
1/09/2023,Belarus,Kelantan,1,1,0
1/09/2023,Belarus,Pahang,0,0,0
1/09/2023,Belarus,Perak,0,0,0
1/09/2023,Belarus,Perlis,1,0,1
1/09/2023,Belarus,Pulau Pinang,11,7,4
1/09/2023,Belarus,Sabah,1,0,1
1/09/2023,Belarus,Sarawak,5,3,2
1/09/2023,Belarus,Selangor,311,156,155
1/09/2023,Belarus,W.P. Labuan,0,0,0
1/09/2023,Belize,Johor,0,0,0
1/09/2023,Belize,Pulau Pinang,1,1,0
1/09/2023,Belize,Sarawak,0,0,0
1/09/2023,Belize,Selangor,8,2,6
1/09/2023,Bermuda,Selangor,0,0,0
1/09/2023,Bolivia,Johor,4,3,1
1/09/2023,Bolivia,Kedah,0,0,0
1/09/2023,Bolivia,Melaka,0,0,0
1/09/2023,Bolivia,Perak,0,0,0
1/09/2023,Bolivia,Perlis,0,0,0
1/09/2023,Bolivia,Pulau Pinang,0,0,0
1/09/2023,Bolivia,Sabah,0,0,0
1/09/2023,Bolivia,Sarawak,1,1,0
1/09/2023,Bolivia,Selangor,16,7,9
1/09/2023,Brazil,Johor,278,177,101
1/09/2023,Brazil,Kedah,35,18,17
1/09/2023,Brazil,Kelantan,0,0,0
1/09/2023,Brazil,Melaka,0,0,0
1/09/2023,Brazil,Pahang,1,0,1
1/09/2023,Brazil,Perak,1,1,0
1/09/2023,Brazil,Perlis,3,2,1
1/09/2023,Brazil,Pulau Pinang,23,14,9
1/09/2023,Brazil,Sabah,2,2,0
1/09/2023,Brazil,Sarawak,10,3,7
1/09/2023,Brazil,Selangor,986,590,396
1/09/2023,Brazil,W.P. Labuan,0,0,0
1/09/2023,Barbados,Johor,2,0,2
1/09/2023,Barbados,Kedah,0,0,0
1/09/2023,Barbados,Perlis,0,0,0
1/09/2023,Barbados,Pulau Pinang,0,0,0
1/09/2023,Barbados,Selangor,7,3,4
1/09/2023,Brunei Darussalam,Johor,423,220,203
1/09/2023,Brunei Darussalam,Kedah,36,16,20
1/09/2023,Brunei Darussalam,Kelantan,5,3,2
1/09/2023,Brunei Darussalam,Melaka,0,0,0
1/09/2023,Brunei Darussalam,Pahang,0,0,0
1/09/2023,Brunei Darussalam,Perak,9,5,4
1/09/2023,Brunei Darussalam,Perlis,23,13,10
1/09/2023,Brunei Darussalam,Pulau Pinang,10,3,7
1/09/2023,Brunei Darussalam,Sabah,148,62,86
1/09/2023,Brunei Darussalam,Sarawak,63606,35362,28244
1/09/2023,Brunei Darussalam,Selangor,5412,2668,2744
1/09/2023,Brunei Darussalam,W.P. Labuan,1036,719,317
1/09/2023,Bhutan,Johor,3,3,0
1/09/2023,Bhutan,Kedah,0,0,0
1/09/2023,Bhutan,Perak,0,0,0
1/09/2023,Bhutan,Perlis,1,0,1
1/09/2023,Bhutan,Pulau Pinang,4,4,0
1/09/2023,Bhutan,Sabah,0,0,0
1/09/2023,Bhutan,Sarawak,0,0,0
1/09/2023,Bhutan,Selangor,87,49,38
1/09/2023,Botswana,Johor,6,4,2
1/09/2023,Botswana,Kedah,1,1,0
1/09/2023,Botswana,Perlis,0,0,0
1/09/2023,Botswana,Pulau Pinang,0,0,0
1/09/2023,Botswana,Sabah,0,0,0
1/09/2023,Botswana,Sarawak,0,0,0
1/09/2023,Botswana,Selangor,67,17,50
1/09/2023,Central African Republic,Kedah,1,0,1
1/09/2023,Central African Republic,Selangor,1,0,1
1/09/2023,Canada,Johor,1277,754,523
1/09/2023,Canada,Kedah,93,53,40
1/09/2023,Canada,Kelantan,0,0,0
1/09/2023,Canada,Melaka,3,1,2
1/09/2023,Canada,Negeri Sembilan,1,1,0
1/09/2023,Canada,Pahang,4,4,0
1/09/2023,Canada,Perak,17,8,9
1/09/2023,Canada,Perlis,27,18,9
1/09/2023,Canada,Pulau Pinang,389,223,166
1/09/2023,Canada,Sabah,18,7,11
1/09/2023,Canada,Sarawak,206,116,90
1/09/2023,Canada,Selangor,3998,2372,1626
1/09/2023,Canada,Terengganu,0,0,0
1/09/2023,Canada,W.P. Labuan,2,1,1
1/09/2023,Cocos (Keeling) Islands,Selangor,0,0,0
1/09/2023,Switzerland,Johor,383,219,164
1/09/2023,Switzerland,Kedah,63,33,30
1/09/2023,Switzerland,Kelantan,1,1,0
1/09/2023,Switzerland,Melaka,0,0,0
1/09/2023,Switzerland,Negeri Sembilan,0,0,0
1/09/2023,Switzerland,Pahang,0,0,0
1/09/2023,Switzerland,Perak,1,1,0
1/09/2023,Switzerland,Perlis,19,12,7
1/09/2023,Switzerland,Pulau Pinang,102,70,32
1/09/2023,Switzerland,Sabah,8,4,4
1/09/2023,Switzerland,Sarawak,34,20,14
1/09/2023,Switzerland,Selangor,1360,846,514
1/09/2023,Switzerland,W.P. Labuan,1,1,0
1/09/2023,Chile,Johor,41,19,22
1/09/2023,Chile,Kedah,8,4,4
1/09/2023,Chile,Kelantan,1,1,0
1/09/2023,Chile,Melaka,0,0,0
1/09/2023,Chile,Pahang,0,0,0
1/09/2023,Chile,Perak,0,0,0
1/09/2023,Chile,Perlis,6,5,1
1/09/2023,Chile,Pulau Pinang,4,4,0
1/09/2023,Chile,Sabah,1,1,0
1/09/2023,Chile,Sarawak,2,2,0
1/09/2023,Chile,Selangor,249,124,125
1/09/2023,China,Johor,49921,21544,28377
1/09/2023,China,Kedah,975,398,577
1/09/2023,China,Kelantan,3,1,2
1/09/2023,China,Melaka,2,1,1
1/09/2023,China,Pahang,75,42,33
1/09/2023,China,Perak,203,88,115
1/09/2023,China,Perlis,73,40,33
1/09/2023,China,Pulau Pinang,8074,4341,3733
1/09/2023,China,Sabah,2008,929,1079
1/09/2023,China,Sarawak,1023,582,441
1/09/2023,China,Selangor,109565,54338,55227
1/09/2023,China,Terengganu,0,0,0
1/09/2023,China,W.P. Labuan,49,40,9
1/09/2023,Côte d'Ivoire,Johor,1,0,1
1/09/2023,Côte d'Ivoire,Kedah,0,0,0
1/09/2023,Côte d'Ivoire,Pulau Pinang,0,0,0
1/09/2023,Côte d'Ivoire,Sabah,0,0,0
1/09/2023,Côte d'Ivoire,Sarawak,0,0,0
1/09/2023,Côte d'Ivoire,Selangor,66,53,13
1/09/2023,Cameroon,Johor,1,1,0
1/09/2023,Cameroon,Kedah,0,0,0
1/09/2023,Cameroon,Pulau Pinang,1,1,0
1/09/2023,Cameroon,Sabah,0,0,0
1/09/2023,Cameroon,Sarawak,1,1,0
1/09/2023,Cameroon,Selangor,77,61,16
1/09/2023,Congo,Johor,1,1,0
1/09/2023,Congo,Pulau Pinang,0,0,0
1/09/2023,Congo,Sarawak,0,0,0
1/09/2023,Congo,Selangor,18,12,6
1/09/2023,Congo,Johor,0,0,0
1/09/2023,Congo,Kedah,0,0,0
1/09/2023,Congo,Selangor,18,11,7
1/09/2023,Cook Islands,Selangor,0,0,0
1/09/2023,Colombia,Johor,26,13,13
1/09/2023,Colombia,Kedah,0,0,0
1/09/2023,Colombia,Perak,0,0,0
1/09/2023,Colombia,Pulau Pinang,8,4,4
1/09/2023,Colombia,Sabah,0,0,0
1/09/2023,Colombia,Sarawak,1,1,0
1/09/2023,Colombia,Selangor,394,225,169
1/09/2023,Colombia,W.P. Labuan,0,0,0
1/09/2023,Comoros,Johor,0,0,0
1/09/2023,Comoros,Kedah,0,0,0
1/09/2023,Comoros,Selangor,37,26,11
1/09/2023,Cabo Verde,Johor,0,0,0
1/09/2023,Cabo Verde,Kedah,0,0,0
1/09/2023,Cabo Verde,Pulau Pinang,0,0,0
1/09/2023,Cabo Verde,Sabah,0,0,0
1/09/2023,Cabo Verde,Selangor,1,0,1
1/09/2023,Costa Rica,Johor,11,6,5
1/09/2023,Costa Rica,Kedah,0,0,0
1/09/2023,Costa Rica,Perak,0,0,0
1/09/2023,Costa Rica,Perlis,0,0,0
1/09/2023,Costa Rica,Pulau Pinang,3,2,1
1/09/2023,Costa Rica,Sabah,2,2,0
1/09/2023,Costa Rica,Sarawak,1,1,0
1/09/2023,Costa Rica,Selangor,77,41,36
1/09/2023,Cuba,Johor,1,0,1
1/09/2023,Cuba,Kedah,1,1,0
1/09/2023,Cuba,Perlis,0,0,0
1/09/2023,Cuba,Pulau Pinang,0,0,0
1/09/2023,Cuba,Sabah,1,1,0
1/09/2023,Cuba,Sarawak,0,0,0
1/09/2023,Cuba,Selangor,22,10,12
1/09/2023,Cyprus,Johor,11,6,5
1/09/2023,Cyprus,Kedah,1,1,0
1/09/2023,Cyprus,Perak,0,0,0
1/09/2023,Cyprus,Perlis,0,0,0
1/09/2023,Cyprus,Pulau Pinang,1,1,0
1/09/2023,Cyprus,Sabah,0,0,0
1/09/2023,Cyprus,Sarawak,0,0,0
1/09/2023,Cyprus,Selangor,69,51,18
1/09/2023,Czechia,Johor,106,56,50
1/09/2023,Czechia,Kedah,10,6,4
1/09/2023,Czechia,Kelantan,0,0,0
1/09/2023,Czechia,Melaka,0,0,0
1/09/2023,Czechia,Negeri Sembilan,0,0,0
1/09/2023,Czechia,Perak,0,0,0
1/09/2023,Czechia,Perlis,5,5,0
1/09/2023,Czechia,Pulau Pinang,13,8,5
1/09/2023,Czechia,Sabah,1,0,1
1/09/2023,Czechia,Sarawak,24,12,12
1/09/2023,Czechia,Selangor,423,258,165
1/09/2023,Czechia,W.P. Labuan,0,0,0
1/09/2023,Germany,Johor,2433,1493,940
1/09/2023,Germany,Kedah,322,179,143
1/09/2023,Germany,Kelantan,12,9,3
1/09/2023,Germany,Melaka,3,1,2
1/09/2023,Germany,Negeri Sembilan,3,2,1
1/09/2023,Germany,Pahang,3,2,1
1/09/2023,Germany,Perak,21,17,4
1/09/2023,Germany,Perlis,71,46,25
1/09/2023,Germany,Pulau Pinang,615,442,173
1/09/2023,Germany,Sabah,35,20,15
1/09/2023,Germany,Sarawak,240,141,99
1/09/2023,Germany,Selangor,7620,4619,3001
1/09/2023,Germany,Terengganu,0,0,0
1/09/2023,Germany,W.P. Labuan,3,2,1
1/09/2023,Djibouti,Johor,1,1,0
1/09/2023,Djibouti,Selangor,12,8,4
1/09/2023,Dominica,Johor,6,5,1
1/09/2023,Dominica,Kedah,0,0,0
1/09/2023,Dominica,Pulau Pinang,2,1,1
1/09/2023,Dominica,Sabah,0,0,0
1/09/2023,Dominica,Sarawak,0,0,0
1/09/2023,Dominica,Selangor,62,49,13
1/09/2023,Dominica,W.P. Labuan,0,0,0
1/09/2023,Denmark,Johor,343,243,100
1/09/2023,Denmark,Kedah,16,9,7
1/09/2023,Denmark,Kelantan,0,0,0
1/09/2023,Denmark,Melaka,1,1,0
1/09/2023,Denmark,Negeri Sembilan,0,0,0
1/09/2023,Denmark,Pahang,0,0,0
1/09/2023,Denmark,Perak,1,1,0
1/09/2023,Denmark,Perlis,5,2,3
1/09/2023,Denmark,Pulau Pinang,45,33,12
1/09/2023,Denmark,Sabah,7,3,4
1/09/2023,Denmark,Sarawak,11,7,4
1/09/2023,Denmark,Selangor,847,529,318
1/09/2023,Denmark,W.P. Labuan,6,1,5
1/09/2023,Dominican Republic,Johor,7,3,4
1/09/2023,Dominican Republic,Kedah,1,0,1
1/09/2023,Dominican Republic,Perak,0,0,0
1/09/2023,Dominican Republic,Perlis,0,0,0
1/09/2023,Dominican Republic,Pulau Pinang,1,1,0
1/09/2023,Dominican Republic,Sabah,0,0,0
1/09/2023,Dominican Republic,Sarawak,0,0,0
1/09/2023,Dominican Republic,Selangor,27,10,17
1/09/2023,Algeria,Johor,80,49,31
1/09/2023,Algeria,Kedah,5,4,1
1/09/2023,Algeria,Kelantan,0,0,0
1/09/2023,Algeria,Melaka,0,0,0
1/09/2023,Algeria,Perak,1,0,1
1/09/2023,Algeria,Perlis,2,2,0
1/09/2023,Algeria,Pulau Pinang,0,0,0
1/09/2023,Algeria,Sabah,3,0,3
1/09/2023,Algeria,Sarawak,3,3,0
1/09/2023,Algeria,Selangor,1622,1014,608
1/09/2023,Algeria,W.P. Labuan,0,0,0
1/09/2023,Ecuador,Johor,16,6,10
1/09/2023,Ecuador,Kedah,0,0,0
1/09/2023,Ecuador,Perak,0,0,0
1/09/2023,Ecuador,Perlis,0,0,0
1/09/2023,Ecuador,Pulau Pinang,4,3,1
1/09/2023,Ecuador,Sabah,0,0,0
1/09/2023,Ecuador,Sarawak,0,0,0
1/09/2023,Ecuador,Selangor,128,58,70
1/09/2023,Egypt,Johor,221,175,46
1/09/2023,Egypt,Kedah,9,7,2
1/09/2023,Egypt,Kelantan,2,1,1
1/09/2023,Egypt,Melaka,0,0,0
1/09/2023,Egypt,Pahang,0,0,0
1/09/2023,Egypt,Perak,0,0,0
1/09/2023,Egypt,Perlis,0,0,0
1/09/2023,Egypt,Pulau Pinang,15,12,3
1/09/2023,Egypt,Sabah,0,0,0
1/09/2023,Egypt,Sarawak,91,56,35
1/09/2023,Egypt,Selangor,2310,1543,767
1/09/2023,Egypt,Terengganu,0,0,0
1/09/2023,Egypt,W.P. Labuan,0,0,0
1/09/2023,Eritrea,Johor,0,0,0
1/09/2023,Eritrea,Pulau Pinang,0,0,0
1/09/2023,Eritrea,Sabah,0,0,0
1/09/2023,Eritrea,Selangor,21,10,11
1/09/2023,Spain,Johor,683,410,273
1/09/2023,Spain,Kedah,56,33,23
1/09/2023,Spain,Kelantan,3,2,1
1/09/2023,Spain,Melaka,0,0,0
1/09/2023,Spain,Negeri Sembilan,0,0,0
1/09/2023,Spain,Pahang,0,0,0
1/09/2023,Spain,Perak,6,3,3
1/09/2023,Spain,Perlis,16,11,5
1/09/2023,Spain,Pulau Pinang,151,82,69
1/09/2023,Spain,Sabah,18,9,9
1/09/2023,Spain,Sarawak,66,43,23
1/09/2023,Spain,Selangor,4142,2211,1931
1/09/2023,Spain,W.P. Labuan,1,0,1
1/09/2023,Estonia,Johor,21,12,9
1/09/2023,Estonia,Kedah,4,0,4
1/09/2023,Estonia,Kelantan,1,0,1
1/09/2023,Estonia,Pahang,0,0,0
1/09/2023,Estonia,Perak,0,0,0
1/09/2023,Estonia,Perlis,1,1,0
1/09/2023,Estonia,Pulau Pinang,0,0,0
1/09/2023,Estonia,Sabah,0,0,0
1/09/2023,Estonia,Sarawak,1,0,1
1/09/2023,Estonia,Selangor,120,81,39
1/09/2023,Estonia,W.P. Labuan,0,0,0
1/09/2023,Ethiopia,Johor,2,2,0
1/09/2023,Ethiopia,Kedah,0,0,0
1/09/2023,Ethiopia,Pulau Pinang,1,1,0
1/09/2023,Ethiopia,Sarawak,0,0,0
1/09/2023,Ethiopia,Selangor,48,27,21
1/09/2023,Finland,Johor,164,94,70
1/09/2023,Finland,Kedah,13,4,9
1/09/2023,Finland,Kelantan,0,0,0
1/09/2023,Finland,Melaka,0,0,0
1/09/2023,Finland,Negeri Sembilan,0,0,0
1/09/2023,Finland,Pahang,0,0,0
1/09/2023,Finland,Perak,5,3,2
1/09/2023,Finland,Perlis,4,3,1
1/09/2023,Finland,Pulau Pinang,35,26,9
1/09/2023,Finland,Sabah,1,1,0
1/09/2023,Finland,Sarawak,3,3,0
1/09/2023,Finland,Selangor,358,237,121
1/09/2023,Finland,W.P. Labuan,0,0,0
1/09/2023,Fiji,Johor,133,67,66
1/09/2023,Fiji,Kedah,4,1,3
1/09/2023,Fiji,Kelantan,1,1,0
1/09/2023,Fiji,Perak,1,1,0
1/09/2023,Fiji,Perlis,0,0,0
1/09/2023,Fiji,Pulau Pinang,0,0,0
1/09/2023,Fiji,Sabah,0,0,0
1/09/2023,Fiji,Sarawak,0,0,0
1/09/2023,Fiji,Selangor,186,104,82
1/09/2023,France,Johor,1795,1076,719
1/09/2023,France,Kedah,171,99,72
1/09/2023,France,Kelantan,8,6,2
1/09/2023,France,Melaka,10,4,6
1/09/2023,France,Negeri Sembilan,4,2,2
1/09/2023,France,Pahang,11,7,4
1/09/2023,France,Perak,18,10,8
1/09/2023,France,Perlis,69,47,22
1/09/2023,France,Pulau Pinang,267,191,76
1/09/2023,France,Sabah,23,15,8
1/09/2023,France,Sarawak,88,55,33
1/09/2023,France,Selangor,7963,4633,3330
1/09/2023,France,Terengganu,1,1,0
1/09/2023,France,W.P. Labuan,2,0,2
1/09/2023,"Micronesia, Federated States of",Johor,0,0,0
1/09/2023,"Micronesia, Federated States of",Pulau Pinang,0,0,0
1/09/2023,"Micronesia, Federated States of",Selangor,1,1,0
1/09/2023,Gabon,Johor,1,0,1
1/09/2023,Gabon,Pulau Pinang,1,1,0
1/09/2023,Gabon,Sarawak,0,0,0
1/09/2023,Gabon,Selangor,41,37,4
1/09/2023,United Kingdom of Great Britain and Northern Ireland,Johor,4488,2942,1546
1/09/2023,United Kingdom of Great Britain and Northern Ireland,Kedah,480,284,196
1/09/2023,United Kingdom of Great Britain and Northern Ireland,Kelantan,14,10,4
1/09/2023,United Kingdom of Great Britain and Northern Ireland,Melaka,2,2,0
1/09/2023,United Kingdom of Great Britain and Northern Ireland,Negeri Sembilan,1,1,0
1/09/2023,United Kingdom of Great Britain and Northern Ireland,Pahang,20,16,4
1/09/2023,United Kingdom of Great Britain and Northern Ireland,Perak,99,55,44
1/09/2023,United Kingdom of Great Britain and Northern Ireland,Perlis,113,72,41
1/09/2023,United Kingdom of Great Britain and Northern Ireland,Pulau Pinang,1275,821,454
1/09/2023,United Kingdom of Great Britain and Northern Ireland,Sabah,146,65,81
1/09/2023,United Kingdom of Great Britain and Northern Ireland,Sarawak,831,546,285
1/09/2023,United Kingdom of Great Britain and Northern Ireland,Selangor,16130,10041,6089
1/09/2023,United Kingdom of Great Britain and Northern Ireland,Terengganu,0,0,0
1/09/2023,United Kingdom of Great Britain and Northern Ireland,W.P. Labuan,29,24,5
1/09/2023,Georgia,Johor,1,1,0
1/09/2023,Georgia,Kedah,1,0,1
1/09/2023,Georgia,Melaka,0,0,0
1/09/2023,Georgia,Perak,0,0,0
1/09/2023,Georgia,Perlis,0,0,0
1/09/2023,Georgia,Pulau Pinang,4,2,2
1/09/2023,Georgia,Sabah,0,0,0
1/09/2023,Georgia,Sarawak,1,0,1
1/09/2023,Georgia,Selangor,72,46,26
1/09/2023,Ghana,Johor,12,11,1
1/09/2023,Ghana,Kedah,0,0,0
1/09/2023,Ghana,Kelantan,0,0,0
1/09/2023,Ghana,Pulau Pinang,8,3,5
1/09/2023,Ghana,Sabah,0,0,0
1/09/2023,Ghana,Sarawak,0,0,0
1/09/2023,Ghana,Selangor,106,83,23
1/09/2023,Gibraltar,Johor,0,0,0
1/09/2023,Gibraltar,Sarawak,0,0,0
1/09/2023,Guinea,Johor,2,1,1
1/09/2023,Guinea,Kedah,2,2,0
1/09/2023,Guinea,Kelantan,0,0,0
1/09/2023,Guinea,Perlis,0,0,0
1/09/2023,Guinea,Pulau Pinang,0,0,0
1/09/2023,Guinea,Sabah,0,0,0
1/09/2023,Guinea,Sarawak,1,1,0
1/09/2023,Guinea,Selangor,78,55,23
1/09/2023,Guadeloupe,Selangor,0,0,0
1/09/2023,Gambia,Johor,4,4,0
1/09/2023,Gambia,Kedah,0,0,0
1/09/2023,Gambia,Kelantan,0,0,0
1/09/2023,Gambia,Pulau Pinang,0,0,0
1/09/2023,Gambia,Sabah,1,1,0
1/09/2023,Gambia,Sarawak,0,0,0
1/09/2023,Gambia,Selangor,23,14,9
1/09/2023,Guinea-Bissau,Johor,0,0,0
1/09/2023,Guinea-Bissau,Selangor,1,1,0
1/09/2023,Equatorial Guinea,Johor,0,0,0
1/09/2023,Equatorial Guinea,Selangor,0,0,0
1/09/2023,Greece,Johor,50,38,12
1/09/2023,Greece,Kedah,5,2,3
1/09/2023,Greece,Kelantan,0,0,0
1/09/2023,Greece,Melaka,0,0,0
1/09/2023,Greece,Negeri Sembilan,0,0,0
1/09/2023,Greece,Pahang,0,0,0
1/09/2023,Greece,Perak,1,1,0
1/09/2023,Greece,Perlis,1,0,1
1/09/2023,Greece,Pulau Pinang,10,9,1
1/09/2023,Greece,Sabah,0,0,0
1/09/2023,Greece,Sarawak,5,4,1
1/09/2023,Greece,Selangor,226,180,46
1/09/2023,Grenada,Johor,8,4,4
1/09/2023,Grenada,Kedah,0,0,0
1/09/2023,Grenada,Pulau Pinang,1,1,0
1/09/2023,Grenada,Sabah,0,0,0
1/09/2023,Grenada,Sarawak,0,0,0
1/09/2023,Grenada,Selangor,5,5,0
1/09/2023,Greenland,Johor,0,0,0
1/09/2023,Greenland,Selangor,1,0,1
1/09/2023,Guatemala,Johor,3,3,0
1/09/2023,Guatemala,Kedah,0,0,0
1/09/2023,Guatemala,Pahang,0,0,0
1/09/2023,Guatemala,Perak,0,0,0
1/09/2023,Guatemala,Pulau Pinang,0,0,0
1/09/2023,Guatemala,Sabah,0,0,0
1/09/2023,Guatemala,Sarawak,0,0,0
1/09/2023,Guatemala,Selangor,60,25,35
1/09/2023,Guatemala,W.P. Labuan,0,0,0
1/09/2023,Guyana,Johor,0,0,0
1/09/2023,Guyana,Kedah,0,0,0
1/09/2023,Guyana,Pulau Pinang,0,0,0
1/09/2023,Guyana,Sarawak,0,0,0
1/09/2023,Guyana,Selangor,7,5,2
1/09/2023,Hong Kong,Johor,9,3,6
1/09/2023,Hong Kong,Kedah,0,0,0
1/09/2023,Hong Kong,Kelantan,0,0,0
1/09/2023,Hong Kong,Pahang,4,1,3
1/09/2023,Hong Kong,Perak,35,21,14
1/09/2023,Hong Kong,Perlis,0,0,0
1/09/2023,Hong Kong,Pulau Pinang,0,0,0
1/09/2023,Hong Kong,Sabah,0,0,0
1/09/2023,Hong Kong,Sarawak,0,0,0
1/09/2023,Hong Kong,Selangor,66,24,42
1/09/2023,Hong Kong,Terengganu,0,0,0
1/09/2023,Heard Island and McDonald Islands,Johor,0,0,0
1/09/2023,Honduras,Johor,8,6,2
1/09/2023,Honduras,Kedah,1,1,0
1/09/2023,Honduras,Perak,0,0,0
1/09/2023,Honduras,Pulau Pinang,0,0,0
1/09/2023,Honduras,Sabah,0,0,0
1/09/2023,Honduras,Sarawak,2,0,2
1/09/2023,Honduras,Selangor,19,14,5
1/09/2023,Croatia,Johor,57,43,14
1/09/2023,Croatia,Kedah,0,0,0
1/09/2023,Croatia,Kelantan,0,0,0
1/09/2023,Croatia,Melaka,0,0,0
1/09/2023,Croatia,Pahang,1,1,0
1/09/2023,Croatia,Perak,0,0,0
1/09/2023,Croatia,Perlis,0,0,0
1/09/2023,Croatia,Pulau Pinang,6,5,1
1/09/2023,Croatia,Sabah,2,0,2
1/09/2023,Croatia,Sarawak,0,0,0
1/09/2023,Croatia,Selangor,124,87,37
1/09/2023,Haiti,Johor,0,0,0
1/09/2023,Haiti,Kedah,0,0,0
1/09/2023,Haiti,Kelantan,0,0,0
1/09/2023,Haiti,Perak,0,0,0
1/09/2023,Haiti,Pulau Pinang,0,0,0
1/09/2023,Haiti,Sabah,0,0,0
1/09/2023,Haiti,Selangor,16,10,6
1/09/2023,Hungary,Johor,77,48,29
1/09/2023,Hungary,Kedah,12,7,5
1/09/2023,Hungary,Kelantan,0,0,0
1/09/2023,Hungary,Pahang,0,0,0
1/09/2023,Hungary,Perak,0,0,0
1/09/2023,Hungary,Perlis,1,1,0
1/09/2023,Hungary,Pulau Pinang,16,10,6
1/09/2023,Hungary,Sabah,4,2,2
1/09/2023,Hungary,Sarawak,3,2,1
1/09/2023,Hungary,Selangor,370,208,162
1/09/2023,Hungary,W.P. Labuan,0,0,0
1/09/2023,Indonesia,Johor,95529,44431,51098
1/09/2023,Indonesia,Kedah,5260,1990,3270
1/09/2023,Indonesia,Kelantan,171,119,52
1/09/2023,Indonesia,Melaka,4156,1828,2328
1/09/2023,Indonesia,Negeri Sembilan,6028,3861,2167
1/09/2023,Indonesia,Pahang,26,15,11
1/09/2023,Indonesia,Perak,236,86,150
1/09/2023,Indonesia,Perlis,604,232,372
1/09/2023,Indonesia,Pulau Pinang,37833,15124,22709
1/09/2023,Indonesia,Sabah,4175,2070,2105
1/09/2023,Indonesia,Sarawak,35887,18905,16982
1/09/2023,Indonesia,Selangor,118926,56501,62425
1/09/2023,Indonesia,Terengganu,0,0,0
1/09/2023,Indonesia,W.P. Labuan,53,34,19
1/09/2023,India,Johor,28112,18909,9203
1/09/2023,India,Kedah,1275,695,580
1/09/2023,India,Kelantan,4,3,1
1/09/2023,India,Melaka,3,3,0
1/09/2023,India,Negeri Sembilan,1,1,0
1/09/2023,India,Pahang,12,9,3
1/09/2023,India,Perak,207,131,76
1/09/2023,India,Perlis,25,16,9
1/09/2023,India,Pulau Pinang,4007,3060,947
1/09/2023,India,Sabah,85,67,18
1/09/2023,India,Sarawak,1094,922,172
1/09/2023,India,Selangor,63166,45168,17998
1/09/2023,India,Terengganu,0,0,0
1/09/2023,India,W.P. Labuan,42,39,3
1/09/2023, British Indian Ocean Territory,Pulau Pinang,0,0,0
1/09/2023, British Indian Ocean Territory,Selangor,0,0,0
1/09/2023,Ireland,Johor,233,152,81
1/09/2023,Ireland,Kedah,46,23,23
1/09/2023,Ireland,Kelantan,0,0,0
1/09/2023,Ireland,Negeri Sembilan,0,0,0
1/09/2023,Ireland,Pahang,5,2,3
1/09/2023,Ireland,Perak,7,5,2
1/09/2023,Ireland,Perlis,9,7,2
1/09/2023,Ireland,Pulau Pinang,98,61,37
1/09/2023,Ireland,Sabah,4,2,2
1/09/2023,Ireland,Sarawak,41,24,17
1/09/2023,Ireland,Selangor,1618,1003,615
1/09/2023,Ireland,Terengganu,0,0,0
1/09/2023,Ireland,W.P. Labuan,0,0,0
1/09/2023,"Iran, Islamic Republic of",Johor,532,259,273
1/09/2023,"Iran, Islamic Republic of",Kedah,30,15,15
1/09/2023,"Iran, Islamic Republic of",Kelantan,0,0,0
1/09/2023,"Iran, Islamic Republic of",Perak,0,0,0
1/09/2023,"Iran, Islamic Republic of",Perlis,3,1,2
1/09/2023,"Iran, Islamic Republic of",Pulau Pinang,7,7,0
1/09/2023,"Iran, Islamic Republic of",Sabah,0,0,0
1/09/2023,"Iran, Islamic Republic of",Sarawak,3,2,1
1/09/2023,"Iran, Islamic Republic of",Selangor,2890,1498,1392
1/09/2023,"Iran, Islamic Republic of",W.P. Labuan,0,0,0
1/09/2023,Iraq,Johor,68,43,25
1/09/2023,Iraq,Kedah,5,5,0
1/09/2023,Iraq,Kelantan,0,0,0
1/09/2023,Iraq,Melaka,0,0,0
1/09/2023,Iraq,Pahang,1,1,0
1/09/2023,Iraq,Perak,0,0,0
1/09/2023,Iraq,Perlis,0,0,0
1/09/2023,Iraq,Pulau Pinang,0,0,0
1/09/2023,Iraq,Sabah,1,0,1
1/09/2023,Iraq,Sarawak,3,1,2
1/09/2023,Iraq,Selangor,1510,1030,480
1/09/2023,Iceland,Johor,4,2,2
1/09/2023,Iceland,Kedah,0,0,0
1/09/2023,Iceland,Kelantan,0,0,0
1/09/2023,Iceland,Perak,0,0,0
1/09/2023,Iceland,Perlis,0,0,0
1/09/2023,Iceland,Pulau Pinang,1,0,1
1/09/2023,Iceland,Sabah,0,0,0
1/09/2023,Iceland,Sarawak,0,0,0
1/09/2023,Iceland,Selangor,20,12,8
1/09/2023,Iceland,W.P. Labuan,0,0,0
1/09/2023,Israel,Pulau Pinang,0,0,0
1/09/2023,Italy,Johor,596,414,182
1/09/2023,Italy,Kedah,41,24,17
1/09/2023,Italy,Kelantan,3,2,1
1/09/2023,Italy,Melaka,0,0,0
1/09/2023,Italy,Negeri Sembilan,0,0,0
1/09/2023,Italy,Pahang,0,0,0
1/09/2023,Italy,Perak,5,4,1
1/09/2023,Italy,Perlis,11,8,3
1/09/2023,Italy,Pulau Pinang,97,74,23
1/09/2023,Italy,Sabah,7,3,4
1/09/2023,Italy,Sarawak,56,38,18
1/09/2023,Italy,Selangor,3501,2237,1264
1/09/2023,Italy,W.P. Labuan,2,2,0
1/09/2023,Jamaica,Johor,2,1,1
1/09/2023,Jamaica,Kedah,0,0,0
1/09/2023,Jamaica,Perak,0,0,0
1/09/2023,Jamaica,Pulau Pinang,3,1,2
1/09/2023,Jamaica,Sabah,0,0,0
1/09/2023,Jamaica,Sarawak,3,2,1
1/09/2023,Jamaica,Selangor,13,8,5
1/09/2023,Jamaica,W.P. Labuan,0,0,0
1/09/2023,Jordan,Johor,23,15,8
1/09/2023,Jordan,Kedah,10,2,8
1/09/2023,Jordan,Kelantan,0,0,0
1/09/2023,Jordan,Melaka,0,0,0
1/09/2023,Jordan,Perlis,0,0,0
1/09/2023,Jordan,Pulau Pinang,11,6,5
1/09/2023,Jordan,Sabah,1,1,0
1/09/2023,Jordan,Sarawak,0,0,0
1/09/2023,Jordan,Selangor,1129,695,434
1/09/2023,Jordan,W.P. Labuan,0,0,0
1/09/2023,Japan,Johor,6653,4460,2193
1/09/2023,Japan,Kedah,160,98,62
1/09/2023,Japan,Kelantan,8,5,3
1/09/2023,Japan,Melaka,3,3,0
1/09/2023,Japan,Negeri Sembilan,0,0,0
1/09/2023,Japan,Pahang,5,5,0
1/09/2023,Japan,Perak,44,30,14
1/09/2023,Japan,Perlis,98,78,20
1/09/2023,Japan,Pulau Pinang,1378,972,406
1/09/2023,Japan,Sabah,94,46,48
1/09/2023,Japan,Sarawak,204,145,59
1/09/2023,Japan,Selangor,23590,14379,9211
1/09/2023,Japan,W.P. Labuan,14,11,3
1/09/2023,Kazakhstan,Johor,52,19,33
1/09/2023,Kazakhstan,Kedah,6,1,5
1/09/2023,Kazakhstan,Kelantan,1,1,0
1/09/2023,Kazakhstan,Melaka,0,0,0
1/09/2023,Kazakhstan,Perak,0,0,0
1/09/2023,Kazakhstan,Perlis,1,0,1
1/09/2023,Kazakhstan,Pulau Pinang,10,5,5
1/09/2023,Kazakhstan,Sabah,0,0,0
1/09/2023,Kazakhstan,Sarawak,7,1,6
1/09/2023,Kazakhstan,Selangor,831,365,466
1/09/2023,Kazakhstan,W.P. Labuan,0,0,0
1/09/2023,Kenya,Johor,52,31,21
1/09/2023,Kenya,Kedah,8,3,5
1/09/2023,Kenya,Kelantan,0,0,0
1/09/2023,Kenya,Perak,0,0,0
1/09/2023,Kenya,Perlis,1,0,1
1/09/2023,Kenya,Pulau Pinang,1,0,1
1/09/2023,Kenya,Sabah,0,0,0
1/09/2023,Kenya,Sarawak,3,2,1
1/09/2023,Kenya,Selangor,560,285,275
1/09/2023,Kyrgyzstan,Johor,38,31,7
1/09/2023,Kyrgyzstan,Kedah,3,2,1
1/09/2023,Kyrgyzstan,Kelantan,0,0,0
1/09/2023,Kyrgyzstan,Perak,0,0,0
1/09/2023,Kyrgyzstan,Perlis,0,0,0
1/09/2023,Kyrgyzstan,Pulau Pinang,4,2,2
1/09/2023,Kyrgyzstan,Sabah,0,0,0
1/09/2023,Kyrgyzstan,Sarawak,0,0,0
1/09/2023,Kyrgyzstan,Selangor,236,123,113
1/09/2023,Cambodia,Johor,1706,696,1010
1/09/2023,Cambodia,Kedah,104,46,58
1/09/2023,Cambodia,Kelantan,430,246,184
1/09/2023,Cambodia,Melaka,0,0,0
1/09/2023,Cambodia,Negeri Sembilan,0,0,0
1/09/2023,Cambodia,Pahang,0,0,0
1/09/2023,Cambodia,Perak,15,2,13
1/09/2023,Cambodia,Perlis,718,409,309
1/09/2023,Cambodia,Pulau Pinang,54,31,23
1/09/2023,Cambodia,Sabah,1,0,1
1/09/2023,Cambodia,Sarawak,12,4,8
1/09/2023,Cambodia,Selangor,3519,1681,1838
1/09/2023,Cambodia,W.P. Labuan,0,0,0
1/09/2023,Kiribati,Johor,0,0,0
1/09/2023,Kiribati,Sabah,0,0,0
1/09/2023,Kiribati,Selangor,1,1,0
1/09/2023,Saint Kitts and Nevis,Johor,17,11,6
1/09/2023,Saint Kitts and Nevis,Kedah,6,5,1
1/09/2023,Saint Kitts and Nevis,Perlis,0,0,0
1/09/2023,Saint Kitts and Nevis,Pulau Pinang,6,4,2
1/09/2023,Saint Kitts and Nevis,Sabah,0,0,0
1/09/2023,Saint Kitts and Nevis,Selangor,62,44,18
1/09/2023,Saint Kitts and Nevis,W.P. Labuan,0,0,0
1/09/2023,"Korea, Republic of",Johor,9916,5561,4355
1/09/2023,"Korea, Republic of",Kedah,160,83,77
1/09/2023,"Korea, Republic of",Kelantan,8,6,2
1/09/2023,"Korea, Republic of",Melaka,2,2,0
1/09/2023,"Korea, Republic of",Negeri Sembilan,0,0,0
1/09/2023,"Korea, Republic of",Pahang,7,3,4
1/09/2023,"Korea, Republic of",Perak,16,10,6
1/09/2023,"Korea, Republic of",Perlis,61,47,14
1/09/2023,"Korea, Republic of",Pulau Pinang,464,279,185
1/09/2023,"Korea, Republic of",Sabah,450,196,254
1/09/2023,"Korea, Republic of",Sarawak,219,134,85
1/09/2023,"Korea, Republic of",Selangor,14842,8207,6635
1/09/2023,"Korea, Republic of",Terengganu,0,0,0
1/09/2023,"Korea, Republic of",W.P. Labuan,6,5,1
1/09/2023,Kuwait,Johor,34,19,15
1/09/2023,Kuwait,Kedah,6,2,4
1/09/2023,Kuwait,Kelantan,0,0,0
1/09/2023,Kuwait,Perak,0,0,0
1/09/2023,Kuwait,Perlis,0,0,0
1/09/2023,Kuwait,Pulau Pinang,8,3,5
1/09/2023,Kuwait,Sabah,0,0,0
1/09/2023,Kuwait,Sarawak,1,1,0
1/09/2023,Kuwait,Selangor,782,417,365
1/09/2023,Kuwait,W.P. Labuan,0,0,0
1/09/2023, Lao People's Democratic Republic,Johor,198,60,138
1/09/2023, Lao People's Democratic Republic,Kedah,773,47,726
1/09/2023, Lao People's Democratic Republic,Kelantan,188,21,167
1/09/2023, Lao People's Democratic Republic,Melaka,0,0,0
1/09/2023, Lao People's Democratic Republic,Perak,36,2,34
1/09/2023, Lao People's Democratic Republic,Perlis,420,69,351
1/09/2023, Lao People's Democratic Republic,Pulau Pinang,13,7,6
1/09/2023, Lao People's Democratic Republic,Sabah,0,0,0
1/09/2023, Lao People's Democratic Republic,Sarawak,13,10,3
1/09/2023, Lao People's Democratic Republic,Selangor,324,127,197
1/09/2023, Lao People's Democratic Republic,W.P. Labuan,0,0,0
1/09/2023,Lebanon,Johor,16,12,4
1/09/2023,Lebanon,Kedah,0,0,0
1/09/2023,Lebanon,Kelantan,0,0,0
1/09/2023,Lebanon,Pahang,0,0,0
1/09/2023,Lebanon,Perak,0,0,0
1/09/2023,Lebanon,Perlis,0,0,0
1/09/2023,Lebanon,Pulau Pinang,1,1,0
1/09/2023,Lebanon,Sabah,0,0,0
1/09/2023,Lebanon,Sarawak,4,4,0
1/09/2023,Lebanon,Selangor,317,196,121
1/09/2023,Lebanon,W.P. Labuan,0,0,0
1/09/2023,Liberia,Johor,1,1,0
1/09/2023,Liberia,Kedah,1,1,0
1/09/2023,Liberia,Sabah,0,0,0
1/09/2023,Liberia,Sarawak,0,0,0
1/09/2023,Liberia,Selangor,8,8,0
1/09/2023,Libya,Johor,7,4,3
1/09/2023,Libya,Kedah,1,1,0
1/09/2023,Libya,Perlis,1,1,0
1/09/2023,Libya,Pulau Pinang,0,0,0
1/09/2023,Libya,Sabah,0,0,0
1/09/2023,Libya,Sarawak,0,0,0
1/09/2023,Libya,Selangor,669,464,205
1/09/2023,Saint Lucia,Johor,10,8,2
1/09/2023,Saint Lucia,Kedah,0,0,0
1/09/2023,Saint Lucia,Pulau Pinang,0,0,0
1/09/2023,Saint Lucia,Sarawak,0,0,0
1/09/2023,Saint Lucia,Selangor,16,11,5
1/09/2023,Liechtenstein,Johor,1,1,0
1/09/2023,Liechtenstein,Kedah,0,0,0
1/09/2023,Liechtenstein,Perlis,0,0,0
1/09/2023,Liechtenstein,Pulau Pinang,0,0,0
1/09/2023,Liechtenstein,Sabah,0,0,0
1/09/2023,Liechtenstein,Sarawak,0,0,0
1/09/2023,Liechtenstein,Selangor,6,6,0
1/09/2023,LKA,Johor,1605,1027,578
1/09/2023,LKA,Kedah,58,27,31
1/09/2023,LKA,Kelantan,0,0,0
1/09/2023,LKA,Melaka,1,1,0
1/09/2023,LKA,Pahang,0,0,0
1/09/2023,LKA,Perak,2,2,0
1/09/2023,LKA,Perlis,0,0,0
1/09/2023,LKA,Pulau Pinang,44,36,8
1/09/2023,LKA,Sabah,3,2,1
1/09/2023,LKA,Sarawak,36,24,12
1/09/2023,LKA,Selangor,5603,3546,2057
1/09/2023,LKA,W.P. Labuan,0,0,0
1/09/2023,Lesotho,Johor,0,0,0
1/09/2023,Lesotho,Kedah,0,0,0
1/09/2023,Lesotho,Pulau Pinang,0,0,0
1/09/2023,Lesotho,Sarawak,0,0,0
1/09/2023,Lesotho,Selangor,6,4,2
1/09/2023,Lithuania,Johor,52,24,28
1/09/2023,Lithuania,Kedah,19,4,15
1/09/2023,Lithuania,Kelantan,1,1,0
1/09/2023,Lithuania,Pahang,0,0,0
1/09/2023,Lithuania,Perak,0,0,0
1/09/2023,Lithuania,Perlis,4,2,2
1/09/2023,Lithuania,Pulau Pinang,9,5,4
1/09/2023,Lithuania,Sabah,0,0,0
1/09/2023,Lithuania,Sarawak,1,1,0
1/09/2023,Lithuania,Selangor,254,122,132
1/09/2023,Lithuania,W.P. Labuan,0,0,0
1/09/2023,Luxembourg,Johor,3,2,1
1/09/2023,Luxembourg,Kedah,0,0,0
1/09/2023,Luxembourg,Kelantan,0,0,0
1/09/2023,Luxembourg,Perak,0,0,0
1/09/2023,Luxembourg,Perlis,0,0,0
1/09/2023,Luxembourg,Pulau Pinang,2,2,0
1/09/2023,Luxembourg,Sabah,0,0,0
1/09/2023,Luxembourg,Sarawak,0,0,0
1/09/2023,Luxembourg,Selangor,36,28,8
1/09/2023,Latvia,Johor,29,14,15
1/09/2023,Latvia,Kedah,2,1,1
1/09/2023,Latvia,Kelantan,1,1,0
1/09/2023,Latvia,Pahang,0,0,0
1/09/2023,Latvia,Perak,0,0,0
1/09/2023,Latvia,Perlis,0,0,0
1/09/2023,Latvia,Pulau Pinang,7,3,4
1/09/2023,Latvia,Sabah,0,0,0
1/09/2023,Latvia,Sarawak,6,3,3
1/09/2023,Latvia,Selangor,153,95,58
1/09/2023,Latvia,W.P. Labuan,0,0,0
1/09/2023,Macao,Johor,0,0,0
1/09/2023,Macao,Pahang,0,0,0
1/09/2023,Macao,Perak,0,0,0
1/09/2023,Macao,Selangor,13,8,5
1/09/2023,Macao,W.P. Labuan,0,0,0
1/09/2023,Morocco,Johor,146,71,75
1/09/2023,Morocco,Kedah,7,4,3
1/09/2023,Morocco,Kelantan,1,1,0
1/09/2023,Morocco,Melaka,0,0,0
1/09/2023,Morocco,Pahang,0,0,0
1/09/2023,Morocco,Perak,0,0,0
1/09/2023,Morocco,Perlis,2,2,0
1/09/2023,Morocco,Pulau Pinang,9,7,2
1/09/2023,Morocco,Sabah,1,1,0
1/09/2023,Morocco,Sarawak,5,4,1
1/09/2023,Morocco,Selangor,1668,766,902
1/09/2023,Morocco,W.P. Labuan,0,0,0
1/09/2023,Monaco,Johor,0,0,0
1/09/2023,Monaco,Kedah,0,0,0
1/09/2023,Monaco,Sabah,0,0,0
1/09/2023,Monaco,Selangor,2,1,1
1/09/2023,"Moldova, Republic of",Johor,1,1,0
1/09/2023,"Moldova, Republic of",Kedah,1,0,1
1/09/2023,"Moldova, Republic of",Kelantan,1,0,1
1/09/2023,"Moldova, Republic of",Negeri Sembilan,0,0,0
1/09/2023,"Moldova, Republic of",Perlis,0,0,0
1/09/2023,"Moldova, Republic of",Pulau Pinang,1,1,0
1/09/2023,"Moldova, Republic of",Sabah,0,0,0
1/09/2023,"Moldova, Republic of",Sarawak,0,0,0
1/09/2023,"Moldova, Republic of",Selangor,33,19,14
1/09/2023,Madagascar,Johor,15,6,9
1/09/2023,Madagascar,Kedah,0,0,0
1/09/2023,Madagascar,Perak,0,0,0
1/09/2023,Madagascar,Perlis,0,0,0
1/09/2023,Madagascar,Pulau Pinang,0,0,0
1/09/2023,Madagascar,Sabah,0,0,0
1/09/2023,Madagascar,Sarawak,0,0,0
1/09/2023,Madagascar,Selangor,98,45,53
1/09/2023,Maldives,Johor,97,51,46
1/09/2023,Maldives,Kedah,2,2,0
1/09/2023,Maldives,Kelantan,0,0,0
1/09/2023,Maldives,Perak,0,0,0
1/09/2023,Maldives,Perlis,1,1,0
1/09/2023,Maldives,Pulau Pinang,2,0,2
1/09/2023,Maldives,Sabah,0,0,0
1/09/2023,Maldives,Sarawak,1,0,1
1/09/2023,Maldives,Selangor,2728,1477,1251
1/09/2023,Mexico,Johor,205,96,109
1/09/2023,Mexico,Kedah,1,0,1
1/09/2023,Mexico,Kelantan,0,0,0
1/09/2023,Mexico,Pahang,0,0,0
1/09/2023,Mexico,Perak,1,0,1
1/09/2023,Mexico,Perlis,0,0,0
1/09/2023,Mexico,Pulau Pinang,38,23,15
1/09/2023,Mexico,Sabah,2,2,0
1/09/2023,Mexico,Sarawak,4,1,3
1/09/2023,Mexico,Selangor,905,420,485
1/09/2023,Mexico,W.P. Labuan,0,0,0
1/09/2023,Marshall Islands,Johor,0,0,0
1/09/2023,Marshall Islands,Kedah,0,0,0
1/09/2023,Marshall Islands,Perak,0,0,0
1/09/2023,Marshall Islands,Pulau Pinang,0,0,0
1/09/2023,Marshall Islands,Sabah,0,0,0
1/09/2023,Marshall Islands,Selangor,4,1,3
1/09/2023,North Macedonia,Johor,4,4,0
1/09/2023,North Macedonia,Kedah,1,0,1
1/09/2023,North Macedonia,Perak,0,0,0
1/09/2023,North Macedonia,Pulau Pinang,0,0,0
1/09/2023,North Macedonia,Sabah,0,0,0
1/09/2023,North Macedonia,Sarawak,1,1,0
1/09/2023,North Macedonia,Selangor,43,24,19
1/09/2023,Mali,Johor,2,2,0
1/09/2023,Mali,Sabah,0,0,0
1/09/2023,Mali,Selangor,19,14,5
1/09/2023,Malta,Johor,21,11,10
1/09/2023,Malta,Kedah,5,4,1
1/09/2023,Malta,Kelantan,0,0,0
1/09/2023,Malta,Perak,0,0,0
1/09/2023,Malta,Perlis,0,0,0
1/09/2023,Malta,Pulau Pinang,1,1,0
1/09/2023,Malta,Sabah,1,1,0
1/09/2023,Malta,Sarawak,1,1,0
1/09/2023,Malta,Selangor,51,33,18
1/09/2023,Malta,W.P. Labuan,0,0,0
1/09/2023,Myanmar,Johor,7130,2139,4991
1/09/2023,Myanmar,Kedah,82,21,61
1/09/2023,Myanmar,Kelantan,1,0,1
1/09/2023,Myanmar,Negeri Sembilan,0,0,0
1/09/2023,Myanmar,Pahang,5,1,4
1/09/2023,Myanmar,Perak,26,6,20
1/09/2023,Myanmar,Perlis,4,1,3
1/09/2023,Myanmar,Pulau Pinang,242,120,122
1/09/2023,Myanmar,Sabah,3,2,1
1/09/2023,Myanmar,Sarawak,72,26,46
1/09/2023,Myanmar,Selangor,7141,4810,2331
1/09/2023,Myanmar,Terengganu,0,0,0
1/09/2023,Myanmar,W.P. Labuan,1,1,0
1/09/2023,Montenegro,Johor,1,1,0
1/09/2023,Montenegro,Kedah,0,0,0
1/09/2023,Montenegro,Pulau Pinang,0,0,0
1/09/2023,Montenegro,Sabah,0,0,0
1/09/2023,Montenegro,Sarawak,0,0,0
1/09/2023,Montenegro,Selangor,10,6,4
1/09/2023,Mongolia,Johor,98,43,55
1/09/2023,Mongolia,Kedah,2,0,2
1/09/2023,Mongolia,Kelantan,0,0,0
1/09/2023,Mongolia,Perak,0,0,0
1/09/2023,Mongolia,Perlis,5,5,0
1/09/2023,Mongolia,Pulau Pinang,6,2,4
1/09/2023,Mongolia,Sabah,0,0,0
1/09/2023,Mongolia,Sarawak,1,0,1
1/09/2023,Mongolia,Selangor,294,115,179
1/09/2023,Northern Mariana Islands,Selangor,0,0,0
1/09/2023,Mozambique,Johor,0,0,0
1/09/2023,Mozambique,Kedah,0,0,0
1/09/2023,Mozambique,Perak,0,0,0
1/09/2023,Mozambique,Pulau Pinang,1,1,0
1/09/2023,Mozambique,Sabah,0,0,0
1/09/2023,Mozambique,Sarawak,1,0,1
1/09/2023,Mozambique,Selangor,25,13,12
1/09/2023,Mauritania,Johor,3,2,1
1/09/2023,Mauritania,Kedah,0,0,0
1/09/2023,Mauritania,Pulau Pinang,0,0,0
1/09/2023,Mauritania,Sabah,0,0,0
1/09/2023,Mauritania,Sarawak,0,0,0
1/09/2023,Mauritania,Selangor,32,29,3
1/09/2023,Mauritius,Johor,138,73,65
1/09/2023,Mauritius,Kedah,8,4,4
1/09/2023,Mauritius,Kelantan,0,0,0
1/09/2023,Mauritius,Pahang,0,0,0
1/09/2023,Mauritius,Perak,1,1,0
1/09/2023,Mauritius,Perlis,1,1,0
1/09/2023,Mauritius,Pulau Pinang,8,4,4
1/09/2023,Mauritius,Sabah,0,0,0
1/09/2023,Mauritius,Sarawak,0,0,0
1/09/2023,Mauritius,Selangor,1790,953,837
1/09/2023,Malawi,Johor,1,1,0
1/09/2023,Malawi,Pulau Pinang,1,1,0
1/09/2023,Malawi,Sabah,0,0,0
1/09/2023,Malawi,Sarawak,0,0,0
1/09/2023,Malawi,Selangor,20,11,9
1/09/2023,Mayotte,Selangor,0,0,0
1/09/2023,Namibia,Johor,3,0,3
1/09/2023,Namibia,Kedah,0,0,0
1/09/2023,Namibia,Perak,0,0,0
1/09/2023,Namibia,Perlis,0,0,0
1/09/2023,Namibia,Pulau Pinang,0,0,0
1/09/2023,Namibia,Sabah,0,0,0
1/09/2023,Namibia,Sarawak,2,2,0
1/09/2023,Namibia,Selangor,23,9,14
1/09/2023,New Caledonia,Selangor,0,0,0
1/09/2023,Niger,Johor,0,0,0
1/09/2023,Niger,Sabah,1,1,0
1/09/2023,Niger,Selangor,4,4,0
1/09/2023,Nigeria,Johor,41,38,3
1/09/2023,Nigeria,Kedah,0,0,0
1/09/2023,Nigeria,Perlis,0,0,0
1/09/2023,Nigeria,Pulau Pinang,2,1,1
1/09/2023,Nigeria,Sabah,1,1,0
1/09/2023,Nigeria,Sarawak,13,11,2
1/09/2023,Nigeria,Selangor,460,342,118
1/09/2023,Nicaragua,Johor,0,0,0
1/09/2023,Nicaragua,Kedah,0,0,0
1/09/2023,Nicaragua,Pulau Pinang,0,0,0
1/09/2023,Nicaragua,Sabah,0,0,0
1/09/2023,Nicaragua,Selangor,10,8,2
1/09/2023,Netherlands,Johor,1166,735,431
1/09/2023,Netherlands,Kedah,134,73,61
1/09/2023,Netherlands,Kelantan,3,3,0
1/09/2023,Netherlands,Melaka,0,0,0
1/09/2023,Netherlands,Negeri Sembilan,0,0,0
1/09/2023,Netherlands,Pahang,7,6,1
1/09/2023,Netherlands,Perak,13,6,7
1/09/2023,Netherlands,Perlis,22,12,10
1/09/2023,Netherlands,Pulau Pinang,191,126,65
1/09/2023,Netherlands,Sabah,16,7,9
1/09/2023,Netherlands,Sarawak,136,85,51
1/09/2023,Netherlands,Selangor,4865,2786,2079
1/09/2023,Netherlands,Terengganu,0,0,0
1/09/2023,Netherlands,W.P. Labuan,3,3,0
1/09/2023,Norway,Johor,145,95,50
1/09/2023,Norway,Kedah,14,9,5
1/09/2023,Norway,Kelantan,0,0,0
1/09/2023,Norway,Melaka,0,0,0
1/09/2023,Norway,Pahang,0,0,0
1/09/2023,Norway,Perak,1,0,1
1/09/2023,Norway,Perlis,2,2,0
1/09/2023,Norway,Pulau Pinang,17,8,9
1/09/2023,Norway,Sabah,2,1,1
1/09/2023,Norway,Sarawak,33,23,10
1/09/2023,Norway,Selangor,577,373,204
1/09/2023,Norway,W.P. Labuan,2,2,0
1/09/2023,Nepal,Johor,1118,776,342
1/09/2023,Nepal,Kedah,23,8,15
1/09/2023,Nepal,Pahang,0,0,0
1/09/2023,Nepal,Perak,0,0,0
1/09/2023,Nepal,Perlis,0,0,0
1/09/2023,Nepal,Pulau Pinang,17,15,2
1/09/2023,Nepal,Sabah,1,1,0
1/09/2023,Nepal,Sarawak,134,100,34
1/09/2023,Nepal,Selangor,9283,8827,456
1/09/2023,Nepal,W.P. Labuan,46,44,2
1/09/2023,Nauru,Johor,1,0,1
1/09/2023,Nauru,Pulau Pinang,0,0,0
1/09/2023,Nauru,Selangor,9,4,5
1/09/2023,New Zealand,Johor,930,581,349
1/09/2023,New Zealand,Kedah,94,55,39
1/09/2023,New Zealand,Kelantan,1,0,1
1/09/2023,New Zealand,Melaka,1,0,1
1/09/2023,New Zealand,Negeri Sembilan,0,0,0
1/09/2023,New Zealand,Pahang,2,1,1
1/09/2023,New Zealand,Perak,22,14,8
1/09/2023,New Zealand,Perlis,19,12,7
1/09/2023,New Zealand,Pulau Pinang,266,158,108
1/09/2023,New Zealand,Sabah,8,4,4
1/09/2023,New Zealand,Sarawak,121,69,52
1/09/2023,New Zealand,Selangor,3702,2121,1581
1/09/2023,New Zealand,Terengganu,0,0,0
1/09/2023,New Zealand,W.P. Labuan,1,1,0
1/09/2023,Oman,Johor,25,12,13
1/09/2023,Oman,Kedah,3,2,1
1/09/2023,Oman,Kelantan,0,0,0
1/09/2023,Oman,Melaka,0,0,0
1/09/2023,Oman,Perak,0,0,0
1/09/2023,Oman,Perlis,1,1,0
1/09/2023,Oman,Pulau Pinang,3,3,0
1/09/2023,Oman,Sabah,1,1,0
1/09/2023,Oman,Sarawak,15,8,7
1/09/2023,Oman,Selangor,1466,910,556
1/09/2023,Pakistan,Johor,1039,749,290
1/09/2023,Pakistan,Kedah,128,98,30
1/09/2023,Pakistan,Kelantan,10,10,0
1/09/2023,Pakistan,Melaka,0,0,0
1/09/2023,Pakistan,Negeri Sembilan,0,0,0
1/09/2023,Pakistan,Pahang,0,0,0
1/09/2023,Pakistan,Perak,9,8,1
1/09/2023,Pakistan,Perlis,15,13,2
1/09/2023,Pakistan,Pulau Pinang,58,52,6
1/09/2023,Pakistan,Sabah,9,9,0
1/09/2023,Pakistan,Sarawak,136,112,24
1/09/2023,Pakistan,Selangor,11875,10367,1508
1/09/2023,Pakistan,W.P. Labuan,1,0,1
1/09/2023,Panama,Johor,9,4,5
1/09/2023,Panama,Kedah,0,0,0
1/09/2023,Panama,Perak,0,0,0
1/09/2023,Panama,Perlis,0,0,0
1/09/2023,Panama,Pulau Pinang,0,0,0
1/09/2023,Panama,Sabah,0,0,0
1/09/2023,Panama,Sarawak,0,0,0
1/09/2023,Panama,Selangor,30,14,16
1/09/2023,Peru,Johor,37,22,15
1/09/2023,Peru,Kedah,3,1,2
1/09/2023,Peru,Kelantan,0,0,0
1/09/2023,Peru,Pahang,0,0,0
1/09/2023,Peru,Perak,0,0,0
1/09/2023,Peru,Perlis,0,0,0
1/09/2023,Peru,Pulau Pinang,4,2,2
1/09/2023,Peru,Sabah,0,0,0
1/09/2023,Peru,Sarawak,0,0,0
1/09/2023,Peru,Selangor,147,72,75
1/09/2023,Peru,W.P. Labuan,0,0,0
1/09/2023,Philippines,Johor,23504,7221,16283
1/09/2023,Philippines,Kedah,337,111,226
1/09/2023,Philippines,Kelantan,27,21,6
1/09/2023,Philippines,Melaka,2,1,1
1/09/2023,Philippines,Negeri Sembilan,0,0,0
1/09/2023,Philippines,Pahang,13,12,1
1/09/2023,Philippines,Perak,55,13,42
1/09/2023,Philippines,Perlis,210,63,147
1/09/2023,Philippines,Pulau Pinang,732,271,461
1/09/2023,Philippines,Sabah,631,358,273
1/09/2023,Philippines,Sarawak,1857,774,1083
1/09/2023,Philippines,Selangor,17431,6932,10499
1/09/2023,Philippines,Terengganu,0,0,0
1/09/2023,Philippines,W.P. Labuan,94,26,68
1/09/2023,Palau,Johor,0,0,0
1/09/2023,Palau,Pulau Pinang,0,0,0
1/09/2023,Palau,Selangor,2,1,1
1/09/2023,Papua New Guinea,Johor,16,10,6
1/09/2023,Papua New Guinea,Kedah,0,0,0
1/09/2023,Papua New Guinea,Kelantan,0,0,0
1/09/2023,Papua New Guinea,Perak,1,1,0
1/09/2023,Papua New Guinea,Pulau Pinang,3,3,0
1/09/2023,Papua New Guinea,Sabah,1,0,1
1/09/2023,Papua New Guinea,Sarawak,4,3,1
1/09/2023,Papua New Guinea,Selangor,72,51,21
1/09/2023,Poland,Johor,391,224,167
1/09/2023,Poland,Kedah,38,16,22
1/09/2023,Poland,Kelantan,0,0,0
1/09/2023,Poland,Melaka,0,0,0
1/09/2023,Poland,Negeri Sembilan,0,0,0
1/09/2023,Poland,Pahang,0,0,0
1/09/2023,Poland,Perak,2,1,1
1/09/2023,Poland,Perlis,16,12,4
1/09/2023,Poland,Pulau Pinang,38,24,14
1/09/2023,Poland,Sabah,9,5,4
1/09/2023,Poland,Sarawak,39,20,19
1/09/2023,Poland,Selangor,1339,684,655
1/09/2023,Poland,Terengganu,0,0,0
1/09/2023,Poland,W.P. Labuan,0,0,0
1/09/2023,"North Korea, Democratic People's Republic of",Selangor,0,0,0
1/09/2023,Portugal,Johor,153,88,65
1/09/2023,Portugal,Kedah,14,6,8
1/09/2023,Portugal,Kelantan,0,0,0
1/09/2023,Portugal,Melaka,0,0,0
1/09/2023,Portugal,Pahang,0,0,0
1/09/2023,Portugal,Perak,3,3,0
1/09/2023,Portugal,Perlis,1,0,1
1/09/2023,Portugal,Pulau Pinang,51,22,29
1/09/2023,Portugal,Sabah,6,3,3
1/09/2023,Portugal,Sarawak,5,2,3
1/09/2023,Portugal,Selangor,855,495,360
1/09/2023,Portugal,W.P. Labuan,0,0,0
1/09/2023,Paraguay,Johor,4,3,1
1/09/2023,Paraguay,Kedah,1,0,1
1/09/2023,Paraguay,Perak,0,0,0
1/09/2023,Paraguay,Perlis,0,0,0
1/09/2023,Paraguay,Pulau Pinang,3,1,2
1/09/2023,Paraguay,Sabah,0,0,0
1/09/2023,Paraguay,Sarawak,0,0,0
1/09/2023,Paraguay,Selangor,24,13,11
1/09/2023,"Palestine, State of",Johor,32,28,4
1/09/2023,"Palestine, State of",Kedah,1,1,0
1/09/2023,"Palestine, State of",Kelantan,0,0,0
1/09/2023,"Palestine, State of",Melaka,0,0,0
1/09/2023,"Palestine, State of",Perak,0,0,0
1/09/2023,"Palestine, State of",Perlis,0,0,0
1/09/2023,"Palestine, State of",Pulau Pinang,2,2,0
1/09/2023,"Palestine, State of",Sabah,0,0,0
1/09/2023,"Palestine, State of",Sarawak,1,1,0
1/09/2023,"Palestine, State of",Selangor,492,338,154
1/09/2023,Qatar,Johor,2,1,1
1/09/2023,Qatar,Kedah,0,0,0
1/09/2023,Qatar,Perlis,2,2,0
1/09/2023,Qatar,Pulau Pinang,1,1,0
1/09/2023,Qatar,Sabah,1,1,0
1/09/2023,Qatar,Sarawak,0,0,0
1/09/2023,Qatar,Selangor,118,89,29
1/09/2023,Réunion,Johor,1,0,1
1/09/2023,Réunion,Sarawak,0,0,0
1/09/2023,Romania,Johor,139,86,53
1/09/2023,Romania,Kedah,9,8,1
1/09/2023,Romania,Kelantan,0,0,0
1/09/2023,Romania,Negeri Sembilan,0,0,0
1/09/2023,Romania,Pahang,1,1,0
1/09/2023,Romania,Perak,0,0,0
1/09/2023,Romania,Perlis,0,0,0
1/09/2023,Romania,Pulau Pinang,13,5,8
1/09/2023,Romania,Sabah,3,1,2
1/09/2023,Romania,Sarawak,9,6,3
1/09/2023,Romania,Selangor,557,304,253
1/09/2023,Romania,W.P. Labuan,0,0,0
1/09/2023,Russian Federation (Russia),Johor,399,208,191
1/09/2023,Russian Federation (Russia),Kedah,213,110,103
1/09/2023,Russian Federation (Russia),Kelantan,54,36,18
1/09/2023,Russian Federation (Russia),Melaka,2,2,0
1/09/2023,Russian Federation (Russia),Negeri Sembilan,3,3,0
1/09/2023,Russian Federation (Russia),Pahang,1,1,0
1/09/2023,Russian Federation (Russia),Perak,2,1,1
1/09/2023,Russian Federation (Russia),Perlis,170,106,64
1/09/2023,Russian Federation (Russia),Pulau Pinang,154,82,72
1/09/2023,Russian Federation (Russia),Sabah,3,1,2
1/09/2023,Russian Federation (Russia),Sarawak,48,31,17
1/09/2023,Russian Federation (Russia),Selangor,6843,3476,3367
1/09/2023,Russian Federation (Russia),W.P. Labuan,6,4,2
1/09/2023,Rwanda,Johor,0,0,0
1/09/2023,Rwanda,Kedah,0,0,0
1/09/2023,Rwanda,Pulau Pinang,1,1,0
1/09/2023,Rwanda,Selangor,10,6,4
1/09/2023,Saudi Arabia,Johor,138,73,65
1/09/2023,Saudi Arabia,Kedah,19,11,8
1/09/2023,Saudi Arabia,Kelantan,6,3,3
1/09/2023,Saudi Arabia,Melaka,0,0,0
1/09/2023,Saudi Arabia,Perak,2,0,2
1/09/2023,Saudi Arabia,Perlis,2,1,1
1/09/2023,Saudi Arabia,Pulau Pinang,19,11,8
1/09/2023,Saudi Arabia,Sabah,2,2,0
1/09/2023,Saudi Arabia,Sarawak,11,7,4
1/09/2023,Saudi Arabia,Selangor,3386,2126,1260
1/09/2023,Saudi Arabia,W.P. Labuan,0,0,0
1/09/2023,Sudan,Johor,12,8,4
1/09/2023,Sudan,Kedah,2,1,1
1/09/2023,Sudan,Kelantan,0,0,0
1/09/2023,Sudan,Perlis,0,0,0
1/09/2023,Sudan,Pulau Pinang,2,1,1
1/09/2023,Sudan,Sabah,0,0,0
1/09/2023,Sudan,Sarawak,2,1,1
1/09/2023,Sudan,Selangor,1047,583,464
1/09/2023,Sudan,W.P. Labuan,1,0,1
1/09/2023,Senegal,Johor,11,8,3
1/09/2023,Senegal,Kedah,0,0,0
1/09/2023,Senegal,Kelantan,0,0,0
1/09/2023,Senegal,Perak,0,0,0
1/09/2023,Senegal,Perlis,0,0,0
1/09/2023,Senegal,Pulau Pinang,0,0,0
1/09/2023,Senegal,Sabah,0,0,0
1/09/2023,Senegal,Sarawak,0,0,0
1/09/2023,Senegal,Selangor,145,116,29
1/09/2023,Singapore,Johor,1310305,742628,567677
1/09/2023,Singapore,Kedah,5433,2819,2614
1/09/2023,Singapore,Kelantan,77,52,25
1/09/2023,Singapore,Melaka,13,12,1
1/09/2023,Singapore,Negeri Sembilan,0,0,0
1/09/2023,Singapore,Pahang,791,402,389
1/09/2023,Singapore,Perak,6499,2981,3518
1/09/2023,Singapore,Perlis,220,115,105
1/09/2023,Singapore,Pulau Pinang,18568,9203,9365
1/09/2023,Singapore,Sabah,537,267,270
1/09/2023,Singapore,Sarawak,4662,2661,2001
1/09/2023,Singapore,Selangor,52584,27079,25505
1/09/2023,Singapore,Terengganu,0,0,0
1/09/2023,Singapore,W.P. Labuan,9,6,3
1/09/2023,South Georgia and the South Sandwich Islands,Johor,0,0,0
1/09/2023,South Georgia and the South Sandwich Islands,Sabah,0,0,0
1/09/2023,South Georgia and the South Sandwich Islands,Selangor,0,0,0
1/09/2023,Saint Helena,Sarawak,0,0,0
1/09/2023,Solomon Islands,Johor,0,0,0
1/09/2023,Solomon Islands,Perlis,0,0,0
1/09/2023,Solomon Islands,Pulau Pinang,0,0,0
1/09/2023,Solomon Islands,Sabah,0,0,0
1/09/2023,Solomon Islands,Sarawak,2,2,0
1/09/2023,Solomon Islands,Selangor,5,4,1
1/09/2023,Solomon Islands,W.P. Labuan,0,0,0
1/09/2023,Sierra Leone,Johor,1,1,0
1/09/2023,Sierra Leone,Kedah,0,0,0
1/09/2023,Sierra Leone,Perak,0,0,0
1/09/2023,Sierra Leone,Pulau Pinang,1,1,0
1/09/2023,Sierra Leone,Sabah,0,0,0
1/09/2023,Sierra Leone,Selangor,31,23,8
1/09/2023,El Salvador,Johor,4,1,3
1/09/2023,El Salvador,Kedah,0,0,0
1/09/2023,El Salvador,Perak,0,0,0
1/09/2023,El Salvador,Perlis,0,0,0
1/09/2023,El Salvador,Pulau Pinang,2,2,0
1/09/2023,El Salvador,Sabah,1,0,1
1/09/2023,El Salvador,Selangor,26,17,9
1/09/2023,El Salvador,W.P. Labuan,0,0,0
1/09/2023,San Marino,Johor,0,0,0
1/09/2023,San Marino,Selangor,0,0,0
1/09/2023,Somalia,Johor,0,0,0
1/09/2023,Somalia,Kedah,0,0,0
1/09/2023,Somalia,Kelantan,0,0,0
1/09/2023,Somalia,Perlis,0,0,0
1/09/2023,Somalia,Sabah,0,0,0
1/09/2023,Somalia,Sarawak,0,0,0
1/09/2023,Somalia,Selangor,251,162,89
1/09/2023,Serbia,Johor,7,6,1
1/09/2023,Serbia,Kedah,3,2,1
1/09/2023,Serbia,Kelantan,0,0,0
1/09/2023,Serbia,Pahang,0,0,0
1/09/2023,Serbia,Perak,0,0,0
1/09/2023,Serbia,Perlis,0,0,0
1/09/2023,Serbia,Pulau Pinang,1,1,0
1/09/2023,Serbia,Sabah,0,0,0
1/09/2023,Serbia,Sarawak,1,0,1
1/09/2023,Serbia,Selangor,96,47,49
1/09/2023,South Sudan,Johor,0,0,0
1/09/2023,South Sudan,Kedah,0,0,0
1/09/2023,South Sudan,Sarawak,1,1,0
1/09/2023,South Sudan,Selangor,33,21,12
1/09/2023,South Sudan,W.P. Labuan,0,0,0
1/09/2023,Sao Tome and Principe,Selangor,2,2,0
1/09/2023,Suriname,Johor,12,5,7
1/09/2023,Suriname,Kedah,0,0,0
1/09/2023,Suriname,Kelantan,0,0,0
1/09/2023,Suriname,Perak,0,0,0
1/09/2023,Suriname,Perlis,0,0,0
1/09/2023,Suriname,Pulau Pinang,3,1,2
1/09/2023,Suriname,Sabah,0,0,0
1/09/2023,Suriname,Sarawak,0,0,0
1/09/2023,Suriname,Selangor,68,35,33
1/09/2023,Slovakia,Johor,26,19,7
1/09/2023,Slovakia,Kedah,24,11,13
1/09/2023,Slovakia,Kelantan,0,0,0
1/09/2023,Slovakia,Negeri Sembilan,0,0,0
1/09/2023,Slovakia,Pahang,0,0,0
1/09/2023,Slovakia,Perak,0,0,0
1/09/2023,Slovakia,Perlis,0,0,0
1/09/2023,Slovakia,Pulau Pinang,7,5,2
1/09/2023,Slovakia,Sabah,2,2,0
1/09/2023,Slovakia,Sarawak,1,0,1
1/09/2023,Slovakia,Selangor,272,156,116
1/09/2023,Slovakia,W.P. Labuan,0,0,0
1/09/2023,Slovenia,Johor,14,6,8
1/09/2023,Slovenia,Kedah,6,2,4
1/09/2023,Slovenia,Kelantan,0,0,0
1/09/2023,Slovenia,Perak,0,0,0
1/09/2023,Slovenia,Perlis,0,0,0
1/09/2023,Slovenia,Pulau Pinang,3,1,2
1/09/2023,Slovenia,Sabah,0,0,0
1/09/2023,Slovenia,Sarawak,4,3,1
1/09/2023,Slovenia,Selangor,138,77,61
1/09/2023,Slovenia,W.P. Labuan,0,0,0
1/09/2023,Sweden,Johor,287,187,100
1/09/2023,Sweden,Kedah,41,21,20
1/09/2023,Sweden,Kelantan,2,2,0
1/09/2023,Sweden,Melaka,0,0,0
1/09/2023,Sweden,Negeri Sembilan,1,1,0
1/09/2023,Sweden,Pahang,0,0,0
1/09/2023,Sweden,Perak,7,7,0
1/09/2023,Sweden,Perlis,16,12,4
1/09/2023,Sweden,Pulau Pinang,57,43,14
1/09/2023,Sweden,Sabah,3,2,1
1/09/2023,Sweden,Sarawak,37,25,12
1/09/2023,Sweden,Selangor,771,527,244
1/09/2023,Sweden,W.P. Labuan,0,0,0
1/09/2023,Eswatini,Johor,0,0,0
1/09/2023,Eswatini,Kedah,0,0,0
1/09/2023,Eswatini,Pulau Pinang,0,0,0
1/09/2023,Eswatini,Sabah,0,0,0
1/09/2023,Eswatini,Selangor,22,8,14
1/09/2023,Seychelles,Johor,2,0,2
1/09/2023,Seychelles,Kedah,0,0,0
1/09/2023,Seychelles,Pulau Pinang,2,1,1
1/09/2023,Seychelles,Sabah,0,0,0
1/09/2023,Seychelles,Sarawak,1,1,0
1/09/2023,Seychelles,Selangor,117,49,68
1/09/2023,Syrian Arab Republic,Johor,22,13,9
1/09/2023,Syrian Arab Republic,Kedah,1,1,0
1/09/2023,Syrian Arab Republic,Kelantan,0,0,0
1/09/2023,Syrian Arab Republic,Pahang,0,0,0
1/09/2023,Syrian Arab Republic,Perlis,0,0,0
1/09/2023,Syrian Arab Republic,Pulau Pinang,2,1,1
1/09/2023,Syrian Arab Republic,Sabah,1,1,0
1/09/2023,Syrian Arab Republic,Sarawak,6,6,0
1/09/2023,Syrian Arab Republic,Selangor,755,466,289
1/09/2023,Syrian Arab Republic,W.P. Labuan,0,0,0
1/09/2023,Turks and Caicos Islands,Perlis,0,0,0
1/09/2023,TCD,Johor,2,2,0
1/09/2023,TCD,Kedah,0,0,0
1/09/2023,TCD,Perlis,1,1,0
1/09/2023,TCD,Selangor,31,25,6
1/09/2023,Togo,Johor,3,1,2
1/09/2023,Togo,Perak,0,0,0
1/09/2023,Togo,Pulau Pinang,0,0,0
1/09/2023,Togo,Selangor,8,6,2
1/09/2023,Thailand,Johor,6671,1797,4874
1/09/2023,Thailand,Kedah,67381,41054,26327
1/09/2023,Thailand,Kelantan,34118,18894,15224
1/09/2023,Thailand,Melaka,10,7,3
1/09/2023,Thailand,Negeri Sembilan,0,0,0
1/09/2023,Thailand,Pahang,27,20,7
1/09/2023,Thailand,Perak,9355,4370,4985
1/09/2023,Thailand,Perlis,50060,29338,20722
1/09/2023,Thailand,Pulau Pinang,1810,766,1044
1/09/2023,Thailand,Sabah,8,1,7
1/09/2023,Thailand,Sarawak,319,120,199
1/09/2023,Thailand,Selangor,14375,5911,8464
1/09/2023,Thailand,Terengganu,1,0,1
1/09/2023,Thailand,W.P. Labuan,15,5,10
1/09/2023,Tajikistan,Johor,2,1,1
1/09/2023,Tajikistan,Kedah,0,0,0
1/09/2023,Tajikistan,Perlis,0,0,0
1/09/2023,Tajikistan,Pulau Pinang,1,1,0
1/09/2023,Tajikistan,Sabah,0,0,0
1/09/2023,Tajikistan,Selangor,108,67,41
1/09/2023,Tokelau,Selangor,0,0,0
1/09/2023,Turkmenistan,Johor,2,0,2
1/09/2023,Turkmenistan,Kedah,0,0,0
1/09/2023,Turkmenistan,Kelantan,0,0,0
1/09/2023,Turkmenistan,Perlis,0,0,0
1/09/2023,Turkmenistan,Pulau Pinang,0,0,0
1/09/2023,Turkmenistan,Sabah,0,0,0
1/09/2023,Turkmenistan,Sarawak,1,1,0
1/09/2023,Turkmenistan,Selangor,127,76,51
1/09/2023,Timor-Leste,Johor,3,3,0
1/09/2023,Timor-Leste,Kedah,0,0,0
1/09/2023,Timor-Leste,Perlis,0,0,0
1/09/2023,Timor-Leste,Pulau Pinang,9,6,3
1/09/2023,Timor-Leste,Sabah,0,0,0
1/09/2023,Timor-Leste,Sarawak,1,1,0
1/09/2023,Timor-Leste,Selangor,247,138,109
1/09/2023,Tonga,Johor,2,1,1
1/09/2023,Tonga,Pulau Pinang,2,1,1
1/09/2023,Tonga,Sarawak,0,0,0
1/09/2023,Tonga,Selangor,15,5,10
1/09/2023,Trinidad and Tobago,Johor,8,3,5
1/09/2023,Trinidad and Tobago,Kedah,2,1,1
1/09/2023,Trinidad and Tobago,Pahang,0,0,0
1/09/2023,Trinidad and Tobago,Pulau Pinang,1,1,0
1/09/2023,Trinidad and Tobago,Sabah,2,1,1
1/09/2023,Trinidad and Tobago,Sarawak,2,2,0
1/09/2023,Trinidad and Tobago,Selangor,39,23,16
1/09/2023,Tunisia,Johor,11,4,7
1/09/2023,Tunisia,Kedah,1,1,0
1/09/2023,Tunisia,Kelantan,0,0,0
1/09/2023,Tunisia,Melaka,0,0,0
1/09/2023,Tunisia,Perak,2,1,1
1/09/2023,Tunisia,Perlis,0,0,0
1/09/2023,Tunisia,Pulau Pinang,4,3,1
1/09/2023,Tunisia,Sabah,0,0,0
1/09/2023,Tunisia,Sarawak,1,1,0
1/09/2023,Tunisia,Selangor,1746,847,899
1/09/2023,Tunisia,W.P. Labuan,0,0,0
1/09/2023,Türkiye,Johor,332,221,111
1/09/2023,Türkiye,Kedah,28,15,13
1/09/2023,Türkiye,Kelantan,0,0,0
1/09/2023,Türkiye,Melaka,1,1,0
1/09/2023,Türkiye,Negeri Sembilan,0,0,0
1/09/2023,Türkiye,Pahang,2,2,0
1/09/2023,Türkiye,Perak,2,2,0
1/09/2023,Türkiye,Perlis,11,9,2
1/09/2023,Türkiye,Pulau Pinang,24,16,8
1/09/2023,Türkiye,Sabah,1,1,0
1/09/2023,Türkiye,Sarawak,18,12,6
1/09/2023,Türkiye,Selangor,2170,1302,868
1/09/2023,Türkiye,W.P. Labuan,0,0,0
1/09/2023,Tuvalu,Selangor,2,1,1
1/09/2023,"Taiwan, Province of China",Johor,5692,2405,3287
1/09/2023,"Taiwan, Province of China",Kedah,113,55,58
1/09/2023,"Taiwan, Province of China",Kelantan,1,1,0
1/09/2023,"Taiwan, Province of China",Melaka,4,3,1
1/09/2023,"Taiwan, Province of China",Negeri Sembilan,0,0,0
1/09/2023,"Taiwan, Province of China",Pahang,15,8,7
1/09/2023,"Taiwan, Province of China",Perak,48,26,22
1/09/2023,"Taiwan, Province of China",Perlis,26,15,11
1/09/2023,"Taiwan, Province of China",Pulau Pinang,3634,1749,1885
1/09/2023,"Taiwan, Province of China",Sabah,281,135,146
1/09/2023,"Taiwan, Province of China",Sarawak,323,147,176
1/09/2023,"Taiwan, Province of China",Selangor,18179,8828,9351
1/09/2023,"Taiwan, Province of China",W.P. Labuan,20,9,11
1/09/2023,"Tanzania, United Republic of",Johor,20,13,7
1/09/2023,"Tanzania, United Republic of",Kedah,0,0,0
1/09/2023,"Tanzania, United Republic of",Perak,0,0,0
1/09/2023,"Tanzania, United Republic of",Perlis,0,0,0
1/09/2023,"Tanzania, United Republic of",Pulau Pinang,1,1,0
1/09/2023,"Tanzania, United Republic of",Sabah,0,0,0
1/09/2023,"Tanzania, United Republic of",Sarawak,2,2,0
1/09/2023,"Tanzania, United Republic of",Selangor,294,173,121
1/09/2023,Uganda,Johor,15,7,8
1/09/2023,Uganda,Kedah,0,0,0
1/09/2023,Uganda,Perak,0,0,0
1/09/2023,Uganda,Perlis,0,0,0
1/09/2023,Uganda,Pulau Pinang,3,2,1
1/09/2023,Uganda,Sabah,0,0,0
1/09/2023,Uganda,Sarawak,0,0,0
1/09/2023,Uganda,Selangor,157,64,93
1/09/2023,Ukraine,Johor,98,52,46
1/09/2023,Ukraine,Kedah,25,10,15
1/09/2023,Ukraine,Kelantan,1,1,0
1/09/2023,Ukraine,Melaka,0,0,0
1/09/2023,Ukraine,Negeri Sembilan,0,0,0
1/09/2023,Ukraine,Pahang,4,4,0
1/09/2023,Ukraine,Perak,1,1,0
1/09/2023,Ukraine,Perlis,6,5,1
1/09/2023,Ukraine,Pulau Pinang,15,11,4
1/09/2023,Ukraine,Sabah,2,2,0
1/09/2023,Ukraine,Sarawak,4,3,1
1/09/2023,Ukraine,Selangor,870,448,422
1/09/2023,Ukraine,W.P. Labuan,1,0,1
1/09/2023,Uruguay,Johor,7,4,3
1/09/2023,Uruguay,Kedah,0,0,0
1/09/2023,Uruguay,Kelantan,0,0,0
1/09/2023,Uruguay,Perak,0,0,0
1/09/2023,Uruguay,Perlis,0,0,0
1/09/2023,Uruguay,Pulau Pinang,0,0,0
1/09/2023,Uruguay,Sabah,0,0,0
1/09/2023,Uruguay,Sarawak,1,0,1
1/09/2023,Uruguay,Selangor,33,18,15
1/09/2023,Uruguay,W.P. Labuan,0,0,0
1/09/2023,United States of America,Johor,4192,2446,1746
1/09/2023,United States of America,Kedah,293,166,127
1/09/2023,United States of America,Kelantan,11,6,5
1/09/2023,United States of America,Melaka,3,3,0
1/09/2023,United States of America,Negeri Sembilan,1,1,0
1/09/2023,United States of America,Pahang,30,19,11
1/09/2023,United States of America,Perak,148,77,71
1/09/2023,United States of America,Perlis,105,67,38
1/09/2023,United States of America,Pulau Pinang,1816,1189,627
1/09/2023,United States of America,Sabah,137,70,67
1/09/2023,United States of America,Sarawak,268,153,115
1/09/2023,United States of America,Selangor,14022,8338,5684
1/09/2023,United States of America,Terengganu,0,0,0
1/09/2023,United States of America,W.P. Labuan,5,4,1
1/09/2023,Uzbekistan,Johor,89,58,31
1/09/2023,Uzbekistan,Kedah,4,3,1
1/09/2023,Uzbekistan,Kelantan,0,0,0
1/09/2023,Uzbekistan,Perak,1,0,1
1/09/2023,Uzbekistan,Perlis,0,0,0
1/09/2023,Uzbekistan,Pulau Pinang,22,14,8
1/09/2023,Uzbekistan,Sabah,0,0,0
1/09/2023,Uzbekistan,Sarawak,1,0,1
1/09/2023,Uzbekistan,Selangor,968,560,408
1/09/2023,Holy See,Johor,0,0,0
1/09/2023,Holy See,Sarawak,0,0,0
1/09/2023,Holy See,Selangor,1,1,0
1/09/2023,Saint Vincent and the Grenadines,Johor,0,0,0
1/09/2023,Saint Vincent and the Grenadines,Kedah,0,0,0
1/09/2023,Saint Vincent and the Grenadines,Pulau Pinang,0,0,0
1/09/2023,Saint Vincent and the Grenadines,Sarawak,0,0,0
1/09/2023,Saint Vincent and the Grenadines,Selangor,2,1,1
1/09/2023,"Venezuela, Bolivarian Republic of",Johor,7,2,5
1/09/2023,"Venezuela, Bolivarian Republic of",Kedah,0,0,0
1/09/2023,"Venezuela, Bolivarian Republic of",Kelantan,0,0,0
1/09/2023,"Venezuela, Bolivarian Republic of",Melaka,0,0,0
1/09/2023,"Venezuela, Bolivarian Republic of",Perak,0,0,0
1/09/2023,"Venezuela, Bolivarian Republic of",Perlis,1,0,1
1/09/2023,"Venezuela, Bolivarian Republic of",Pulau Pinang,0,0,0
1/09/2023,"Venezuela, Bolivarian Republic of",Sabah,0,0,0
1/09/2023,"Venezuela, Bolivarian Republic of",Sarawak,7,5,2
1/09/2023,"Venezuela, Bolivarian Republic of",Selangor,92,43,49
1/09/2023,"Venezuela, Bolivarian Republic of",W.P. Labuan,0,0,0
1/09/2023,Viet Nam,Johor,14872,4843,10029
1/09/2023,Viet Nam,Kedah,246,31,215
1/09/2023,Viet Nam,Kelantan,31,10,21
1/09/2023,Viet Nam,Melaka,0,0,0
1/09/2023,Viet Nam,Negeri Sembilan,0,0,0
1/09/2023,Viet Nam,Pahang,1,1,0
1/09/2023,Viet Nam,Perak,130,11,119
1/09/2023,Viet Nam,Perlis,211,27,184
1/09/2023,Viet Nam,Pulau Pinang,1586,614,972
1/09/2023,Viet Nam,Sabah,7,4,3
1/09/2023,Viet Nam,Sarawak,210,45,165
1/09/2023,Viet Nam,Selangor,16439,6033,10406
1/09/2023,Viet Nam,Terengganu,0,0,0
1/09/2023,Viet Nam,W.P. Labuan,3,3,0
1/09/2023,Vanuatu,Johor,44,36,8
1/09/2023,Vanuatu,Kedah,0,0,0
1/09/2023,Vanuatu,Pulau Pinang,8,7,1
1/09/2023,Vanuatu,Sabah,1,1,0
1/09/2023,Vanuatu,Sarawak,0,0,0
1/09/2023,Vanuatu,Selangor,121,110,11
1/09/2023, Samoa,Johor,0,0,0
1/09/2023, Samoa,Sarawak,0,0,0
1/09/2023, Samoa,Selangor,7,4,3
1/09/2023,Yemen,Johor,20,18,2
1/09/2023,Yemen,Kedah,4,3,1
1/09/2023,Yemen,Kelantan,0,0,0
1/09/2023,Yemen,Melaka,4,2,2
1/09/2023,Yemen,Pahang,0,0,0
1/09/2023,Yemen,Perak,0,0,0
1/09/2023,Yemen,Perlis,1,1,0
1/09/2023,Yemen,Pulau Pinang,5,3,2
1/09/2023,Yemen,Sabah,1,1,0
1/09/2023,Yemen,Sarawak,3,3,0
1/09/2023,Yemen,Selangor,1472,1059,413
1/09/2023,Yemen,W.P. Labuan,0,0,0
1/09/2023,South Africa,Johor,301,182,119
1/09/2023,South Africa,Kedah,28,16,12
1/09/2023,South Africa,Kelantan,0,0,0
1/09/2023,South Africa,Melaka,0,0,0
1/09/2023,South Africa,Pahang,0,0,0
1/09/2023,South Africa,Perak,3,1,2
1/09/2023,South Africa,Perlis,8,4,4
1/09/2023,South Africa,Pulau Pinang,32,21,11
1/09/2023,South Africa,Sabah,6,2,4
1/09/2023,South Africa,Sarawak,80,39,41
1/09/2023,South Africa,Selangor,1133,679,454
1/09/2023,South Africa,Terengganu,0,0,0
1/09/2023,South Africa,W.P. Labuan,1,0,1
1/09/2023,ZAR,Selangor,0,0,0
1/09/2023,Zambia,Johor,3,1,2
1/09/2023,Zambia,Kedah,0,0,0
1/09/2023,Zambia,Perak,0,0,0
1/09/2023,Zambia,Perlis,0,0,0
1/09/2023,Zambia,Pulau Pinang,0,0,0
1/09/2023,Zambia,Sabah,0,0,0
1/09/2023,Zambia,Sarawak,0,0,0
1/09/2023,Zambia,Selangor,118,49,69
1/09/2023,Zimbabwe,Johor,14,6,8
1/09/2023,Zimbabwe,Kedah,0,0,0
1/09/2023,Zimbabwe,Kelantan,0,0,0
1/09/2023,Zimbabwe,Perak,1,0,1
1/09/2023,Zimbabwe,Perlis,0,0,0
1/09/2023,Zimbabwe,Pulau Pinang,0,0,0
1/09/2023,Zimbabwe,Sabah,1,1,0
1/09/2023,Zimbabwe,Sarawak,2,2,0
1/09/2023,Zimbabwe,Selangor,181,95,86
1/10/2023,Aruba,Kedah,0,0,0
1/10/2023,Aruba,Pulau Pinang,0,0,0
1/10/2023,Afghanistan,Johor,0,0,0
1/10/2023,Afghanistan,Kedah,0,0,0
1/10/2023,Afghanistan,Perlis,0,0,0
1/10/2023,Afghanistan,Pulau Pinang,1,0,1
1/10/2023,Afghanistan,Sarawak,0,0,0
1/10/2023,Afghanistan,Selangor,72,57,15
1/10/2023,Angola,Johor,1,1,0
1/10/2023,Angola,Kedah,0,0,0
1/10/2023,Angola,Sabah,0,0,0
1/10/2023,Angola,Selangor,4,3,1
1/10/2023,Anguilla,Selangor,0,0,0
1/10/2023,Albania,Johor,27,20,7
1/10/2023,Albania,Kedah,1,0,1
1/10/2023,Albania,Perak,0,0,0
1/10/2023,Albania,Perlis,0,0,0
1/10/2023,Albania,Pulau Pinang,1,0,1
1/10/2023,Albania,Sabah,0,0,0
1/10/2023,Albania,Sarawak,1,1,0
1/10/2023,Albania,Selangor,32,17,15
1/10/2023,Andorra,Johor,3,1,2
1/10/2023,Andorra,Kedah,0,0,0
1/10/2023,Andorra,Perlis,0,0,0
1/10/2023,Andorra,Pulau Pinang,1,1,0
1/10/2023,Andorra,Selangor,11,9,2
1/10/2023,Antigua and Barbuda,Selangor,0,0,0
1/10/2023,United Arab Emirates,Johor,17,9,8
1/10/2023,United Arab Emirates,Kedah,2,1,1
1/10/2023,United Arab Emirates,Kelantan,0,0,0
1/10/2023,United Arab Emirates,Perak,0,0,0
1/10/2023,United Arab Emirates,Perlis,1,1,0
1/10/2023,United Arab Emirates,Pulau Pinang,1,1,0
1/10/2023,United Arab Emirates,Sabah,0,0,0
1/10/2023,United Arab Emirates,Sarawak,0,0,0
1/10/2023,United Arab Emirates,Selangor,406,250,156
1/10/2023,Argentina,Johor,83,49,34
1/10/2023,Argentina,Kedah,30,18,12
1/10/2023,Argentina,Kelantan,0,0,0
1/10/2023,Argentina,Melaka,0,0,0
1/10/2023,Argentina,Perak,1,1,0
1/10/2023,Argentina,Perlis,4,2,2
1/10/2023,Argentina,Pulau Pinang,7,3,4
1/10/2023,Argentina,Sabah,0,0,0
1/10/2023,Argentina,Sarawak,4,3,1
1/10/2023,Argentina,Selangor,383,219,164
1/10/2023,Argentina,W.P. Labuan,0,0,0
1/10/2023,Armenia,Johor,23,5,18
1/10/2023,Armenia,Kedah,21,8,13
1/10/2023,Armenia,Kelantan,0,0,0
1/10/2023,Armenia,Perak,0,0,0
1/10/2023,Armenia,Perlis,1,1,0
1/10/2023,Armenia,Pulau Pinang,0,0,0
1/10/2023,Armenia,Sabah,0,0,0
1/10/2023,Armenia,Sarawak,1,1,0
1/10/2023,Armenia,Selangor,236,72,164
1/10/2023,Antarctica,Selangor,0,0,0
1/10/2023,Antigua and Barbuda,Johor,6,5,1
1/10/2023,Antigua and Barbuda,Kedah,0,0,0
1/10/2023,Antigua and Barbuda,Pulau Pinang,0,0,0
1/10/2023,Antigua and Barbuda,Sarawak,0,0,0
1/10/2023,Antigua and Barbuda,Selangor,8,7,1
1/10/2023,Australia,Johor,5758,3403,2355
1/10/2023,Australia,Kedah,528,318,210
1/10/2023,Australia,Kelantan,2,1,1
1/10/2023,Australia,Melaka,1,1,0
1/10/2023,Australia,Negeri Sembilan,2,2,0
1/10/2023,Australia,Pahang,26,13,13
1/10/2023,Australia,Perak,214,117,97
1/10/2023,Australia,Perlis,78,42,36
1/10/2023,Australia,Pulau Pinang,1817,959,858
1/10/2023,Australia,Sabah,85,42,43
1/10/2023,Australia,Sarawak,501,272,229
1/10/2023,Australia,Selangor,24006,13843,10163
1/10/2023,Australia,Terengganu,0,0,0
1/10/2023,Australia,W.P. Labuan,5,3,2
1/10/2023,Austria,Johor,182,121,61
1/10/2023,Austria,Kedah,28,19,9
1/10/2023,Austria,Kelantan,6,6,0
1/10/2023,Austria,Melaka,0,0,0
1/10/2023,Austria,Negeri Sembilan,0,0,0
1/10/2023,Austria,Pahang,0,0,0
1/10/2023,Austria,Perak,1,1,0
1/10/2023,Austria,Perlis,5,3,2
1/10/2023,Austria,Pulau Pinang,78,55,23
1/10/2023,Austria,Sabah,1,0,1
1/10/2023,Austria,Sarawak,16,8,8
1/10/2023,Austria,Selangor,750,462,288
1/10/2023,Austria,Terengganu,0,0,0
1/10/2023,Austria,W.P. Labuan,0,0,0
1/10/2023,Azerbaijan,Johor,1,0,1
1/10/2023,Azerbaijan,Kedah,1,1,0
1/10/2023,Azerbaijan,Kelantan,0,0,0
1/10/2023,Azerbaijan,Melaka,0,0,0
1/10/2023,Azerbaijan,Perlis,1,1,0
1/10/2023,Azerbaijan,Pulau Pinang,0,0,0
1/10/2023,Azerbaijan,Sabah,0,0,0
1/10/2023,Azerbaijan,Sarawak,0,0,0
1/10/2023,Azerbaijan,Selangor,133,70,63
1/10/2023,Azerbaijan,W.P. Labuan,0,0,0
1/10/2023,Burundi,Pulau Pinang,0,0,0
1/10/2023,Burundi,Sarawak,0,0,0
1/10/2023,Burundi,Selangor,1,0,1
1/10/2023,Belgium,Johor,277,189,88
1/10/2023,Belgium,Kedah,58,27,31
1/10/2023,Belgium,Kelantan,3,2,1
1/10/2023,Belgium,Melaka,0,0,0
1/10/2023,Belgium,Negeri Sembilan,0,0,0
1/10/2023,Belgium,Pahang,0,0,0
1/10/2023,Belgium,Perak,1,1,0
1/10/2023,Belgium,Perlis,15,9,6
1/10/2023,Belgium,Pulau Pinang,72,45,27
1/10/2023,Belgium,Sabah,2,2,0
1/10/2023,Belgium,Sarawak,20,9,11
1/10/2023,Belgium,Selangor,1245,762,483
1/10/2023,Belgium,W.P. Labuan,0,0,0
1/10/2023,Benin,Johor,3,3,0
1/10/2023,Benin,Kedah,0,0,0
1/10/2023,Benin,Perak,0,0,0
1/10/2023,Benin,Pulau Pinang,0,0,0
1/10/2023,Benin,Sabah,0,0,0
1/10/2023,Benin,Sarawak,0,0,0
1/10/2023,Benin,Selangor,8,6,2
1/10/2023,Burkina Faso,Perak,0,0,0
1/10/2023,Burkina Faso,Pulau Pinang,0,0,0
1/10/2023,Burkina Faso,Selangor,7,6,1
1/10/2023,Bangladesh,Johor,3629,3020,609
1/10/2023,Bangladesh,Kedah,129,83,46
1/10/2023,Bangladesh,Kelantan,2,2,0
1/10/2023,Bangladesh,Melaka,0,0,0
1/10/2023,Bangladesh,Negeri Sembilan,0,0,0
1/10/2023,Bangladesh,Pahang,0,0,0
1/10/2023,Bangladesh,Perak,11,9,2
1/10/2023,Bangladesh,Perlis,6,6,0
1/10/2023,Bangladesh,Pulau Pinang,218,208,10
1/10/2023,Bangladesh,Sabah,9,6,3
1/10/2023,Bangladesh,Sarawak,38,31,7
1/10/2023,Bangladesh,Selangor,39230,37522,1708
1/10/2023,Bangladesh,W.P. Labuan,18,18,0
1/10/2023,Bulgaria,Johor,32,18,14
1/10/2023,Bulgaria,Kedah,6,3,3
1/10/2023,Bulgaria,Kelantan,0,0,0
1/10/2023,Bulgaria,Pahang,0,0,0
1/10/2023,Bulgaria,Perak,0,0,0
1/10/2023,Bulgaria,Perlis,1,1,0
1/10/2023,Bulgaria,Pulau Pinang,9,6,3
1/10/2023,Bulgaria,Sabah,0,0,0
1/10/2023,Bulgaria,Sarawak,1,1,0
1/10/2023,Bulgaria,Selangor,173,93,80
1/10/2023,Bulgaria,W.P. Labuan,0,0,0
1/10/2023,Bahrain,Johor,18,13,5
1/10/2023,Bahrain,Kedah,2,1,1
1/10/2023,Bahrain,Kelantan,0,0,0
1/10/2023,Bahrain,Perlis,3,3,0
1/10/2023,Bahrain,Pulau Pinang,0,0,0
1/10/2023,Bahrain,Sabah,0,0,0
1/10/2023,Bahrain,Sarawak,0,0,0
1/10/2023,Bahrain,Selangor,175,122,53
1/10/2023,Bahamas,Johor,1,0,1
1/10/2023,Bahamas,Kedah,1,0,1
1/10/2023,Bahamas,Perak,0,0,0
1/10/2023,Bahamas,Sabah,0,0,0
1/10/2023,Bahamas,Sarawak,0,0,0
1/10/2023,Bahamas,Selangor,7,4,3
1/10/2023,Bosnia and Herzegovina,Johor,9,6,3
1/10/2023,Bosnia and Herzegovina,Kedah,0,0,0
1/10/2023,Bosnia and Herzegovina,Perlis,1,1,0
1/10/2023,Bosnia and Herzegovina,Pulau Pinang,0,0,0
1/10/2023,Bosnia and Herzegovina,Sabah,0,0,0
1/10/2023,Bosnia and Herzegovina,Sarawak,0,0,0
1/10/2023,Bosnia and Herzegovina,Selangor,41,23,18
1/10/2023,Belarus,Johor,24,11,13
1/10/2023,Belarus,Kedah,12,6,6
1/10/2023,Belarus,Kelantan,1,1,0
1/10/2023,Belarus,Pahang,0,0,0
1/10/2023,Belarus,Perak,0,0,0
1/10/2023,Belarus,Perlis,1,0,1
1/10/2023,Belarus,Pulau Pinang,6,3,3
1/10/2023,Belarus,Sabah,0,0,0
1/10/2023,Belarus,Sarawak,1,0,1
1/10/2023,Belarus,Selangor,333,152,181
1/10/2023,Belarus,W.P. Labuan,0,0,0
1/10/2023,Belize,Johor,0,0,0
1/10/2023,Belize,Pulau Pinang,0,0,0
1/10/2023,Belize,Sarawak,0,0,0
1/10/2023,Belize,Selangor,1,1,0
1/10/2023,Bermuda,Selangor,0,0,0
1/10/2023,Bolivia,Johor,2,1,1
1/10/2023,Bolivia,Kedah,0,0,0
1/10/2023,Bolivia,Melaka,0,0,0
1/10/2023,Bolivia,Perak,0,0,0
1/10/2023,Bolivia,Perlis,0,0,0
1/10/2023,Bolivia,Pulau Pinang,0,0,0
1/10/2023,Bolivia,Sabah,0,0,0
1/10/2023,Bolivia,Sarawak,0,0,0
1/10/2023,Bolivia,Selangor,277,139,138
1/10/2023,Brazil,Johor,252,146,106
1/10/2023,Brazil,Kedah,42,18,24
1/10/2023,Brazil,Kelantan,2,1,1
1/10/2023,Brazil,Melaka,0,0,0
1/10/2023,Brazil,Pahang,0,0,0
1/10/2023,Brazil,Perak,2,1,1
1/10/2023,Brazil,Perlis,6,5,1
1/10/2023,Brazil,Pulau Pinang,26,17,9
1/10/2023,Brazil,Sabah,5,4,1
1/10/2023,Brazil,Sarawak,9,7,2
1/10/2023,Brazil,Selangor,1032,628,404
1/10/2023,Brazil,W.P. Labuan,2,2,0
1/10/2023,Barbados,Johor,2,2,0
1/10/2023,Barbados,Kedah,0,0,0
1/10/2023,Barbados,Perlis,0,0,0
1/10/2023,Barbados,Pulau Pinang,0,0,0
1/10/2023,Barbados,Selangor,5,3,2
1/10/2023,Brunei Darussalam,Johor,327,156,171
1/10/2023,Brunei Darussalam,Kedah,17,8,9
1/10/2023,Brunei Darussalam,Kelantan,9,8,1
1/10/2023,Brunei Darussalam,Melaka,0,0,0
1/10/2023,Brunei Darussalam,Pahang,0,0,0
1/10/2023,Brunei Darussalam,Perak,1,1,0
1/10/2023,Brunei Darussalam,Perlis,27,10,17
1/10/2023,Brunei Darussalam,Pulau Pinang,22,10,12
1/10/2023,Brunei Darussalam,Sabah,134,61,73
1/10/2023,Brunei Darussalam,Sarawak,58974,33361,25613
1/10/2023,Brunei Darussalam,Selangor,4375,2176,2199
1/10/2023,Brunei Darussalam,W.P. Labuan,871,646,225
1/10/2023,Bhutan,Johor,10,7,3
1/10/2023,Bhutan,Kedah,0,0,0
1/10/2023,Bhutan,Perak,0,0,0
1/10/2023,Bhutan,Perlis,0,0,0
1/10/2023,Bhutan,Pulau Pinang,0,0,0
1/10/2023,Bhutan,Sabah,0,0,0
1/10/2023,Bhutan,Sarawak,0,0,0
1/10/2023,Bhutan,Selangor,48,32,16
1/10/2023,Botswana,Johor,2,2,0
1/10/2023,Botswana,Kedah,0,0,0
1/10/2023,Botswana,Perlis,0,0,0
1/10/2023,Botswana,Pulau Pinang,0,0,0
1/10/2023,Botswana,Sabah,0,0,0
1/10/2023,Botswana,Sarawak,0,0,0
1/10/2023,Botswana,Selangor,14,4,10
1/10/2023,Central African Republic,Kedah,0,0,0
1/10/2023,Central African Republic,Selangor,1,0,1
1/10/2023,Canada,Johor,1558,889,669
1/10/2023,Canada,Kedah,168,84,84
1/10/2023,Canada,Kelantan,0,0,0
1/10/2023,Canada,Melaka,0,0,0
1/10/2023,Canada,Negeri Sembilan,0,0,0
1/10/2023,Canada,Pahang,6,4,2
1/10/2023,Canada,Perak,34,20,14
1/10/2023,Canada,Perlis,41,28,13
1/10/2023,Canada,Pulau Pinang,479,266,213
1/10/2023,Canada,Sabah,46,28,18
1/10/2023,Canada,Sarawak,242,146,96
1/10/2023,Canada,Selangor,4518,2586,1932
1/10/2023,Canada,Terengganu,0,0,0
1/10/2023,Canada,W.P. Labuan,4,3,1
1/10/2023,Cocos (Keeling) Islands,Selangor,0,0,0
1/10/2023,Switzerland,Johor,403,246,157
1/10/2023,Switzerland,Kedah,106,58,48
1/10/2023,Switzerland,Kelantan,1,0,1
1/10/2023,Switzerland,Melaka,0,0,0
1/10/2023,Switzerland,Negeri Sembilan,0,0,0
1/10/2023,Switzerland,Pahang,1,1,0
1/10/2023,Switzerland,Perak,5,2,3
1/10/2023,Switzerland,Perlis,20,8,12
1/10/2023,Switzerland,Pulau Pinang,157,93,64
1/10/2023,Switzerland,Sabah,9,6,3
1/10/2023,Switzerland,Sarawak,47,22,25
1/10/2023,Switzerland,Selangor,1372,845,527
1/10/2023,Switzerland,W.P. Labuan,5,3,2
1/10/2023,Chile,Johor,40,17,23
1/10/2023,Chile,Kedah,9,3,6
1/10/2023,Chile,Kelantan,1,0,1
1/10/2023,Chile,Melaka,0,0,0
1/10/2023,Chile,Pahang,0,0,0
1/10/2023,Chile,Perak,0,0,0
1/10/2023,Chile,Perlis,2,1,1
1/10/2023,Chile,Pulau Pinang,10,5,5
1/10/2023,Chile,Sabah,0,0,0
1/10/2023,Chile,Sarawak,1,1,0
1/10/2023,Chile,Selangor,247,130,117
1/10/2023,China,Johor,48690,21231,27459
1/10/2023,China,Kedah,1156,521,635
1/10/2023,China,Kelantan,12,7,5
1/10/2023,China,Melaka,3,3,0
1/10/2023,China,Pahang,28,14,14
1/10/2023,China,Perak,237,97,140
1/10/2023,China,Perlis,94,53,41
1/10/2023,China,Pulau Pinang,9209,4790,4419
1/10/2023,China,Sabah,1575,765,810
1/10/2023,China,Sarawak,957,490,467
1/10/2023,China,Selangor,96676,49199,47477
1/10/2023,China,Terengganu,1,1,0
1/10/2023,China,W.P. Labuan,44,39,5
1/10/2023,Côte d'Ivoire,Johor,2,2,0
1/10/2023,Côte d'Ivoire,Kedah,0,0,0
1/10/2023,Côte d'Ivoire,Pulau Pinang,0,0,0
1/10/2023,Côte d'Ivoire,Sabah,0,0,0
1/10/2023,Côte d'Ivoire,Sarawak,0,0,0
1/10/2023,Côte d'Ivoire,Selangor,16,11,5
1/10/2023,Cameroon,Johor,2,2,0
1/10/2023,Cameroon,Kedah,1,1,0
1/10/2023,Cameroon,Pulau Pinang,0,0,0
1/10/2023,Cameroon,Sabah,1,1,0
1/10/2023,Cameroon,Sarawak,0,0,0
1/10/2023,Cameroon,Selangor,25,20,5
1/10/2023,Congo,Johor,3,3,0
1/10/2023,Congo,Pulau Pinang,0,0,0
1/10/2023,Congo,Sarawak,0,0,0
1/10/2023,Congo,Selangor,13,10,3
1/10/2023,Congo,Johor,0,0,0
1/10/2023,Congo,Kedah,0,0,0
1/10/2023,Congo,Selangor,17,14,3
1/10/2023,Cook Islands,Selangor,0,0,0
1/10/2023,Colombia,Johor,47,33,14
1/10/2023,Colombia,Kedah,8,3,5
1/10/2023,Colombia,Perak,0,0,0
1/10/2023,Colombia,Pulau Pinang,6,3,3
1/10/2023,Colombia,Sabah,2,1,1
1/10/2023,Colombia,Sarawak,1,1,0
1/10/2023,Colombia,Selangor,241,127,114
1/10/2023,Colombia,W.P. Labuan,1,1,0
1/10/2023,Comoros,Johor,0,0,0
1/10/2023,Comoros,Kedah,0,0,0
1/10/2023,Comoros,Selangor,21,13,8
1/10/2023,Cabo Verde,Johor,0,0,0
1/10/2023,Cabo Verde,Kedah,0,0,0
1/10/2023,Cabo Verde,Pulau Pinang,0,0,0
1/10/2023,Cabo Verde,Sabah,0,0,0
1/10/2023,Cabo Verde,Selangor,5,2,3
1/10/2023,Costa Rica,Johor,22,15,7
1/10/2023,Costa Rica,Kedah,3,1,2
1/10/2023,Costa Rica,Perak,0,0,0
1/10/2023,Costa Rica,Perlis,0,0,0
1/10/2023,Costa Rica,Pulau Pinang,13,7,6
1/10/2023,Costa Rica,Sabah,0,0,0
1/10/2023,Costa Rica,Sarawak,3,3,0
1/10/2023,Costa Rica,Selangor,58,33,25
1/10/2023,Cuba,Johor,5,3,2
1/10/2023,Cuba,Kedah,0,0,0
1/10/2023,Cuba,Perlis,0,0,0
1/10/2023,Cuba,Pulau Pinang,0,0,0
1/10/2023,Cuba,Sabah,0,0,0
1/10/2023,Cuba,Sarawak,0,0,0
1/10/2023,Cuba,Selangor,13,6,7
1/10/2023,Cyprus,Johor,20,14,6
1/10/2023,Cyprus,Kedah,0,0,0
1/10/2023,Cyprus,Perak,0,0,0
1/10/2023,Cyprus,Perlis,0,0,0
1/10/2023,Cyprus,Pulau Pinang,2,1,1
1/10/2023,Cyprus,Sabah,0,0,0
1/10/2023,Cyprus,Sarawak,1,0,1
1/10/2023,Cyprus,Selangor,73,42,31
1/10/2023,Czechia,Johor,81,41,40
1/10/2023,Czechia,Kedah,39,18,21
1/10/2023,Czechia,Kelantan,0,0,0
1/10/2023,Czechia,Melaka,0,0,0
1/10/2023,Czechia,Negeri Sembilan,0,0,0
1/10/2023,Czechia,Perak,0,0,0
1/10/2023,Czechia,Perlis,2,1,1
1/10/2023,Czechia,Pulau Pinang,11,5,6
1/10/2023,Czechia,Sabah,2,1,1
1/10/2023,Czechia,Sarawak,5,5,0
1/10/2023,Czechia,Selangor,503,302,201
1/10/2023,Czechia,W.P. Labuan,0,0,0
1/10/2023,Germany,Johor,2566,1575,991
1/10/2023,Germany,Kedah,368,197,171
1/10/2023,Germany,Kelantan,16,10,6
1/10/2023,Germany,Melaka,3,1,2
1/10/2023,Germany,Negeri Sembilan,1,1,0
1/10/2023,Germany,Pahang,12,10,2
1/10/2023,Germany,Perak,39,21,18
1/10/2023,Germany,Perlis,68,41,27
1/10/2023,Germany,Pulau Pinang,786,540,246
1/10/2023,Germany,Sabah,31,16,15
1/10/2023,Germany,Sarawak,230,153,77
1/10/2023,Germany,Selangor,6844,4246,2598
1/10/2023,Germany,Terengganu,0,0,0
1/10/2023,Germany,W.P. Labuan,5,2,3
1/10/2023,Djibouti,Johor,1,1,0
1/10/2023,Djibouti,Selangor,12,8,4
1/10/2023,Dominica,Johor,4,3,1
1/10/2023,Dominica,Kedah,0,0,0
1/10/2023,Dominica,Pulau Pinang,0,0,0
1/10/2023,Dominica,Sabah,0,0,0
1/10/2023,Dominica,Sarawak,0,0,0
1/10/2023,Dominica,Selangor,44,38,6
1/10/2023,Dominica,W.P. Labuan,0,0,0
1/10/2023,Denmark,Johor,358,243,115
1/10/2023,Denmark,Kedah,46,28,18
1/10/2023,Denmark,Kelantan,0,0,0
1/10/2023,Denmark,Melaka,0,0,0
1/10/2023,Denmark,Negeri Sembilan,0,0,0
1/10/2023,Denmark,Pahang,0,0,0
1/10/2023,Denmark,Perak,0,0,0
1/10/2023,Denmark,Perlis,6,4,2
1/10/2023,Denmark,Pulau Pinang,62,39,23
1/10/2023,Denmark,Sabah,16,8,8
1/10/2023,Denmark,Sarawak,17,9,8
1/10/2023,Denmark,Selangor,1113,654,459
1/10/2023,Denmark,W.P. Labuan,0,0,0
1/10/2023,Dominican Republic,Johor,0,0,0
1/10/2023,Dominican Republic,Kedah,0,0,0
1/10/2023,Dominican Republic,Perak,0,0,0
1/10/2023,Dominican Republic,Perlis,0,0,0
1/10/2023,Dominican Republic,Pulau Pinang,2,1,1
1/10/2023,Dominican Republic,Sabah,0,0,0
1/10/2023,Dominican Republic,Sarawak,0,0,0
1/10/2023,Dominican Republic,Selangor,20,9,11
1/10/2023,Algeria,Johor,34,21,13
1/10/2023,Algeria,Kedah,2,2,0
1/10/2023,Algeria,Kelantan,1,1,0
1/10/2023,Algeria,Melaka,0,0,0
1/10/2023,Algeria,Perak,0,0,0
1/10/2023,Algeria,Perlis,0,0,0
1/10/2023,Algeria,Pulau Pinang,2,1,1
1/10/2023,Algeria,Sabah,0,0,0
1/10/2023,Algeria,Sarawak,2,2,0
1/10/2023,Algeria,Selangor,1145,741,404
1/10/2023,Algeria,W.P. Labuan,0,0,0
1/10/2023,Ecuador,Johor,9,5,4
1/10/2023,Ecuador,Kedah,1,1,0
1/10/2023,Ecuador,Perak,0,0,0
1/10/2023,Ecuador,Perlis,0,0,0
1/10/2023,Ecuador,Pulau Pinang,0,0,0
1/10/2023,Ecuador,Sabah,0,0,0
1/10/2023,Ecuador,Sarawak,0,0,0
1/10/2023,Ecuador,Selangor,72,42,30
1/10/2023,Egypt,Johor,239,211,28
1/10/2023,Egypt,Kedah,5,4,1
1/10/2023,Egypt,Kelantan,2,2,0
1/10/2023,Egypt,Melaka,0,0,0
1/10/2023,Egypt,Pahang,0,0,0
1/10/2023,Egypt,Perak,1,0,1
1/10/2023,Egypt,Perlis,1,1,0
1/10/2023,Egypt,Pulau Pinang,9,9,0
1/10/2023,Egypt,Sabah,1,1,0
1/10/2023,Egypt,Sarawak,73,41,32
1/10/2023,Egypt,Selangor,2259,1559,700
1/10/2023,Egypt,Terengganu,0,0,0
1/10/2023,Egypt,W.P. Labuan,0,0,0
1/10/2023,Eritrea,Johor,0,0,0
1/10/2023,Eritrea,Pulau Pinang,0,0,0
1/10/2023,Eritrea,Sabah,0,0,0
1/10/2023,Eritrea,Selangor,13,10,3
1/10/2023,Spain,Johor,586,340,246
1/10/2023,Spain,Kedah,109,57,52
1/10/2023,Spain,Kelantan,8,4,4
1/10/2023,Spain,Melaka,0,0,0
1/10/2023,Spain,Negeri Sembilan,0,0,0
1/10/2023,Spain,Pahang,3,2,1
1/10/2023,Spain,Perak,8,5,3
1/10/2023,Spain,Perlis,15,9,6
1/10/2023,Spain,Pulau Pinang,112,73,39
1/10/2023,Spain,Sabah,13,5,8
1/10/2023,Spain,Sarawak,60,35,25
1/10/2023,Spain,Selangor,3213,1795,1418
1/10/2023,Spain,W.P. Labuan,2,1,1
1/10/2023,Estonia,Johor,23,11,12
1/10/2023,Estonia,Kedah,27,14,13
1/10/2023,Estonia,Kelantan,0,0,0
1/10/2023,Estonia,Pahang,0,0,0
1/10/2023,Estonia,Perak,0,0,0
1/10/2023,Estonia,Perlis,0,0,0
1/10/2023,Estonia,Pulau Pinang,9,3,6
1/10/2023,Estonia,Sabah,3,2,1
1/10/2023,Estonia,Sarawak,3,2,1
1/10/2023,Estonia,Selangor,198,101,97
1/10/2023,Estonia,W.P. Labuan,1,0,1
1/10/2023,Ethiopia,Johor,0,0,0
1/10/2023,Ethiopia,Kedah,0,0,0
1/10/2023,Ethiopia,Pulau Pinang,0,0,0
1/10/2023,Ethiopia,Sarawak,0,0,0
1/10/2023,Ethiopia,Selangor,61,42,19
1/10/2023,Finland,Johor,203,113,90
1/10/2023,Finland,Kedah,37,20,17
1/10/2023,Finland,Kelantan,0,0,0
1/10/2023,Finland,Melaka,0,0,0
1/10/2023,Finland,Negeri Sembilan,0,0,0
1/10/2023,Finland,Pahang,0,0,0
1/10/2023,Finland,Perak,5,3,2
1/10/2023,Finland,Perlis,2,2,0
1/10/2023,Finland,Pulau Pinang,62,31,31
1/10/2023,Finland,Sabah,1,1,0
1/10/2023,Finland,Sarawak,10,6,4
1/10/2023,Finland,Selangor,470,255,215
1/10/2023,Finland,W.P. Labuan,0,0,0
1/10/2023,Fiji,Johor,63,34,29
1/10/2023,Fiji,Kedah,3,3,0
1/10/2023,Fiji,Kelantan,0,0,0
1/10/2023,Fiji,Perak,0,0,0
1/10/2023,Fiji,Perlis,0,0,0
1/10/2023,Fiji,Pulau Pinang,6,4,2
1/10/2023,Fiji,Sabah,0,0,0
1/10/2023,Fiji,Sarawak,1,1,0
1/10/2023,Fiji,Selangor,166,76,90
1/10/2023,France,Johor,2135,1285,850
1/10/2023,France,Kedah,322,169,153
1/10/2023,France,Kelantan,24,16,8
1/10/2023,France,Melaka,7,4,3
1/10/2023,France,Negeri Sembilan,3,0,3
1/10/2023,France,Pahang,24,14,10
1/10/2023,France,Perak,27,22,5
1/10/2023,France,Perlis,45,29,16
1/10/2023,France,Pulau Pinang,329,207,122
1/10/2023,France,Sabah,34,25,9
1/10/2023,France,Sarawak,80,50,30
1/10/2023,France,Selangor,7994,4822,3172
1/10/2023,France,Terengganu,0,0,0
1/10/2023,France,W.P. Labuan,6,3,3
1/10/2023,"Micronesia, Federated States of",Johor,0,0,0
1/10/2023,"Micronesia, Federated States of",Pulau Pinang,0,0,0
1/10/2023,"Micronesia, Federated States of",Selangor,1,0,1
1/10/2023,Gabon,Johor,1,0,1
1/10/2023,Gabon,Pulau Pinang,0,0,0
1/10/2023,Gabon,Sarawak,0,0,0
1/10/2023,Gabon,Selangor,10,4,6
1/10/2023,United Kingdom of Great Britain and Northern Ireland,Johor,5482,3422,2060
1/10/2023,United Kingdom of Great Britain and Northern Ireland,Kedah,747,413,334
1/10/2023,United Kingdom of Great Britain and Northern Ireland,Kelantan,23,14,9
1/10/2023,United Kingdom of Great Britain and Northern Ireland,Melaka,1,1,0
1/10/2023,United Kingdom of Great Britain and Northern Ireland,Negeri Sembilan,2,2,0
1/10/2023,United Kingdom of Great Britain and Northern Ireland,Pahang,35,25,10
1/10/2023,United Kingdom of Great Britain and Northern Ireland,Perak,86,58,28
1/10/2023,United Kingdom of Great Britain and Northern Ireland,Perlis,122,76,46
1/10/2023,United Kingdom of Great Britain and Northern Ireland,Pulau Pinang,1587,957,630
1/10/2023,United Kingdom of Great Britain and Northern Ireland,Sabah,106,58,48
1/10/2023,United Kingdom of Great Britain and Northern Ireland,Sarawak,991,585,406
1/10/2023,United Kingdom of Great Britain and Northern Ireland,Selangor,17730,10854,6876
1/10/2023,United Kingdom of Great Britain and Northern Ireland,Terengganu,0,0,0
1/10/2023,United Kingdom of Great Britain and Northern Ireland,W.P. Labuan,45,35,10
1/10/2023,Georgia,Johor,3,2,1
1/10/2023,Georgia,Kedah,2,1,1
1/10/2023,Georgia,Melaka,0,0,0
1/10/2023,Georgia,Perak,0,0,0
1/10/2023,Georgia,Perlis,0,0,0
1/10/2023,Georgia,Pulau Pinang,4,2,2
1/10/2023,Georgia,Sabah,2,1,1
1/10/2023,Georgia,Sarawak,0,0,0
1/10/2023,Georgia,Selangor,42,24,18
1/10/2023,Ghana,Johor,8,7,1
1/10/2023,Ghana,Kedah,0,0,0
1/10/2023,Ghana,Kelantan,0,0,0
1/10/2023,Ghana,Pulau Pinang,0,0,0
1/10/2023,Ghana,Sabah,0,0,0
1/10/2023,Ghana,Sarawak,0,0,0
1/10/2023,Ghana,Selangor,94,59,35
1/10/2023,Gibraltar,Johor,1,0,1
1/10/2023,Gibraltar,Sarawak,0,0,0
1/10/2023,Guinea,Johor,4,2,2
1/10/2023,Guinea,Kedah,1,1,0
1/10/2023,Guinea,Kelantan,1,1,0
1/10/2023,Guinea,Perlis,0,0,0
1/10/2023,Guinea,Pulau Pinang,0,0,0
1/10/2023,Guinea,Sabah,0,0,0
1/10/2023,Guinea,Sarawak,0,0,0
1/10/2023,Guinea,Selangor,57,37,20
1/10/2023,Guadeloupe,Selangor,0,0,0
1/10/2023,Gambia,Johor,4,4,0
1/10/2023,Gambia,Kedah,0,0,0
1/10/2023,Gambia,Kelantan,0,0,0
1/10/2023,Gambia,Pulau Pinang,0,0,0
1/10/2023,Gambia,Sabah,2,2,0
1/10/2023,Gambia,Sarawak,0,0,0
1/10/2023,Gambia,Selangor,34,25,9
1/10/2023,Guinea-Bissau,Johor,0,0,0
1/10/2023,Guinea-Bissau,Selangor,0,0,0
1/10/2023,Equatorial Guinea,Johor,1,1,0
1/10/2023,Equatorial Guinea,Selangor,2,1,1
1/10/2023,Greece,Johor,80,62,18
1/10/2023,Greece,Kedah,1,0,1
1/10/2023,Greece,Kelantan,0,0,0
1/10/2023,Greece,Melaka,0,0,0
1/10/2023,Greece,Negeri Sembilan,1,1,0
1/10/2023,Greece,Pahang,0,0,0
1/10/2023,Greece,Perak,0,0,0
1/10/2023,Greece,Perlis,1,1,0
1/10/2023,Greece,Pulau Pinang,13,11,2
1/10/2023,Greece,Sabah,3,2,1
1/10/2023,Greece,Sarawak,19,13,6
1/10/2023,Greece,Selangor,251,174,77
1/10/2023,Grenada,Johor,11,4,7
1/10/2023,Grenada,Kedah,0,0,0
1/10/2023,Grenada,Pulau Pinang,1,1,0
1/10/2023,Grenada,Sabah,0,0,0
1/10/2023,Grenada,Sarawak,0,0,0
1/10/2023,Grenada,Selangor,20,17,3
1/10/2023,Greenland,Johor,0,0,0
1/10/2023,Greenland,Selangor,0,0,0
1/10/2023,Guatemala,Johor,2,2,0
1/10/2023,Guatemala,Kedah,0,0,0
1/10/2023,Guatemala,Pahang,0,0,0
1/10/2023,Guatemala,Perak,0,0,0
1/10/2023,Guatemala,Pulau Pinang,1,1,0
1/10/2023,Guatemala,Sabah,0,0,0
1/10/2023,Guatemala,Sarawak,0,0,0
1/10/2023,Guatemala,Selangor,45,24,21
1/10/2023,Guatemala,W.P. Labuan,0,0,0
1/10/2023,Guyana,Johor,0,0,0
1/10/2023,Guyana,Kedah,0,0,0
1/10/2023,Guyana,Pulau Pinang,0,0,0
1/10/2023,Guyana,Sarawak,0,0,0
1/10/2023,Guyana,Selangor,3,0,3
1/10/2023,Hong Kong,Johor,6,5,1
1/10/2023,Hong Kong,Kedah,0,0,0
1/10/2023,Hong Kong,Kelantan,0,0,0
1/10/2023,Hong Kong,Pahang,2,2,0
1/10/2023,Hong Kong,Perak,21,10,11
1/10/2023,Hong Kong,Perlis,0,0,0
1/10/2023,Hong Kong,Pulau Pinang,0,0,0
1/10/2023,Hong Kong,Sabah,0,0,0
1/10/2023,Hong Kong,Sarawak,0,0,0
1/10/2023,Hong Kong,Selangor,2,1,1
1/10/2023,Hong Kong,Terengganu,1,1,0
1/10/2023,Heard Island and McDonald Islands,Johor,0,0,0
1/10/2023,Honduras,Johor,3,3,0
1/10/2023,Honduras,Kedah,1,1,0
1/10/2023,Honduras,Perak,0,0,0
1/10/2023,Honduras,Pulau Pinang,0,0,0
1/10/2023,Honduras,Sabah,0,0,0
1/10/2023,Honduras,Sarawak,0,0,0
1/10/2023,Honduras,Selangor,21,13,8
1/10/2023,Croatia,Johor,49,37,12
1/10/2023,Croatia,Kedah,1,1,0
1/10/2023,Croatia,Kelantan,0,0,0
1/10/2023,Croatia,Melaka,0,0,0
1/10/2023,Croatia,Pahang,2,2,0
1/10/2023,Croatia,Perak,0,0,0
1/10/2023,Croatia,Perlis,0,0,0
1/10/2023,Croatia,Pulau Pinang,7,3,4
1/10/2023,Croatia,Sabah,0,0,0
1/10/2023,Croatia,Sarawak,0,0,0
1/10/2023,Croatia,Selangor,201,135,66
1/10/2023,Haiti,Johor,1,1,0
1/10/2023,Haiti,Kedah,0,0,0
1/10/2023,Haiti,Kelantan,0,0,0
1/10/2023,Haiti,Perak,0,0,0
1/10/2023,Haiti,Pulau Pinang,0,0,0
1/10/2023,Haiti,Sabah,0,0,0
1/10/2023,Haiti,Selangor,4,4,0
1/10/2023,Hungary,Johor,106,66,40
1/10/2023,Hungary,Kedah,21,10,11
1/10/2023,Hungary,Kelantan,0,0,0
1/10/2023,Hungary,Pahang,0,0,0
1/10/2023,Hungary,Perak,3,3,0
1/10/2023,Hungary,Perlis,2,1,1
1/10/2023,Hungary,Pulau Pinang,24,15,9
1/10/2023,Hungary,Sabah,2,1,1
1/10/2023,Hungary,Sarawak,7,4,3
1/10/2023,Hungary,Selangor,492,268,224
1/10/2023,Hungary,W.P. Labuan,0,0,0
1/10/2023,Indonesia,Johor,93484,43240,50244
1/10/2023,Indonesia,Kedah,6462,2392,4070
1/10/2023,Indonesia,Kelantan,278,133,145
1/10/2023,Indonesia,Melaka,3476,1526,1950
1/10/2023,Indonesia,Negeri Sembilan,5078,3032,2046
1/10/2023,Indonesia,Pahang,16,11,5
1/10/2023,Indonesia,Perak,262,122,140
1/10/2023,Indonesia,Perlis,616,315,301
1/10/2023,Indonesia,Pulau Pinang,38534,15377,23157
1/10/2023,Indonesia,Sabah,3845,1995,1850
1/10/2023,Indonesia,Sarawak,34683,18599,16084
1/10/2023,Indonesia,Selangor,126287,59676,66611
1/10/2023,Indonesia,Terengganu,0,0,0
1/10/2023,Indonesia,W.P. Labuan,55,37,18
1/10/2023,India,Johor,26747,18215,8532
1/10/2023,India,Kedah,1245,660,585
1/10/2023,India,Kelantan,3,3,0
1/10/2023,India,Melaka,2,2,0
1/10/2023,India,Negeri Sembilan,2,2,0
1/10/2023,India,Pahang,10,9,1
1/10/2023,India,Perak,151,115,36
1/10/2023,India,Perlis,30,26,4
1/10/2023,India,Pulau Pinang,920,675,245
1/10/2023,India,Sabah,96,76,20
1/10/2023,India,Sarawak,1091,938,153
1/10/2023,India,Selangor,52719,35647,17072
1/10/2023,India,Terengganu,0,0,0
1/10/2023,India,W.P. Labuan,28,27,1
1/10/2023, British Indian Ocean Territory,Pulau Pinang,0,0,0
1/10/2023, British Indian Ocean Territory,Selangor,0,0,0
1/10/2023,Ireland,Johor,297,187,110
1/10/2023,Ireland,Kedah,58,29,29
1/10/2023,Ireland,Kelantan,2,1,1
1/10/2023,Ireland,Negeri Sembilan,0,0,0
1/10/2023,Ireland,Pahang,0,0,0
1/10/2023,Ireland,Perak,7,5,2
1/10/2023,Ireland,Perlis,13,9,4
1/10/2023,Ireland,Pulau Pinang,91,57,34
1/10/2023,Ireland,Sabah,6,3,3
1/10/2023,Ireland,Sarawak,43,22,21
1/10/2023,Ireland,Selangor,1375,818,557
1/10/2023,Ireland,Terengganu,0,0,0
1/10/2023,Ireland,W.P. Labuan,1,0,1
1/10/2023,"Iran, Islamic Republic of",Johor,314,163,151
1/10/2023,"Iran, Islamic Republic of",Kedah,12,8,4
1/10/2023,"Iran, Islamic Republic of",Kelantan,0,0,0
1/10/2023,"Iran, Islamic Republic of",Perak,0,0,0
1/10/2023,"Iran, Islamic Republic of",Perlis,3,2,1
1/10/2023,"Iran, Islamic Republic of",Pulau Pinang,6,2,4
1/10/2023,"Iran, Islamic Republic of",Sabah,0,0,0
1/10/2023,"Iran, Islamic Republic of",Sarawak,2,2,0
1/10/2023,"Iran, Islamic Republic of",Selangor,1857,1000,857
1/10/2023,"Iran, Islamic Republic of",W.P. Labuan,0,0,0
1/10/2023,Iraq,Johor,22,14,8
1/10/2023,Iraq,Kedah,4,1,3
1/10/2023,Iraq,Kelantan,0,0,0
1/10/2023,Iraq,Melaka,0,0,0
1/10/2023,Iraq,Pahang,0,0,0
1/10/2023,Iraq,Perak,0,0,0
1/10/2023,Iraq,Perlis,0,0,0
1/10/2023,Iraq,Pulau Pinang,6,5,1
1/10/2023,Iraq,Sabah,1,1,0
1/10/2023,Iraq,Sarawak,4,2,2
1/10/2023,Iraq,Selangor,1482,1030,452
1/10/2023,Iceland,Johor,3,2,1
1/10/2023,Iceland,Kedah,0,0,0
1/10/2023,Iceland,Kelantan,0,0,0
1/10/2023,Iceland,Perak,2,1,1
1/10/2023,Iceland,Perlis,2,0,2
1/10/2023,Iceland,Pulau Pinang,1,1,0
1/10/2023,Iceland,Sabah,1,0,1
1/10/2023,Iceland,Sarawak,2,2,0
1/10/2023,Iceland,Selangor,19,10,9
1/10/2023,Iceland,W.P. Labuan,0,0,0
1/10/2023,Israel,Pulau Pinang,0,0,0
1/10/2023,Italy,Johor,600,427,173
1/10/2023,Italy,Kedah,87,54,33
1/10/2023,Italy,Kelantan,4,3,1
1/10/2023,Italy,Melaka,2,1,1
1/10/2023,Italy,Negeri Sembilan,0,0,0
1/10/2023,Italy,Pahang,5,3,2
1/10/2023,Italy,Perak,6,4,2
1/10/2023,Italy,Perlis,13,10,3
1/10/2023,Italy,Pulau Pinang,129,97,32
1/10/2023,Italy,Sabah,10,5,5
1/10/2023,Italy,Sarawak,34,20,14
1/10/2023,Italy,Selangor,2554,1749,805
1/10/2023,Italy,W.P. Labuan,2,2,0
1/10/2023,Jamaica,Johor,8,1,7
1/10/2023,Jamaica,Kedah,0,0,0
1/10/2023,Jamaica,Perak,0,0,0
1/10/2023,Jamaica,Pulau Pinang,0,0,0
1/10/2023,Jamaica,Sabah,0,0,0
1/10/2023,Jamaica,Sarawak,0,0,0
1/10/2023,Jamaica,Selangor,18,5,13
1/10/2023,Jamaica,W.P. Labuan,0,0,0
1/10/2023,Jordan,Johor,31,19,12
1/10/2023,Jordan,Kedah,5,2,3
1/10/2023,Jordan,Kelantan,0,0,0
1/10/2023,Jordan,Melaka,0,0,0
1/10/2023,Jordan,Perlis,4,2,2
1/10/2023,Jordan,Pulau Pinang,1,0,1
1/10/2023,Jordan,Sabah,0,0,0
1/10/2023,Jordan,Sarawak,1,1,0
1/10/2023,Jordan,Selangor,896,548,348
1/10/2023,Jordan,W.P. Labuan,0,0,0
1/10/2023,Japan,Johor,7275,4752,2523
1/10/2023,Japan,Kedah,204,116,88
1/10/2023,Japan,Kelantan,6,4,2
1/10/2023,Japan,Melaka,3,2,1
1/10/2023,Japan,Negeri Sembilan,0,0,0
1/10/2023,Japan,Pahang,10,7,3
1/10/2023,Japan,Perak,36,25,11
1/10/2023,Japan,Perlis,52,42,10
1/10/2023,Japan,Pulau Pinang,1246,911,335
1/10/2023,Japan,Sabah,66,36,30
1/10/2023,Japan,Sarawak,204,129,75
1/10/2023,Japan,Selangor,19869,12610,7259
1/10/2023,Japan,W.P. Labuan,13,9,4
1/10/2023,Kazakhstan,Johor,71,29,42
1/10/2023,Kazakhstan,Kedah,10,2,8
1/10/2023,Kazakhstan,Kelantan,5,0,5
1/10/2023,Kazakhstan,Melaka,0,0,0
1/10/2023,Kazakhstan,Perak,0,0,0
1/10/2023,Kazakhstan,Perlis,6,2,4
1/10/2023,Kazakhstan,Pulau Pinang,3,1,2
1/10/2023,Kazakhstan,Sabah,3,2,1
1/10/2023,Kazakhstan,Sarawak,5,3,2
1/10/2023,Kazakhstan,Selangor,780,321,459
1/10/2023,Kazakhstan,W.P. Labuan,0,0,0
1/10/2023,Kenya,Johor,52,22,30
1/10/2023,Kenya,Kedah,3,1,2
1/10/2023,Kenya,Kelantan,0,0,0
1/10/2023,Kenya,Perak,0,0,0
1/10/2023,Kenya,Perlis,1,0,1
1/10/2023,Kenya,Pulau Pinang,1,0,1
1/10/2023,Kenya,Sabah,2,2,0
1/10/2023,Kenya,Sarawak,1,0,1
1/10/2023,Kenya,Selangor,530,271,259
1/10/2023,Kyrgyzstan,Johor,46,31,15
1/10/2023,Kyrgyzstan,Kedah,2,1,1
1/10/2023,Kyrgyzstan,Kelantan,0,0,0
1/10/2023,Kyrgyzstan,Perak,0,0,0
1/10/2023,Kyrgyzstan,Perlis,0,0,0
1/10/2023,Kyrgyzstan,Pulau Pinang,2,1,1
1/10/2023,Kyrgyzstan,Sabah,0,0,0
1/10/2023,Kyrgyzstan,Sarawak,0,0,0
1/10/2023,Kyrgyzstan,Selangor,237,116,121
1/10/2023,Cambodia,Johor,2180,960,1220
1/10/2023,Cambodia,Kedah,123,53,70
1/10/2023,Cambodia,Kelantan,434,228,206
1/10/2023,Cambodia,Melaka,0,0,0
1/10/2023,Cambodia,Negeri Sembilan,0,0,0
1/10/2023,Cambodia,Pahang,0,0,0
1/10/2023,Cambodia,Perak,3,2,1
1/10/2023,Cambodia,Perlis,672,386,286
1/10/2023,Cambodia,Pulau Pinang,44,20,24
1/10/2023,Cambodia,Sabah,2,0,2
1/10/2023,Cambodia,Sarawak,18,11,7
1/10/2023,Cambodia,Selangor,4039,1962,2077
1/10/2023,Cambodia,W.P. Labuan,0,0,0
1/10/2023,Kiribati,Johor,0,0,0
1/10/2023,Kiribati,Sabah,0,0,0
1/10/2023,Kiribati,Selangor,0,0,0
1/10/2023,Saint Kitts and Nevis,Johor,21,14,7
1/10/2023,Saint Kitts and Nevis,Kedah,2,1,1
1/10/2023,Saint Kitts and Nevis,Perlis,0,0,0
1/10/2023,Saint Kitts and Nevis,Pulau Pinang,2,2,0
1/10/2023,Saint Kitts and Nevis,Sabah,0,0,0
1/10/2023,Saint Kitts and Nevis,Selangor,70,52,18
1/10/2023,Saint Kitts and Nevis,W.P. Labuan,0,0,0
1/10/2023,"Korea, Republic of",Johor,10225,5654,4571
1/10/2023,"Korea, Republic of",Kedah,198,99,99
1/10/2023,"Korea, Republic of",Kelantan,2,0,2
1/10/2023,"Korea, Republic of",Melaka,4,2,2
1/10/2023,"Korea, Republic of",Negeri Sembilan,0,0,0
1/10/2023,"Korea, Republic of",Pahang,3,0,3
1/10/2023,"Korea, Republic of",Perak,20,14,6
1/10/2023,"Korea, Republic of",Perlis,61,36,25
1/10/2023,"Korea, Republic of",Pulau Pinang,572,323,249
1/10/2023,"Korea, Republic of",Sabah,372,190,182
1/10/2023,"Korea, Republic of",Sarawak,258,159,99
1/10/2023,"Korea, Republic of",Selangor,13234,7452,5782
1/10/2023,"Korea, Republic of",Terengganu,0,0,0
1/10/2023,"Korea, Republic of",W.P. Labuan,3,3,0
1/10/2023,Kuwait,Johor,11,5,6
1/10/2023,Kuwait,Kedah,2,2,0
1/10/2023,Kuwait,Kelantan,0,0,0
1/10/2023,Kuwait,Perak,0,0,0
1/10/2023,Kuwait,Perlis,0,0,0
1/10/2023,Kuwait,Pulau Pinang,2,1,1
1/10/2023,Kuwait,Sabah,0,0,0
1/10/2023,Kuwait,Sarawak,0,0,0
1/10/2023,Kuwait,Selangor,410,267,143
1/10/2023,Kuwait,W.P. Labuan,0,0,0
1/10/2023, Lao People's Democratic Republic,Johor,232,64,168
1/10/2023, Lao People's Democratic Republic,Kedah,906,61,845
1/10/2023, Lao People's Democratic Republic,Kelantan,160,12,148
1/10/2023, Lao People's Democratic Republic,Melaka,0,0,0
1/10/2023, Lao People's Democratic Republic,Perak,33,3,30
1/10/2023, Lao People's Democratic Republic,Perlis,414,69,345
1/10/2023, Lao People's Democratic Republic,Pulau Pinang,22,11,11
1/10/2023, Lao People's Democratic Republic,Sabah,2,0,2
1/10/2023, Lao People's Democratic Republic,Sarawak,14,9,5
1/10/2023, Lao People's Democratic Republic,Selangor,358,159,199
1/10/2023, Lao People's Democratic Republic,W.P. Labuan,0,0,0
1/10/2023,Lebanon,Johor,26,12,14
1/10/2023,Lebanon,Kedah,0,0,0
1/10/2023,Lebanon,Kelantan,0,0,0
1/10/2023,Lebanon,Pahang,0,0,0
1/10/2023,Lebanon,Perak,1,1,0
1/10/2023,Lebanon,Perlis,0,0,0
1/10/2023,Lebanon,Pulau Pinang,0,0,0
1/10/2023,Lebanon,Sabah,0,0,0
1/10/2023,Lebanon,Sarawak,2,2,0
1/10/2023,Lebanon,Selangor,284,195,89
1/10/2023,Lebanon,W.P. Labuan,0,0,0
1/10/2023,Liberia,Johor,3,2,1
1/10/2023,Liberia,Kedah,0,0,0
1/10/2023,Liberia,Sabah,0,0,0
1/10/2023,Liberia,Sarawak,0,0,0
1/10/2023,Liberia,Selangor,9,7,2
1/10/2023,Libya,Johor,7,5,2
1/10/2023,Libya,Kedah,0,0,0
1/10/2023,Libya,Perlis,0,0,0
1/10/2023,Libya,Pulau Pinang,0,0,0
1/10/2023,Libya,Sabah,0,0,0
1/10/2023,Libya,Sarawak,3,3,0
1/10/2023,Libya,Selangor,437,313,124
1/10/2023,Saint Lucia,Johor,6,6,0
1/10/2023,Saint Lucia,Kedah,0,0,0
1/10/2023,Saint Lucia,Pulau Pinang,1,1,0
1/10/2023,Saint Lucia,Sarawak,2,1,1
1/10/2023,Saint Lucia,Selangor,7,6,1
1/10/2023,Liechtenstein,Johor,5,2,3
1/10/2023,Liechtenstein,Kedah,1,0,1
1/10/2023,Liechtenstein,Perlis,0,0,0
1/10/2023,Liechtenstein,Pulau Pinang,2,2,0
1/10/2023,Liechtenstein,Sabah,0,0,0
1/10/2023,Liechtenstein,Sarawak,0,0,0
1/10/2023,Liechtenstein,Selangor,9,1,8
1/10/2023,LKA,Johor,1196,770,426
1/10/2023,LKA,Kedah,55,35,20
1/10/2023,LKA,Kelantan,0,0,0
1/10/2023,LKA,Melaka,1,1,0
1/10/2023,LKA,Pahang,0,0,0
1/10/2023,LKA,Perak,8,6,2
1/10/2023,LKA,Perlis,1,1,0
1/10/2023,LKA,Pulau Pinang,42,27,15
1/10/2023,LKA,Sabah,3,2,1
1/10/2023,LKA,Sarawak,49,31,18
1/10/2023,LKA,Selangor,4199,2712,1487
1/10/2023,LKA,W.P. Labuan,0,0,0
1/10/2023,Lesotho,Johor,1,0,1
1/10/2023,Lesotho,Kedah,1,0,1
1/10/2023,Lesotho,Pulau Pinang,0,0,0
1/10/2023,Lesotho,Sarawak,0,0,0
1/10/2023,Lesotho,Selangor,9,4,5
1/10/2023,Lithuania,Johor,89,42,47
1/10/2023,Lithuania,Kedah,25,14,11
1/10/2023,Lithuania,Kelantan,0,0,0
1/10/2023,Lithuania,Pahang,0,0,0
1/10/2023,Lithuania,Perak,0,0,0
1/10/2023,Lithuania,Perlis,1,1,0
1/10/2023,Lithuania,Pulau Pinang,4,0,4
1/10/2023,Lithuania,Sabah,6,1,5
1/10/2023,Lithuania,Sarawak,4,3,1
1/10/2023,Lithuania,Selangor,332,180,152
1/10/2023,Lithuania,W.P. Labuan,14,5,9
1/10/2023,Luxembourg,Johor,9,7,2
1/10/2023,Luxembourg,Kedah,7,4,3
1/10/2023,Luxembourg,Kelantan,0,0,0
1/10/2023,Luxembourg,Perak,0,0,0
1/10/2023,Luxembourg,Perlis,0,0,0
1/10/2023,Luxembourg,Pulau Pinang,3,3,0
1/10/2023,Luxembourg,Sabah,0,0,0
1/10/2023,Luxembourg,Sarawak,0,0,0
1/10/2023,Luxembourg,Selangor,57,36,21
1/10/2023,Latvia,Johor,32,13,19
1/10/2023,Latvia,Kedah,7,2,5
1/10/2023,Latvia,Kelantan,0,0,0
1/10/2023,Latvia,Pahang,0,0,0
1/10/2023,Latvia,Perak,0,0,0
1/10/2023,Latvia,Perlis,0,0,0
1/10/2023,Latvia,Pulau Pinang,1,0,1
1/10/2023,Latvia,Sabah,2,0,2
1/10/2023,Latvia,Sarawak,1,0,1
1/10/2023,Latvia,Selangor,169,88,81
1/10/2023,Latvia,W.P. Labuan,6,2,4
1/10/2023,Macao,Johor,0,0,0
1/10/2023,Macao,Pahang,0,0,0
1/10/2023,Macao,Perak,1,1,0
1/10/2023,Macao,Selangor,0,0,0
1/10/2023,Macao,W.P. Labuan,0,0,0
1/10/2023,Morocco,Johor,78,45,33
1/10/2023,Morocco,Kedah,8,5,3
1/10/2023,Morocco,Kelantan,2,2,0
1/10/2023,Morocco,Melaka,0,0,0
1/10/2023,Morocco,Pahang,0,0,0
1/10/2023,Morocco,Perak,0,0,0
1/10/2023,Morocco,Perlis,5,4,1
1/10/2023,Morocco,Pulau Pinang,13,9,4
1/10/2023,Morocco,Sabah,0,0,0
1/10/2023,Morocco,Sarawak,2,2,0
1/10/2023,Morocco,Selangor,1357,693,664
1/10/2023,Morocco,W.P. Labuan,0,0,0
1/10/2023,Monaco,Johor,0,0,0
1/10/2023,Monaco,Kedah,0,0,0
1/10/2023,Monaco,Sabah,0,0,0
1/10/2023,Monaco,Selangor,1,1,0
1/10/2023,"Moldova, Republic of",Johor,1,1,0
1/10/2023,"Moldova, Republic of",Kedah,1,0,1
1/10/2023,"Moldova, Republic of",Kelantan,0,0,0
1/10/2023,"Moldova, Republic of",Negeri Sembilan,1,1,0
1/10/2023,"Moldova, Republic of",Perlis,0,0,0
1/10/2023,"Moldova, Republic of",Pulau Pinang,0,0,0
1/10/2023,"Moldova, Republic of",Sabah,0,0,0
1/10/2023,"Moldova, Republic of",Sarawak,0,0,0
1/10/2023,"Moldova, Republic of",Selangor,42,23,19
1/10/2023,Madagascar,Johor,7,4,3
1/10/2023,Madagascar,Kedah,1,0,1
1/10/2023,Madagascar,Perak,0,0,0
1/10/2023,Madagascar,Perlis,0,0,0
1/10/2023,Madagascar,Pulau Pinang,2,2,0
1/10/2023,Madagascar,Sabah,0,0,0
1/10/2023,Madagascar,Sarawak,0,0,0
1/10/2023,Madagascar,Selangor,87,42,45
1/10/2023,Maldives,Johor,158,65,93
1/10/2023,Maldives,Kedah,2,1,1
1/10/2023,Maldives,Kelantan,0,0,0
1/10/2023,Maldives,Perak,0,0,0
1/10/2023,Maldives,Perlis,0,0,0
1/10/2023,Maldives,Pulau Pinang,1,1,0
1/10/2023,Maldives,Sabah,0,0,0
1/10/2023,Maldives,Sarawak,0,0,0
1/10/2023,Maldives,Selangor,2499,1371,1128
1/10/2023,Mexico,Johor,227,104,123
1/10/2023,Mexico,Kedah,9,4,5
1/10/2023,Mexico,Kelantan,0,0,0
1/10/2023,Mexico,Pahang,0,0,0
1/10/2023,Mexico,Perak,0,0,0
1/10/2023,Mexico,Perlis,2,1,1
1/10/2023,Mexico,Pulau Pinang,32,28,4
1/10/2023,Mexico,Sabah,1,1,0
1/10/2023,Mexico,Sarawak,6,3,3
1/10/2023,Mexico,Selangor,882,455,427
1/10/2023,Mexico,W.P. Labuan,0,0,0
1/10/2023,Marshall Islands,Johor,2,1,1
1/10/2023,Marshall Islands,Kedah,0,0,0
1/10/2023,Marshall Islands,Perak,2,1,1
1/10/2023,Marshall Islands,Pulau Pinang,0,0,0
1/10/2023,Marshall Islands,Sabah,0,0,0
1/10/2023,Marshall Islands,Selangor,0,0,0
1/10/2023,North Macedonia,Johor,4,2,2
1/10/2023,North Macedonia,Kedah,0,0,0
1/10/2023,North Macedonia,Perak,0,0,0
1/10/2023,North Macedonia,Pulau Pinang,2,1,1
1/10/2023,North Macedonia,Sabah,0,0,0
1/10/2023,North Macedonia,Sarawak,1,0,1
1/10/2023,North Macedonia,Selangor,57,27,30
1/10/2023,Mali,Johor,3,3,0
1/10/2023,Mali,Sabah,0,0,0
1/10/2023,Mali,Selangor,11,5,6
1/10/2023,Malta,Johor,7,6,1
1/10/2023,Malta,Kedah,0,0,0
1/10/2023,Malta,Kelantan,0,0,0
1/10/2023,Malta,Perak,0,0,0
1/10/2023,Malta,Perlis,0,0,0
1/10/2023,Malta,Pulau Pinang,3,2,1
1/10/2023,Malta,Sabah,0,0,0
1/10/2023,Malta,Sarawak,0,0,0
1/10/2023,Malta,Selangor,27,20,7
1/10/2023,Malta,W.P. Labuan,0,0,0
1/10/2023,Myanmar,Johor,6179,1980,4199
1/10/2023,Myanmar,Kedah,77,21,56
1/10/2023,Myanmar,Kelantan,0,0,0
1/10/2023,Myanmar,Negeri Sembilan,0,0,0
1/10/2023,Myanmar,Pahang,3,1,2
1/10/2023,Myanmar,Perak,21,6,15
1/10/2023,Myanmar,Perlis,1,0,1
1/10/2023,Myanmar,Pulau Pinang,293,157,136
1/10/2023,Myanmar,Sabah,7,1,6
1/10/2023,Myanmar,Sarawak,92,45,47
1/10/2023,Myanmar,Selangor,6339,4111,2228
1/10/2023,Myanmar,Terengganu,0,0,0
1/10/2023,Myanmar,W.P. Labuan,0,0,0
1/10/2023,Montenegro,Johor,3,3,0
1/10/2023,Montenegro,Kedah,0,0,0
1/10/2023,Montenegro,Pulau Pinang,0,0,0
1/10/2023,Montenegro,Sabah,0,0,0
1/10/2023,Montenegro,Sarawak,1,1,0
1/10/2023,Montenegro,Selangor,11,11,0
1/10/2023,Mongolia,Johor,106,26,80
1/10/2023,Mongolia,Kedah,9,3,6
1/10/2023,Mongolia,Kelantan,2,2,0
1/10/2023,Mongolia,Perak,0,0,0
1/10/2023,Mongolia,Perlis,1,0,1
1/10/2023,Mongolia,Pulau Pinang,20,8,12
1/10/2023,Mongolia,Sabah,0,0,0
1/10/2023,Mongolia,Sarawak,0,0,0
1/10/2023,Mongolia,Selangor,358,130,228
1/10/2023,Northern Mariana Islands,Selangor,0,0,0
1/10/2023,Mozambique,Johor,0,0,0
1/10/2023,Mozambique,Kedah,0,0,0
1/10/2023,Mozambique,Perak,0,0,0
1/10/2023,Mozambique,Pulau Pinang,0,0,0
1/10/2023,Mozambique,Sabah,0,0,0
1/10/2023,Mozambique,Sarawak,0,0,0
1/10/2023,Mozambique,Selangor,14,10,4
1/10/2023,Mauritania,Johor,3,1,2
1/10/2023,Mauritania,Kedah,0,0,0
1/10/2023,Mauritania,Pulau Pinang,1,1,0
1/10/2023,Mauritania,Sabah,0,0,0
1/10/2023,Mauritania,Sarawak,0,0,0
1/10/2023,Mauritania,Selangor,23,21,2
1/10/2023,Mauritius,Johor,101,58,43
1/10/2023,Mauritius,Kedah,0,0,0
1/10/2023,Mauritius,Kelantan,0,0,0
1/10/2023,Mauritius,Pahang,0,0,0
1/10/2023,Mauritius,Perak,2,2,0
1/10/2023,Mauritius,Perlis,2,1,1
1/10/2023,Mauritius,Pulau Pinang,3,1,2
1/10/2023,Mauritius,Sabah,1,1,0
1/10/2023,Mauritius,Sarawak,0,0,0
1/10/2023,Mauritius,Selangor,1766,928,838
1/10/2023,Malawi,Johor,2,0,2
1/10/2023,Malawi,Pulau Pinang,0,0,0
1/10/2023,Malawi,Sabah,0,0,0
1/10/2023,Malawi,Sarawak,0,0,0
1/10/2023,Malawi,Selangor,20,13,7
1/10/2023,Mayotte,Selangor,0,0,0
1/10/2023,Namibia,Johor,1,1,0
1/10/2023,Namibia,Kedah,0,0,0
1/10/2023,Namibia,Perak,0,0,0
1/10/2023,Namibia,Perlis,1,1,0
1/10/2023,Namibia,Pulau Pinang,0,0,0
1/10/2023,Namibia,Sabah,0,0,0
1/10/2023,Namibia,Sarawak,1,1,0
1/10/2023,Namibia,Selangor,32,20,12
1/10/2023,New Caledonia,Selangor,0,0,0
1/10/2023,Niger,Johor,0,0,0
1/10/2023,Niger,Sabah,0,0,0
1/10/2023,Niger,Selangor,3,2,1
1/10/2023,Nigeria,Johor,32,27,5
1/10/2023,Nigeria,Kedah,1,1,0
1/10/2023,Nigeria,Perlis,1,1,0
1/10/2023,Nigeria,Pulau Pinang,0,0,0
1/10/2023,Nigeria,Sabah,0,0,0
1/10/2023,Nigeria,Sarawak,9,8,1
1/10/2023,Nigeria,Selangor,457,333,124
1/10/2023,Nicaragua,Johor,0,0,0
1/10/2023,Nicaragua,Kedah,0,0,0
1/10/2023,Nicaragua,Pulau Pinang,0,0,0
1/10/2023,Nicaragua,Sabah,0,0,0
1/10/2023,Nicaragua,Selangor,2,2,0
1/10/2023,Netherlands,Johor,1115,704,411
1/10/2023,Netherlands,Kedah,156,87,69
1/10/2023,Netherlands,Kelantan,7,3,4
1/10/2023,Netherlands,Melaka,1,1,0
1/10/2023,Netherlands,Negeri Sembilan,0,0,0
1/10/2023,Netherlands,Pahang,2,1,1
1/10/2023,Netherlands,Perak,6,4,2
1/10/2023,Netherlands,Perlis,36,22,14
1/10/2023,Netherlands,Pulau Pinang,252,173,79
1/10/2023,Netherlands,Sabah,21,9,12
1/10/2023,Netherlands,Sarawak,144,71,73
1/10/2023,Netherlands,Selangor,4256,2507,1749
1/10/2023,Netherlands,Terengganu,0,0,0
1/10/2023,Netherlands,W.P. Labuan,1,1,0
1/10/2023,Norway,Johor,193,117,76
1/10/2023,Norway,Kedah,21,12,9
1/10/2023,Norway,Kelantan,0,0,0
1/10/2023,Norway,Melaka,0,0,0
1/10/2023,Norway,Pahang,0,0,0
1/10/2023,Norway,Perak,1,1,0
1/10/2023,Norway,Perlis,3,3,0
1/10/2023,Norway,Pulau Pinang,43,23,20
1/10/2023,Norway,Sabah,0,0,0
1/10/2023,Norway,Sarawak,12,10,2
1/10/2023,Norway,Selangor,673,440,233
1/10/2023,Norway,W.P. Labuan,0,0,0
1/10/2023,Nepal,Johor,944,587,357
1/10/2023,Nepal,Kedah,19,12,7
1/10/2023,Nepal,Pahang,1,1,0
1/10/2023,Nepal,Perak,0,0,0
1/10/2023,Nepal,Perlis,1,1,0
1/10/2023,Nepal,Pulau Pinang,11,7,4
1/10/2023,Nepal,Sabah,2,2,0
1/10/2023,Nepal,Sarawak,130,91,39
1/10/2023,Nepal,Selangor,7181,6586,595
1/10/2023,Nepal,W.P. Labuan,18,17,1
1/10/2023,Nauru,Johor,0,0,0
1/10/2023,Nauru,Pulau Pinang,0,0,0
1/10/2023,Nauru,Selangor,0,0,0
1/10/2023,New Zealand,Johor,956,590,366
1/10/2023,New Zealand,Kedah,97,44,53
1/10/2023,New Zealand,Kelantan,1,1,0
1/10/2023,New Zealand,Melaka,0,0,0
1/10/2023,New Zealand,Negeri Sembilan,2,2,0
1/10/2023,New Zealand,Pahang,23,13,10
1/10/2023,New Zealand,Perak,35,18,17
1/10/2023,New Zealand,Perlis,20,13,7
1/10/2023,New Zealand,Pulau Pinang,225,128,97
1/10/2023,New Zealand,Sabah,7,3,4
1/10/2023,New Zealand,Sarawak,131,80,51
1/10/2023,New Zealand,Selangor,3365,1970,1395
1/10/2023,New Zealand,Terengganu,0,0,0
1/10/2023,New Zealand,W.P. Labuan,5,3,2
1/10/2023,Oman,Johor,29,19,10
1/10/2023,Oman,Kedah,4,3,1
1/10/2023,Oman,Kelantan,0,0,0
1/10/2023,Oman,Melaka,0,0,0
1/10/2023,Oman,Perak,1,1,0
1/10/2023,Oman,Perlis,5,5,0
1/10/2023,Oman,Pulau Pinang,5,5,0
1/10/2023,Oman,Sabah,0,0,0
1/10/2023,Oman,Sarawak,2,2,0
1/10/2023,Oman,Selangor,1135,744,391
1/10/2023,Pakistan,Johor,1109,810,299
1/10/2023,Pakistan,Kedah,78,54,24
1/10/2023,Pakistan,Kelantan,17,17,0
1/10/2023,Pakistan,Melaka,0,0,0
1/10/2023,Pakistan,Negeri Sembilan,0,0,0
1/10/2023,Pakistan,Pahang,2,2,0
1/10/2023,Pakistan,Perak,13,13,0
1/10/2023,Pakistan,Perlis,14,13,1
1/10/2023,Pakistan,Pulau Pinang,76,67,9
1/10/2023,Pakistan,Sabah,6,6,0
1/10/2023,Pakistan,Sarawak,124,105,19
1/10/2023,Pakistan,Selangor,10590,9067,1523
1/10/2023,Pakistan,W.P. Labuan,0,0,0
1/10/2023,Panama,Johor,5,2,3
1/10/2023,Panama,Kedah,1,0,1
1/10/2023,Panama,Perak,0,0,0
1/10/2023,Panama,Perlis,0,0,0
1/10/2023,Panama,Pulau Pinang,0,0,0
1/10/2023,Panama,Sabah,1,1,0
1/10/2023,Panama,Sarawak,0,0,0
1/10/2023,Panama,Selangor,41,23,18
1/10/2023,Peru,Johor,43,23,20
1/10/2023,Peru,Kedah,3,1,2
1/10/2023,Peru,Kelantan,0,0,0
1/10/2023,Peru,Pahang,0,0,0
1/10/2023,Peru,Perak,2,1,1
1/10/2023,Peru,Perlis,0,0,0
1/10/2023,Peru,Pulau Pinang,5,1,4
1/10/2023,Peru,Sabah,1,0,1
1/10/2023,Peru,Sarawak,0,0,0
1/10/2023,Peru,Selangor,396,171,225
1/10/2023,Peru,W.P. Labuan,0,0,0
1/10/2023,Philippines,Johor,22838,6909,15929
1/10/2023,Philippines,Kedah,458,132,326
1/10/2023,Philippines,Kelantan,39,19,20
1/10/2023,Philippines,Melaka,0,0,0
1/10/2023,Philippines,Negeri Sembilan,0,0,0
1/10/2023,Philippines,Pahang,28,20,8
1/10/2023,Philippines,Perak,55,13,42
1/10/2023,Philippines,Perlis,281,91,190
1/10/2023,Philippines,Pulau Pinang,721,304,417
1/10/2023,Philippines,Sabah,576,304,272
1/10/2023,Philippines,Sarawak,1928,793,1135
1/10/2023,Philippines,Selangor,16866,7263,9603
1/10/2023,Philippines,Terengganu,2,2,0
1/10/2023,Philippines,W.P. Labuan,115,33,82
1/10/2023,Palau,Johor,0,0,0
1/10/2023,Palau,Pulau Pinang,0,0,0
1/10/2023,Palau,Selangor,1,1,0
1/10/2023,Papua New Guinea,Johor,12,5,7
1/10/2023,Papua New Guinea,Kedah,0,0,0
1/10/2023,Papua New Guinea,Kelantan,0,0,0
1/10/2023,Papua New Guinea,Perak,0,0,0
1/10/2023,Papua New Guinea,Pulau Pinang,3,1,2
1/10/2023,Papua New Guinea,Sabah,0,0,0
1/10/2023,Papua New Guinea,Sarawak,1,0,1
1/10/2023,Papua New Guinea,Selangor,106,72,34
1/10/2023,Poland,Johor,394,201,193
1/10/2023,Poland,Kedah,58,25,33
1/10/2023,Poland,Kelantan,1,1,0
1/10/2023,Poland,Melaka,0,0,0
1/10/2023,Poland,Negeri Sembilan,0,0,0
1/10/2023,Poland,Pahang,0,0,0
1/10/2023,Poland,Perak,7,4,3
1/10/2023,Poland,Perlis,4,3,1
1/10/2023,Poland,Pulau Pinang,58,30,28
1/10/2023,Poland,Sabah,4,2,2
1/10/2023,Poland,Sarawak,37,20,17
1/10/2023,Poland,Selangor,1342,695,647
1/10/2023,Poland,Terengganu,0,0,0
1/10/2023,Poland,W.P. Labuan,0,0,0
1/10/2023,"North Korea, Democratic People's Republic of",Selangor,0,0,0
1/10/2023,Portugal,Johor,153,85,68
1/10/2023,Portugal,Kedah,19,6,13
1/10/2023,Portugal,Kelantan,0,0,0
1/10/2023,Portugal,Melaka,0,0,0
1/10/2023,Portugal,Pahang,1,1,0
1/10/2023,Portugal,Perak,0,0,0
1/10/2023,Portugal,Perlis,1,1,0
1/10/2023,Portugal,Pulau Pinang,58,32,26
1/10/2023,Portugal,Sabah,7,5,2
1/10/2023,Portugal,Sarawak,6,3,3
1/10/2023,Portugal,Selangor,817,484,333
1/10/2023,Portugal,W.P. Labuan,0,0,0
1/10/2023,Paraguay,Johor,8,6,2
1/10/2023,Paraguay,Kedah,0,0,0
1/10/2023,Paraguay,Perak,0,0,0
1/10/2023,Paraguay,Perlis,0,0,0
1/10/2023,Paraguay,Pulau Pinang,0,0,0
1/10/2023,Paraguay,Sabah,0,0,0
1/10/2023,Paraguay,Sarawak,0,0,0
1/10/2023,Paraguay,Selangor,5,1,4
1/10/2023,"Palestine, State of",Johor,21,17,4
1/10/2023,"Palestine, State of",Kedah,1,0,1
1/10/2023,"Palestine, State of",Kelantan,0,0,0
1/10/2023,"Palestine, State of",Melaka,0,0,0
1/10/2023,"Palestine, State of",Perak,1,1,0
1/10/2023,"Palestine, State of",Perlis,0,0,0
1/10/2023,"Palestine, State of",Pulau Pinang,0,0,0
1/10/2023,"Palestine, State of",Sabah,0,0,0
1/10/2023,"Palestine, State of",Sarawak,2,2,0
1/10/2023,"Palestine, State of",Selangor,374,248,126
1/10/2023,Qatar,Johor,14,8,6
1/10/2023,Qatar,Kedah,0,0,0
1/10/2023,Qatar,Perlis,0,0,0
1/10/2023,Qatar,Pulau Pinang,0,0,0
1/10/2023,Qatar,Sabah,0,0,0
1/10/2023,Qatar,Sarawak,1,1,0
1/10/2023,Qatar,Selangor,131,83,48
1/10/2023,Réunion,Johor,0,0,0
1/10/2023,Réunion,Sarawak,0,0,0
1/10/2023,Romania,Johor,122,72,50
1/10/2023,Romania,Kedah,14,3,11
1/10/2023,Romania,Kelantan,2,1,1
1/10/2023,Romania,Negeri Sembilan,0,0,0
1/10/2023,Romania,Pahang,1,1,0
1/10/2023,Romania,Perak,0,0,0
1/10/2023,Romania,Perlis,0,0,0
1/10/2023,Romania,Pulau Pinang,21,11,10
1/10/2023,Romania,Sabah,0,0,0
1/10/2023,Romania,Sarawak,6,2,4
1/10/2023,Romania,Selangor,676,357,319
1/10/2023,Romania,W.P. Labuan,0,0,0
1/10/2023,Russian Federation (Russia),Johor,407,195,212
1/10/2023,Russian Federation (Russia),Kedah,266,124,142
1/10/2023,Russian Federation (Russia),Kelantan,54,27,27
1/10/2023,Russian Federation (Russia),Melaka,1,1,0
1/10/2023,Russian Federation (Russia),Negeri Sembilan,0,0,0
1/10/2023,Russian Federation (Russia),Pahang,7,4,3
1/10/2023,Russian Federation (Russia),Perak,1,0,1
1/10/2023,Russian Federation (Russia),Perlis,141,88,53
1/10/2023,Russian Federation (Russia),Pulau Pinang,180,100,80
1/10/2023,Russian Federation (Russia),Sabah,23,7,16
1/10/2023,Russian Federation (Russia),Sarawak,43,25,18
1/10/2023,Russian Federation (Russia),Selangor,7294,3721,3573
1/10/2023,Russian Federation (Russia),W.P. Labuan,10,6,4
1/10/2023,Rwanda,Johor,0,0,0
1/10/2023,Rwanda,Kedah,1,0,1
1/10/2023,Rwanda,Pulau Pinang,0,0,0
1/10/2023,Rwanda,Selangor,11,6,5
1/10/2023,Saudi Arabia,Johor,143,82,61
1/10/2023,Saudi Arabia,Kedah,28,15,13
1/10/2023,Saudi Arabia,Kelantan,6,2,4
1/10/2023,Saudi Arabia,Melaka,0,0,0
1/10/2023,Saudi Arabia,Perak,1,0,1
1/10/2023,Saudi Arabia,Perlis,7,6,1
1/10/2023,Saudi Arabia,Pulau Pinang,20,12,8
1/10/2023,Saudi Arabia,Sabah,0,0,0
1/10/2023,Saudi Arabia,Sarawak,11,7,4
1/10/2023,Saudi Arabia,Selangor,3761,2280,1481
1/10/2023,Saudi Arabia,W.P. Labuan,0,0,0
1/10/2023,Sudan,Johor,6,2,4
1/10/2023,Sudan,Kedah,0,0,0
1/10/2023,Sudan,Kelantan,0,0,0
1/10/2023,Sudan,Perlis,0,0,0
1/10/2023,Sudan,Pulau Pinang,0,0,0
1/10/2023,Sudan,Sabah,1,1,0
1/10/2023,Sudan,Sarawak,1,1,0
1/10/2023,Sudan,Selangor,1236,748,488
1/10/2023,Sudan,W.P. Labuan,0,0,0
1/10/2023,Senegal,Johor,2,1,1
1/10/2023,Senegal,Kedah,0,0,0
1/10/2023,Senegal,Kelantan,0,0,0
1/10/2023,Senegal,Perak,0,0,0
1/10/2023,Senegal,Perlis,1,1,0
1/10/2023,Senegal,Pulau Pinang,1,1,0
1/10/2023,Senegal,Sabah,0,0,0
1/10/2023,Senegal,Sarawak,0,0,0
1/10/2023,Senegal,Selangor,51,39,12
1/10/2023,Singapore,Johor,1284587,740290,544297
1/10/2023,Singapore,Kedah,4531,2459,2072
1/10/2023,Singapore,Kelantan,73,43,30
1/10/2023,Singapore,Melaka,13,10,3
1/10/2023,Singapore,Negeri Sembilan,5,5,0
1/10/2023,Singapore,Pahang,681,397,284
1/10/2023,Singapore,Perak,5582,2557,3025
1/10/2023,Singapore,Perlis,229,142,87
1/10/2023,Singapore,Pulau Pinang,16645,8224,8421
1/10/2023,Singapore,Sabah,527,280,247
1/10/2023,Singapore,Sarawak,3958,2260,1698
1/10/2023,Singapore,Selangor,38965,21247,17718
1/10/2023,Singapore,Terengganu,0,0,0
1/10/2023,Singapore,W.P. Labuan,25,19,6
1/10/2023,South Georgia and the South Sandwich Islands,Johor,0,0,0
1/10/2023,South Georgia and the South Sandwich Islands,Sabah,0,0,0
1/10/2023,South Georgia and the South Sandwich Islands,Selangor,0,0,0
1/10/2023,Saint Helena,Sarawak,0,0,0
1/10/2023,Solomon Islands,Johor,2,1,1
1/10/2023,Solomon Islands,Perlis,0,0,0
1/10/2023,Solomon Islands,Pulau Pinang,0,0,0
1/10/2023,Solomon Islands,Sabah,0,0,0
1/10/2023,Solomon Islands,Sarawak,1,0,1
1/10/2023,Solomon Islands,Selangor,5,3,2
1/10/2023,Solomon Islands,W.P. Labuan,0,0,0
1/10/2023,Sierra Leone,Johor,2,1,1
1/10/2023,Sierra Leone,Kedah,0,0,0
1/10/2023,Sierra Leone,Perak,0,0,0
1/10/2023,Sierra Leone,Pulau Pinang,1,0,1
1/10/2023,Sierra Leone,Sabah,1,1,0
1/10/2023,Sierra Leone,Selangor,21,14,7
1/10/2023,El Salvador,Johor,2,0,2
1/10/2023,El Salvador,Kedah,0,0,0
1/10/2023,El Salvador,Perak,0,0,0
1/10/2023,El Salvador,Perlis,0,0,0
1/10/2023,El Salvador,Pulau Pinang,2,1,1
1/10/2023,El Salvador,Sabah,0,0,0
1/10/2023,El Salvador,Selangor,17,9,8
1/10/2023,El Salvador,W.P. Labuan,0,0,0
1/10/2023,San Marino,Johor,0,0,0
1/10/2023,San Marino,Selangor,1,1,0
1/10/2023,Somalia,Johor,0,0,0
1/10/2023,Somalia,Kedah,0,0,0
1/10/2023,Somalia,Kelantan,0,0,0
1/10/2023,Somalia,Perlis,0,0,0
1/10/2023,Somalia,Sabah,0,0,0
1/10/2023,Somalia,Sarawak,0,0,0
1/10/2023,Somalia,Selangor,268,168,100
1/10/2023,Serbia,Johor,7,6,1
1/10/2023,Serbia,Kedah,4,3,1
1/10/2023,Serbia,Kelantan,0,0,0
1/10/2023,Serbia,Pahang,0,0,0
1/10/2023,Serbia,Perak,0,0,0
1/10/2023,Serbia,Perlis,0,0,0
1/10/2023,Serbia,Pulau Pinang,15,4,11
1/10/2023,Serbia,Sabah,0,0,0
1/10/2023,Serbia,Sarawak,1,0,1
1/10/2023,Serbia,Selangor,101,59,42
1/10/2023,South Sudan,Johor,0,0,0
1/10/2023,South Sudan,Kedah,0,0,0
1/10/2023,South Sudan,Sarawak,0,0,0
1/10/2023,South Sudan,Selangor,18,10,8
1/10/2023,South Sudan,W.P. Labuan,0,0,0
1/10/2023,Sao Tome and Principe,Selangor,2,2,0
1/10/2023,Suriname,Johor,5,2,3
1/10/2023,Suriname,Kedah,0,0,0
1/10/2023,Suriname,Kelantan,0,0,0
1/10/2023,Suriname,Perak,0,0,0
1/10/2023,Suriname,Perlis,0,0,0
1/10/2023,Suriname,Pulau Pinang,0,0,0
1/10/2023,Suriname,Sabah,0,0,0
1/10/2023,Suriname,Sarawak,0,0,0
1/10/2023,Suriname,Selangor,18,11,7
1/10/2023,Slovakia,Johor,29,20,9
1/10/2023,Slovakia,Kedah,54,28,26
1/10/2023,Slovakia,Kelantan,0,0,0
1/10/2023,Slovakia,Negeri Sembilan,0,0,0
1/10/2023,Slovakia,Pahang,0,0,0
1/10/2023,Slovakia,Perak,0,0,0
1/10/2023,Slovakia,Perlis,1,1,0
1/10/2023,Slovakia,Pulau Pinang,17,13,4
1/10/2023,Slovakia,Sabah,1,0,1
1/10/2023,Slovakia,Sarawak,2,2,0
1/10/2023,Slovakia,Selangor,358,202,156
1/10/2023,Slovakia,W.P. Labuan,0,0,0
1/10/2023,Slovenia,Johor,22,13,9
1/10/2023,Slovenia,Kedah,3,1,2
1/10/2023,Slovenia,Kelantan,0,0,0
1/10/2023,Slovenia,Perak,0,0,0
1/10/2023,Slovenia,Perlis,0,0,0
1/10/2023,Slovenia,Pulau Pinang,7,5,2
1/10/2023,Slovenia,Sabah,1,0,1
1/10/2023,Slovenia,Sarawak,2,2,0
1/10/2023,Slovenia,Selangor,136,80,56
1/10/2023,Slovenia,W.P. Labuan,0,0,0
1/10/2023,Sweden,Johor,317,158,159
1/10/2023,Sweden,Kedah,66,21,45
1/10/2023,Sweden,Kelantan,4,2,2
1/10/2023,Sweden,Melaka,1,1,0
1/10/2023,Sweden,Negeri Sembilan,0,0,0
1/10/2023,Sweden,Pahang,0,0,0
1/10/2023,Sweden,Perak,7,5,2
1/10/2023,Sweden,Perlis,7,6,1
1/10/2023,Sweden,Pulau Pinang,75,47,28
1/10/2023,Sweden,Sabah,14,9,5
1/10/2023,Sweden,Sarawak,50,32,18
1/10/2023,Sweden,Selangor,1022,616,406
1/10/2023,Sweden,W.P. Labuan,0,0,0
1/10/2023,Eswatini,Johor,1,1,0
1/10/2023,Eswatini,Kedah,0,0,0
1/10/2023,Eswatini,Pulau Pinang,0,0,0
1/10/2023,Eswatini,Sabah,1,0,1
1/10/2023,Eswatini,Selangor,29,19,10
1/10/2023,Seychelles,Johor,10,2,8
1/10/2023,Seychelles,Kedah,0,0,0
1/10/2023,Seychelles,Pulau Pinang,3,1,2
1/10/2023,Seychelles,Sabah,0,0,0
1/10/2023,Seychelles,Sarawak,1,1,0
1/10/2023,Seychelles,Selangor,57,23,34
1/10/2023,Syrian Arab Republic,Johor,14,10,4
1/10/2023,Syrian Arab Republic,Kedah,0,0,0
1/10/2023,Syrian Arab Republic,Kelantan,0,0,0
1/10/2023,Syrian Arab Republic,Pahang,0,0,0
1/10/2023,Syrian Arab Republic,Perlis,1,1,0
1/10/2023,Syrian Arab Republic,Pulau Pinang,2,2,0
1/10/2023,Syrian Arab Republic,Sabah,0,0,0
1/10/2023,Syrian Arab Republic,Sarawak,2,2,0
1/10/2023,Syrian Arab Republic,Selangor,687,467,220
1/10/2023,Syrian Arab Republic,W.P. Labuan,0,0,0
1/10/2023,Turks and Caicos Islands,Perlis,0,0,0
1/10/2023,TCD,Johor,1,1,0
1/10/2023,TCD,Kedah,1,1,0
1/10/2023,TCD,Perlis,1,1,0
1/10/2023,TCD,Selangor,45,32,13
1/10/2023,Togo,Johor,8,8,0
1/10/2023,Togo,Perak,0,0,0
1/10/2023,Togo,Pulau Pinang,0,0,0
1/10/2023,Togo,Selangor,12,9,3
1/10/2023,Thailand,Johor,11757,3601,8156
1/10/2023,Thailand,Kedah,78352,46416,31936
1/10/2023,Thailand,Kelantan,46426,24852,21574
1/10/2023,Thailand,Melaka,2,2,0
1/10/2023,Thailand,Negeri Sembilan,1,0,1
1/10/2023,Thailand,Pahang,10,6,4
1/10/2023,Thailand,Perak,11505,5283,6222
1/10/2023,Thailand,Perlis,56604,31372,25232
1/10/2023,Thailand,Pulau Pinang,2810,1048,1762
1/10/2023,Thailand,Sabah,20,13,7
1/10/2023,Thailand,Sarawak,320,115,205
1/10/2023,Thailand,Selangor,19691,7707,11984
1/10/2023,Thailand,Terengganu,0,0,0
1/10/2023,Thailand,W.P. Labuan,11,3,8
1/10/2023,Tajikistan,Johor,7,6,1
1/10/2023,Tajikistan,Kedah,0,0,0
1/10/2023,Tajikistan,Perlis,0,0,0
1/10/2023,Tajikistan,Pulau Pinang,0,0,0
1/10/2023,Tajikistan,Sabah,0,0,0
1/10/2023,Tajikistan,Selangor,157,120,37
1/10/2023,Tokelau,Selangor,0,0,0
1/10/2023,Turkmenistan,Johor,0,0,0
1/10/2023,Turkmenistan,Kedah,0,0,0
1/10/2023,Turkmenistan,Kelantan,0,0,0
1/10/2023,Turkmenistan,Perlis,0,0,0
1/10/2023,Turkmenistan,Pulau Pinang,0,0,0
1/10/2023,Turkmenistan,Sabah,0,0,0
1/10/2023,Turkmenistan,Sarawak,2,2,0
1/10/2023,Turkmenistan,Selangor,121,83,38
1/10/2023,Timor-Leste,Johor,5,1,4
1/10/2023,Timor-Leste,Kedah,2,0,2
1/10/2023,Timor-Leste,Perlis,0,0,0
1/10/2023,Timor-Leste,Pulau Pinang,12,8,4
1/10/2023,Timor-Leste,Sabah,0,0,0
1/10/2023,Timor-Leste,Sarawak,4,4,0
1/10/2023,Timor-Leste,Selangor,183,112,71
1/10/2023,Tonga,Johor,1,1,0
1/10/2023,Tonga,Pulau Pinang,3,1,2
1/10/2023,Tonga,Sarawak,0,0,0
1/10/2023,Tonga,Selangor,33,7,26
1/10/2023,Trinidad and Tobago,Johor,14,6,8
1/10/2023,Trinidad and Tobago,Kedah,0,0,0
1/10/2023,Trinidad and Tobago,Pahang,0,0,0
1/10/2023,Trinidad and Tobago,Pulau Pinang,1,0,1
1/10/2023,Trinidad and Tobago,Sabah,0,0,0
1/10/2023,Trinidad and Tobago,Sarawak,3,1,2
1/10/2023,Trinidad and Tobago,Selangor,32,19,13
1/10/2023,Tunisia,Johor,9,7,2
1/10/2023,Tunisia,Kedah,1,1,0
1/10/2023,Tunisia,Kelantan,0,0,0
1/10/2023,Tunisia,Melaka,0,0,0
1/10/2023,Tunisia,Perak,0,0,0
1/10/2023,Tunisia,Perlis,0,0,0
1/10/2023,Tunisia,Pulau Pinang,6,5,1
1/10/2023,Tunisia,Sabah,0,0,0
1/10/2023,Tunisia,Sarawak,0,0,0
1/10/2023,Tunisia,Selangor,937,475,462
1/10/2023,Tunisia,W.P. Labuan,0,0,0
1/10/2023,Türkiye,Johor,346,259,87
1/10/2023,Türkiye,Kedah,34,23,11
1/10/2023,Türkiye,Kelantan,1,1,0
1/10/2023,Türkiye,Melaka,0,0,0
1/10/2023,Türkiye,Negeri Sembilan,0,0,0
1/10/2023,Türkiye,Pahang,2,0,2
1/10/2023,Türkiye,Perak,1,1,0
1/10/2023,Türkiye,Perlis,10,9,1
1/10/2023,Türkiye,Pulau Pinang,39,29,10
1/10/2023,Türkiye,Sabah,1,0,1
1/10/2023,Türkiye,Sarawak,25,16,9
1/10/2023,Türkiye,Selangor,1607,1183,424
1/10/2023,Türkiye,W.P. Labuan,0,0,0
1/10/2023,Tuvalu,Selangor,0,0,0
1/10/2023,"Taiwan, Province of China",Johor,6859,2862,3997
1/10/2023,"Taiwan, Province of China",Kedah,118,64,54
1/10/2023,"Taiwan, Province of China",Kelantan,3,3,0
1/10/2023,"Taiwan, Province of China",Melaka,1,1,0
1/10/2023,"Taiwan, Province of China",Negeri Sembilan,0,0,0
1/10/2023,"Taiwan, Province of China",Pahang,5,3,2
1/10/2023,"Taiwan, Province of China",Perak,53,25,28
1/10/2023,"Taiwan, Province of China",Perlis,6,2,4
1/10/2023,"Taiwan, Province of China",Pulau Pinang,4338,2089,2249
1/10/2023,"Taiwan, Province of China",Sabah,106,46,60
1/10/2023,"Taiwan, Province of China",Sarawak,263,119,144
1/10/2023,"Taiwan, Province of China",Selangor,17862,8281,9581
1/10/2023,"Taiwan, Province of China",W.P. Labuan,6,5,1
1/10/2023,"Tanzania, United Republic of",Johor,17,11,6
1/10/2023,"Tanzania, United Republic of",Kedah,1,0,1
1/10/2023,"Tanzania, United Republic of",Perak,0,0,0
1/10/2023,"Tanzania, United Republic of",Perlis,0,0,0
1/10/2023,"Tanzania, United Republic of",Pulau Pinang,1,1,0
1/10/2023,"Tanzania, United Republic of",Sabah,0,0,0
1/10/2023,"Tanzania, United Republic of",Sarawak,4,4,0
1/10/2023,"Tanzania, United Republic of",Selangor,263,117,146
1/10/2023,Uganda,Johor,26,8,18
1/10/2023,Uganda,Kedah,0,0,0
1/10/2023,Uganda,Perak,0,0,0
1/10/2023,Uganda,Perlis,0,0,0
1/10/2023,Uganda,Pulau Pinang,0,0,0
1/10/2023,Uganda,Sabah,0,0,0
1/10/2023,Uganda,Sarawak,0,0,0
1/10/2023,Uganda,Selangor,158,82,76
1/10/2023,Ukraine,Johor,96,42,54
1/10/2023,Ukraine,Kedah,22,10,12
1/10/2023,Ukraine,Kelantan,0,0,0
1/10/2023,Ukraine,Melaka,5,5,0
1/10/2023,Ukraine,Negeri Sembilan,0,0,0
1/10/2023,Ukraine,Pahang,0,0,0
1/10/2023,Ukraine,Perak,1,0,1
1/10/2023,Ukraine,Perlis,7,4,3
1/10/2023,Ukraine,Pulau Pinang,20,9,11
1/10/2023,Ukraine,Sabah,5,2,3
1/10/2023,Ukraine,Sarawak,0,0,0
1/10/2023,Ukraine,Selangor,906,442,464
1/10/2023,Ukraine,W.P. Labuan,1,1,0
1/10/2023,Uruguay,Johor,3,2,1
1/10/2023,Uruguay,Kedah,1,1,0
1/10/2023,Uruguay,Kelantan,0,0,0
1/10/2023,Uruguay,Perak,0,0,0
1/10/2023,Uruguay,Perlis,0,0,0
1/10/2023,Uruguay,Pulau Pinang,1,1,0
1/10/2023,Uruguay,Sabah,0,0,0
1/10/2023,Uruguay,Sarawak,1,1,0
1/10/2023,Uruguay,Selangor,64,36,28
1/10/2023,Uruguay,W.P. Labuan,0,0,0
1/10/2023,United States of America,Johor,4641,2658,1983
1/10/2023,United States of America,Kedah,369,203,166
1/10/2023,United States of America,Kelantan,14,10,4
1/10/2023,United States of America,Melaka,12,6,6
1/10/2023,United States of America,Negeri Sembilan,0,0,0
1/10/2023,United States of America,Pahang,21,18,3
1/10/2023,United States of America,Perak,104,59,45
1/10/2023,United States of America,Perlis,49,30,19
1/10/2023,United States of America,Pulau Pinang,2064,1233,831
1/10/2023,United States of America,Sabah,71,39,32
1/10/2023,United States of America,Sarawak,288,156,132
1/10/2023,United States of America,Selangor,14060,8310,5750
1/10/2023,United States of America,Terengganu,0,0,0
1/10/2023,United States of America,W.P. Labuan,3,3,0
1/10/2023,Uzbekistan,Johor,66,49,17
1/10/2023,Uzbekistan,Kedah,8,5,3
1/10/2023,Uzbekistan,Kelantan,0,0,0
1/10/2023,Uzbekistan,Perak,0,0,0
1/10/2023,Uzbekistan,Perlis,2,2,0
1/10/2023,Uzbekistan,Pulau Pinang,12,5,7
1/10/2023,Uzbekistan,Sabah,2,2,0
1/10/2023,Uzbekistan,Sarawak,0,0,0
1/10/2023,Uzbekistan,Selangor,900,545,355
1/10/2023,Holy See,Johor,0,0,0
1/10/2023,Holy See,Sarawak,0,0,0
1/10/2023,Holy See,Selangor,0,0,0
1/10/2023,Saint Vincent and the Grenadines,Johor,0,0,0
1/10/2023,Saint Vincent and the Grenadines,Kedah,0,0,0
1/10/2023,Saint Vincent and the Grenadines,Pulau Pinang,0,0,0
1/10/2023,Saint Vincent and the Grenadines,Sarawak,0,0,0
1/10/2023,Saint Vincent and the Grenadines,Selangor,1,0,1
1/10/2023,"Venezuela, Bolivarian Republic of",Johor,13,8,5
1/10/2023,"Venezuela, Bolivarian Republic of",Kedah,0,0,0
1/10/2023,"Venezuela, Bolivarian Republic of",Kelantan,0,0,0
1/10/2023,"Venezuela, Bolivarian Republic of",Melaka,0,0,0
1/10/2023,"Venezuela, Bolivarian Republic of",Perak,0,0,0
1/10/2023,"Venezuela, Bolivarian Republic of",Perlis,0,0,0
1/10/2023,"Venezuela, Bolivarian Republic of",Pulau Pinang,6,4,2
1/10/2023,"Venezuela, Bolivarian Republic of",Sabah,0,0,0
1/10/2023,"Venezuela, Bolivarian Republic of",Sarawak,5,3,2
1/10/2023,"Venezuela, Bolivarian Republic of",Selangor,87,48,39
1/10/2023,"Venezuela, Bolivarian Republic of",W.P. Labuan,0,0,0
1/10/2023,Viet Nam,Johor,14353,4405,9948
1/10/2023,Viet Nam,Kedah,367,75,292
1/10/2023,Viet Nam,Kelantan,15,5,10
1/10/2023,Viet Nam,Melaka,0,0,0
1/10/2023,Viet Nam,Negeri Sembilan,0,0,0
1/10/2023,Viet Nam,Pahang,1,0,1
1/10/2023,Viet Nam,Perak,186,10,176
1/10/2023,Viet Nam,Perlis,131,28,103
1/10/2023,Viet Nam,Pulau Pinang,1245,367,878
1/10/2023,Viet Nam,Sabah,14,7,7
1/10/2023,Viet Nam,Sarawak,219,69,150
1/10/2023,Viet Nam,Selangor,15135,5369,9766
1/10/2023,Viet Nam,Terengganu,0,0,0
1/10/2023,Viet Nam,W.P. Labuan,1,1,0
1/10/2023,Vanuatu,Johor,56,41,15
1/10/2023,Vanuatu,Kedah,0,0,0
1/10/2023,Vanuatu,Pulau Pinang,5,3,2
1/10/2023,Vanuatu,Sabah,0,0,0
1/10/2023,Vanuatu,Sarawak,0,0,0
1/10/2023,Vanuatu,Selangor,85,67,18
1/10/2023, Samoa,Johor,1,1,0
1/10/2023, Samoa,Sarawak,0,0,0
1/10/2023, Samoa,Selangor,4,3,1
1/10/2023,Yemen,Johor,31,18,13
1/10/2023,Yemen,Kedah,2,2,0
1/10/2023,Yemen,Kelantan,2,0,2
1/10/2023,Yemen,Melaka,0,0,0
1/10/2023,Yemen,Pahang,0,0,0
1/10/2023,Yemen,Perak,1,1,0
1/10/2023,Yemen,Perlis,2,2,0
1/10/2023,Yemen,Pulau Pinang,2,2,0
1/10/2023,Yemen,Sabah,0,0,0
1/10/2023,Yemen,Sarawak,2,1,1
1/10/2023,Yemen,Selangor,1710,1303,407
1/10/2023,Yemen,W.P. Labuan,0,0,0
1/10/2023,South Africa,Johor,289,182,107
1/10/2023,South Africa,Kedah,37,20,17
1/10/2023,South Africa,Kelantan,2,1,1
1/10/2023,South Africa,Melaka,0,0,0
1/10/2023,South Africa,Pahang,0,0,0
1/10/2023,South Africa,Perak,2,2,0
1/10/2023,South Africa,Perlis,21,12,9
1/10/2023,South Africa,Pulau Pinang,55,26,29
1/10/2023,South Africa,Sabah,7,5,2
1/10/2023,South Africa,Sarawak,59,33,26
1/10/2023,South Africa,Selangor,1058,619,439
1/10/2023,South Africa,Terengganu,0,0,0
1/10/2023,South Africa,W.P. Labuan,0,0,0
1/10/2023,ZAR,Selangor,0,0,0
1/10/2023,Zambia,Johor,6,4,2
1/10/2023,Zambia,Kedah,1,0,1
1/10/2023,Zambia,Perak,0,0,0
1/10/2023,Zambia,Perlis,1,1,0
1/10/2023,Zambia,Pulau Pinang,1,0,1
1/10/2023,Zambia,Sabah,0,0,0
1/10/2023,Zambia,Sarawak,0,0,0
1/10/2023,Zambia,Selangor,47,26,21
1/10/2023,Zimbabwe,Johor,7,3,4
1/10/2023,Zimbabwe,Kedah,0,0,0
1/10/2023,Zimbabwe,Kelantan,0,0,0
1/10/2023,Zimbabwe,Perak,0,0,0
1/10/2023,Zimbabwe,Perlis,1,0,1
1/10/2023,Zimbabwe,Pulau Pinang,3,2,1
1/10/2023,Zimbabwe,Sabah,0,0,0
1/10/2023,Zimbabwe,Sarawak,0,0,0
1/10/2023,Zimbabwe,Selangor,189,86,103
1/11/2023,Aruba,Kedah,0,0,0
1/11/2023,Aruba,Pulau Pinang,0,0,0
1/11/2023,Afghanistan,Johor,1,1,0
1/11/2023,Afghanistan,Kedah,0,0,0
1/11/2023,Afghanistan,Perlis,0,0,0
1/11/2023,Afghanistan,Pulau Pinang,1,1,0
1/11/2023,Afghanistan,Sarawak,0,0,0
1/11/2023,Afghanistan,Selangor,42,32,10
1/11/2023,Angola,Johor,0,0,0
1/11/2023,Angola,Kedah,0,0,0
1/11/2023,Angola,Sabah,0,0,0
1/11/2023,Angola,Selangor,3,3,0
1/11/2023,Anguilla,Selangor,1,1,0
1/11/2023,Albania,Johor,15,13,2
1/11/2023,Albania,Kedah,1,1,0
1/11/2023,Albania,Perak,0,0,0
1/11/2023,Albania,Perlis,0,0,0
1/11/2023,Albania,Pulau Pinang,1,1,0
1/11/2023,Albania,Sabah,0,0,0
1/11/2023,Albania,Sarawak,0,0,0
1/11/2023,Albania,Selangor,38,23,15
1/11/2023,Andorra,Johor,3,1,2
1/11/2023,Andorra,Kedah,0,0,0
1/11/2023,Andorra,Perlis,0,0,0
1/11/2023,Andorra,Pulau Pinang,0,0,0
1/11/2023,Andorra,Selangor,6,3,3
1/11/2023,Antigua and Barbuda,Selangor,0,0,0
1/11/2023,United Arab Emirates,Johor,15,9,6
1/11/2023,United Arab Emirates,Kedah,0,0,0
1/11/2023,United Arab Emirates,Kelantan,0,0,0
1/11/2023,United Arab Emirates,Perak,0,0,0
1/11/2023,United Arab Emirates,Perlis,1,1,0
1/11/2023,United Arab Emirates,Pulau Pinang,0,0,0
1/11/2023,United Arab Emirates,Sabah,0,0,0
1/11/2023,United Arab Emirates,Sarawak,0,0,0
1/11/2023,United Arab Emirates,Selangor,369,235,134
1/11/2023,Argentina,Johor,80,54,26
1/11/2023,Argentina,Kedah,41,15,26
1/11/2023,Argentina,Kelantan,0,0,0
1/11/2023,Argentina,Melaka,1,1,0
1/11/2023,Argentina,Perak,0,0,0
1/11/2023,Argentina,Perlis,1,1,0
1/11/2023,Argentina,Pulau Pinang,15,5,10
1/11/2023,Argentina,Sabah,4,3,1
1/11/2023,Argentina,Sarawak,3,3,0
1/11/2023,Argentina,Selangor,411,230,181
1/11/2023,Argentina,W.P. Labuan,0,0,0
1/11/2023,Armenia,Johor,2,2,0
1/11/2023,Armenia,Kedah,0,0,0
1/11/2023,Armenia,Kelantan,1,1,0
1/11/2023,Armenia,Perak,0,0,0
1/11/2023,Armenia,Perlis,0,0,0
1/11/2023,Armenia,Pulau Pinang,3,2,1
1/11/2023,Armenia,Sabah,1,1,0
1/11/2023,Armenia,Sarawak,0,0,0
1/11/2023,Armenia,Selangor,32,17,15
1/11/2023,Antarctica,Selangor,0,0,0
1/11/2023,Antigua and Barbuda,Johor,3,3,0
1/11/2023,Antigua and Barbuda,Kedah,0,0,0
1/11/2023,Antigua and Barbuda,Pulau Pinang,0,0,0
1/11/2023,Antigua and Barbuda,Sarawak,0,0,0
1/11/2023,Antigua and Barbuda,Selangor,15,10,5
1/11/2023,Australia,Johor,5161,3050,2111
1/11/2023,Australia,Kedah,684,346,338
1/11/2023,Australia,Kelantan,4,3,1
1/11/2023,Australia,Melaka,4,2,2
1/11/2023,Australia,Negeri Sembilan,3,3,0
1/11/2023,Australia,Pahang,10,8,2
1/11/2023,Australia,Perak,228,122,106
1/11/2023,Australia,Perlis,94,57,37
1/11/2023,Australia,Pulau Pinang,2127,1142,985
1/11/2023,Australia,Sabah,265,124,141
1/11/2023,Australia,Sarawak,481,272,209
1/11/2023,Australia,Selangor,26398,15601,10797
1/11/2023,Australia,Terengganu,4,3,1
1/11/2023,Australia,W.P. Labuan,8,6,2
1/11/2023,Austria,Johor,183,130,53
1/11/2023,Austria,Kedah,66,38,28
1/11/2023,Austria,Kelantan,5,5,0
1/11/2023,Austria,Melaka,0,0,0
1/11/2023,Austria,Negeri Sembilan,2,1,1
1/11/2023,Austria,Pahang,0,0,0
1/11/2023,Austria,Perak,4,4,0
1/11/2023,Austria,Perlis,16,9,7
1/11/2023,Austria,Pulau Pinang,103,81,22
1/11/2023,Austria,Sabah,10,6,4
1/11/2023,Austria,Sarawak,9,5,4
1/11/2023,Austria,Selangor,941,635,306
1/11/2023,Austria,Terengganu,0,0,0
1/11/2023,Austria,W.P. Labuan,0,0,0
1/11/2023,Azerbaijan,Johor,9,7,2
1/11/2023,Azerbaijan,Kedah,2,0,2
1/11/2023,Azerbaijan,Kelantan,0,0,0
1/11/2023,Azerbaijan,Melaka,0,0,0
1/11/2023,Azerbaijan,Perlis,0,0,0
1/11/2023,Azerbaijan,Pulau Pinang,1,1,0
1/11/2023,Azerbaijan,Sabah,0,0,0
1/11/2023,Azerbaijan,Sarawak,2,1,1
1/11/2023,Azerbaijan,Selangor,151,82,69
1/11/2023,Azerbaijan,W.P. Labuan,0,0,0
1/11/2023,Burundi,Pulau Pinang,1,0,1
1/11/2023,Burundi,Sarawak,0,0,0
1/11/2023,Burundi,Selangor,2,1,1
1/11/2023,Belgium,Johor,259,170,89
1/11/2023,Belgium,Kedah,68,41,27
1/11/2023,Belgium,Kelantan,3,2,1
1/11/2023,Belgium,Melaka,5,2,3
1/11/2023,Belgium,Negeri Sembilan,0,0,0
1/11/2023,Belgium,Pahang,0,0,0
1/11/2023,Belgium,Perak,0,0,0
1/11/2023,Belgium,Perlis,7,4,3
1/11/2023,Belgium,Pulau Pinang,76,51,25
1/11/2023,Belgium,Sabah,18,10,8
1/11/2023,Belgium,Sarawak,12,9,3
1/11/2023,Belgium,Selangor,1217,817,400
1/11/2023,Belgium,W.P. Labuan,2,2,0
1/11/2023,Benin,Johor,1,1,0
1/11/2023,Benin,Kedah,0,0,0
1/11/2023,Benin,Perak,0,0,0
1/11/2023,Benin,Pulau Pinang,0,0,0
1/11/2023,Benin,Sabah,2,2,0
1/11/2023,Benin,Sarawak,1,1,0
1/11/2023,Benin,Selangor,11,8,3
1/11/2023,Burkina Faso,Perak,0,0,0
1/11/2023,Burkina Faso,Pulau Pinang,0,0,0
1/11/2023,Burkina Faso,Selangor,5,3,2
1/11/2023,Bangladesh,Johor,2690,2231,459
1/11/2023,Bangladesh,Kedah,62,41,21
1/11/2023,Bangladesh,Kelantan,2,2,0
1/11/2023,Bangladesh,Melaka,0,0,0
1/11/2023,Bangladesh,Negeri Sembilan,0,0,0
1/11/2023,Bangladesh,Pahang,1,1,0
1/11/2023,Bangladesh,Perak,2,1,1
1/11/2023,Bangladesh,Perlis,4,3,1
1/11/2023,Bangladesh,Pulau Pinang,190,172,18
1/11/2023,Bangladesh,Sabah,7,7,0
1/11/2023,Bangladesh,Sarawak,42,32,10
1/11/2023,Bangladesh,Selangor,35940,34250,1690
1/11/2023,Bangladesh,W.P. Labuan,11,11,0
1/11/2023,Bulgaria,Johor,57,32,25
1/11/2023,Bulgaria,Kedah,20,10,10
1/11/2023,Bulgaria,Kelantan,1,1,0
1/11/2023,Bulgaria,Pahang,0,0,0
1/11/2023,Bulgaria,Perak,0,0,0
1/11/2023,Bulgaria,Perlis,0,0,0
1/11/2023,Bulgaria,Pulau Pinang,19,13,6
1/11/2023,Bulgaria,Sabah,1,1,0
1/11/2023,Bulgaria,Sarawak,0,0,0
1/11/2023,Bulgaria,Selangor,375,175,200
1/11/2023,Bulgaria,W.P. Labuan,0,0,0
1/11/2023,Bahrain,Johor,6,5,1
1/11/2023,Bahrain,Kedah,1,1,0
1/11/2023,Bahrain,Kelantan,0,0,0
1/11/2023,Bahrain,Perlis,0,0,0
1/11/2023,Bahrain,Pulau Pinang,2,1,1
1/11/2023,Bahrain,Sabah,0,0,0
1/11/2023,Bahrain,Sarawak,1,1,0
1/11/2023,Bahrain,Selangor,139,83,56
1/11/2023,Bahamas,Johor,2,1,1
1/11/2023,Bahamas,Kedah,0,0,0
1/11/2023,Bahamas,Perak,0,0,0
1/11/2023,Bahamas,Sabah,0,0,0
1/11/2023,Bahamas,Sarawak,0,0,0
1/11/2023,Bahamas,Selangor,0,0,0
1/11/2023,Bosnia and Herzegovina,Johor,2,2,0
1/11/2023,Bosnia and Herzegovina,Kedah,0,0,0
1/11/2023,Bosnia and Herzegovina,Perlis,0,0,0
1/11/2023,Bosnia and Herzegovina,Pulau Pinang,4,2,2
1/11/2023,Bosnia and Herzegovina,Sabah,0,0,0
1/11/2023,Bosnia and Herzegovina,Sarawak,4,4,0
1/11/2023,Bosnia and Herzegovina,Selangor,65,35,30
1/11/2023,Belarus,Johor,13,4,9
1/11/2023,Belarus,Kedah,22,9,13
1/11/2023,Belarus,Kelantan,2,1,1
1/11/2023,Belarus,Pahang,0,0,0
1/11/2023,Belarus,Perak,0,0,0
1/11/2023,Belarus,Perlis,0,0,0
1/11/2023,Belarus,Pulau Pinang,15,4,11
1/11/2023,Belarus,Sabah,4,1,3
1/11/2023,Belarus,Sarawak,3,0,3
1/11/2023,Belarus,Selangor,409,181,228
1/11/2023,Belarus,W.P. Labuan,0,0,0
1/11/2023,Belize,Johor,6,2,4
1/11/2023,Belize,Pulau Pinang,0,0,0
1/11/2023,Belize,Sarawak,0,0,0
1/11/2023,Belize,Selangor,5,3,2
1/11/2023,Bermuda,Selangor,0,0,0
1/11/2023,Bolivia,Johor,4,3,1
1/11/2023,Bolivia,Kedah,0,0,0
1/11/2023,Bolivia,Melaka,0,0,0
1/11/2023,Bolivia,Perak,0,0,0
1/11/2023,Bolivia,Perlis,0,0,0
1/11/2023,Bolivia,Pulau Pinang,0,0,0
1/11/2023,Bolivia,Sabah,0,0,0
1/11/2023,Bolivia,Sarawak,0,0,0
1/11/2023,Bolivia,Selangor,40,29,11
1/11/2023,Brazil,Johor,360,216,144
1/11/2023,Brazil,Kedah,60,27,33
1/11/2023,Brazil,Kelantan,0,0,0
1/11/2023,Brazil,Melaka,4,3,1
1/11/2023,Brazil,Pahang,4,3,1
1/11/2023,Brazil,Perak,6,3,3
1/11/2023,Brazil,Perlis,8,2,6
1/11/2023,Brazil,Pulau Pinang,19,12,7
1/11/2023,Brazil,Sabah,8,6,2
1/11/2023,Brazil,Sarawak,16,12,4
1/11/2023,Brazil,Selangor,996,579,417
1/11/2023,Brazil,W.P. Labuan,0,0,0
1/11/2023,Barbados,Johor,1,0,1
1/11/2023,Barbados,Kedah,0,0,0
1/11/2023,Barbados,Perlis,0,0,0
1/11/2023,Barbados,Pulau Pinang,0,0,0
1/11/2023,Barbados,Selangor,5,5,0
1/11/2023,Brunei Darussalam,Johor,502,264,238
1/11/2023,Brunei Darussalam,Kedah,31,14,17
1/11/2023,Brunei Darussalam,Kelantan,23,12,11
1/11/2023,Brunei Darussalam,Melaka,0,0,0
1/11/2023,Brunei Darussalam,Pahang,0,0,0
1/11/2023,Brunei Darussalam,Perak,3,1,2
1/11/2023,Brunei Darussalam,Perlis,37,22,15
1/11/2023,Brunei Darussalam,Pulau Pinang,29,15,14
1/11/2023,Brunei Darussalam,Sabah,1075,451,624
1/11/2023,Brunei Darussalam,Sarawak,64400,36057,28343
1/11/2023,Brunei Darussalam,Selangor,6185,3123,3062
1/11/2023,Brunei Darussalam,W.P. Labuan,1189,825,364
1/11/2023,Bhutan,Johor,18,11,7
1/11/2023,Bhutan,Kedah,2,2,0
1/11/2023,Bhutan,Perak,0,0,0
1/11/2023,Bhutan,Perlis,0,0,0
1/11/2023,Bhutan,Pulau Pinang,2,1,1
1/11/2023,Bhutan,Sabah,1,1,0
1/11/2023,Bhutan,Sarawak,0,0,0
1/11/2023,Bhutan,Selangor,44,34,10
1/11/2023,Botswana,Johor,1,0,1
1/11/2023,Botswana,Kedah,1,1,0
1/11/2023,Botswana,Perlis,1,1,0
1/11/2023,Botswana,Pulau Pinang,1,1,0
1/11/2023,Botswana,Sabah,0,0,0
1/11/2023,Botswana,Sarawak,0,0,0
1/11/2023,Botswana,Selangor,10,5,5
1/11/2023,Central African Republic,Kedah,0,0,0
1/11/2023,Central African Republic,Selangor,0,0,0
1/11/2023,Canada,Johor,1605,891,714
1/11/2023,Canada,Kedah,209,114,95
1/11/2023,Canada,Kelantan,7,4,3
1/11/2023,Canada,Melaka,0,0,0
1/11/2023,Canada,Negeri Sembilan,0,0,0
1/11/2023,Canada,Pahang,5,4,1
1/11/2023,Canada,Perak,52,26,26
1/11/2023,Canada,Perlis,44,28,16
1/11/2023,Canada,Pulau Pinang,638,346,292
1/11/2023,Canada,Sabah,112,61,51
1/11/2023,Canada,Sarawak,235,133,102
1/11/2023,Canada,Selangor,4874,2820,2054
1/11/2023,Canada,Terengganu,0,0,0
1/11/2023,Canada,W.P. Labuan,7,3,4
1/11/2023,Cocos (Keeling) Islands,Selangor,0,0,0
1/11/2023,Switzerland,Johor,439,258,181
1/11/2023,Switzerland,Kedah,151,76,75
1/11/2023,Switzerland,Kelantan,4,3,1
1/11/2023,Switzerland,Melaka,0,0,0
1/11/2023,Switzerland,Negeri Sembilan,4,1,3
1/11/2023,Switzerland,Pahang,6,4,2
1/11/2023,Switzerland,Perak,7,5,2
1/11/2023,Switzerland,Perlis,19,10,9
1/11/2023,Switzerland,Pulau Pinang,147,100,47
1/11/2023,Switzerland,Sabah,22,14,8
1/11/2023,Switzerland,Sarawak,30,15,15
1/11/2023,Switzerland,Selangor,1347,822,525
1/11/2023,Switzerland,W.P. Labuan,1,1,0
1/11/2023,Chile,Johor,33,20,13
1/11/2023,Chile,Kedah,12,5,7
1/11/2023,Chile,Kelantan,0,0,0
1/11/2023,Chile,Melaka,0,0,0
1/11/2023,Chile,Pahang,0,0,0
1/11/2023,Chile,Perak,0,0,0
1/11/2023,Chile,Perlis,2,0,2
1/11/2023,Chile,Pulau Pinang,5,3,2
1/11/2023,Chile,Sabah,6,1,5
1/11/2023,Chile,Sarawak,3,2,1
1/11/2023,Chile,Selangor,314,166,148
1/11/2023,China,Johor,40105,17947,22158
1/11/2023,China,Kedah,1155,525,630
1/11/2023,China,Kelantan,14,12,2
1/11/2023,China,Melaka,2,2,0
1/11/2023,China,Pahang,41,23,18
1/11/2023,China,Perak,259,112,147
1/11/2023,China,Perlis,139,73,66
1/11/2023,China,Pulau Pinang,7833,4314,3519
1/11/2023,China,Sabah,8287,3955,4332
1/11/2023,China,Sarawak,991,499,492
1/11/2023,China,Selangor,81817,44534,37283
1/11/2023,China,Terengganu,0,0,0
1/11/2023,China,W.P. Labuan,51,42,9
1/11/2023,Côte d'Ivoire,Johor,1,1,0
1/11/2023,Côte d'Ivoire,Kedah,0,0,0
1/11/2023,Côte d'Ivoire,Pulau Pinang,0,0,0
1/11/2023,Côte d'Ivoire,Sabah,0,0,0
1/11/2023,Côte d'Ivoire,Sarawak,0,0,0
1/11/2023,Côte d'Ivoire,Selangor,39,23,16
1/11/2023,Cameroon,Johor,0,0,0
1/11/2023,Cameroon,Kedah,0,0,0
1/11/2023,Cameroon,Pulau Pinang,0,0,0
1/11/2023,Cameroon,Sabah,0,0,0
1/11/2023,Cameroon,Sarawak,0,0,0
1/11/2023,Cameroon,Selangor,28,14,14
1/11/2023,Congo,Johor,2,2,0
1/11/2023,Congo,Pulau Pinang,0,0,0
1/11/2023,Congo,Sarawak,0,0,0
1/11/2023,Congo,Selangor,11,7,4
1/11/2023,Congo,Johor,0,0,0
1/11/2023,Congo,Kedah,0,0,0
1/11/2023,Congo,Selangor,1,0,1
1/11/2023,Cook Islands,Selangor,0,0,0
1/11/2023,Colombia,Johor,11,8,3
1/11/2023,Colombia,Kedah,6,4,2
1/11/2023,Colombia,Perak,0,0,0
1/11/2023,Colombia,Pulau Pinang,4,2,2
1/11/2023,Colombia,Sabah,0,0,0
1/11/2023,Colombia,Sarawak,1,1,0
1/11/2023,Colombia,Selangor,198,110,88
1/11/2023,Colombia,W.P. Labuan,0,0,0
1/11/2023,Comoros,Johor,1,1,0
1/11/2023,Comoros,Kedah,0,0,0
1/11/2023,Comoros,Selangor,16,10,6
1/11/2023,Cabo Verde,Johor,1,0,1
1/11/2023,Cabo Verde,Kedah,0,0,0
1/11/2023,Cabo Verde,Pulau Pinang,0,0,0
1/11/2023,Cabo Verde,Sabah,0,0,0
1/11/2023,Cabo Verde,Selangor,1,0,1
1/11/2023,Costa Rica,Johor,19,13,6
1/11/2023,Costa Rica,Kedah,0,0,0
1/11/2023,Costa Rica,Perak,0,0,0
1/11/2023,Costa Rica,Perlis,0,0,0
1/11/2023,Costa Rica,Pulau Pinang,3,3,0
1/11/2023,Costa Rica,Sabah,1,1,0
1/11/2023,Costa Rica,Sarawak,0,0,0
1/11/2023,Costa Rica,Selangor,57,37,20
1/11/2023,Cuba,Johor,5,4,1
1/11/2023,Cuba,Kedah,0,0,0
1/11/2023,Cuba,Perlis,0,0,0
1/11/2023,Cuba,Pulau Pinang,1,0,1
1/11/2023,Cuba,Sabah,0,0,0
1/11/2023,Cuba,Sarawak,0,0,0
1/11/2023,Cuba,Selangor,33,17,16
1/11/2023,Cyprus,Johor,12,4,8
1/11/2023,Cyprus,Kedah,0,0,0
1/11/2023,Cyprus,Perak,0,0,0
1/11/2023,Cyprus,Perlis,0,0,0
1/11/2023,Cyprus,Pulau Pinang,0,0,0
1/11/2023,Cyprus,Sabah,1,1,0
1/11/2023,Cyprus,Sarawak,1,1,0
1/11/2023,Cyprus,Selangor,111,74,37
1/11/2023,Czechia,Johor,170,91,79
1/11/2023,Czechia,Kedah,117,49,68
1/11/2023,Czechia,Kelantan,1,0,1
1/11/2023,Czechia,Melaka,0,0,0
1/11/2023,Czechia,Negeri Sembilan,0,0,0
1/11/2023,Czechia,Perak,0,0,0
1/11/2023,Czechia,Perlis,0,0,0
1/11/2023,Czechia,Pulau Pinang,19,11,8
1/11/2023,Czechia,Sabah,14,9,5
1/11/2023,Czechia,Sarawak,12,7,5
1/11/2023,Czechia,Selangor,669,388,281
1/11/2023,Czechia,W.P. Labuan,12,4,8
1/11/2023,Germany,Johor,2467,1562,905
1/11/2023,Germany,Kedah,784,393,391
1/11/2023,Germany,Kelantan,7,6,1
1/11/2023,Germany,Melaka,0,0,0
1/11/2023,Germany,Negeri Sembilan,1,1,0
1/11/2023,Germany,Pahang,6,5,1
1/11/2023,Germany,Perak,21,16,5
1/11/2023,Germany,Perlis,87,52,35
1/11/2023,Germany,Pulau Pinang,845,648,197
1/11/2023,Germany,Sabah,110,74,36
1/11/2023,Germany,Sarawak,158,106,52
1/11/2023,Germany,Selangor,7252,4649,2603
1/11/2023,Germany,Terengganu,1,1,0
1/11/2023,Germany,W.P. Labuan,7,4,3
1/11/2023,Djibouti,Johor,0,0,0
1/11/2023,Djibouti,Selangor,14,9,5
1/11/2023,Dominica,Johor,2,2,0
1/11/2023,Dominica,Kedah,0,0,0
1/11/2023,Dominica,Pulau Pinang,0,0,0
1/11/2023,Dominica,Sabah,0,0,0
1/11/2023,Dominica,Sarawak,0,0,0
1/11/2023,Dominica,Selangor,37,32,5
1/11/2023,Dominica,W.P. Labuan,0,0,0
1/11/2023,Denmark,Johor,276,216,60
1/11/2023,Denmark,Kedah,141,67,74
1/11/2023,Denmark,Kelantan,1,1,0
1/11/2023,Denmark,Melaka,0,0,0
1/11/2023,Denmark,Negeri Sembilan,4,2,2
1/11/2023,Denmark,Pahang,0,0,0
1/11/2023,Denmark,Perak,4,3,1
1/11/2023,Denmark,Perlis,26,15,11
1/11/2023,Denmark,Pulau Pinang,85,58,27
1/11/2023,Denmark,Sabah,22,15,7
1/11/2023,Denmark,Sarawak,9,6,3
1/11/2023,Denmark,Selangor,1015,649,366
1/11/2023,Denmark,W.P. Labuan,0,0,0
1/11/2023,Dominican Republic,Johor,2,0,2
1/11/2023,Dominican Republic,Kedah,0,0,0
1/11/2023,Dominican Republic,Perak,0,0,0
1/11/2023,Dominican Republic,Perlis,0,0,0
1/11/2023,Dominican Republic,Pulau Pinang,1,1,0
1/11/2023,Dominican Republic,Sabah,1,0,1
1/11/2023,Dominican Republic,Sarawak,0,0,0
1/11/2023,Dominican Republic,Selangor,92,46,46
1/11/2023,Algeria,Johor,20,14,6
1/11/2023,Algeria,Kedah,2,2,0
1/11/2023,Algeria,Kelantan,0,0,0
1/11/2023,Algeria,Melaka,0,0,0
1/11/2023,Algeria,Perak,0,0,0
1/11/2023,Algeria,Perlis,0,0,0
1/11/2023,Algeria,Pulau Pinang,1,1,0
1/11/2023,Algeria,Sabah,2,2,0
1/11/2023,Algeria,Sarawak,3,3,0
1/11/2023,Algeria,Selangor,767,514,253
1/11/2023,Algeria,W.P. Labuan,0,0,0
1/11/2023,Ecuador,Johor,9,6,3
1/11/2023,Ecuador,Kedah,3,0,3
1/11/2023,Ecuador,Perak,0,0,0
1/11/2023,Ecuador,Perlis,0,0,0
1/11/2023,Ecuador,Pulau Pinang,3,1,2
1/11/2023,Ecuador,Sabah,3,2,1
1/11/2023,Ecuador,Sarawak,0,0,0
1/11/2023,Ecuador,Selangor,105,55,50
1/11/2023,Egypt,Johor,193,160,33
1/11/2023,Egypt,Kedah,7,5,2
1/11/2023,Egypt,Kelantan,4,1,3
1/11/2023,Egypt,Melaka,0,0,0
1/11/2023,Egypt,Pahang,0,0,0
1/11/2023,Egypt,Perak,0,0,0
1/11/2023,Egypt,Perlis,0,0,0
1/11/2023,Egypt,Pulau Pinang,14,10,4
1/11/2023,Egypt,Sabah,0,0,0
1/11/2023,Egypt,Sarawak,52,42,10
1/11/2023,Egypt,Selangor,1948,1329,619
1/11/2023,Egypt,Terengganu,0,0,0
1/11/2023,Egypt,W.P. Labuan,0,0,0
1/11/2023,Eritrea,Johor,0,0,0
1/11/2023,Eritrea,Pulau Pinang,0,0,0
1/11/2023,Eritrea,Sabah,0,0,0
1/11/2023,Eritrea,Selangor,26,14,12
1/11/2023,Spain,Johor,526,330,196
1/11/2023,Spain,Kedah,277,138,139
1/11/2023,Spain,Kelantan,3,2,1
1/11/2023,Spain,Melaka,2,1,1
1/11/2023,Spain,Negeri Sembilan,1,1,0
1/11/2023,Spain,Pahang,0,0,0
1/11/2023,Spain,Perak,9,7,2
1/11/2023,Spain,Perlis,14,10,4
1/11/2023,Spain,Pulau Pinang,116,69,47
1/11/2023,Spain,Sabah,31,21,10
1/11/2023,Spain,Sarawak,49,29,20
1/11/2023,Spain,Selangor,3435,2110,1325
1/11/2023,Spain,W.P. Labuan,3,2,1
1/11/2023,Estonia,Johor,36,17,19
1/11/2023,Estonia,Kedah,25,13,12
1/11/2023,Estonia,Kelantan,6,2,4
1/11/2023,Estonia,Pahang,0,0,0
1/11/2023,Estonia,Perak,0,0,0
1/11/2023,Estonia,Perlis,3,1,2
1/11/2023,Estonia,Pulau Pinang,3,3,0
1/11/2023,Estonia,Sabah,2,1,1
1/11/2023,Estonia,Sarawak,18,8,10
1/11/2023,Estonia,Selangor,283,148,135
1/11/2023,Estonia,W.P. Labuan,0,0,0
1/11/2023,Ethiopia,Johor,1,1,0
1/11/2023,Ethiopia,Kedah,1,0,1
1/11/2023,Ethiopia,Pulau Pinang,0,0,0
1/11/2023,Ethiopia,Sarawak,0,0,0
1/11/2023,Ethiopia,Selangor,35,26,9
1/11/2023,Finland,Johor,238,148,90
1/11/2023,Finland,Kedah,112,46,66
1/11/2023,Finland,Kelantan,0,0,0
1/11/2023,Finland,Melaka,0,0,0
1/11/2023,Finland,Negeri Sembilan,3,3,0
1/11/2023,Finland,Pahang,0,0,0
1/11/2023,Finland,Perak,3,3,0
1/11/2023,Finland,Perlis,2,2,0
1/11/2023,Finland,Pulau Pinang,67,47,20
1/11/2023,Finland,Sabah,10,8,2
1/11/2023,Finland,Sarawak,22,10,12
1/11/2023,Finland,Selangor,585,325,260
1/11/2023,Finland,W.P. Labuan,0,0,0
1/11/2023,Fiji,Johor,58,39,19
1/11/2023,Fiji,Kedah,2,0,2
1/11/2023,Fiji,Kelantan,0,0,0
1/11/2023,Fiji,Perak,0,0,0
1/11/2023,Fiji,Perlis,0,0,0
1/11/2023,Fiji,Pulau Pinang,1,1,0
1/11/2023,Fiji,Sabah,0,0,0
1/11/2023,Fiji,Sarawak,1,1,0
1/11/2023,Fiji,Selangor,127,59,68
1/11/2023,France,Johor,1868,1182,686
1/11/2023,France,Kedah,412,242,170
1/11/2023,France,Kelantan,16,12,4
1/11/2023,France,Melaka,3,1,2
1/11/2023,France,Negeri Sembilan,5,3,2
1/11/2023,France,Pahang,13,7,6
1/11/2023,France,Perak,27,22,5
1/11/2023,France,Perlis,44,33,11
1/11/2023,France,Pulau Pinang,425,282,143
1/11/2023,France,Sabah,78,49,29
1/11/2023,France,Sarawak,82,54,28
1/11/2023,France,Selangor,7412,4785,2627
1/11/2023,France,Terengganu,0,0,0
1/11/2023,France,W.P. Labuan,3,3,0
1/11/2023,"Micronesia, Federated States of",Johor,0,0,0
1/11/2023,"Micronesia, Federated States of",Pulau Pinang,0,0,0
1/11/2023,"Micronesia, Federated States of",Selangor,10,5,5
1/11/2023,Gabon,Johor,1,0,1
1/11/2023,Gabon,Pulau Pinang,0,0,0
1/11/2023,Gabon,Sarawak,0,0,0
1/11/2023,Gabon,Selangor,11,7,4
1/11/2023,United Kingdom of Great Britain and Northern Ireland,Johor,4695,2980,1715
1/11/2023,United Kingdom of Great Britain and Northern Ireland,Kedah,1202,650,552
1/11/2023,United Kingdom of Great Britain and Northern Ireland,Kelantan,23,15,8
1/11/2023,United Kingdom of Great Britain and Northern Ireland,Melaka,5,4,1
1/11/2023,United Kingdom of Great Britain and Northern Ireland,Negeri Sembilan,0,0,0
1/11/2023,United Kingdom of Great Britain and Northern Ireland,Pahang,14,10,4
1/11/2023,United Kingdom of Great Britain and Northern Ireland,Perak,88,55,33
1/11/2023,United Kingdom of Great Britain and Northern Ireland,Perlis,138,89,49
1/11/2023,United Kingdom of Great Britain and Northern Ireland,Pulau Pinang,1688,1001,687
1/11/2023,United Kingdom of Great Britain and Northern Ireland,Sabah,265,140,125
1/11/2023,United Kingdom of Great Britain and Northern Ireland,Sarawak,669,431,238
1/11/2023,United Kingdom of Great Britain and Northern Ireland,Selangor,17675,11303,6372
1/11/2023,United Kingdom of Great Britain and Northern Ireland,Terengganu,0,0,0
1/11/2023,United Kingdom of Great Britain and Northern Ireland,W.P. Labuan,39,31,8
1/11/2023,Georgia,Johor,12,9,3
1/11/2023,Georgia,Kedah,1,1,0
1/11/2023,Georgia,Melaka,0,0,0
1/11/2023,Georgia,Perak,0,0,0
1/11/2023,Georgia,Perlis,0,0,0
1/11/2023,Georgia,Pulau Pinang,3,0,3
1/11/2023,Georgia,Sabah,0,0,0
1/11/2023,Georgia,Sarawak,0,0,0
1/11/2023,Georgia,Selangor,48,30,18
1/11/2023,Ghana,Johor,6,4,2
1/11/2023,Ghana,Kedah,0,0,0
1/11/2023,Ghana,Kelantan,0,0,0
1/11/2023,Ghana,Pulau Pinang,0,0,0
1/11/2023,Ghana,Sabah,0,0,0
1/11/2023,Ghana,Sarawak,0,0,0
1/11/2023,Ghana,Selangor,125,84,41
1/11/2023,Gibraltar,Johor,0,0,0
1/11/2023,Gibraltar,Sarawak,0,0,0
1/11/2023,Guinea,Johor,4,2,2
1/11/2023,Guinea,Kedah,1,0,1
1/11/2023,Guinea,Kelantan,0,0,0
1/11/2023,Guinea,Perlis,0,0,0
1/11/2023,Guinea,Pulau Pinang,0,0,0
1/11/2023,Guinea,Sabah,0,0,0
1/11/2023,Guinea,Sarawak,0,0,0
1/11/2023,Guinea,Selangor,61,44,17
1/11/2023,Guadeloupe,Selangor,0,0,0
1/11/2023,Gambia,Johor,1,0,1
1/11/2023,Gambia,Kedah,0,0,0
1/11/2023,Gambia,Kelantan,0,0,0
1/11/2023,Gambia,Pulau Pinang,0,0,0
1/11/2023,Gambia,Sabah,0,0,0
1/11/2023,Gambia,Sarawak,0,0,0
1/11/2023,Gambia,Selangor,28,21,7
1/11/2023,Guinea-Bissau,Johor,0,0,0
1/11/2023,Guinea-Bissau,Selangor,1,0,1
1/11/2023,Equatorial Guinea,Johor,0,0,0
1/11/2023,Equatorial Guinea,Selangor,0,0,0
1/11/2023,Greece,Johor,71,48,23
1/11/2023,Greece,Kedah,6,2,4
1/11/2023,Greece,Kelantan,0,0,0
1/11/2023,Greece,Melaka,0,0,0
1/11/2023,Greece,Negeri Sembilan,0,0,0
1/11/2023,Greece,Pahang,0,0,0
1/11/2023,Greece,Perak,0,0,0
1/11/2023,Greece,Perlis,3,1,2
1/11/2023,Greece,Pulau Pinang,21,12,9
1/11/2023,Greece,Sabah,2,2,0
1/11/2023,Greece,Sarawak,4,4,0
1/11/2023,Greece,Selangor,293,212,81
1/11/2023,Grenada,Johor,2,0,2
1/11/2023,Grenada,Kedah,0,0,0
1/11/2023,Grenada,Pulau Pinang,1,1,0
1/11/2023,Grenada,Sabah,0,0,0
1/11/2023,Grenada,Sarawak,0,0,0
1/11/2023,Grenada,Selangor,9,8,1
1/11/2023,Greenland,Johor,0,0,0
1/11/2023,Greenland,Selangor,0,0,0
1/11/2023,Guatemala,Johor,6,2,4
1/11/2023,Guatemala,Kedah,1,1,0
1/11/2023,Guatemala,Pahang,0,0,0
1/11/2023,Guatemala,Perak,0,0,0
1/11/2023,Guatemala,Pulau Pinang,7,5,2
1/11/2023,Guatemala,Sabah,0,0,0
1/11/2023,Guatemala,Sarawak,0,0,0
1/11/2023,Guatemala,Selangor,63,39,24
1/11/2023,Guatemala,W.P. Labuan,0,0,0
1/11/2023,Guyana,Johor,1,0,1
1/11/2023,Guyana,Kedah,0,0,0
1/11/2023,Guyana,Pulau Pinang,0,0,0
1/11/2023,Guyana,Sarawak,0,0,0
1/11/2023,Guyana,Selangor,16,10,6
1/11/2023,Hong Kong,Johor,6,1,5
1/11/2023,Hong Kong,Kedah,0,0,0
1/11/2023,Hong Kong,Kelantan,0,0,0
1/11/2023,Hong Kong,Pahang,4,2,2
1/11/2023,Hong Kong,Perak,51,29,22
1/11/2023,Hong Kong,Perlis,2,2,0
1/11/2023,Hong Kong,Pulau Pinang,0,0,0
1/11/2023,Hong Kong,Sabah,53,28,25
1/11/2023,Hong Kong,Sarawak,0,0,0
1/11/2023,Hong Kong,Selangor,42,15,27
1/11/2023,Hong Kong,Terengganu,0,0,0
1/11/2023,Heard Island and McDonald Islands,Johor,0,0,0
1/11/2023,Honduras,Johor,6,4,2
1/11/2023,Honduras,Kedah,1,1,0
1/11/2023,Honduras,Perak,0,0,0
1/11/2023,Honduras,Pulau Pinang,0,0,0
1/11/2023,Honduras,Sabah,0,0,0
1/11/2023,Honduras,Sarawak,0,0,0
1/11/2023,Honduras,Selangor,26,16,10
1/11/2023,Croatia,Johor,60,31,29
1/11/2023,Croatia,Kedah,2,0,2
1/11/2023,Croatia,Kelantan,0,0,0
1/11/2023,Croatia,Melaka,1,1,0
1/11/2023,Croatia,Pahang,0,0,0
1/11/2023,Croatia,Perak,0,0,0
1/11/2023,Croatia,Perlis,0,0,0
1/11/2023,Croatia,Pulau Pinang,3,2,1
1/11/2023,Croatia,Sabah,8,7,1
1/11/2023,Croatia,Sarawak,1,1,0
1/11/2023,Croatia,Selangor,243,139,104
1/11/2023,Haiti,Johor,1,1,0
1/11/2023,Haiti,Kedah,0,0,0
1/11/2023,Haiti,Kelantan,0,0,0
1/11/2023,Haiti,Perak,0,0,0
1/11/2023,Haiti,Pulau Pinang,0,0,0
1/11/2023,Haiti,Sabah,0,0,0
1/11/2023,Haiti,Selangor,9,6,3
1/11/2023,Hungary,Johor,108,66,42
1/11/2023,Hungary,Kedah,30,13,17
1/11/2023,Hungary,Kelantan,0,0,0
1/11/2023,Hungary,Pahang,0,0,0
1/11/2023,Hungary,Perak,1,1,0
1/11/2023,Hungary,Perlis,2,0,2
1/11/2023,Hungary,Pulau Pinang,30,15,15
1/11/2023,Hungary,Sabah,1,0,1
1/11/2023,Hungary,Sarawak,6,4,2
1/11/2023,Hungary,Selangor,550,299,251
1/11/2023,Hungary,W.P. Labuan,0,0,0
1/11/2023,Indonesia,Johor,96612,45154,51458
1/11/2023,Indonesia,Kedah,5183,1900,3283
1/11/2023,Indonesia,Kelantan,139,80,59
1/11/2023,Indonesia,Melaka,3624,1639,1985
1/11/2023,Indonesia,Negeri Sembilan,5507,3369,2138
1/11/2023,Indonesia,Pahang,17,7,10
1/11/2023,Indonesia,Perak,217,84,133
1/11/2023,Indonesia,Perlis,652,255,397
1/11/2023,Indonesia,Pulau Pinang,39593,15700,23893
1/11/2023,Indonesia,Sabah,4552,2211,2341
1/11/2023,Indonesia,Sarawak,35677,19271,16406
1/11/2023,Indonesia,Selangor,139070,66141,72929
1/11/2023,Indonesia,Terengganu,0,0,0
1/11/2023,Indonesia,W.P. Labuan,43,22,21
1/11/2023,India,Johor,19940,13134,6806
1/11/2023,India,Kedah,1165,622,543
1/11/2023,India,Kelantan,7,5,2
1/11/2023,India,Melaka,12,12,0
1/11/2023,India,Negeri Sembilan,1,1,0
1/11/2023,India,Pahang,15,12,3
1/11/2023,India,Perak,163,122,41
1/11/2023,India,Perlis,18,14,4
1/11/2023,India,Pulau Pinang,895,674,221
1/11/2023,India,Sabah,189,143,46
1/11/2023,India,Sarawak,1029,824,205
1/11/2023,India,Selangor,48321,33365,14956
1/11/2023,India,Terengganu,0,0,0
1/11/2023,India,W.P. Labuan,31,29,2
1/11/2023, British Indian Ocean Territory,Pulau Pinang,1,0,1
1/11/2023, British Indian Ocean Territory,Selangor,1,0,1
1/11/2023,Ireland,Johor,296,192,104
1/11/2023,Ireland,Kedah,69,35,34
1/11/2023,Ireland,Kelantan,1,1,0
1/11/2023,Ireland,Negeri Sembilan,0,0,0
1/11/2023,Ireland,Pahang,0,0,0
1/11/2023,Ireland,Perak,2,0,2
1/11/2023,Ireland,Perlis,17,12,5
1/11/2023,Ireland,Pulau Pinang,100,66,34
1/11/2023,Ireland,Sabah,12,9,3
1/11/2023,Ireland,Sarawak,36,13,23
1/11/2023,Ireland,Selangor,1383,861,522
1/11/2023,Ireland,Terengganu,2,2,0
1/11/2023,Ireland,W.P. Labuan,2,1,1
1/11/2023,"Iran, Islamic Republic of",Johor,256,134,122
1/11/2023,"Iran, Islamic Republic of",Kedah,7,4,3
1/11/2023,"Iran, Islamic Republic of",Kelantan,0,0,0
1/11/2023,"Iran, Islamic Republic of",Perak,0,0,0
1/11/2023,"Iran, Islamic Republic of",Perlis,2,2,0
1/11/2023,"Iran, Islamic Republic of",Pulau Pinang,12,7,5
1/11/2023,"Iran, Islamic Republic of",Sabah,2,2,0
1/11/2023,"Iran, Islamic Republic of",Sarawak,5,5,0
1/11/2023,"Iran, Islamic Republic of",Selangor,2308,1253,1055
1/11/2023,"Iran, Islamic Republic of",W.P. Labuan,0,0,0
1/11/2023,Iraq,Johor,17,14,3
1/11/2023,Iraq,Kedah,2,1,1
1/11/2023,Iraq,Kelantan,0,0,0
1/11/2023,Iraq,Melaka,0,0,0
1/11/2023,Iraq,Pahang,0,0,0
1/11/2023,Iraq,Perak,0,0,0
1/11/2023,Iraq,Perlis,0,0,0
1/11/2023,Iraq,Pulau Pinang,3,2,1
1/11/2023,Iraq,Sabah,0,0,0
1/11/2023,Iraq,Sarawak,3,1,2
1/11/2023,Iraq,Selangor,1358,947,411
1/11/2023,Iceland,Johor,16,9,7
1/11/2023,Iceland,Kedah,1,1,0
1/11/2023,Iceland,Kelantan,0,0,0
1/11/2023,Iceland,Perak,0,0,0
1/11/2023,Iceland,Perlis,0,0,0
1/11/2023,Iceland,Pulau Pinang,1,1,0
1/11/2023,Iceland,Sabah,5,4,1
1/11/2023,Iceland,Sarawak,0,0,0
1/11/2023,Iceland,Selangor,34,18,16
1/11/2023,Iceland,W.P. Labuan,0,0,0
1/11/2023,Israel,Pulau Pinang,0,0,0
1/11/2023,Italy,Johor,586,407,179
1/11/2023,Italy,Kedah,200,108,92
1/11/2023,Italy,Kelantan,3,3,0
1/11/2023,Italy,Melaka,0,0,0
1/11/2023,Italy,Negeri Sembilan,0,0,0
1/11/2023,Italy,Pahang,2,2,0
1/11/2023,Italy,Perak,3,2,1
1/11/2023,Italy,Perlis,17,10,7
1/11/2023,Italy,Pulau Pinang,141,107,34
1/11/2023,Italy,Sabah,19,12,7
1/11/2023,Italy,Sarawak,33,26,7
1/11/2023,Italy,Selangor,3126,2253,873
1/11/2023,Italy,W.P. Labuan,0,0,0
1/11/2023,Jamaica,Johor,0,0,0
1/11/2023,Jamaica,Kedah,0,0,0
1/11/2023,Jamaica,Perak,0,0,0
1/11/2023,Jamaica,Pulau Pinang,1,1,0
1/11/2023,Jamaica,Sabah,0,0,0
1/11/2023,Jamaica,Sarawak,1,1,0
1/11/2023,Jamaica,Selangor,36,10,26
1/11/2023,Jamaica,W.P. Labuan,0,0,0
1/11/2023,Jordan,Johor,15,11,4
1/11/2023,Jordan,Kedah,5,4,1
1/11/2023,Jordan,Kelantan,0,0,0
1/11/2023,Jordan,Melaka,0,0,0
1/11/2023,Jordan,Perlis,1,1,0
1/11/2023,Jordan,Pulau Pinang,14,11,3
1/11/2023,Jordan,Sabah,0,0,0
1/11/2023,Jordan,Sarawak,0,0,0
1/11/2023,Jordan,Selangor,709,470,239
1/11/2023,Jordan,W.P. Labuan,0,0,0
1/11/2023,Japan,Johor,7015,4526,2489
1/11/2023,Japan,Kedah,279,136,143
1/11/2023,Japan,Kelantan,12,9,3
1/11/2023,Japan,Melaka,2,2,0
1/11/2023,Japan,Negeri Sembilan,0,0,0
1/11/2023,Japan,Pahang,18,14,4
1/11/2023,Japan,Perak,85,59,26
1/11/2023,Japan,Perlis,53,46,7
1/11/2023,Japan,Pulau Pinang,1327,982,345
1/11/2023,Japan,Sabah,225,132,93
1/11/2023,Japan,Sarawak,227,148,79
1/11/2023,Japan,Selangor,20707,13397,7310
1/11/2023,Japan,W.P. Labuan,13,8,5
1/11/2023,Kazakhstan,Johor,36,17,19
1/11/2023,Kazakhstan,Kedah,8,4,4
1/11/2023,Kazakhstan,Kelantan,1,0,1
1/11/2023,Kazakhstan,Melaka,0,0,0
1/11/2023,Kazakhstan,Perak,0,0,0
1/11/2023,Kazakhstan,Perlis,6,2,4
1/11/2023,Kazakhstan,Pulau Pinang,12,5,7
1/11/2023,Kazakhstan,Sabah,4,1,3
1/11/2023,Kazakhstan,Sarawak,13,6,7
1/11/2023,Kazakhstan,Selangor,892,375,517
1/11/2023,Kazakhstan,W.P. Labuan,0,0,0
1/11/2023,Kenya,Johor,68,26,42
1/11/2023,Kenya,Kedah,2,1,1
1/11/2023,Kenya,Kelantan,0,0,0
1/11/2023,Kenya,Perak,0,0,0
1/11/2023,Kenya,Perlis,0,0,0
1/11/2023,Kenya,Pulau Pinang,6,4,2
1/11/2023,Kenya,Sabah,0,0,0
1/11/2023,Kenya,Sarawak,3,1,2
1/11/2023,Kenya,Selangor,582,286,296
1/11/2023,Kyrgyzstan,Johor,26,18,8
1/11/2023,Kyrgyzstan,Kedah,3,3,0
1/11/2023,Kyrgyzstan,Kelantan,0,0,0
1/11/2023,Kyrgyzstan,Perak,0,0,0
1/11/2023,Kyrgyzstan,Perlis,1,0,1
1/11/2023,Kyrgyzstan,Pulau Pinang,2,2,0
1/11/2023,Kyrgyzstan,Sabah,0,0,0
1/11/2023,Kyrgyzstan,Sarawak,0,0,0
1/11/2023,Kyrgyzstan,Selangor,281,157,124
1/11/2023,Cambodia,Johor,2846,1218,1628
1/11/2023,Cambodia,Kedah,109,57,52
1/11/2023,Cambodia,Kelantan,354,181,173
1/11/2023,Cambodia,Melaka,0,0,0
1/11/2023,Cambodia,Negeri Sembilan,0,0,0
1/11/2023,Cambodia,Pahang,0,0,0
1/11/2023,Cambodia,Perak,14,4,10
1/11/2023,Cambodia,Perlis,618,344,274
1/11/2023,Cambodia,Pulau Pinang,45,22,23
1/11/2023,Cambodia,Sabah,3,0,3
1/11/2023,Cambodia,Sarawak,7,1,6
1/11/2023,Cambodia,Selangor,4255,1991,2264
1/11/2023,Cambodia,W.P. Labuan,0,0,0
1/11/2023,Kiribati,Johor,0,0,0
1/11/2023,Kiribati,Sabah,0,0,0
1/11/2023,Kiribati,Selangor,0,0,0
1/11/2023,Saint Kitts and Nevis,Johor,26,16,10
1/11/2023,Saint Kitts and Nevis,Kedah,2,1,1
1/11/2023,Saint Kitts and Nevis,Perlis,0,0,0
1/11/2023,Saint Kitts and Nevis,Pulau Pinang,0,0,0
1/11/2023,Saint Kitts and Nevis,Sabah,0,0,0
1/11/2023,Saint Kitts and Nevis,Selangor,56,44,12
1/11/2023,Saint Kitts and Nevis,W.P. Labuan,0,0,0
1/11/2023,"Korea, Republic of",Johor,9723,5285,4438
1/11/2023,"Korea, Republic of",Kedah,209,106,103
1/11/2023,"Korea, Republic of",Kelantan,2,1,1
1/11/2023,"Korea, Republic of",Melaka,1,1,0
1/11/2023,"Korea, Republic of",Negeri Sembilan,0,0,0
1/11/2023,"Korea, Republic of",Pahang,5,3,2
1/11/2023,"Korea, Republic of",Perak,31,14,17
1/11/2023,"Korea, Republic of",Perlis,52,34,18
1/11/2023,"Korea, Republic of",Pulau Pinang,475,289,186
1/11/2023,"Korea, Republic of",Sabah,9304,3884,5420
1/11/2023,"Korea, Republic of",Sarawak,194,116,78
1/11/2023,"Korea, Republic of",Selangor,14482,8292,6190
1/11/2023,"Korea, Republic of",Terengganu,0,0,0
1/11/2023,"Korea, Republic of",W.P. Labuan,1,0,1
1/11/2023,Kuwait,Johor,18,8,10
1/11/2023,Kuwait,Kedah,4,2,2
1/11/2023,Kuwait,Kelantan,0,0,0
1/11/2023,Kuwait,Perak,0,0,0
1/11/2023,Kuwait,Perlis,3,3,0
1/11/2023,Kuwait,Pulau Pinang,2,1,1
1/11/2023,Kuwait,Sabah,0,0,0
1/11/2023,Kuwait,Sarawak,0,0,0
1/11/2023,Kuwait,Selangor,287,184,103
1/11/2023,Kuwait,W.P. Labuan,0,0,0
1/11/2023, Lao People's Democratic Republic,Johor,186,60,126
1/11/2023, Lao People's Democratic Republic,Kedah,873,72,801
1/11/2023, Lao People's Democratic Republic,Kelantan,138,7,131
1/11/2023, Lao People's Democratic Republic,Melaka,0,0,0
1/11/2023, Lao People's Democratic Republic,Perak,36,5,31
1/11/2023, Lao People's Democratic Republic,Perlis,463,76,387
1/11/2023, Lao People's Democratic Republic,Pulau Pinang,21,7,14
1/11/2023, Lao People's Democratic Republic,Sabah,0,0,0
1/11/2023, Lao People's Democratic Republic,Sarawak,8,2,6
1/11/2023, Lao People's Democratic Republic,Selangor,318,154,164
1/11/2023, Lao People's Democratic Republic,W.P. Labuan,1,0,1
1/11/2023,Lebanon,Johor,13,9,4
1/11/2023,Lebanon,Kedah,7,3,4
1/11/2023,Lebanon,Kelantan,0,0,0
1/11/2023,Lebanon,Pahang,0,0,0
1/11/2023,Lebanon,Perak,1,1,0
1/11/2023,Lebanon,Perlis,0,0,0
1/11/2023,Lebanon,Pulau Pinang,3,2,1
1/11/2023,Lebanon,Sabah,2,2,0
1/11/2023,Lebanon,Sarawak,2,2,0
1/11/2023,Lebanon,Selangor,301,194,107
1/11/2023,Lebanon,W.P. Labuan,0,0,0
1/11/2023,Liberia,Johor,0,0,0
1/11/2023,Liberia,Kedah,0,0,0
1/11/2023,Liberia,Sabah,0,0,0
1/11/2023,Liberia,Sarawak,1,1,0
1/11/2023,Liberia,Selangor,8,8,0
1/11/2023,Libya,Johor,0,0,0
1/11/2023,Libya,Kedah,0,0,0
1/11/2023,Libya,Perlis,0,0,0
1/11/2023,Libya,Pulau Pinang,0,0,0
1/11/2023,Libya,Sabah,0,0,0
1/11/2023,Libya,Sarawak,2,1,1
1/11/2023,Libya,Selangor,405,301,104
1/11/2023,Saint Lucia,Johor,4,3,1
1/11/2023,Saint Lucia,Kedah,0,0,0
1/11/2023,Saint Lucia,Pulau Pinang,2,2,0
1/11/2023,Saint Lucia,Sarawak,1,1,0
1/11/2023,Saint Lucia,Selangor,6,6,0
1/11/2023,Liechtenstein,Johor,0,0,0
1/11/2023,Liechtenstein,Kedah,1,1,0
1/11/2023,Liechtenstein,Perlis,0,0,0
1/11/2023,Liechtenstein,Pulau Pinang,3,2,1
1/11/2023,Liechtenstein,Sabah,0,0,0
1/11/2023,Liechtenstein,Sarawak,0,0,0
1/11/2023,Liechtenstein,Selangor,7,6,1
1/11/2023,LKA,Johor,817,539,278
1/11/2023,LKA,Kedah,48,33,15
1/11/2023,LKA,Kelantan,0,0,0
1/11/2023,LKA,Melaka,0,0,0
1/11/2023,LKA,Pahang,0,0,0
1/11/2023,LKA,Perak,2,1,1
1/11/2023,LKA,Perlis,0,0,0
1/11/2023,LKA,Pulau Pinang,39,22,17
1/11/2023,LKA,Sabah,15,10,5
1/11/2023,LKA,Sarawak,17,14,3
1/11/2023,LKA,Selangor,4946,3188,1758
1/11/2023,LKA,W.P. Labuan,0,0,0
1/11/2023,Lesotho,Johor,0,0,0
1/11/2023,Lesotho,Kedah,0,0,0
1/11/2023,Lesotho,Pulau Pinang,0,0,0
1/11/2023,Lesotho,Sarawak,0,0,0
1/11/2023,Lesotho,Selangor,3,0,3
1/11/2023,Lithuania,Johor,107,44,63
1/11/2023,Lithuania,Kedah,65,29,36
1/11/2023,Lithuania,Kelantan,1,1,0
1/11/2023,Lithuania,Pahang,0,0,0
1/11/2023,Lithuania,Perak,1,0,1
1/11/2023,Lithuania,Perlis,1,1,0
1/11/2023,Lithuania,Pulau Pinang,14,5,9
1/11/2023,Lithuania,Sabah,2,1,1
1/11/2023,Lithuania,Sarawak,4,1,3
1/11/2023,Lithuania,Selangor,486,247,239
1/11/2023,Lithuania,W.P. Labuan,22,10,12
1/11/2023,Luxembourg,Johor,12,10,2
1/11/2023,Luxembourg,Kedah,4,3,1
1/11/2023,Luxembourg,Kelantan,0,0,0
1/11/2023,Luxembourg,Perak,0,0,0
1/11/2023,Luxembourg,Perlis,0,0,0
1/11/2023,Luxembourg,Pulau Pinang,5,3,2
1/11/2023,Luxembourg,Sabah,0,0,0
1/11/2023,Luxembourg,Sarawak,0,0,0
1/11/2023,Luxembourg,Selangor,51,37,14
1/11/2023,Latvia,Johor,69,20,49
1/11/2023,Latvia,Kedah,6,4,2
1/11/2023,Latvia,Kelantan,1,0,1
1/11/2023,Latvia,Pahang,0,0,0
1/11/2023,Latvia,Perak,1,1,0
1/11/2023,Latvia,Perlis,2,2,0
1/11/2023,Latvia,Pulau Pinang,6,2,4
1/11/2023,Latvia,Sabah,3,1,2
1/11/2023,Latvia,Sarawak,16,5,11
1/11/2023,Latvia,Selangor,208,96,112
1/11/2023,Latvia,W.P. Labuan,0,0,0
1/11/2023,Macao,Johor,0,0,0
1/11/2023,Macao,Pahang,0,0,0
1/11/2023,Macao,Perak,0,0,0
1/11/2023,Macao,Selangor,0,0,0
1/11/2023,Macao,W.P. Labuan,0,0,0
1/11/2023,Morocco,Johor,78,50,28
1/11/2023,Morocco,Kedah,12,7,5
1/11/2023,Morocco,Kelantan,1,1,0
1/11/2023,Morocco,Melaka,0,0,0
1/11/2023,Morocco,Pahang,0,0,0
1/11/2023,Morocco,Perak,0,0,0
1/11/2023,Morocco,Perlis,0,0,0
1/11/2023,Morocco,Pulau Pinang,8,8,0
1/11/2023,Morocco,Sabah,0,0,0
1/11/2023,Morocco,Sarawak,8,5,3
1/11/2023,Morocco,Selangor,835,456,379
1/11/2023,Morocco,W.P. Labuan,0,0,0
1/11/2023,Monaco,Johor,0,0,0
1/11/2023,Monaco,Kedah,1,1,0
1/11/2023,Monaco,Sabah,1,1,0
1/11/2023,Monaco,Selangor,5,5,0
1/11/2023,"Moldova, Republic of",Johor,1,1,0
1/11/2023,"Moldova, Republic of",Kedah,0,0,0
1/11/2023,"Moldova, Republic of",Kelantan,0,0,0
1/11/2023,"Moldova, Republic of",Negeri Sembilan,0,0,0
1/11/2023,"Moldova, Republic of",Perlis,0,0,0
1/11/2023,"Moldova, Republic of",Pulau Pinang,0,0,0
1/11/2023,"Moldova, Republic of",Sabah,0,0,0
1/11/2023,"Moldova, Republic of",Sarawak,0,0,0
1/11/2023,"Moldova, Republic of",Selangor,33,20,13
1/11/2023,Madagascar,Johor,3,1,2
1/11/2023,Madagascar,Kedah,0,0,0
1/11/2023,Madagascar,Perak,0,0,0
1/11/2023,Madagascar,Perlis,0,0,0
1/11/2023,Madagascar,Pulau Pinang,0,0,0
1/11/2023,Madagascar,Sabah,0,0,0
1/11/2023,Madagascar,Sarawak,0,0,0
1/11/2023,Madagascar,Selangor,42,21,21
1/11/2023,Maldives,Johor,128,66,62
1/11/2023,Maldives,Kedah,1,0,1
1/11/2023,Maldives,Kelantan,0,0,0
1/11/2023,Maldives,Perak,0,0,0
1/11/2023,Maldives,Perlis,0,0,0
1/11/2023,Maldives,Pulau Pinang,4,2,2
1/11/2023,Maldives,Sabah,0,0,0
1/11/2023,Maldives,Sarawak,0,0,0
1/11/2023,Maldives,Selangor,2354,1339,1015
1/11/2023,Mexico,Johor,278,127,151
1/11/2023,Mexico,Kedah,11,3,8
1/11/2023,Mexico,Kelantan,2,1,1
1/11/2023,Mexico,Pahang,0,0,0
1/11/2023,Mexico,Perak,0,0,0
1/11/2023,Mexico,Perlis,4,1,3
1/11/2023,Mexico,Pulau Pinang,39,27,12
1/11/2023,Mexico,Sabah,2,1,1
1/11/2023,Mexico,Sarawak,4,2,2
1/11/2023,Mexico,Selangor,866,428,438
1/11/2023,Mexico,W.P. Labuan,0,0,0
1/11/2023,Marshall Islands,Johor,1,1,0
1/11/2023,Marshall Islands,Kedah,0,0,0
1/11/2023,Marshall Islands,Perak,0,0,0
1/11/2023,Marshall Islands,Pulau Pinang,0,0,0
1/11/2023,Marshall Islands,Sabah,0,0,0
1/11/2023,Marshall Islands,Selangor,3,3,0
1/11/2023,North Macedonia,Johor,5,3,2
1/11/2023,North Macedonia,Kedah,2,1,1
1/11/2023,North Macedonia,Perak,0,0,0
1/11/2023,North Macedonia,Pulau Pinang,0,0,0
1/11/2023,North Macedonia,Sabah,0,0,0
1/11/2023,North Macedonia,Sarawak,1,1,0
1/11/2023,North Macedonia,Selangor,32,23,9
1/11/2023,Mali,Johor,1,1,0
1/11/2023,Mali,Sabah,0,0,0
1/11/2023,Mali,Selangor,9,7,2
1/11/2023,Malta,Johor,3,1,2
1/11/2023,Malta,Kedah,0,0,0
1/11/2023,Malta,Kelantan,0,0,0
1/11/2023,Malta,Perak,0,0,0
1/11/2023,Malta,Perlis,0,0,0
1/11/2023,Malta,Pulau Pinang,37,20,17
1/11/2023,Malta,Sabah,0,0,0
1/11/2023,Malta,Sarawak,0,0,0
1/11/2023,Malta,Selangor,55,37,18
1/11/2023,Malta,W.P. Labuan,0,0,0
1/11/2023,Myanmar,Johor,6026,1643,4383
1/11/2023,Myanmar,Kedah,64,9,55
1/11/2023,Myanmar,Kelantan,2,1,1
1/11/2023,Myanmar,Negeri Sembilan,0,0,0
1/11/2023,Myanmar,Pahang,1,0,1
1/11/2023,Myanmar,Perak,39,10,29
1/11/2023,Myanmar,Perlis,3,1,2
1/11/2023,Myanmar,Pulau Pinang,438,209,229
1/11/2023,Myanmar,Sabah,18,5,13
1/11/2023,Myanmar,Sarawak,49,20,29
1/11/2023,Myanmar,Selangor,6648,4479,2169
1/11/2023,Myanmar,Terengganu,0,0,0
1/11/2023,Myanmar,W.P. Labuan,0,0,0
1/11/2023,Montenegro,Johor,5,5,0
1/11/2023,Montenegro,Kedah,0,0,0
1/11/2023,Montenegro,Pulau Pinang,0,0,0
1/11/2023,Montenegro,Sabah,0,0,0
1/11/2023,Montenegro,Sarawak,0,0,0
1/11/2023,Montenegro,Selangor,14,12,2
1/11/2023,Mongolia,Johor,137,51,86
1/11/2023,Mongolia,Kedah,22,9,13
1/11/2023,Mongolia,Kelantan,1,0,1
1/11/2023,Mongolia,Perak,2,1,1
1/11/2023,Mongolia,Perlis,0,0,0
1/11/2023,Mongolia,Pulau Pinang,9,2,7
1/11/2023,Mongolia,Sabah,5,2,3
1/11/2023,Mongolia,Sarawak,0,0,0
1/11/2023,Mongolia,Selangor,445,177,268
1/11/2023,Northern Mariana Islands,Selangor,0,0,0
1/11/2023,Mozambique,Johor,0,0,0
1/11/2023,Mozambique,Kedah,0,0,0
1/11/2023,Mozambique,Perak,0,0,0
1/11/2023,Mozambique,Pulau Pinang,0,0,0
1/11/2023,Mozambique,Sabah,0,0,0
1/11/2023,Mozambique,Sarawak,0,0,0
1/11/2023,Mozambique,Selangor,19,8,11
1/11/2023,Mauritania,Johor,0,0,0
1/11/2023,Mauritania,Kedah,0,0,0
1/11/2023,Mauritania,Pulau Pinang,0,0,0
1/11/2023,Mauritania,Sabah,0,0,0
1/11/2023,Mauritania,Sarawak,0,0,0
1/11/2023,Mauritania,Selangor,25,19,6
1/11/2023,Mauritius,Johor,380,172,208
1/11/2023,Mauritius,Kedah,12,4,8
1/11/2023,Mauritius,Kelantan,0,0,0
1/11/2023,Mauritius,Pahang,0,0,0
1/11/2023,Mauritius,Perak,0,0,0
1/11/2023,Mauritius,Perlis,2,2,0
1/11/2023,Mauritius,Pulau Pinang,10,5,5
1/11/2023,Mauritius,Sabah,2,1,1
1/11/2023,Mauritius,Sarawak,2,0,2
1/11/2023,Mauritius,Selangor,2568,1205,1363
1/11/2023,Malawi,Johor,5,2,3
1/11/2023,Malawi,Pulau Pinang,0,0,0
1/11/2023,Malawi,Sabah,0,0,0
1/11/2023,Malawi,Sarawak,0,0,0
1/11/2023,Malawi,Selangor,27,18,9
1/11/2023,Mayotte,Selangor,1,0,1
1/11/2023,Namibia,Johor,2,0,2
1/11/2023,Namibia,Kedah,0,0,0
1/11/2023,Namibia,Perak,5,2,3
1/11/2023,Namibia,Perlis,0,0,0
1/11/2023,Namibia,Pulau Pinang,1,1,0
1/11/2023,Namibia,Sabah,1,1,0
1/11/2023,Namibia,Sarawak,0,0,0
1/11/2023,Namibia,Selangor,32,12,20
1/11/2023,New Caledonia,Selangor,0,0,0
1/11/2023,Niger,Johor,0,0,0
1/11/2023,Niger,Sabah,0,0,0
1/11/2023,Niger,Selangor,1,0,1
1/11/2023,Nigeria,Johor,33,28,5
1/11/2023,Nigeria,Kedah,1,1,0
1/11/2023,Nigeria,Perlis,0,0,0
1/11/2023,Nigeria,Pulau Pinang,5,5,0
1/11/2023,Nigeria,Sabah,0,0,0
1/11/2023,Nigeria,Sarawak,6,2,4
1/11/2023,Nigeria,Selangor,484,369,115
1/11/2023,Nicaragua,Johor,0,0,0
1/11/2023,Nicaragua,Kedah,1,1,0
1/11/2023,Nicaragua,Pulau Pinang,0,0,0
1/11/2023,Nicaragua,Sabah,0,0,0
1/11/2023,Nicaragua,Selangor,6,3,3
1/11/2023,Netherlands,Johor,970,624,346
1/11/2023,Netherlands,Kedah,315,158,157
1/11/2023,Netherlands,Kelantan,2,1,1
1/11/2023,Netherlands,Melaka,4,2,2
1/11/2023,Netherlands,Negeri Sembilan,4,3,1
1/11/2023,Netherlands,Pahang,0,0,0
1/11/2023,Netherlands,Perak,12,10,2
1/11/2023,Netherlands,Perlis,16,12,4
1/11/2023,Netherlands,Pulau Pinang,252,152,100
1/11/2023,Netherlands,Sabah,48,26,22
1/11/2023,Netherlands,Sarawak,103,57,46
1/11/2023,Netherlands,Selangor,4250,2637,1613
1/11/2023,Netherlands,Terengganu,2,2,0
1/11/2023,Netherlands,W.P. Labuan,4,3,1
1/11/2023,Norway,Johor,178,111,67
1/11/2023,Norway,Kedah,81,38,43
1/11/2023,Norway,Kelantan,1,1,0
1/11/2023,Norway,Melaka,1,1,0
1/11/2023,Norway,Pahang,0,0,0
1/11/2023,Norway,Perak,2,1,1
1/11/2023,Norway,Perlis,5,4,1
1/11/2023,Norway,Pulau Pinang,38,24,14
1/11/2023,Norway,Sabah,9,7,2
1/11/2023,Norway,Sarawak,13,11,2
1/11/2023,Norway,Selangor,749,475,274
1/11/2023,Norway,W.P. Labuan,1,1,0
1/11/2023,Nepal,Johor,856,534,322
1/11/2023,Nepal,Kedah,18,11,7
1/11/2023,Nepal,Pahang,1,1,0
1/11/2023,Nepal,Perak,0,0,0
1/11/2023,Nepal,Perlis,0,0,0
1/11/2023,Nepal,Pulau Pinang,23,15,8
1/11/2023,Nepal,Sabah,3,2,1
1/11/2023,Nepal,Sarawak,141,110,31
1/11/2023,Nepal,Selangor,8471,7874,597
1/11/2023,Nepal,W.P. Labuan,35,35,0
1/11/2023,Nauru,Johor,5,3,2
1/11/2023,Nauru,Pulau Pinang,0,0,0
1/11/2023,Nauru,Selangor,3,3,0
1/11/2023,New Zealand,Johor,693,414,279
1/11/2023,New Zealand,Kedah,89,44,45
1/11/2023,New Zealand,Kelantan,7,5,2
1/11/2023,New Zealand,Melaka,4,2,2
1/11/2023,New Zealand,Negeri Sembilan,0,0,0
1/11/2023,New Zealand,Pahang,0,0,0
1/11/2023,New Zealand,Perak,19,9,10
1/11/2023,New Zealand,Perlis,7,5,2
1/11/2023,New Zealand,Pulau Pinang,245,143,102
1/11/2023,New Zealand,Sabah,31,21,10
1/11/2023,New Zealand,Sarawak,110,64,46
1/11/2023,New Zealand,Selangor,3530,2105,1425
1/11/2023,New Zealand,Terengganu,0,0,0
1/11/2023,New Zealand,W.P. Labuan,0,0,0
1/11/2023,Oman,Johor,47,25,22
1/11/2023,Oman,Kedah,5,5,0
1/11/2023,Oman,Kelantan,0,0,0
1/11/2023,Oman,Melaka,0,0,0
1/11/2023,Oman,Perak,1,1,0
1/11/2023,Oman,Perlis,0,0,0
1/11/2023,Oman,Pulau Pinang,0,0,0
1/11/2023,Oman,Sabah,0,0,0
1/11/2023,Oman,Sarawak,4,4,0
1/11/2023,Oman,Selangor,1617,1048,569
1/11/2023,Pakistan,Johor,718,523,195
1/11/2023,Pakistan,Kedah,98,65,33
1/11/2023,Pakistan,Kelantan,19,19,0
1/11/2023,Pakistan,Melaka,3,3,0
1/11/2023,Pakistan,Negeri Sembilan,0,0,0
1/11/2023,Pakistan,Pahang,0,0,0
1/11/2023,Pakistan,Perak,11,10,1
1/11/2023,Pakistan,Perlis,15,15,0
1/11/2023,Pakistan,Pulau Pinang,78,71,7
1/11/2023,Pakistan,Sabah,20,19,1
1/11/2023,Pakistan,Sarawak,126,111,15
1/11/2023,Pakistan,Selangor,8964,7439,1525
1/11/2023,Pakistan,W.P. Labuan,4,3,1
1/11/2023,Panama,Johor,2,1,1
1/11/2023,Panama,Kedah,0,0,0
1/11/2023,Panama,Perak,0,0,0
1/11/2023,Panama,Perlis,0,0,0
1/11/2023,Panama,Pulau Pinang,3,2,1
1/11/2023,Panama,Sabah,1,0,1
1/11/2023,Panama,Sarawak,0,0,0
1/11/2023,Panama,Selangor,43,20,23
1/11/2023,Peru,Johor,24,8,16
1/11/2023,Peru,Kedah,4,3,1
1/11/2023,Peru,Kelantan,0,0,0
1/11/2023,Peru,Pahang,0,0,0
1/11/2023,Peru,Perak,0,0,0
1/11/2023,Peru,Perlis,2,0,2
1/11/2023,Peru,Pulau Pinang,6,1,5
1/11/2023,Peru,Sabah,2,2,0
1/11/2023,Peru,Sarawak,0,0,0
1/11/2023,Peru,Selangor,151,83,68
1/11/2023,Peru,W.P. Labuan,0,0,0
1/11/2023,Philippines,Johor,24853,7657,17196
1/11/2023,Philippines,Kedah,415,123,292
1/11/2023,Philippines,Kelantan,24,8,16
1/11/2023,Philippines,Melaka,0,0,0
1/11/2023,Philippines,Negeri Sembilan,0,0,0
1/11/2023,Philippines,Pahang,34,27,7
1/11/2023,Philippines,Perak,82,21,61
1/11/2023,Philippines,Perlis,202,62,140
1/11/2023,Philippines,Pulau Pinang,800,345,455
1/11/2023,Philippines,Sabah,1444,680,764
1/11/2023,Philippines,Sarawak,1883,777,1106
1/11/2023,Philippines,Selangor,16484,6894,9590
1/11/2023,Philippines,Terengganu,0,0,0
1/11/2023,Philippines,W.P. Labuan,117,36,81
1/11/2023,Palau,Johor,3,0,3
1/11/2023,Palau,Pulau Pinang,0,0,0
1/11/2023,Palau,Selangor,3,3,0
1/11/2023,Papua New Guinea,Johor,71,32,39
1/11/2023,Papua New Guinea,Kedah,1,1,0
1/11/2023,Papua New Guinea,Kelantan,0,0,0
1/11/2023,Papua New Guinea,Perak,0,0,0
1/11/2023,Papua New Guinea,Pulau Pinang,2,1,1
1/11/2023,Papua New Guinea,Sabah,4,2,2
1/11/2023,Papua New Guinea,Sarawak,8,8,0
1/11/2023,Papua New Guinea,Selangor,117,83,34
1/11/2023,Poland,Johor,551,283,268
1/11/2023,Poland,Kedah,176,79,97
1/11/2023,Poland,Kelantan,2,1,1
1/11/2023,Poland,Melaka,0,0,0
1/11/2023,Poland,Negeri Sembilan,0,0,0
1/11/2023,Poland,Pahang,0,0,0
1/11/2023,Poland,Perak,2,1,1
1/11/2023,Poland,Perlis,22,13,9
1/11/2023,Poland,Pulau Pinang,87,57,30
1/11/2023,Poland,Sabah,28,15,13
1/11/2023,Poland,Sarawak,37,22,15
1/11/2023,Poland,Selangor,1738,938,800
1/11/2023,Poland,Terengganu,1,1,0
1/11/2023,Poland,W.P. Labuan,1,1,0
1/11/2023,"North Korea, Democratic People's Republic of",Selangor,0,0,0
1/11/2023,Portugal,Johor,179,102,77
1/11/2023,Portugal,Kedah,69,42,27
1/11/2023,Portugal,Kelantan,2,2,0
1/11/2023,Portugal,Melaka,0,0,0
1/11/2023,Portugal,Pahang,0,0,0
1/11/2023,Portugal,Perak,3,2,1
1/11/2023,Portugal,Perlis,1,1,0
1/11/2023,Portugal,Pulau Pinang,62,39,23
1/11/2023,Portugal,Sabah,16,10,6
1/11/2023,Portugal,Sarawak,4,1,3
1/11/2023,Portugal,Selangor,897,532,365
1/11/2023,Portugal,W.P. Labuan,0,0,0
1/11/2023,Paraguay,Johor,5,3,2
1/11/2023,Paraguay,Kedah,0,0,0
1/11/2023,Paraguay,Perak,0,0,0
1/11/2023,Paraguay,Perlis,0,0,0
1/11/2023,Paraguay,Pulau Pinang,0,0,0
1/11/2023,Paraguay,Sabah,2,1,1
1/11/2023,Paraguay,Sarawak,0,0,0
1/11/2023,Paraguay,Selangor,8,5,3
1/11/2023,"Palestine, State of",Johor,22,21,1
1/11/2023,"Palestine, State of",Kedah,0,0,0
1/11/2023,"Palestine, State of",Kelantan,0,0,0
1/11/2023,"Palestine, State of",Melaka,0,0,0
1/11/2023,"Palestine, State of",Perak,0,0,0
1/11/2023,"Palestine, State of",Perlis,0,0,0
1/11/2023,"Palestine, State of",Pulau Pinang,2,2,0
1/11/2023,"Palestine, State of",Sabah,0,0,0
1/11/2023,"Palestine, State of",Sarawak,0,0,0
1/11/2023,"Palestine, State of",Selangor,262,187,75
1/11/2023,Qatar,Johor,6,0,6
1/11/2023,Qatar,Kedah,1,0,1
1/11/2023,Qatar,Perlis,0,0,0
1/11/2023,Qatar,Pulau Pinang,0,0,0
1/11/2023,Qatar,Sabah,0,0,0
1/11/2023,Qatar,Sarawak,2,2,0
1/11/2023,Qatar,Selangor,93,68,25
1/11/2023,Réunion,Johor,0,0,0
1/11/2023,Réunion,Sarawak,0,0,0
1/11/2023,Romania,Johor,177,106,71
1/11/2023,Romania,Kedah,29,15,14
1/11/2023,Romania,Kelantan,0,0,0
1/11/2023,Romania,Negeri Sembilan,0,0,0
1/11/2023,Romania,Pahang,0,0,0
1/11/2023,Romania,Perak,0,0,0
1/11/2023,Romania,Perlis,1,0,1
1/11/2023,Romania,Pulau Pinang,26,14,12
1/11/2023,Romania,Sabah,5,4,1
1/11/2023,Romania,Sarawak,3,3,0
1/11/2023,Romania,Selangor,719,379,340
1/11/2023,Romania,W.P. Labuan,0,0,0
1/11/2023,Russian Federation (Russia),Johor,432,205,227
1/11/2023,Russian Federation (Russia),Kedah,388,176,212
1/11/2023,Russian Federation (Russia),Kelantan,38,21,17
1/11/2023,Russian Federation (Russia),Melaka,0,0,0
1/11/2023,Russian Federation (Russia),Negeri Sembilan,0,0,0
1/11/2023,Russian Federation (Russia),Pahang,3,1,2
1/11/2023,Russian Federation (Russia),Perak,6,4,2
1/11/2023,Russian Federation (Russia),Perlis,171,96,75
1/11/2023,Russian Federation (Russia),Pulau Pinang,236,118,118
1/11/2023,Russian Federation (Russia),Sabah,45,23,22
1/11/2023,Russian Federation (Russia),Sarawak,82,42,40
1/11/2023,Russian Federation (Russia),Selangor,9052,4526,4526
1/11/2023,Russian Federation (Russia),W.P. Labuan,7,5,2
1/11/2023,Rwanda,Johor,3,1,2
1/11/2023,Rwanda,Kedah,0,0,0
1/11/2023,Rwanda,Pulau Pinang,1,1,0
1/11/2023,Rwanda,Selangor,6,4,2
1/11/2023,Saudi Arabia,Johor,284,176,108
1/11/2023,Saudi Arabia,Kedah,66,37,29
1/11/2023,Saudi Arabia,Kelantan,8,6,2
1/11/2023,Saudi Arabia,Melaka,0,0,0
1/11/2023,Saudi Arabia,Perak,2,2,0
1/11/2023,Saudi Arabia,Perlis,8,5,3
1/11/2023,Saudi Arabia,Pulau Pinang,46,22,24
1/11/2023,Saudi Arabia,Sabah,2,1,1
1/11/2023,Saudi Arabia,Sarawak,8,8,0
1/11/2023,Saudi Arabia,Selangor,6825,3703,3122
1/11/2023,Saudi Arabia,W.P. Labuan,0,0,0
1/11/2023,Sudan,Johor,18,8,10
1/11/2023,Sudan,Kedah,2,1,1
1/11/2023,Sudan,Kelantan,0,0,0
1/11/2023,Sudan,Perlis,0,0,0
1/11/2023,Sudan,Pulau Pinang,0,0,0
1/11/2023,Sudan,Sabah,0,0,0
1/11/2023,Sudan,Sarawak,5,4,1
1/11/2023,Sudan,Selangor,1508,835,673
1/11/2023,Sudan,W.P. Labuan,0,0,0
1/11/2023,Senegal,Johor,5,4,1
1/11/2023,Senegal,Kedah,1,0,1
1/11/2023,Senegal,Kelantan,0,0,0
1/11/2023,Senegal,Perak,0,0,0
1/11/2023,Senegal,Perlis,0,0,0
1/11/2023,Senegal,Pulau Pinang,0,0,0
1/11/2023,Senegal,Sabah,0,0,0
1/11/2023,Senegal,Sarawak,0,0,0
1/11/2023,Senegal,Selangor,90,75,15
1/11/2023,Singapore,Johor,1289911,729528,560383
1/11/2023,Singapore,Kedah,6692,3385,3307
1/11/2023,Singapore,Kelantan,64,34,30
1/11/2023,Singapore,Melaka,23,19,4
1/11/2023,Singapore,Negeri Sembilan,0,0,0
1/11/2023,Singapore,Pahang,533,251,282
1/11/2023,Singapore,Perak,7407,3400,4007
1/11/2023,Singapore,Perlis,284,152,132
1/11/2023,Singapore,Pulau Pinang,24374,11929,12445
1/11/2023,Singapore,Sabah,2712,1410,1302
1/11/2023,Singapore,Sarawak,4567,2481,2086
1/11/2023,Singapore,Selangor,46627,24446,22181
1/11/2023,Singapore,Terengganu,0,0,0
1/11/2023,Singapore,W.P. Labuan,5,4,1
1/11/2023,South Georgia and the South Sandwich Islands,Johor,0,0,0
1/11/2023,South Georgia and the South Sandwich Islands,Sabah,1,0,1
1/11/2023,South Georgia and the South Sandwich Islands,Selangor,0,0,0
1/11/2023,Saint Helena,Sarawak,0,0,0
1/11/2023,Solomon Islands,Johor,46,27,19
1/11/2023,Solomon Islands,Perlis,0,0,0
1/11/2023,Solomon Islands,Pulau Pinang,1,1,0
1/11/2023,Solomon Islands,Sabah,0,0,0
1/11/2023,Solomon Islands,Sarawak,6,2,4
1/11/2023,Solomon Islands,Selangor,19,10,9
1/11/2023,Solomon Islands,W.P. Labuan,0,0,0
1/11/2023,Sierra Leone,Johor,1,1,0
1/11/2023,Sierra Leone,Kedah,1,0,1
1/11/2023,Sierra Leone,Perak,0,0,0
1/11/2023,Sierra Leone,Pulau Pinang,0,0,0
1/11/2023,Sierra Leone,Sabah,0,0,0
1/11/2023,Sierra Leone,Selangor,44,27,17
1/11/2023,El Salvador,Johor,0,0,0
1/11/2023,El Salvador,Kedah,0,0,0
1/11/2023,El Salvador,Perak,0,0,0
1/11/2023,El Salvador,Perlis,1,0,1
1/11/2023,El Salvador,Pulau Pinang,1,0,1
1/11/2023,El Salvador,Sabah,0,0,0
1/11/2023,El Salvador,Selangor,12,7,5
1/11/2023,El Salvador,W.P. Labuan,0,0,0
1/11/2023,San Marino,Johor,0,0,0
1/11/2023,San Marino,Selangor,4,4,0
1/11/2023,Somalia,Johor,1,1,0
1/11/2023,Somalia,Kedah,0,0,0
1/11/2023,Somalia,Kelantan,0,0,0
1/11/2023,Somalia,Perlis,0,0,0
1/11/2023,Somalia,Sabah,0,0,0
1/11/2023,Somalia,Sarawak,0,0,0
1/11/2023,Somalia,Selangor,305,186,119
1/11/2023,Serbia,Johor,3,2,1
1/11/2023,Serbia,Kedah,1,1,0
1/11/2023,Serbia,Kelantan,0,0,0
1/11/2023,Serbia,Pahang,0,0,0
1/11/2023,Serbia,Perak,1,0,1
1/11/2023,Serbia,Perlis,0,0,0
1/11/2023,Serbia,Pulau Pinang,7,6,1
1/11/2023,Serbia,Sabah,0,0,0
1/11/2023,Serbia,Sarawak,1,1,0
1/11/2023,Serbia,Selangor,97,46,51
1/11/2023,South Sudan,Johor,1,0,1
1/11/2023,South Sudan,Kedah,0,0,0
1/11/2023,South Sudan,Sarawak,0,0,0
1/11/2023,South Sudan,Selangor,34,22,12
1/11/2023,South Sudan,W.P. Labuan,0,0,0
1/11/2023,Sao Tome and Principe,Selangor,1,1,0
1/11/2023,Suriname,Johor,3,1,2
1/11/2023,Suriname,Kedah,0,0,0
1/11/2023,Suriname,Kelantan,0,0,0
1/11/2023,Suriname,Perak,0,0,0
1/11/2023,Suriname,Perlis,0,0,0
1/11/2023,Suriname,Pulau Pinang,0,0,0
1/11/2023,Suriname,Sabah,0,0,0
1/11/2023,Suriname,Sarawak,0,0,0
1/11/2023,Suriname,Selangor,17,13,4
1/11/2023,Slovakia,Johor,44,22,22
1/11/2023,Slovakia,Kedah,54,26,28
1/11/2023,Slovakia,Kelantan,0,0,0
1/11/2023,Slovakia,Negeri Sembilan,0,0,0
1/11/2023,Slovakia,Pahang,0,0,0
1/11/2023,Slovakia,Perak,0,0,0
1/11/2023,Slovakia,Perlis,2,2,0
1/11/2023,Slovakia,Pulau Pinang,21,14,7
1/11/2023,Slovakia,Sabah,6,3,3
1/11/2023,Slovakia,Sarawak,1,1,0
1/11/2023,Slovakia,Selangor,394,221,173
1/11/2023,Slovakia,W.P. Labuan,4,2,2
1/11/2023,Slovenia,Johor,24,14,10
1/11/2023,Slovenia,Kedah,12,4,8
1/11/2023,Slovenia,Kelantan,0,0,0
1/11/2023,Slovenia,Perak,0,0,0
1/11/2023,Slovenia,Perlis,1,1,0
1/11/2023,Slovenia,Pulau Pinang,10,5,5
1/11/2023,Slovenia,Sabah,1,1,0
1/11/2023,Slovenia,Sarawak,0,0,0
1/11/2023,Slovenia,Selangor,181,105,76
1/11/2023,Slovenia,W.P. Labuan,0,0,0
1/11/2023,Sweden,Johor,347,207,140
1/11/2023,Sweden,Kedah,146,64,82
1/11/2023,Sweden,Kelantan,2,0,2
1/11/2023,Sweden,Melaka,0,0,0
1/11/2023,Sweden,Negeri Sembilan,0,0,0
1/11/2023,Sweden,Pahang,1,1,0
1/11/2023,Sweden,Perak,6,5,1
1/11/2023,Sweden,Perlis,14,12,2
1/11/2023,Sweden,Pulau Pinang,113,74,39
1/11/2023,Sweden,Sabah,11,6,5
1/11/2023,Sweden,Sarawak,40,22,18
1/11/2023,Sweden,Selangor,1269,753,516
1/11/2023,Sweden,W.P. Labuan,2,1,1
1/11/2023,Eswatini,Johor,3,2,1
1/11/2023,Eswatini,Kedah,0,0,0
1/11/2023,Eswatini,Pulau Pinang,0,0,0
1/11/2023,Eswatini,Sabah,0,0,0
1/11/2023,Eswatini,Selangor,25,14,11
1/11/2023,Seychelles,Johor,0,0,0
1/11/2023,Seychelles,Kedah,1,1,0
1/11/2023,Seychelles,Pulau Pinang,0,0,0
1/11/2023,Seychelles,Sabah,0,0,0
1/11/2023,Seychelles,Sarawak,0,0,0
1/11/2023,Seychelles,Selangor,70,29,41
1/11/2023,Syrian Arab Republic,Johor,12,8,4
1/11/2023,Syrian Arab Republic,Kedah,0,0,0
1/11/2023,Syrian Arab Republic,Kelantan,1,0,1
1/11/2023,Syrian Arab Republic,Pahang,0,0,0
1/11/2023,Syrian Arab Republic,Perlis,0,0,0
1/11/2023,Syrian Arab Republic,Pulau Pinang,5,5,0
1/11/2023,Syrian Arab Republic,Sabah,0,0,0
1/11/2023,Syrian Arab Republic,Sarawak,1,1,0
1/11/2023,Syrian Arab Republic,Selangor,813,539,274
1/11/2023,Syrian Arab Republic,W.P. Labuan,0,0,0
1/11/2023,Turks and Caicos Islands,Perlis,0,0,0
1/11/2023,TCD,Johor,2,2,0
1/11/2023,TCD,Kedah,0,0,0
1/11/2023,TCD,Perlis,0,0,0
1/11/2023,TCD,Selangor,46,40,6
1/11/2023,Togo,Johor,0,0,0
1/11/2023,Togo,Perak,0,0,0
1/11/2023,Togo,Pulau Pinang,0,0,0
1/11/2023,Togo,Selangor,13,10,3
1/11/2023,Thailand,Johor,6138,1699,4439
1/11/2023,Thailand,Kedah,66908,40495,26413
1/11/2023,Thailand,Kelantan,39482,20641,18841
1/11/2023,Thailand,Melaka,3,1,2
1/11/2023,Thailand,Negeri Sembilan,0,0,0
1/11/2023,Thailand,Pahang,6,4,2
1/11/2023,Thailand,Perak,9890,4626,5264
1/11/2023,Thailand,Perlis,52035,30442,21593
1/11/2023,Thailand,Pulau Pinang,2374,959,1415
1/11/2023,Thailand,Sabah,32,11,21
1/11/2023,Thailand,Sarawak,310,106,204
1/11/2023,Thailand,Selangor,13787,5643,8144
1/11/2023,Thailand,Terengganu,2,0,2
1/11/2023,Thailand,W.P. Labuan,13,4,9
1/11/2023,Tajikistan,Johor,4,3,1
1/11/2023,Tajikistan,Kedah,0,0,0
1/11/2023,Tajikistan,Perlis,0,0,0
1/11/2023,Tajikistan,Pulau Pinang,0,0,0
1/11/2023,Tajikistan,Sabah,0,0,0
1/11/2023,Tajikistan,Selangor,144,105,39
1/11/2023,Tokelau,Selangor,0,0,0
1/11/2023,Turkmenistan,Johor,0,0,0
1/11/2023,Turkmenistan,Kedah,3,0,3
1/11/2023,Turkmenistan,Kelantan,0,0,0
1/11/2023,Turkmenistan,Perlis,0,0,0
1/11/2023,Turkmenistan,Pulau Pinang,5,4,1
1/11/2023,Turkmenistan,Sabah,0,0,0
1/11/2023,Turkmenistan,Sarawak,0,0,0
1/11/2023,Turkmenistan,Selangor,93,52,41
1/11/2023,Timor-Leste,Johor,5,2,3
1/11/2023,Timor-Leste,Kedah,0,0,0
1/11/2023,Timor-Leste,Perlis,0,0,0
1/11/2023,Timor-Leste,Pulau Pinang,10,4,6
1/11/2023,Timor-Leste,Sabah,3,3,0
1/11/2023,Timor-Leste,Sarawak,4,3,1
1/11/2023,Timor-Leste,Selangor,211,134,77
1/11/2023,Tonga,Johor,2,0,2
1/11/2023,Tonga,Pulau Pinang,8,4,4
1/11/2023,Tonga,Sarawak,0,0,0
1/11/2023,Tonga,Selangor,19,12,7
1/11/2023,Trinidad and Tobago,Johor,3,1,2
1/11/2023,Trinidad and Tobago,Kedah,0,0,0
1/11/2023,Trinidad and Tobago,Pahang,0,0,0
1/11/2023,Trinidad and Tobago,Pulau Pinang,0,0,0
1/11/2023,Trinidad and Tobago,Sabah,0,0,0
1/11/2023,Trinidad and Tobago,Sarawak,0,0,0
1/11/2023,Trinidad and Tobago,Selangor,43,24,19
1/11/2023,Tunisia,Johor,18,7,11
1/11/2023,Tunisia,Kedah,0,0,0
1/11/2023,Tunisia,Kelantan,1,1,0
1/11/2023,Tunisia,Melaka,0,0,0
1/11/2023,Tunisia,Perak,0,0,0
1/11/2023,Tunisia,Perlis,1,1,0
1/11/2023,Tunisia,Pulau Pinang,2,2,0
1/11/2023,Tunisia,Sabah,0,0,0
1/11/2023,Tunisia,Sarawak,1,1,0
1/11/2023,Tunisia,Selangor,665,371,294
1/11/2023,Tunisia,W.P. Labuan,0,0,0
1/11/2023,Türkiye,Johor,353,262,91
1/11/2023,Türkiye,Kedah,47,31,16
1/11/2023,Türkiye,Kelantan,1,0,1
1/11/2023,Türkiye,Melaka,0,0,0
1/11/2023,Türkiye,Negeri Sembilan,0,0,0
1/11/2023,Türkiye,Pahang,0,0,0
1/11/2023,Türkiye,Perak,2,2,0
1/11/2023,Türkiye,Perlis,23,16,7
1/11/2023,Türkiye,Pulau Pinang,28,24,4
1/11/2023,Türkiye,Sabah,9,6,3
1/11/2023,Türkiye,Sarawak,20,18,2
1/11/2023,Türkiye,Selangor,1495,1065,430
1/11/2023,Türkiye,W.P. Labuan,0,0,0
1/11/2023,Tuvalu,Selangor,1,1,0
1/11/2023,"Taiwan, Province of China",Johor,5648,2240,3408
1/11/2023,"Taiwan, Province of China",Kedah,129,60,69
1/11/2023,"Taiwan, Province of China",Kelantan,0,0,0
1/11/2023,"Taiwan, Province of China",Melaka,3,1,2
1/11/2023,"Taiwan, Province of China",Negeri Sembilan,0,0,0
1/11/2023,"Taiwan, Province of China",Pahang,3,1,2
1/11/2023,"Taiwan, Province of China",Perak,47,26,21
1/11/2023,"Taiwan, Province of China",Perlis,23,18,5
1/11/2023,"Taiwan, Province of China",Pulau Pinang,4032,2028,2004
1/11/2023,"Taiwan, Province of China",Sabah,1021,497,524
1/11/2023,"Taiwan, Province of China",Sarawak,293,121,172
1/11/2023,"Taiwan, Province of China",Selangor,15768,7249,8519
1/11/2023,"Taiwan, Province of China",W.P. Labuan,5,4,1
1/11/2023,"Tanzania, United Republic of",Johor,38,29,9
1/11/2023,"Tanzania, United Republic of",Kedah,0,0,0
1/11/2023,"Tanzania, United Republic of",Perak,0,0,0
1/11/2023,"Tanzania, United Republic of",Perlis,0,0,0
1/11/2023,"Tanzania, United Republic of",Pulau Pinang,1,0,1
1/11/2023,"Tanzania, United Republic of",Sabah,0,0,0
1/11/2023,"Tanzania, United Republic of",Sarawak,2,2,0
1/11/2023,"Tanzania, United Republic of",Selangor,245,133,112
1/11/2023,Uganda,Johor,15,4,11
1/11/2023,Uganda,Kedah,0,0,0
1/11/2023,Uganda,Perak,0,0,0
1/11/2023,Uganda,Perlis,0,0,0
1/11/2023,Uganda,Pulau Pinang,2,1,1
1/11/2023,Uganda,Sabah,0,0,0
1/11/2023,Uganda,Sarawak,0,0,0
1/11/2023,Uganda,Selangor,132,55,77
1/11/2023,Ukraine,Johor,105,50,55
1/11/2023,Ukraine,Kedah,36,15,21
1/11/2023,Ukraine,Kelantan,4,4,0
1/11/2023,Ukraine,Melaka,6,6,0
1/11/2023,Ukraine,Negeri Sembilan,0,0,0
1/11/2023,Ukraine,Pahang,5,4,1
1/11/2023,Ukraine,Perak,3,1,2
1/11/2023,Ukraine,Perlis,3,2,1
1/11/2023,Ukraine,Pulau Pinang,21,11,10
1/11/2023,Ukraine,Sabah,4,1,3
1/11/2023,Ukraine,Sarawak,1,1,0
1/11/2023,Ukraine,Selangor,920,455,465
1/11/2023,Ukraine,W.P. Labuan,0,0,0
1/11/2023,Uruguay,Johor,4,1,3
1/11/2023,Uruguay,Kedah,1,0,1
1/11/2023,Uruguay,Kelantan,0,0,0
1/11/2023,Uruguay,Perak,0,0,0
1/11/2023,Uruguay,Perlis,0,0,0
1/11/2023,Uruguay,Pulau Pinang,0,0,0
1/11/2023,Uruguay,Sabah,0,0,0
1/11/2023,Uruguay,Sarawak,0,0,0
1/11/2023,Uruguay,Selangor,77,33,44
1/11/2023,Uruguay,W.P. Labuan,0,0,0
1/11/2023,United States of America,Johor,4676,2673,2003
1/11/2023,United States of America,Kedah,460,256,204
1/11/2023,United States of America,Kelantan,18,13,5
1/11/2023,United States of America,Melaka,3,2,1
1/11/2023,United States of America,Negeri Sembilan,0,0,0
1/11/2023,United States of America,Pahang,11,5,6
1/11/2023,United States of America,Perak,170,87,83
1/11/2023,United States of America,Perlis,70,46,24
1/11/2023,United States of America,Pulau Pinang,2101,1305,796
1/11/2023,United States of America,Sabah,259,144,115
1/11/2023,United States of America,Sarawak,246,130,116
1/11/2023,United States of America,Selangor,15372,9055,6317
1/11/2023,United States of America,Terengganu,3,3,0
1/11/2023,United States of America,W.P. Labuan,7,5,2
1/11/2023,Uzbekistan,Johor,81,69,12
1/11/2023,Uzbekistan,Kedah,20,12,8
1/11/2023,Uzbekistan,Kelantan,0,0,0
1/11/2023,Uzbekistan,Perak,1,0,1
1/11/2023,Uzbekistan,Perlis,4,1,3
1/11/2023,Uzbekistan,Pulau Pinang,11,6,5
1/11/2023,Uzbekistan,Sabah,2,1,1
1/11/2023,Uzbekistan,Sarawak,0,0,0
1/11/2023,Uzbekistan,Selangor,1260,763,497
1/11/2023,Holy See,Johor,0,0,0
1/11/2023,Holy See,Sarawak,0,0,0
1/11/2023,Holy See,Selangor,0,0,0
1/11/2023,Saint Vincent and the Grenadines,Johor,0,0,0
1/11/2023,Saint Vincent and the Grenadines,Kedah,0,0,0
1/11/2023,Saint Vincent and the Grenadines,Pulau Pinang,0,0,0
1/11/2023,Saint Vincent and the Grenadines,Sarawak,0,0,0
1/11/2023,Saint Vincent and the Grenadines,Selangor,0,0,0
1/11/2023,"Venezuela, Bolivarian Republic of",Johor,13,8,5
1/11/2023,"Venezuela, Bolivarian Republic of",Kedah,1,0,1
1/11/2023,"Venezuela, Bolivarian Republic of",Kelantan,0,0,0
1/11/2023,"Venezuela, Bolivarian Republic of",Melaka,0,0,0
1/11/2023,"Venezuela, Bolivarian Republic of",Perak,0,0,0
1/11/2023,"Venezuela, Bolivarian Republic of",Perlis,1,0,1
1/11/2023,"Venezuela, Bolivarian Republic of",Pulau Pinang,2,1,1
1/11/2023,"Venezuela, Bolivarian Republic of",Sabah,0,0,0
1/11/2023,"Venezuela, Bolivarian Republic of",Sarawak,1,0,1
1/11/2023,"Venezuela, Bolivarian Republic of",Selangor,78,45,33
1/11/2023,"Venezuela, Bolivarian Republic of",W.P. Labuan,0,0,0
1/11/2023,Viet Nam,Johor,12151,3617,8534
1/11/2023,Viet Nam,Kedah,296,42,254
1/11/2023,Viet Nam,Kelantan,13,3,10
1/11/2023,Viet Nam,Melaka,0,0,0
1/11/2023,Viet Nam,Negeri Sembilan,0,0,0
1/11/2023,Viet Nam,Pahang,1,0,1
1/11/2023,Viet Nam,Perak,190,12,178
1/11/2023,Viet Nam,Perlis,186,19,167
1/11/2023,Viet Nam,Pulau Pinang,1156,367,789
1/11/2023,Viet Nam,Sabah,29,10,19
1/11/2023,Viet Nam,Sarawak,248,44,204
1/11/2023,Viet Nam,Selangor,14854,5712,9142
1/11/2023,Viet Nam,Terengganu,0,0,0
1/11/2023,Viet Nam,W.P. Labuan,0,0,0
1/11/2023,Vanuatu,Johor,58,43,15
1/11/2023,Vanuatu,Kedah,0,0,0
1/11/2023,Vanuatu,Pulau Pinang,0,0,0
1/11/2023,Vanuatu,Sabah,2,2,0
1/11/2023,Vanuatu,Sarawak,0,0,0
1/11/2023,Vanuatu,Selangor,71,62,9
1/11/2023, Samoa,Johor,2,2,0
1/11/2023, Samoa,Sarawak,0,0,0
1/11/2023, Samoa,Selangor,8,0,8
1/11/2023,Yemen,Johor,37,29,8
1/11/2023,Yemen,Kedah,8,6,2
1/11/2023,Yemen,Kelantan,0,0,0
1/11/2023,Yemen,Melaka,0,0,0
1/11/2023,Yemen,Pahang,0,0,0
1/11/2023,Yemen,Perak,1,1,0
1/11/2023,Yemen,Perlis,3,3,0
1/11/2023,Yemen,Pulau Pinang,5,4,1
1/11/2023,Yemen,Sabah,0,0,0
1/11/2023,Yemen,Sarawak,4,4,0
1/11/2023,Yemen,Selangor,1595,1117,478
1/11/2023,Yemen,W.P. Labuan,0,0,0
1/11/2023,South Africa,Johor,228,142,86
1/11/2023,South Africa,Kedah,32,18,14
1/11/2023,South Africa,Kelantan,0,0,0
1/11/2023,South Africa,Melaka,0,0,0
1/11/2023,South Africa,Pahang,1,1,0
1/11/2023,South Africa,Perak,2,0,2
1/11/2023,South Africa,Perlis,10,7,3
1/11/2023,South Africa,Pulau Pinang,46,27,19
1/11/2023,South Africa,Sabah,7,4,3
1/11/2023,South Africa,Sarawak,81,35,46
1/11/2023,South Africa,Selangor,1178,756,422
1/11/2023,South Africa,Terengganu,2,2,0
1/11/2023,South Africa,W.P. Labuan,0,0,0
1/11/2023,ZAR,Selangor,1,1,0
1/11/2023,Zambia,Johor,2,1,1
1/11/2023,Zambia,Kedah,0,0,0
1/11/2023,Zambia,Perak,0,0,0
1/11/2023,Zambia,Perlis,0,0,0
1/11/2023,Zambia,Pulau Pinang,4,1,3
1/11/2023,Zambia,Sabah,1,0,1
1/11/2023,Zambia,Sarawak,0,0,0
1/11/2023,Zambia,Selangor,102,61,41
1/11/2023,Zimbabwe,Johor,12,7,5
1/11/2023,Zimbabwe,Kedah,0,0,0
1/11/2023,Zimbabwe,Kelantan,0,0,0
1/11/2023,Zimbabwe,Perak,0,0,0
1/11/2023,Zimbabwe,Perlis,0,0,0
1/11/2023,Zimbabwe,Pulau Pinang,0,0,0
1/11/2023,Zimbabwe,Sabah,1,0,1
1/11/2023,Zimbabwe,Sarawak,0,0,0
1/11/2023,Zimbabwe,Selangor,169,73,96
1/12/2023,Afghanistan,Perlis,1,1,0
1/12/2023,Afghanistan,Sarawak,2,2,0
1/12/2023,Afghanistan,Selangor,70,51,19
1/12/2023,Angola,Johor,1,0,1
1/12/2023,Angola,Selangor,2,1,1
1/12/2023,Albania,Johor,17,15,2
1/12/2023,Albania,Kedah,5,3,2
1/12/2023,Albania,Pulau Pinang,1,1,0
1/12/2023,Albania,Sabah,1,0,1
1/12/2023,Albania,Selangor,50,34,16
1/12/2023,Andorra,Pulau Pinang,6,3,3
1/12/2023,Andorra,Selangor,10,5,5
1/12/2023,United Arab Emirates,Johor,45,22,23
1/12/2023,United Arab Emirates,Kedah,3,1,2
1/12/2023,United Arab Emirates,Selangor,1108,580,528
1/12/2023,Argentina,Johor,83,51,32
1/12/2023,Argentina,Kedah,45,21,24
1/12/2023,Argentina,Perlis,3,2,1
1/12/2023,Argentina,Pulau Pinang,8,3,5
1/12/2023,Argentina,Sabah,3,2,1
1/12/2023,Argentina,Sarawak,1,1,0
1/12/2023,Argentina,Selangor,485,236,249
1/12/2023,Armenia,Johor,3,2,1
1/12/2023,Armenia,Pulau Pinang,4,0,4
1/12/2023,Armenia,Selangor,56,28,28
1/12/2023,Antarctica,Selangor,2,1,1
1/12/2023,Antigua and Barbuda,Johor,5,3,2
1/12/2023,Antigua and Barbuda,Sabah,1,0,1
1/12/2023,Antigua and Barbuda,Selangor,24,14,10
1/12/2023,Australia,Johor,7092,3949,3143
1/12/2023,Australia,Kedah,1182,632,550
1/12/2023,Australia,Kelantan,8,5,3
1/12/2023,Australia,Pahang,34,20,14
1/12/2023,Australia,Perak,356,187,169
1/12/2023,Australia,Perlis,100,56,44
1/12/2023,Australia,Pulau Pinang,2988,1536,1452
1/12/2023,Australia,Sabah,590,302,288
1/12/2023,Australia,Sarawak,864,472,392
1/12/2023,Australia,Selangor,41444,23064,18380
1/12/2023,Australia,W.P. Labuan,15,13,2
1/12/2023,Austria,Johor,201,131,70
1/12/2023,Austria,Kedah,167,82,85
1/12/2023,Austria,Kelantan,2,1,1
1/12/2023,Austria,Perlis,11,6,5
1/12/2023,Austria,Pulau Pinang,74,50,24
1/12/2023,Austria,Sabah,7,5,2
1/12/2023,Austria,Sarawak,18,13,5
1/12/2023,Austria,Selangor,997,578,419
1/12/2023,Austria,W.P. Labuan,1,1,0
1/12/2023,Azerbaijan,Johor,20,15,5
1/12/2023,Azerbaijan,Kedah,5,2,3
1/12/2023,Azerbaijan,Sarawak,3,1,2
1/12/2023,Azerbaijan,Selangor,208,98,110
1/12/2023,Burundi,Selangor,8,4,4
1/12/2023,Belgium,Johor,192,116,76
1/12/2023,Belgium,Kedah,155,82,73
1/12/2023,Belgium,Kelantan,3,3,0
1/12/2023,Belgium,Perak,5,2,3
1/12/2023,Belgium,Perlis,18,12,6
1/12/2023,Belgium,Pulau Pinang,88,61,27
1/12/2023,Belgium,Sabah,17,9,8
1/12/2023,Belgium,Sarawak,23,17,6
1/12/2023,Belgium,Selangor,1138,720,418
1/12/2023,Belgium,W.P. Labuan,2,2,0
1/12/2023,Benin,Johor,1,1,0
1/12/2023,Benin,Sarawak,1,0,1
1/12/2023,Benin,Selangor,14,7,7
1/12/2023,Burkina Faso,Johor,2,2,0
1/12/2023,Burkina Faso,Selangor,4,4,0
1/12/2023,Bangladesh,Johor,2916,2203,713
1/12/2023,Bangladesh,Kedah,58,36,22
1/12/2023,Bangladesh,Kelantan,2,2,0
1/12/2023,Bangladesh,Perak,4,2,2
1/12/2023,Bangladesh,Perlis,3,2,1
1/12/2023,Bangladesh,Pulau Pinang,176,155,21
1/12/2023,Bangladesh,Sabah,6,4,2
1/12/2023,Bangladesh,Sarawak,80,49,31
1/12/2023,Bangladesh,Selangor,38847,36343,2504
1/12/2023,Bangladesh,W.P. Labuan,21,20,1
1/12/2023,Bulgaria,Johor,44,27,17
1/12/2023,Bulgaria,Kedah,35,18,17
1/12/2023,Bulgaria,Perak,1,0,1
1/12/2023,Bulgaria,Pulau Pinang,16,11,5
1/12/2023,Bulgaria,Sabah,5,4,1
1/12/2023,Bulgaria,Sarawak,2,2,0
1/12/2023,Bulgaria,Selangor,409,215,194
1/12/2023,Bahrain,Johor,9,4,5
1/12/2023,Bahrain,Kedah,8,4,4
1/12/2023,Bahrain,Selangor,149,82,67
1/12/2023,Bahamas,Kedah,2,1,1
1/12/2023,Bahamas,Selangor,20,13,7
1/12/2023,Bosnia and Herzegovina,Johor,11,7,4
1/12/2023,Bosnia and Herzegovina,Kedah,5,3,2
1/12/2023,Bosnia and Herzegovina,Pulau Pinang,1,1,0
1/12/2023,Bosnia and Herzegovina,Sabah,1,0,1
1/12/2023,Bosnia and Herzegovina,Sarawak,1,1,0
1/12/2023,Bosnia and Herzegovina,Selangor,60,30,30
1/12/2023,Belarus,Johor,16,6,10
1/12/2023,Belarus,Kedah,20,8,12
1/12/2023,Belarus,Kelantan,1,1,0
1/12/2023,Belarus,Pulau Pinang,8,4,4
1/12/2023,Belarus,Sabah,2,1,1
1/12/2023,Belarus,Sarawak,4,1,3
1/12/2023,Belarus,Selangor,393,183,210
1/12/2023,Belize,Johor,12,6,6
1/12/2023,Belize,Pulau Pinang,2,1,1
1/12/2023,Belize,Sarawak,1,1,0
1/12/2023,Belize,Selangor,6,5,1
1/12/2023,Bolivia,Kedah,2,0,2
1/12/2023,Bolivia,Pulau Pinang,2,1,1
1/12/2023,Bolivia,Sabah,1,1,0
1/12/2023,Bolivia,Selangor,24,12,12
1/12/2023,Brazil,Johor,297,152,145
1/12/2023,Brazil,Kedah,163,88,75
1/12/2023,Brazil,Pahang,3,2,1
1/12/2023,Brazil,Perlis,6,3,3
1/12/2023,Brazil,Pulau Pinang,44,27,17
1/12/2023,Brazil,Sabah,14,6,8
1/12/2023,Brazil,Sarawak,1,0,1
1/12/2023,Brazil,Selangor,1193,626,567
1/12/2023,Barbados,Johor,1,0,1
1/12/2023,Barbados,Selangor,6,3,3
1/12/2023,Brunei Darussalam,Johor,1917,975,942
1/12/2023,Brunei Darussalam,Kedah,105,51,54
1/12/2023,Brunei Darussalam,Kelantan,22,8,14
1/12/2023,Brunei Darussalam,Melaka,5,2,3
1/12/2023,Brunei Darussalam,Perak,5,2,3
1/12/2023,Brunei Darussalam,Perlis,116,58,58
1/12/2023,Brunei Darussalam,Pulau Pinang,31,15,16
1/12/2023,Brunei Darussalam,Sabah,2833,1266,1567
1/12/2023,Brunei Darussalam,Sarawak,151340,81793,69547
1/12/2023,Brunei Darussalam,Selangor,10737,5165,5572
1/12/2023,Brunei Darussalam,W.P. Labuan,3106,1821,1285
1/12/2023,Bhutan,Johor,16,16,0
1/12/2023,Bhutan,Selangor,48,32,16
1/12/2023,BVT,Selangor,1,0,1
1/12/2023,Botswana,Selangor,16,6,10
1/12/2023,Canada,Johor,1513,832,681
1/12/2023,Canada,Kedah,431,230,201
1/12/2023,Canada,Kelantan,2,2,0
1/12/2023,Canada,Pahang,5,3,2
1/12/2023,Canada,Perak,44,19,25
1/12/2023,Canada,Perlis,43,25,18
1/12/2023,Canada,Pulau Pinang,644,331,313
1/12/2023,Canada,Sabah,205,107,98
1/12/2023,Canada,Sarawak,311,167,144
1/12/2023,Canada,Selangor,6274,3453,2821
1/12/2023,Canada,W.P. Labuan,5,1,4
1/12/2023,Switzerland,Johor,384,208,176
1/12/2023,Switzerland,Kedah,310,161,149
1/12/2023,Switzerland,Kelantan,3,3,0
1/12/2023,Switzerland,Perak,2,1,1
1/12/2023,Switzerland,Perlis,27,18,9
1/12/2023,Switzerland,Pulau Pinang,168,102,66
1/12/2023,Switzerland,Sabah,21,9,12
1/12/2023,Switzerland,Sarawak,22,10,12
1/12/2023,Switzerland,Selangor,1707,1020,687
1/12/2023,Chile,Johor,32,18,14
1/12/2023,Chile,Kedah,26,13,13
1/12/2023,Chile,Perlis,6,3,3
1/12/2023,Chile,Pulau Pinang,6,4,2
1/12/2023,Chile,Sabah,4,1,3
1/12/2023,Chile,Selangor,267,125,142
1/12/2023,China,Johor,57202,25651,31551
1/12/2023,China,Kedah,1430,646,784
1/12/2023,China,Kelantan,28,21,7
1/12/2023,China,Melaka,2,0,2
1/12/2023,China,Negeri Sembilan,5,4,1
1/12/2023,China,Pahang,52,24,28
1/12/2023,China,Perak,357,169,188
1/12/2023,China,Perlis,328,171,157
1/12/2023,China,Pulau Pinang,8862,4588,4274
1/12/2023,China,Sabah,7294,3348,3946
1/12/2023,China,Sarawak,1634,877,757
1/12/2023,China,Selangor,102109,52914,49195
1/12/2023,China,W.P. Labuan,91,77,14
1/12/2023,Côte d'Ivoire,Johor,3,3,0
1/12/2023,Côte d'Ivoire,Selangor,5,1,4
1/12/2023,Cameroon,Kedah,1,1,0
1/12/2023,Cameroon,Selangor,21,14,7
1/12/2023,Congo,Johor,2,2,0
1/12/2023,Congo,Selangor,15,7,8
1/12/2023,Congo,Selangor,4,4,0
1/12/2023,Colombia,Johor,20,9,11
1/12/2023,Colombia,Kedah,8,4,4
1/12/2023,Colombia,Perlis,1,1,0
1/12/2023,Colombia,Pulau Pinang,10,2,8
1/12/2023,Colombia,Sabah,1,0,1
1/12/2023,Colombia,Sarawak,4,4,0
1/12/2023,Colombia,Selangor,227,123,104
1/12/2023,Comoros,Johor,5,0,5
1/12/2023,Comoros,Kedah,1,1,0
1/12/2023,Comoros,Selangor,12,8,4
1/12/2023,Cabo Verde,Selangor,1,0,1
1/12/2023,Costa Rica,Johor,10,3,7
1/12/2023,Costa Rica,Kedah,6,4,2
1/12/2023,Costa Rica,Pulau Pinang,12,8,4
1/12/2023,Costa Rica,Sabah,1,1,0
1/12/2023,Costa Rica,Selangor,52,33,19
1/12/2023,Cuba,Johor,7,6,1
1/12/2023,Cuba,Pulau Pinang,1,1,0
1/12/2023,Cuba,Selangor,20,13,7
1/12/2023,Cyprus,Johor,6,4,2
1/12/2023,Cyprus,Kedah,7,3,4
1/12/2023,Cyprus,Pulau Pinang,2,0,2
1/12/2023,Cyprus,Sabah,7,3,4
1/12/2023,Cyprus,Sarawak,1,0,1
1/12/2023,Cyprus,Selangor,81,43,38
1/12/2023,Czechia,Johor,105,66,39
1/12/2023,Czechia,Kedah,181,105,76
1/12/2023,Czechia,Perak,1,0,1
1/12/2023,Czechia,Perlis,6,3,3
1/12/2023,Czechia,Pulau Pinang,29,19,10
1/12/2023,Czechia,Sabah,10,7,3
1/12/2023,Czechia,Sarawak,4,2,2
1/12/2023,Czechia,Selangor,960,536,424
1/12/2023,Germany,Johor,2039,1351,688
1/12/2023,Germany,Kedah,2860,1463,1397
1/12/2023,Germany,Kelantan,17,12,5
1/12/2023,Germany,Melaka,4,2,2
1/12/2023,Germany,Pahang,6,3,3
1/12/2023,Germany,Perak,15,11,4
1/12/2023,Germany,Perlis,127,78,49
1/12/2023,Germany,Pulau Pinang,660,422,238
1/12/2023,Germany,Sabah,150,99,51
1/12/2023,Germany,Sarawak,146,85,61
1/12/2023,Germany,Selangor,10513,6023,4490
1/12/2023,Germany,W.P. Labuan,6,5,1
1/12/2023,Djibouti,Selangor,13,6,7
1/12/2023,Dominica,Johor,9,7,2
1/12/2023,Dominica,Sarawak,2,1,1
1/12/2023,Dominica,Selangor,60,40,20
1/12/2023,Denmark,Johor,258,184,74
1/12/2023,Denmark,Kedah,177,86,91
1/12/2023,Denmark,Kelantan,1,1,0
1/12/2023,Denmark,Melaka,6,3,3
1/12/2023,Denmark,Perak,3,2,1
1/12/2023,Denmark,Perlis,11,9,2
1/12/2023,Denmark,Pulau Pinang,66,41,25
1/12/2023,Denmark,Sabah,23,14,9
1/12/2023,Denmark,Sarawak,13,6,7
1/12/2023,Denmark,Selangor,1176,689,487
1/12/2023,Dominican Republic,Johor,2,0,2
1/12/2023,Dominican Republic,Pulau Pinang,2,0,2
1/12/2023,Dominican Republic,Sarawak,1,0,1
1/12/2023,Dominican Republic,Selangor,10,5,5
1/12/2023,Algeria,Johor,41,25,16
1/12/2023,Algeria,Kedah,6,6,0
1/12/2023,Algeria,Perlis,2,2,0
1/12/2023,Algeria,Pulau Pinang,3,2,1
1/12/2023,Algeria,Sabah,2,1,1
1/12/2023,Algeria,Sarawak,9,8,1
1/12/2023,Algeria,Selangor,924,537,387
1/12/2023,Ecuador,Johor,17,7,10
1/12/2023,Ecuador,Kedah,2,0,2
1/12/2023,Ecuador,Perlis,2,0,2
1/12/2023,Ecuador,Pulau Pinang,5,2,3
1/12/2023,Ecuador,Selangor,78,40,38
1/12/2023,Egypt,Johor,266,207,59
1/12/2023,Egypt,Kedah,5,3,2
1/12/2023,Egypt,Perak,2,1,1
1/12/2023,Egypt,Perlis,1,0,1
1/12/2023,Egypt,Pulau Pinang,14,10,4
1/12/2023,Egypt,Sabah,16,10,6
1/12/2023,Egypt,Sarawak,220,132,88
1/12/2023,Egypt,Selangor,1888,1258,630
1/12/2023,Egypt,W.P. Labuan,1,1,0
1/12/2023,Eritrea,Selangor,14,5,9
1/12/2023,Spain,Johor,348,209,139
1/12/2023,Spain,Kedah,266,129,137
1/12/2023,Spain,Kelantan,2,2,0
1/12/2023,Spain,Pahang,1,1,0
1/12/2023,Spain,Perlis,18,14,4
1/12/2023,Spain,Pulau Pinang,105,55,50
1/12/2023,Spain,Sabah,38,21,17
1/12/2023,Spain,Sarawak,37,24,13
1/12/2023,Spain,Selangor,2692,1471,1221
1/12/2023,Spain,W.P. Labuan,5,3,2
1/12/2023,Estonia,Johor,32,15,17
1/12/2023,Estonia,Kedah,32,12,20
1/12/2023,Estonia,Perlis,5,2,3
1/12/2023,Estonia,Pulau Pinang,8,5,3
1/12/2023,Estonia,Sabah,5,4,1
1/12/2023,Estonia,Sarawak,4,1,3
1/12/2023,Estonia,Selangor,424,215,209
1/12/2023,Ethiopia,Sabah,1,0,1
1/12/2023,Ethiopia,Selangor,27,15,12
1/12/2023,Finland,Johor,164,102,62
1/12/2023,Finland,Kedah,117,64,53
1/12/2023,Finland,Melaka,3,3,0
1/12/2023,Finland,Perlis,12,8,4
1/12/2023,Finland,Pulau Pinang,69,41,28
1/12/2023,Finland,Sabah,18,9,9
1/12/2023,Finland,Sarawak,16,12,4
1/12/2023,Finland,Selangor,835,463,372
1/12/2023,Fiji,Johor,184,79,105
1/12/2023,Fiji,Kedah,4,2,2
1/12/2023,Fiji,Pulau Pinang,2,2,0
1/12/2023,Fiji,Sabah,1,0,1
1/12/2023,Fiji,Sarawak,3,0,3
1/12/2023,Fiji,Selangor,295,134,161
1/12/2023,France,Johor,1773,1137,636
1/12/2023,France,Kedah,770,425,345
1/12/2023,France,Kelantan,13,8,5
1/12/2023,France,Melaka,1,1,0
1/12/2023,France,Negeri Sembilan,5,3,2
1/12/2023,France,Pahang,37,17,20
1/12/2023,France,Perak,44,25,19
1/12/2023,France,Perlis,71,49,22
1/12/2023,France,Pulau Pinang,459,280,179
1/12/2023,France,Sabah,143,86,57
1/12/2023,France,Sarawak,72,51,21
1/12/2023,France,Selangor,7563,4513,3050
1/12/2023,France,W.P. Labuan,3,2,1
1/12/2023,Gabon,Selangor,8,4,4
1/12/2023,United Kingdom of Great Britain and Northern Ireland,Johor,4739,3036,1703
1/12/2023,United Kingdom of Great Britain and Northern Ireland,Kedah,3896,2029,1867
1/12/2023,United Kingdom of Great Britain and Northern Ireland,Kelantan,13,10,3
1/12/2023,United Kingdom of Great Britain and Northern Ireland,Melaka,1,0,1
1/12/2023,United Kingdom of Great Britain and Northern Ireland,Pahang,33,18,15
1/12/2023,United Kingdom of Great Britain and Northern Ireland,Perak,96,52,44
1/12/2023,United Kingdom of Great Britain and Northern Ireland,Perlis,153,102,51
1/12/2023,United Kingdom of Great Britain and Northern Ireland,Pulau Pinang,1877,1116,761
1/12/2023,United Kingdom of Great Britain and Northern Ireland,Sabah,492,277,215
1/12/2023,United Kingdom of Great Britain and Northern Ireland,Sarawak,1579,921,658
1/12/2023,United Kingdom of Great Britain and Northern Ireland,Selangor,22293,12978,9315
1/12/2023,United Kingdom of Great Britain and Northern Ireland,W.P. Labuan,34,23,11
1/12/2023,Georgia,Johor,3,2,1
1/12/2023,Georgia,Kedah,3,1,2
1/12/2023,Georgia,Pulau Pinang,1,1,0
1/12/2023,Georgia,Selangor,68,37,31
1/12/2023,Ghana,Johor,7,6,1
1/12/2023,Ghana,Kedah,6,2,4
1/12/2023,Ghana,Perlis,2,1,1
1/12/2023,Ghana,Pulau Pinang,3,2,1
1/12/2023,Ghana,Sabah,1,1,0
1/12/2023,Ghana,Sarawak,1,1,0
1/12/2023,Ghana,Selangor,127,68,59
1/12/2023,Guinea,Johor,11,8,3
1/12/2023,Guinea,Perlis,1,0,1
1/12/2023,Guinea,Sabah,1,1,0
1/12/2023,Guinea,Selangor,55,42,13
1/12/2023,Gambia,Johor,1,1,0
1/12/2023,Gambia,Selangor,25,17,8
1/12/2023,Equatorial Guinea,Johor,1,1,0
1/12/2023,Greece,Johor,51,33,18
1/12/2023,Greece,Kedah,34,20,14
1/12/2023,Greece,Perlis,2,2,0
1/12/2023,Greece,Pulau Pinang,10,5,5
1/12/2023,Greece,Sabah,5,2,3
1/12/2023,Greece,Sarawak,4,3,1
1/12/2023,Greece,Selangor,463,275,188
1/12/2023,Grenada,Kedah,4,1,3
1/12/2023,Grenada,Selangor,10,6,4
1/12/2023,Guatemala,Johor,4,2,2
1/12/2023,Guatemala,Kedah,5,2,3
1/12/2023,Guatemala,Selangor,38,20,18
1/12/2023,Guyana,Johor,7,4,3
1/12/2023,Guyana,Selangor,9,6,3
1/12/2023,Hong Kong,Johor,1,0,1
1/12/2023,Hong Kong,Kedah,3,1,2
1/12/2023,Hong Kong,Pahang,3,1,2
1/12/2023,Hong Kong,Perak,51,24,27
1/12/2023,Hong Kong,Sabah,6470,2834,3636
1/12/2023,Hong Kong,Selangor,2750,1481,1269
1/12/2023,Honduras,Johor,3,3,0
1/12/2023,Honduras,Kedah,1,1,0
1/12/2023,Honduras,Selangor,9,6,3
1/12/2023,Croatia,Johor,27,19,8
1/12/2023,Croatia,Kedah,9,5,4
1/12/2023,Croatia,Pulau Pinang,6,5,1
1/12/2023,Croatia,Sabah,1,1,0
1/12/2023,Croatia,Sarawak,5,5,0
1/12/2023,Croatia,Selangor,325,181,144
1/12/2023,Haiti,Johor,5,3,2
1/12/2023,Haiti,Selangor,8,5,3
1/12/2023,Hungary,Johor,102,66,36
1/12/2023,Hungary,Kedah,78,44,34
1/12/2023,Hungary,Kelantan,2,1,1
1/12/2023,Hungary,Perak,1,1,0
1/12/2023,Hungary,Perlis,6,5,1
1/12/2023,Hungary,Pulau Pinang,47,25,22
1/12/2023,Hungary,Sabah,3,0,3
1/12/2023,Hungary,Sarawak,8,5,3
1/12/2023,Hungary,Selangor,843,423,420
1/12/2023,Indonesia,Johor,120074,52520,67554
1/12/2023,Indonesia,Kedah,6403,2358,4045
1/12/2023,Indonesia,Kelantan,124,83,41
1/12/2023,Indonesia,Melaka,5327,2256,3071
1/12/2023,Indonesia,Negeri Sembilan,5111,2637,2474
1/12/2023,Indonesia,Pahang,45,34,11
1/12/2023,Indonesia,Perak,338,87,251
1/12/2023,Indonesia,Perlis,719,257,462
1/12/2023,Indonesia,Pulau Pinang,40678,16866,23812
1/12/2023,Indonesia,Sabah,7170,3155,4015
1/12/2023,Indonesia,Sarawak,55980,26397,29583
1/12/2023,Indonesia,Selangor,161439,74219,87220
1/12/2023,Indonesia,W.P. Labuan,73,38,35
1/12/2023,India,Johor,37891,24550,13341
1/12/2023,India,Kedah,1460,805,655
1/12/2023,India,Kelantan,4,3,1
1/12/2023,India,Melaka,3,2,1
1/12/2023,India,Pahang,19,9,10
1/12/2023,India,Perak,399,279,120
1/12/2023,India,Perlis,60,46,14
1/12/2023,India,Pulau Pinang,1269,776,493
1/12/2023,India,Sabah,230,156,74
1/12/2023,India,Sarawak,3061,2401,660
1/12/2023,India,Selangor,67889,43330,24559
1/12/2023,India,W.P. Labuan,121,107,14
1/12/2023, British Indian Ocean Territory,Selangor,2,0,2
1/12/2023,Ireland,Johor,208,122,86
1/12/2023,Ireland,Kedah,151,79,72
1/12/2023,Ireland,Kelantan,3,3,0
1/12/2023,Ireland,Perak,8,6,2
1/12/2023,Ireland,Perlis,10,6,4
1/12/2023,Ireland,Pulau Pinang,130,72,58
1/12/2023,Ireland,Sabah,14,9,5
1/12/2023,Ireland,Sarawak,43,26,17
1/12/2023,Ireland,Selangor,1330,795,535
1/12/2023,"Iran, Islamic Republic of",Johor,352,193,159
1/12/2023,"Iran, Islamic Republic of",Kedah,11,6,5
1/12/2023,"Iran, Islamic Republic of",Perlis,3,3,0
1/12/2023,"Iran, Islamic Republic of",Pulau Pinang,10,6,4
1/12/2023,"Iran, Islamic Republic of",Sabah,2,1,1
1/12/2023,"Iran, Islamic Republic of",Sarawak,6,4,2
1/12/2023,"Iran, Islamic Republic of",Selangor,2481,1322,1159
1/12/2023,Iraq,Johor,72,49,23
1/12/2023,Iraq,Pulau Pinang,1,1,0
1/12/2023,Iraq,Sabah,1,1,0
1/12/2023,Iraq,Sarawak,4,3,1
1/12/2023,Iraq,Selangor,1498,1038,460
1/12/2023,Iceland,Johor,10,8,2
1/12/2023,Iceland,Kedah,1,1,0
1/12/2023,Iceland,Perak,6,3,3
1/12/2023,Iceland,Pulau Pinang,7,3,4
1/12/2023,Iceland,Sabah,1,1,0
1/12/2023,Iceland,Sarawak,1,1,0
1/12/2023,Iceland,Selangor,47,28,19
1/12/2023,Israel,Pulau Pinang,1,0,1
1/12/2023,Italy,Johor,576,358,218
1/12/2023,Italy,Kedah,441,251,190
1/12/2023,Italy,Kelantan,3,3,0
1/12/2023,Italy,Negeri Sembilan,1,1,0
1/12/2023,Italy,Perak,6,5,1
1/12/2023,Italy,Perlis,27,23,4
1/12/2023,Italy,Pulau Pinang,144,95,49
1/12/2023,Italy,Sabah,38,27,11
1/12/2023,Italy,Sarawak,51,34,17
1/12/2023,Italy,Selangor,3479,2093,1386
1/12/2023,Italy,W.P. Labuan,2,2,0
1/12/2023,Jamaica,Johor,3,1,2
1/12/2023,Jamaica,Kedah,1,0,1
1/12/2023,Jamaica,Pulau Pinang,1,0,1
1/12/2023,Jamaica,Selangor,12,7,5
1/12/2023,Jordan,Johor,15,14,1
1/12/2023,Jordan,Kedah,2,2,0
1/12/2023,Jordan,Pahang,1,1,0
1/12/2023,Jordan,Perak,1,1,0
1/12/2023,Jordan,Pulau Pinang,18,8,10
1/12/2023,Jordan,Sabah,1,1,0
1/12/2023,Jordan,Selangor,897,529,368
1/12/2023,Japan,Johor,6394,4020,2374
1/12/2023,Japan,Kedah,508,262,246
1/12/2023,Japan,Kelantan,10,7,3
1/12/2023,Japan,Melaka,1,1,0
1/12/2023,Japan,Negeri Sembilan,1,1,0
1/12/2023,Japan,Pahang,24,15,9
1/12/2023,Japan,Perak,53,27,26
1/12/2023,Japan,Perlis,76,60,16
1/12/2023,Japan,Pulau Pinang,1614,1023,591
1/12/2023,Japan,Sabah,507,275,232
1/12/2023,Japan,Sarawak,212,116,96
1/12/2023,Japan,Selangor,20372,12029,8343
1/12/2023,Japan,W.P. Labuan,19,13,6
1/12/2023,Kazakhstan,Johor,68,29,39
1/12/2023,Kazakhstan,Kedah,25,13,12
1/12/2023,Kazakhstan,Kelantan,2,1,1
1/12/2023,Kazakhstan,Perlis,8,3,5
1/12/2023,Kazakhstan,Pulau Pinang,9,3,6
1/12/2023,Kazakhstan,Sabah,1,0,1
1/12/2023,Kazakhstan,Sarawak,3,0,3
1/12/2023,Kazakhstan,Selangor,1156,478,678
1/12/2023,Kazakhstan,W.P. Labuan,1,0,1
1/12/2023,Kenya,Johor,96,52,44
1/12/2023,Kenya,Kedah,10,6,4
1/12/2023,Kenya,Pulau Pinang,20,9,11
1/12/2023,Kenya,Selangor,800,406,394
1/12/2023,Kyrgyzstan,Johor,37,27,10
1/12/2023,Kyrgyzstan,Kedah,6,4,2
1/12/2023,Kyrgyzstan,Pulau Pinang,6,2,4
1/12/2023,Kyrgyzstan,Sabah,5,3,2
1/12/2023,Kyrgyzstan,Selangor,311,136,175
1/12/2023,Cambodia,Johor,2487,1059,1428
1/12/2023,Cambodia,Kedah,334,263,71
1/12/2023,Cambodia,Kelantan,423,231,192
1/12/2023,Cambodia,Melaka,1,0,1
1/12/2023,Cambodia,Perak,7,1,6
1/12/2023,Cambodia,Perlis,551,327,224
1/12/2023,Cambodia,Pulau Pinang,36,17,19
1/12/2023,Cambodia,Sabah,3,2,1
1/12/2023,Cambodia,Sarawak,9,3,6
1/12/2023,Cambodia,Selangor,4017,1746,2271
1/12/2023,Kiribati,Johor,1,0,1
1/12/2023,Kiribati,Selangor,7,2,5
1/12/2023,Saint Kitts and Nevis,Johor,18,12,6
1/12/2023,Saint Kitts and Nevis,Kedah,3,2,1
1/12/2023,Saint Kitts and Nevis,Perak,1,0,1
1/12/2023,Saint Kitts and Nevis,Pulau Pinang,2,2,0
1/12/2023,Saint Kitts and Nevis,Sabah,7,3,4
1/12/2023,Saint Kitts and Nevis,Selangor,83,59,24
1/12/2023,"Korea, Republic of",Johor,12417,6647,5770
1/12/2023,"Korea, Republic of",Kedah,371,173,198
1/12/2023,"Korea, Republic of",Kelantan,6,4,2
1/12/2023,"Korea, Republic of",Pahang,3,1,2
1/12/2023,"Korea, Republic of",Perak,32,18,14
1/12/2023,"Korea, Republic of",Perlis,131,77,54
1/12/2023,"Korea, Republic of",Pulau Pinang,567,283,284
1/12/2023,"Korea, Republic of",Sabah,17290,7509,9781
1/12/2023,"Korea, Republic of",Sarawak,319,175,144
1/12/2023,"Korea, Republic of",Selangor,18135,9782,8353
1/12/2023,"Korea, Republic of",W.P. Labuan,10,5,5
1/12/2023,Kuwait,Johor,13,10,3
1/12/2023,Kuwait,Kedah,1,1,0
1/12/2023,Kuwait,Pulau Pinang,3,2,1
1/12/2023,Kuwait,Sarawak,1,1,0
1/12/2023,Kuwait,Selangor,375,226,149
1/12/2023, Lao People's Democratic Republic,Johor,211,73,138
1/12/2023, Lao People's Democratic Republic,Kedah,994,76,918
1/12/2023, Lao People's Democratic Republic,Kelantan,166,8,158
1/12/2023, Lao People's Democratic Republic,Perak,43,7,36
1/12/2023, Lao People's Democratic Republic,Perlis,347,63,284
1/12/2023, Lao People's Democratic Republic,Pulau Pinang,29,3,26
1/12/2023, Lao People's Democratic Republic,Sabah,1,0,1
1/12/2023, Lao People's Democratic Republic,Sarawak,28,9,19
1/12/2023, Lao People's Democratic Republic,Selangor,257,88,169
1/12/2023,Lebanon,Johor,43,25,18
1/12/2023,Lebanon,Kedah,8,4,4
1/12/2023,Lebanon,Pulau Pinang,9,5,4
1/12/2023,Lebanon,Sarawak,6,5,1
1/12/2023,Lebanon,Selangor,424,258,166
1/12/2023,Liberia,Johor,2,2,0
1/12/2023,Liberia,Selangor,9,9,0
1/12/2023,Libya,Johor,5,4,1
1/12/2023,Libya,Pulau Pinang,7,5,2
1/12/2023,Libya,Sarawak,1,1,0
1/12/2023,Libya,Selangor,375,274,101
1/12/2023,Saint Lucia,Johor,5,3,2
1/12/2023,Saint Lucia,Kedah,1,0,1
1/12/2023,Saint Lucia,Sarawak,5,3,2
1/12/2023,Saint Lucia,Selangor,15,12,3
1/12/2023,Liechtenstein,Pulau Pinang,5,4,1
1/12/2023,Liechtenstein,Selangor,3,1,2
1/12/2023,LKA,Johor,1132,660,472
1/12/2023,LKA,Kedah,39,19,20
1/12/2023,LKA,Melaka,1,1,0
1/12/2023,LKA,Perak,10,6,4
1/12/2023,LKA,Perlis,9,6,3
1/12/2023,LKA,Pulau Pinang,75,43,32
1/12/2023,LKA,Sabah,7,4,3
1/12/2023,LKA,Sarawak,53,40,13
1/12/2023,LKA,Selangor,5552,3192,2360
1/12/2023,LKA,W.P. Labuan,3,3,0
1/12/2023,Lesotho,Selangor,4,1,3
1/12/2023,Lithuania,Johor,43,20,23
1/12/2023,Lithuania,Kedah,88,43,45
1/12/2023,Lithuania,Kelantan,1,1,0
1/12/2023,Lithuania,Perlis,7,4,3
1/12/2023,Lithuania,Pulau Pinang,19,9,10
1/12/2023,Lithuania,Sabah,2,1,1
1/12/2023,Lithuania,Sarawak,24,7,17
1/12/2023,Lithuania,Selangor,589,303,286
1/12/2023,Luxembourg,Johor,5,4,1
1/12/2023,Luxembourg,Kedah,9,6,3
1/12/2023,Luxembourg,Pulau Pinang,2,2,0
1/12/2023,Luxembourg,Sabah,1,1,0
1/12/2023,Luxembourg,Selangor,43,24,19
1/12/2023,Latvia,Johor,29,13,16
1/12/2023,Latvia,Kedah,20,9,11
1/12/2023,Latvia,Perak,1,0,1
1/12/2023,Latvia,Perlis,1,1,0
1/12/2023,Latvia,Pulau Pinang,3,1,2
1/12/2023,Latvia,Sabah,2,1,1
1/12/2023,Latvia,Sarawak,10,4,6
1/12/2023,Latvia,Selangor,254,129,125
1/12/2023,Macao,Selangor,25,14,11
1/12/2023,Morocco,Johor,113,70,43
1/12/2023,Morocco,Kedah,10,4,6
1/12/2023,Morocco,Kelantan,3,2,1
1/12/2023,Morocco,Perak,1,0,1
1/12/2023,Morocco,Perlis,4,3,1
1/12/2023,Morocco,Pulau Pinang,10,8,2
1/12/2023,Morocco,Sabah,5,4,1
1/12/2023,Morocco,Sarawak,14,12,2
1/12/2023,Morocco,Selangor,952,486,466
1/12/2023,Monaco,Johor,1,1,0
1/12/2023,Monaco,Selangor,2,2,0
1/12/2023,"Moldova, Republic of",Johor,8,4,4
1/12/2023,"Moldova, Republic of",Pulau Pinang,1,1,0
1/12/2023,"Moldova, Republic of",Selangor,28,18,10
1/12/2023,Madagascar,Johor,16,6,10
1/12/2023,Madagascar,Pulau Pinang,4,1,3
1/12/2023,Madagascar,Selangor,73,37,36
1/12/2023,Maldives,Johor,299,138,161
1/12/2023,Maldives,Kedah,4,4,0
1/12/2023,Maldives,Pulau Pinang,1,1,0
1/12/2023,Maldives,Sabah,8,4,4
1/12/2023,Maldives,Sarawak,4,4,0
1/12/2023,Maldives,Selangor,4511,2194,2317
1/12/2023,Mexico,Johor,174,76,98
1/12/2023,Mexico,Kedah,103,49,54
1/12/2023,Mexico,Kelantan,1,0,1
1/12/2023,Mexico,Pahang,1,1,0
1/12/2023,Mexico,Perak,6,4,2
1/12/2023,Mexico,Perlis,3,2,1
1/12/2023,Mexico,Pulau Pinang,24,16,8
1/12/2023,Mexico,Sabah,3,1,2
1/12/2023,Mexico,Sarawak,3,2,1
1/12/2023,Mexico,Selangor,836,419,417
1/12/2023,Marshall Islands,Sarawak,1,1,0
1/12/2023,Marshall Islands,Selangor,2,1,1
1/12/2023,North Macedonia,Johor,10,4,6
1/12/2023,North Macedonia,Kedah,3,2,1
1/12/2023,North Macedonia,Pulau Pinang,1,0,1
1/12/2023,North Macedonia,Sarawak,2,1,1
1/12/2023,North Macedonia,Selangor,50,26,24
1/12/2023,Mali,Selangor,13,12,1
1/12/2023,Malta,Johor,11,6,5
1/12/2023,Malta,Kedah,12,8,4
1/12/2023,Malta,Selangor,61,32,29
1/12/2023,Myanmar,Johor,8500,2412,6088
1/12/2023,Myanmar,Kedah,91,20,71
1/12/2023,Myanmar,Kelantan,3,3,0
1/12/2023,Myanmar,Pahang,3,1,2
1/12/2023,Myanmar,Perak,40,7,33
1/12/2023,Myanmar,Perlis,5,1,4
1/12/2023,Myanmar,Pulau Pinang,551,243,308
1/12/2023,Myanmar,Sabah,28,11,17
1/12/2023,Myanmar,Sarawak,117,57,60
1/12/2023,Myanmar,Selangor,6539,4251,2288
1/12/2023,Myanmar,W.P. Labuan,1,1,0
1/12/2023,Montenegro,Selangor,26,20,6
1/12/2023,Mongolia,Johor,293,137,156
1/12/2023,Mongolia,Kedah,22,11,11
1/12/2023,Mongolia,Perlis,6,3,3
1/12/2023,Mongolia,Pulau Pinang,13,5,8
1/12/2023,Mongolia,Sabah,17,5,12
1/12/2023,Mongolia,Selangor,622,273,349
1/12/2023,Mozambique,Selangor,41,22,19
1/12/2023,Mauritania,Selangor,30,22,8
1/12/2023,Mauritius,Johor,443,221,222
1/12/2023,Mauritius,Kedah,5,3,2
1/12/2023,Mauritius,Pahang,1,1,0
1/12/2023,Mauritius,Pulau Pinang,11,6,5
1/12/2023,Mauritius,Sabah,2,1,1
1/12/2023,Mauritius,Selangor,2884,1374,1510
1/12/2023,Malawi,Sabah,1,0,1
1/12/2023,Malawi,Selangor,37,21,16
1/12/2023,Namibia,Johor,4,1,3
1/12/2023,Namibia,Kedah,1,1,0
1/12/2023,Namibia,Sabah,1,0,1
1/12/2023,Namibia,Selangor,25,14,11
1/12/2023,Niger,Selangor,1,1,0
1/12/2023,Nigeria,Johor,28,25,3
1/12/2023,Nigeria,Pulau Pinang,5,3,2
1/12/2023,Nigeria,Sabah,1,1,0
1/12/2023,Nigeria,Sarawak,22,17,5
1/12/2023,Nigeria,Selangor,346,261,85
1/12/2023,Nicaragua,Johor,5,3,2
1/12/2023,Nicaragua,Selangor,4,2,2
1/12/2023,Netherlands,Johor,861,546,315
1/12/2023,Netherlands,Kedah,397,201,196
1/12/2023,Netherlands,Melaka,1,1,0
1/12/2023,Netherlands,Pahang,11,5,6
1/12/2023,Netherlands,Perak,13,9,4
1/12/2023,Netherlands,Perlis,29,19,10
1/12/2023,Netherlands,Pulau Pinang,268,157,111
1/12/2023,Netherlands,Sabah,74,45,29
1/12/2023,Netherlands,Sarawak,114,67,47
1/12/2023,Netherlands,Selangor,4556,2656,1900
1/12/2023,Netherlands,W.P. Labuan,4,2,2
1/12/2023,Norway,Johor,135,75,60
1/12/2023,Norway,Kedah,124,58,66
1/12/2023,Norway,Kelantan,3,3,0
1/12/2023,Norway,Perlis,5,2,3
1/12/2023,Norway,Pulau Pinang,42,24,18
1/12/2023,Norway,Sabah,7,3,4
1/12/2023,Norway,Sarawak,14,11,3
1/12/2023,Norway,Selangor,946,514,432
1/12/2023,Nepal,Johor,759,621,138
1/12/2023,Nepal,Kedah,4,2,2
1/12/2023,Nepal,Perak,1,1,0
1/12/2023,Nepal,Pulau Pinang,20,15,5
1/12/2023,Nepal,Sabah,9,8,1
1/12/2023,Nepal,Sarawak,496,347,149
1/12/2023,Nepal,Selangor,10982,10428,554
1/12/2023,Nepal,W.P. Labuan,71,65,6
1/12/2023,Nauru,Selangor,2,2,0
1/12/2023,New Zealand,Johor,1101,615,486
1/12/2023,New Zealand,Kedah,200,115,85
1/12/2023,New Zealand,Kelantan,1,1,0
1/12/2023,New Zealand,Melaka,2,1,1
1/12/2023,New Zealand,Pahang,4,3,1
1/12/2023,New Zealand,Perak,37,16,21
1/12/2023,New Zealand,Perlis,20,17,3
1/12/2023,New Zealand,Pulau Pinang,364,194,170
1/12/2023,New Zealand,Sabah,118,64,54
1/12/2023,New Zealand,Sarawak,216,125,91
1/12/2023,New Zealand,Selangor,4693,2618,2075
1/12/2023,New Zealand,W.P. Labuan,1,0,1
1/12/2023,Oman,Johor,41,20,21
1/12/2023,Oman,Kedah,7,5,2
1/12/2023,Oman,Pulau Pinang,3,2,1
1/12/2023,Oman,Sabah,4,0,4
1/12/2023,Oman,Sarawak,8,4,4
1/12/2023,Oman,Selangor,1852,1094,758
1/12/2023,Oman,W.P. Labuan,1,1,0
1/12/2023,Pakistan,Johor,695,480,215
1/12/2023,Pakistan,Kedah,69,58,11
1/12/2023,Pakistan,Kelantan,16,16,0
1/12/2023,Pakistan,Melaka,1,1,0
1/12/2023,Pakistan,Perak,14,14,0
1/12/2023,Pakistan,Perlis,18,18,0
1/12/2023,Pakistan,Pulau Pinang,95,86,9
1/12/2023,Pakistan,Sabah,24,21,3
1/12/2023,Pakistan,Sarawak,215,168,47
1/12/2023,Pakistan,Selangor,11072,8723,2349
1/12/2023,Pakistan,W.P. Labuan,7,4,3
1/12/2023,Panama,Johor,1,1,0
1/12/2023,Panama,Selangor,22,10,12
1/12/2023,Peru,Johor,23,13,10
1/12/2023,Peru,Kedah,21,8,13
1/12/2023,Peru,Perlis,1,0,1
1/12/2023,Peru,Pulau Pinang,3,3,0
1/12/2023,Peru,Sabah,6,4,2
1/12/2023,Peru,Selangor,161,75,86
1/12/2023,Philippines,Johor,27937,8557,19380
1/12/2023,Philippines,Kedah,586,193,393
1/12/2023,Philippines,Kelantan,20,7,13
1/12/2023,Philippines,Negeri Sembilan,1,1,0
1/12/2023,Philippines,Pahang,10,1,9
1/12/2023,Philippines,Perak,78,18,60
1/12/2023,Philippines,Perlis,248,72,176
1/12/2023,Philippines,Pulau Pinang,818,320,498
1/12/2023,Philippines,Sabah,1733,712,1021
1/12/2023,Philippines,Sarawak,4368,1836,2532
1/12/2023,Philippines,Selangor,19207,7604,11603
1/12/2023,Philippines,Terengganu,1,1,0
1/12/2023,Philippines,W.P. Labuan,139,52,87
1/12/2023,Papua New Guinea,Johor,31,15,16
1/12/2023,Papua New Guinea,Perak,2,1,1
1/12/2023,Papua New Guinea,Pulau Pinang,2,2,0
1/12/2023,Papua New Guinea,Sarawak,2,0,2
1/12/2023,Papua New Guinea,Selangor,39,22,17
1/12/2023,Poland,Johor,365,196,169
1/12/2023,Poland,Kedah,197,102,95
1/12/2023,Poland,Kelantan,1,1,0
1/12/2023,Poland,Pahang,7,3,4
1/12/2023,Poland,Perlis,18,10,8
1/12/2023,Poland,Pulau Pinang,65,42,23
1/12/2023,Poland,Sabah,41,21,20
1/12/2023,Poland,Sarawak,24,15,9
1/12/2023,Poland,Selangor,1705,883,822
1/12/2023,Poland,W.P. Labuan,1,1,0
1/12/2023,Portugal,Johor,162,91,71
1/12/2023,Portugal,Kedah,83,47,36
1/12/2023,Portugal,Perak,1,1,0
1/12/2023,Portugal,Perlis,8,6,2
1/12/2023,Portugal,Pulau Pinang,54,25,29
1/12/2023,Portugal,Sabah,23,9,14
1/12/2023,Portugal,Sarawak,13,7,6
1/12/2023,Portugal,Selangor,848,484,364
1/12/2023,Paraguay,Johor,10,4,6
1/12/2023,Paraguay,Selangor,19,15,4
1/12/2023,"Palestine, State of",Johor,15,14,1
1/12/2023,"Palestine, State of",Pulau Pinang,1,1,0
1/12/2023,"Palestine, State of",Sabah,2,2,0
1/12/2023,"Palestine, State of",Sarawak,3,2,1
1/12/2023,"Palestine, State of",Selangor,287,205,82
1/12/2023,Qatar,Johor,9,6,3
1/12/2023,Qatar,Perlis,1,1,0
1/12/2023,Qatar,Pulau Pinang,10,7,3
1/12/2023,Qatar,Sarawak,2,2,0
1/12/2023,Qatar,Selangor,164,96,68
1/12/2023,Romania,Johor,136,76,60
1/12/2023,Romania,Kedah,166,75,91
1/12/2023,Romania,Perak,1,1,0
1/12/2023,Romania,Perlis,1,0,1
1/12/2023,Romania,Pulau Pinang,28,16,12
1/12/2023,Romania,Sabah,8,5,3
1/12/2023,Romania,Sarawak,10,6,4
1/12/2023,Romania,Selangor,1517,761,756
1/12/2023,Romania,W.P. Labuan,2,1,1
1/12/2023,Russian Federation (Russia),Johor,537,255,282
1/12/2023,Russian Federation (Russia),Kedah,444,206,238
1/12/2023,Russian Federation (Russia),Kelantan,12,7,5
1/12/2023,Russian Federation (Russia),Melaka,1,1,0
1/12/2023,Russian Federation (Russia),Perak,8,4,4
1/12/2023,Russian Federation (Russia),Perlis,39,26,13
1/12/2023,Russian Federation (Russia),Pulau Pinang,190,96,94
1/12/2023,Russian Federation (Russia),Sabah,69,34,35
1/12/2023,Russian Federation (Russia),Sarawak,72,43,29
1/12/2023,Russian Federation (Russia),Selangor,9263,4486,4777
1/12/2023,Russian Federation (Russia),W.P. Labuan,11,6,5
1/12/2023,Rwanda,Kedah,1,0,1
1/12/2023,Rwanda,Selangor,5,1,4
1/12/2023,Saudi Arabia,Johor,180,100,80
1/12/2023,Saudi Arabia,Kedah,33,25,8
1/12/2023,Saudi Arabia,Kelantan,1,1,0
1/12/2023,Saudi Arabia,Pulau Pinang,29,13,16
1/12/2023,Saudi Arabia,Sarawak,30,16,14
1/12/2023,Saudi Arabia,Selangor,3297,1938,1359
1/12/2023,Sudan,Johor,25,13,12
1/12/2023,Sudan,Kelantan,3,2,1
1/12/2023,Sudan,Perlis,1,1,0
1/12/2023,Sudan,Pulau Pinang,6,4,2
1/12/2023,Sudan,Sabah,2,2,0
1/12/2023,Sudan,Sarawak,13,8,5
1/12/2023,Sudan,Selangor,1318,723,595
1/12/2023,Senegal,Johor,10,5,5
1/12/2023,Senegal,Selangor,41,29,12
1/12/2023,Singapore,Johor,1414194,776492,637702
1/12/2023,Singapore,Kedah,10509,5328,5181
1/12/2023,Singapore,Kelantan,87,54,33
1/12/2023,Singapore,Melaka,51,40,11
1/12/2023,Singapore,Negeri Sembilan,3,2,1
1/12/2023,Singapore,Pahang,943,459,484
1/12/2023,Singapore,Perak,8880,4055,4825
1/12/2023,Singapore,Perlis,698,382,316
1/12/2023,Singapore,Pulau Pinang,33751,16522,17229
1/12/2023,Singapore,Sabah,4733,2311,2422
1/12/2023,Singapore,Sarawak,6550,3388,3162
1/12/2023,Singapore,Selangor,75052,37116,37936
1/12/2023,Singapore,W.P. Labuan,25,18,7
1/12/2023,Solomon Islands,Johor,1,1,0
1/12/2023,Solomon Islands,Sabah,3,2,1
1/12/2023,Solomon Islands,Sarawak,5,1,4
1/12/2023,Solomon Islands,Selangor,2,2,0
1/12/2023,Sierra Leone,Johor,11,9,2
1/12/2023,Sierra Leone,Perlis,1,1,0
1/12/2023,Sierra Leone,Selangor,20,12,8
1/12/2023,El Salvador,Pulau Pinang,3,2,1
1/12/2023,El Salvador,Selangor,12,6,6
1/12/2023,San Marino,Kedah,2,0,2
1/12/2023,San Marino,Selangor,2,0,2
1/12/2023,Somalia,Selangor,202,123,79
1/12/2023,Serbia,Johor,15,11,4
1/12/2023,Serbia,Kedah,9,4,5
1/12/2023,Serbia,Pulau Pinang,7,4,3
1/12/2023,Serbia,Sabah,4,2,2
1/12/2023,Serbia,Sarawak,1,1,0
1/12/2023,Serbia,Selangor,108,54,54
1/12/2023,South Sudan,Johor,1,0,1
1/12/2023,South Sudan,Sarawak,1,1,0
1/12/2023,South Sudan,Selangor,33,17,16
1/12/2023,Sao Tome and Principe,Selangor,3,1,2
1/12/2023,Suriname,Johor,4,2,2
1/12/2023,Suriname,Selangor,15,8,7
1/12/2023,Slovakia,Johor,41,23,18
1/12/2023,Slovakia,Kedah,65,35,30
1/12/2023,Slovakia,Perlis,5,4,1
1/12/2023,Slovakia,Pulau Pinang,9,5,4
1/12/2023,Slovakia,Sabah,6,4,2
1/12/2023,Slovakia,Selangor,411,222,189
1/12/2023,Slovenia,Johor,24,13,11
1/12/2023,Slovenia,Kedah,18,9,9
1/12/2023,Slovenia,Pulau Pinang,2,2,0
1/12/2023,Slovenia,Sabah,2,2,0
1/12/2023,Slovenia,Sarawak,1,0,1
1/12/2023,Slovenia,Selangor,208,118,90
1/12/2023,Sweden,Johor,240,144,96
1/12/2023,Sweden,Kedah,295,154,141
1/12/2023,Sweden,Kelantan,2,2,0
1/12/2023,Sweden,Perak,4,2,2
1/12/2023,Sweden,Perlis,20,14,6
1/12/2023,Sweden,Pulau Pinang,121,75,46
1/12/2023,Sweden,Sabah,24,16,8
1/12/2023,Sweden,Sarawak,15,12,3
1/12/2023,Sweden,Selangor,2055,1153,902
1/12/2023,Eswatini,Johor,4,4,0
1/12/2023,Eswatini,Selangor,21,9,12
1/12/2023,Seychelles,Johor,34,14,20
1/12/2023,Seychelles,Kedah,2,1,1
1/12/2023,Seychelles,Sarawak,1,0,1
1/12/2023,Seychelles,Selangor,207,86,121
1/12/2023,Syrian Arab Republic,Johor,24,18,6
1/12/2023,Syrian Arab Republic,Kedah,2,2,0
1/12/2023,Syrian Arab Republic,Kelantan,2,2,0
1/12/2023,Syrian Arab Republic,Melaka,1,1,0
1/12/2023,Syrian Arab Republic,Pahang,1,1,0
1/12/2023,Syrian Arab Republic,Perlis,1,1,0
1/12/2023,Syrian Arab Republic,Pulau Pinang,2,1,1
1/12/2023,Syrian Arab Republic,Sarawak,7,6,1
1/12/2023,Syrian Arab Republic,Selangor,749,462,287
1/12/2023,Turks and Caicos Islands,Selangor,1,0,1
1/12/2023,TCD,Johor,5,5,0
1/12/2023,TCD,Selangor,24,21,3
1/12/2023,Togo,Johor,3,1,2
1/12/2023,Togo,Selangor,13,11,2
1/12/2023,Thailand,Johor,8857,2797,6060
1/12/2023,Thailand,Kedah,67463,40200,27263
1/12/2023,Thailand,Kelantan,41287,21144,20143
1/12/2023,Thailand,Melaka,2,1,1
1/12/2023,Thailand,Pahang,11,5,6
1/12/2023,Thailand,Perak,11252,5080,6172
1/12/2023,Thailand,Perlis,49380,28480,20900
1/12/2023,Thailand,Pulau Pinang,2619,989,1630
1/12/2023,Thailand,Sabah,26,7,19
1/12/2023,Thailand,Sarawak,478,188,290
1/12/2023,Thailand,Selangor,14102,5309,8793
1/12/2023,Thailand,W.P. Labuan,8,4,4
1/12/2023,Tajikistan,Johor,6,6,0
1/12/2023,Tajikistan,Kelantan,1,1,0
1/12/2023,Tajikistan,Perlis,2,1,1
1/12/2023,Tajikistan,Sabah,1,0,1
1/12/2023,Tajikistan,Selangor,203,145,58
1/12/2023,Turkmenistan,Johor,3,2,1
1/12/2023,Turkmenistan,Perlis,1,1,0
1/12/2023,Turkmenistan,Sarawak,2,2,0
1/12/2023,Turkmenistan,Selangor,117,81,36
1/12/2023,Timor-Leste,Johor,9,4,5
1/12/2023,Timor-Leste,Kedah,5,1,4
1/12/2023,Timor-Leste,Sarawak,3,3,0
1/12/2023,Timor-Leste,Selangor,305,167,138
1/12/2023,Tonga,Pulau Pinang,2,2,0
1/12/2023,Tonga,Selangor,17,7,10
1/12/2023,Trinidad and Tobago,Johor,4,2,2
1/12/2023,Trinidad and Tobago,Kedah,1,0,1
1/12/2023,Trinidad and Tobago,Sarawak,2,0,2
1/12/2023,Trinidad and Tobago,Selangor,32,18,14
1/12/2023,Tunisia,Johor,9,4,5
1/12/2023,Tunisia,Kedah,7,2,5
1/12/2023,Tunisia,Perlis,2,2,0
1/12/2023,Tunisia,Pulau Pinang,16,11,5
1/12/2023,Tunisia,Sabah,2,1,1
1/12/2023,Tunisia,Selangor,837,429,408
1/12/2023,Türkiye,Johor,254,192,62
1/12/2023,Türkiye,Kedah,69,42,27
1/12/2023,Türkiye,Kelantan,2,2,0
1/12/2023,Türkiye,Pahang,1,1,0
1/12/2023,Türkiye,Perak,1,1,0
1/12/2023,Türkiye,Perlis,17,15,2
1/12/2023,Türkiye,Pulau Pinang,57,34,23
1/12/2023,Türkiye,Sabah,3,3,0
1/12/2023,Türkiye,Sarawak,31,22,9
1/12/2023,Türkiye,Selangor,1614,1082,532
1/12/2023,"Taiwan, Province of China",Johor,5075,2193,2882
1/12/2023,"Taiwan, Province of China",Kedah,145,74,71
1/12/2023,"Taiwan, Province of China",Kelantan,2,1,1
1/12/2023,"Taiwan, Province of China",Pahang,3,2,1
1/12/2023,"Taiwan, Province of China",Perak,53,32,21
1/12/2023,"Taiwan, Province of China",Perlis,22,10,12
1/12/2023,"Taiwan, Province of China",Pulau Pinang,3595,1795,1800
1/12/2023,"Taiwan, Province of China",Sabah,1012,480,532
1/12/2023,"Taiwan, Province of China",Sarawak,327,155,172
1/12/2023,"Taiwan, Province of China",Selangor,10872,5373,5499
1/12/2023,"Taiwan, Province of China",W.P. Labuan,6,2,4
1/12/2023,"Tanzania, United Republic of",Johor,44,19,25
1/12/2023,"Tanzania, United Republic of",Kedah,4,0,4
1/12/2023,"Tanzania, United Republic of",Pulau Pinang,1,1,0
1/12/2023,"Tanzania, United Republic of",Selangor,384,190,194
1/12/2023,"Tanzania, United Republic of",W.P. Labuan,1,1,0
1/12/2023,Uganda,Johor,32,15,17
1/12/2023,Uganda,Kedah,1,0,1
1/12/2023,Uganda,Sarawak,2,2,0
1/12/2023,Uganda,Selangor,202,100,102
1/12/2023,Ukraine,Johor,122,59,63
1/12/2023,Ukraine,Kedah,41,17,24
1/12/2023,Ukraine,Kelantan,2,1,1
1/12/2023,Ukraine,Perlis,3,1,2
1/12/2023,Ukraine,Pulau Pinang,26,12,14
1/12/2023,Ukraine,Sabah,7,5,2
1/12/2023,Ukraine,Sarawak,6,3,3
1/12/2023,Ukraine,Selangor,1188,568,620
1/12/2023,Uruguay,Johor,2,0,2
1/12/2023,Uruguay,Perlis,1,1,0
1/12/2023,Uruguay,Pulau Pinang,2,2,0
1/12/2023,Uruguay,Selangor,46,25,21
1/12/2023,United States of America,Johor,4742,2712,2030
1/12/2023,United States of America,Kedah,1579,787,792
1/12/2023,United States of America,Kelantan,12,8,4
1/12/2023,United States of America,Melaka,1,1,0
1/12/2023,United States of America,Pahang,8,6,2
1/12/2023,United States of America,Perak,142,78,64
1/12/2023,United States of America,Perlis,110,72,38
1/12/2023,United States of America,Pulau Pinang,2548,1342,1206
1/12/2023,United States of America,Sabah,470,268,202
1/12/2023,United States of America,Sarawak,327,205,122
1/12/2023,United States of America,Selangor,21722,11794,9928
1/12/2023,United States of America,W.P. Labuan,9,8,1
1/12/2023,Uzbekistan,Johor,137,92,45
1/12/2023,Uzbekistan,Kedah,28,17,11
1/12/2023,Uzbekistan,Kelantan,4,2,2
1/12/2023,Uzbekistan,Pulau Pinang,9,5,4
1/12/2023,Uzbekistan,Sabah,7,4,3
1/12/2023,Uzbekistan,Sarawak,1,0,1
1/12/2023,Uzbekistan,Selangor,1682,979,703
1/12/2023,Holy See,Pulau Pinang,1,1,0
1/12/2023,Holy See,Sarawak,1,1,0
1/12/2023,Saint Vincent and the Grenadines,Selangor,3,2,1
1/12/2023,"Venezuela, Bolivarian Republic of",Johor,23,14,9
1/12/2023,"Venezuela, Bolivarian Republic of",Kedah,2,1,1
1/12/2023,"Venezuela, Bolivarian Republic of",Pulau Pinang,1,0,1
1/12/2023,"Venezuela, Bolivarian Republic of",Sabah,2,1,1
1/12/2023,"Venezuela, Bolivarian Republic of",Sarawak,1,0,1
1/12/2023,"Venezuela, Bolivarian Republic of",Selangor,86,40,46
1/12/2023,Viet Nam,Johor,11258,3169,8089
1/12/2023,Viet Nam,Kedah,347,46,301
1/12/2023,Viet Nam,Kelantan,9,3,6
1/12/2023,Viet Nam,Pahang,9,8,1
1/12/2023,Viet Nam,Perak,238,20,218
1/12/2023,Viet Nam,Perlis,186,15,171
1/12/2023,Viet Nam,Pulau Pinang,848,214,634
1/12/2023,Viet Nam,Sabah,30,9,21
1/12/2023,Viet Nam,Sarawak,375,60,315
1/12/2023,Viet Nam,Selangor,11849,3991,7858
1/12/2023,Viet Nam,W.P. Labuan,3,3,0
1/12/2023,Vanuatu,Johor,49,33,16
1/12/2023,Vanuatu,Pulau Pinang,4,4,0
1/12/2023,Vanuatu,Sabah,1,1,0
1/12/2023,Vanuatu,Selangor,111,82,29
1/12/2023, Samoa,Johor,1,0,1
1/12/2023, Samoa,Selangor,4,2,2
1/12/2023,Yemen,Johor,30,21,9
1/12/2023,Yemen,Kedah,9,9,0
1/12/2023,Yemen,Kelantan,1,1,0
1/12/2023,Yemen,Melaka,4,2,2
1/12/2023,Yemen,Perlis,3,3,0
1/12/2023,Yemen,Pulau Pinang,7,4,3
1/12/2023,Yemen,Sarawak,4,2,2
1/12/2023,Yemen,Selangor,1283,869,414
1/12/2023,South Africa,Johor,402,229,173
1/12/2023,South Africa,Kedah,123,68,55
1/12/2023,South Africa,Kelantan,1,0,1
1/12/2023,South Africa,Pahang,5,3,2
1/12/2023,South Africa,Perak,3,3,0
1/12/2023,South Africa,Perlis,14,6,8
1/12/2023,South Africa,Pulau Pinang,111,53,58
1/12/2023,South Africa,Sabah,35,16,19
1/12/2023,South Africa,Sarawak,203,98,105
1/12/2023,South Africa,Selangor,2743,1358,1385
1/12/2023,South Africa,W.P. Labuan,8,2,6
1/12/2023,ZAR,Selangor,3,1,2
1/12/2023,Zambia,Johor,18,9,9
1/12/2023,Zambia,Selangor,161,74,87
1/12/2023,Zimbabwe,Johor,28,15,13
1/12/2023,Zimbabwe,Kedah,1,0,1
1/12/2023,Zimbabwe,Pulau Pinang,7,3,4
1/12/2023,Zimbabwe,Sabah,1,1,0
1/12/2023,Zimbabwe,Selangor,274,132,142
1/01/2024,Afghanistan,Selangor,74,62,12
1/01/2024,Angola,Johor,1,1,0
1/01/2024,Angola,Selangor,9,6,3
1/01/2024,Albania,Johor,18,15,3
1/01/2024,Albania,Kedah,7,4,3
1/01/2024,Albania,Pulau Pinang,3,1,2
1/01/2024,Albania,Sabah,2,1,1
1/01/2024,Albania,Selangor,43,26,17
1/01/2024,Andorra,Selangor,1,1,0
1/01/2024,Antigua and Barbuda,Selangor,1,0,1
1/01/2024,United Arab Emirates,Johor,7,3,4
1/01/2024,United Arab Emirates,Pulau Pinang,1,1,0
1/01/2024,United Arab Emirates,Selangor,358,240,118
1/01/2024,Argentina,Johor,116,59,57
1/01/2024,Argentina,Kedah,209,93,116
1/01/2024,Argentina,Kelantan,1,0,1
1/01/2024,Argentina,Perlis,7,6,1
1/01/2024,Argentina,Pulau Pinang,13,3,10
1/01/2024,Argentina,Sabah,8,4,4
1/01/2024,Argentina,Sarawak,2,2,0
1/01/2024,Argentina,Selangor,855,419,436
1/01/2024,Armenia,Johor,3,3,0
1/01/2024,Armenia,Kedah,2,0,2
1/01/2024,Armenia,Pulau Pinang,1,1,0
1/01/2024,Armenia,Sabah,3,3,0
1/01/2024,Armenia,Selangor,110,50,60
1/01/2024,Antigua and Barbuda,Johor,2,2,0
1/01/2024,Antigua and Barbuda,Kedah,3,0,3
1/01/2024,Antigua and Barbuda,Selangor,13,8,5
1/01/2024,Australia,Johor,5856,3319,2537
1/01/2024,Australia,Kedah,1431,742,689
1/01/2024,Australia,Kelantan,7,4,3
1/01/2024,Australia,Melaka,3,2,1
1/01/2024,Australia,Pahang,55,32,23
1/01/2024,Australia,Perak,280,142,138
1/01/2024,Australia,Perlis,112,72,40
1/01/2024,Australia,Pulau Pinang,2575,1317,1258
1/01/2024,Australia,Sabah,473,242,231
1/01/2024,Australia,Sarawak,884,476,408
1/01/2024,Australia,Selangor,38688,21461,17227
1/01/2024,Australia,Terengganu,1,1,0
1/01/2024,Australia,W.P. Labuan,9,5,4
1/01/2024,Austria,Johor,205,131,74
1/01/2024,Austria,Kedah,190,100,90
1/01/2024,Austria,Kelantan,2,2,0
1/01/2024,Austria,Perak,1,0,1
1/01/2024,Austria,Perlis,25,15,10
1/01/2024,Austria,Pulau Pinang,94,67,27
1/01/2024,Austria,Sabah,14,6,8
1/01/2024,Austria,Sarawak,14,8,6
1/01/2024,Austria,Selangor,1104,688,416
1/01/2024,Azerbaijan,Johor,8,7,1
1/01/2024,Azerbaijan,Kedah,5,2,3
1/01/2024,Azerbaijan,Pulau Pinang,2,1,1
1/01/2024,Azerbaijan,Sabah,1,1,0
1/01/2024,Azerbaijan,Selangor,188,107,81
1/01/2024,Burundi,Sarawak,2,1,1
1/01/2024,Burundi,Selangor,8,8,0
1/01/2024,Belgium,Johor,192,120,72
1/01/2024,Belgium,Kedah,166,94,72
1/01/2024,Belgium,Kelantan,2,2,0
1/01/2024,Belgium,Melaka,2,2,0
1/01/2024,Belgium,Pahang,1,0,1
1/01/2024,Belgium,Perak,4,2,2
1/01/2024,Belgium,Perlis,18,11,7
1/01/2024,Belgium,Pulau Pinang,88,56,32
1/01/2024,Belgium,Sabah,19,10,9
1/01/2024,Belgium,Sarawak,21,11,10
1/01/2024,Belgium,Selangor,1547,894,653
1/01/2024,Benin,Johor,2,2,0
1/01/2024,Benin,Sarawak,1,0,1
1/01/2024,Benin,Selangor,12,10,2
1/01/2024,Burkina Faso,Selangor,9,8,1
1/01/2024,Bangladesh,Johor,2202,1729,473
1/01/2024,Bangladesh,Kedah,129,71,58
1/01/2024,Bangladesh,Kelantan,1,1,0
1/01/2024,Bangladesh,Perak,3,3,0
1/01/2024,Bangladesh,Pulau Pinang,234,208,26
1/01/2024,Bangladesh,Sabah,9,8,1
1/01/2024,Bangladesh,Sarawak,67,51,16
1/01/2024,Bangladesh,Selangor,38752,35941,2811
1/01/2024,Bangladesh,W.P. Labuan,15,14,1
1/01/2024,Bulgaria,Johor,61,36,25
1/01/2024,Bulgaria,Kedah,63,30,33
1/01/2024,Bulgaria,Perak,1,1,0
1/01/2024,Bulgaria,Perlis,1,1,0
1/01/2024,Bulgaria,Pulau Pinang,32,17,15
1/01/2024,Bulgaria,Sabah,4,3,1
1/01/2024,Bulgaria,Sarawak,1,1,0
1/01/2024,Bulgaria,Selangor,515,270,245
1/01/2024,Bahrain,Kedah,8,5,3
1/01/2024,Bahrain,Pulau Pinang,1,1,0
1/01/2024,Bahrain,Selangor,256,134,122
1/01/2024,Bahamas,Selangor,8,4,4
1/01/2024,Bosnia and Herzegovina,Johor,21,9,12
1/01/2024,Bosnia and Herzegovina,Perlis,1,1,0
1/01/2024,Bosnia and Herzegovina,Pulau Pinang,2,2,0
1/01/2024,Bosnia and Herzegovina,Sabah,2,2,0
1/01/2024,Bosnia and Herzegovina,Selangor,116,69,47
1/01/2024,Belarus,Johor,11,4,7
1/01/2024,Belarus,Kedah,21,9,12
1/01/2024,Belarus,Perlis,1,0,1
1/01/2024,Belarus,Pulau Pinang,19,8,11
1/01/2024,Belarus,Sabah,4,2,2
1/01/2024,Belarus,Sarawak,4,3,1
1/01/2024,Belarus,Selangor,570,270,300
1/01/2024,Belize,Johor,3,3,0
1/01/2024,Belize,Pulau Pinang,1,1,0
1/01/2024,Belize,Selangor,9,5,4
1/01/2024,Bolivia,Johor,6,4,2
1/01/2024,Bolivia,Kedah,1,1,0
1/01/2024,Bolivia,Selangor,41,24,17
1/01/2024,Brazil,Johor,208,114,94
1/01/2024,Brazil,Kedah,198,84,114
1/01/2024,Brazil,Kelantan,1,0,1
1/01/2024,Brazil,Perlis,5,4,1
1/01/2024,Brazil,Pulau Pinang,23,10,13
1/01/2024,Brazil,Sabah,5,4,1
1/01/2024,Brazil,Sarawak,8,5,3
1/01/2024,Brazil,Selangor,1467,766,701
1/01/2024,Barbados,Johor,1,0,1
1/01/2024,Barbados,Selangor,6,5,1
1/01/2024,Brunei Darussalam,Johor,390,207,183
1/01/2024,Brunei Darussalam,Kedah,34,13,21
1/01/2024,Brunei Darussalam,Pahang,1,0,1
1/01/2024,Brunei Darussalam,Perak,2,0,2
1/01/2024,Brunei Darussalam,Perlis,61,33,28
1/01/2024,Brunei Darussalam,Pulau Pinang,16,6,10
1/01/2024,Brunei Darussalam,Sabah,1269,555,714
1/01/2024,Brunei Darussalam,Sarawak,118380,65041,53339
1/01/2024,Brunei Darussalam,Selangor,4745,2388,2357
1/01/2024,Brunei Darussalam,W.P. Labuan,906,612,294
1/01/2024,Bhutan,Perak,2,1,1
1/01/2024,Bhutan,Perlis,2,1,1
1/01/2024,Bhutan,Selangor,52,28,24
1/01/2024,Botswana,Johor,2,1,1
1/01/2024,Botswana,Selangor,17,9,8
1/01/2024,Canada,Johor,1512,864,648
1/01/2024,Canada,Kedah,499,272,227
1/01/2024,Canada,Kelantan,4,4,0
1/01/2024,Canada,Melaka,2,1,1
1/01/2024,Canada,Pahang,1,0,1
1/01/2024,Canada,Perak,42,27,15
1/01/2024,Canada,Perlis,81,48,33
1/01/2024,Canada,Pulau Pinang,706,363,343
1/01/2024,Canada,Sabah,175,83,92
1/01/2024,Canada,Sarawak,349,178,171
1/01/2024,Canada,Selangor,6136,3491,2645
1/01/2024,Canada,W.P. Labuan,7,5,2
1/01/2024,Switzerland,Johor,355,201,154
1/01/2024,Switzerland,Kedah,327,168,159
1/01/2024,Switzerland,Kelantan,1,1,0
1/01/2024,Switzerland,Melaka,1,1,0
1/01/2024,Switzerland,Negeri Sembilan,2,1,1
1/01/2024,Switzerland,Pahang,4,2,2
1/01/2024,Switzerland,Perak,6,3,3
1/01/2024,Switzerland,Perlis,41,22,19
1/01/2024,Switzerland,Pulau Pinang,170,115,55
1/01/2024,Switzerland,Sabah,44,26,18
1/01/2024,Switzerland,Sarawak,20,11,9
1/01/2024,Switzerland,Selangor,1824,1104,720
1/01/2024,Chile,Johor,35,16,19
1/01/2024,Chile,Kedah,37,12,25
1/01/2024,Chile,Perlis,4,3,1
1/01/2024,Chile,Pulau Pinang,8,6,2
1/01/2024,Chile,Sabah,4,3,1
1/01/2024,Chile,Sarawak,3,3,0
1/01/2024,Chile,Selangor,439,212,227
1/01/2024,China,Johor,59992,25949,34043
1/01/2024,China,Kedah,2247,998,1249
1/01/2024,China,Kelantan,13,10,3
1/01/2024,China,Melaka,6,5,1
1/01/2024,China,Pahang,62,39,23
1/01/2024,China,Perak,293,145,148
1/01/2024,China,Perlis,393,213,180
1/01/2024,China,Pulau Pinang,11748,5901,5847
1/01/2024,China,Sabah,12533,5464,7069
1/01/2024,China,Sarawak,1576,831,745
1/01/2024,China,Selangor,139974,68413,71561
1/01/2024,China,W.P. Labuan,63,55,8
1/01/2024,Côte d'Ivoire,Johor,1,1,0
1/01/2024,Côte d'Ivoire,Selangor,17,13,4
1/01/2024,Cameroon,Sabah,1,1,0
1/01/2024,Cameroon,Selangor,29,21,8
1/01/2024,Congo,Sarawak,1,1,0
1/01/2024,Congo,Selangor,29,17,12
1/01/2024,Congo,Selangor,4,3,1
1/01/2024,Colombia,Johor,29,12,17
1/01/2024,Colombia,Kedah,1,1,0
1/01/2024,Colombia,Perak,1,1,0
1/01/2024,Colombia,Pulau Pinang,10,2,8
1/01/2024,Colombia,Sabah,1,1,0
1/01/2024,Colombia,Sarawak,2,2,0
1/01/2024,Colombia,Selangor,281,152,129
1/01/2024,Comoros,Selangor,16,10,6
1/01/2024,Cabo Verde,Selangor,1,0,1
1/01/2024,Costa Rica,Johor,30,20,10
1/01/2024,Costa Rica,Kedah,4,2,2
1/01/2024,Costa Rica,Pulau Pinang,18,10,8
1/01/2024,Costa Rica,Selangor,101,46,55
1/01/2024,Cuba,Johor,13,10,3
1/01/2024,Cuba,Pulau Pinang,1,1,0
1/01/2024,Cuba,Sabah,2,0,2
1/01/2024,Cuba,Selangor,28,14,14
1/01/2024,Cyprus,Johor,4,1,3
1/01/2024,Cyprus,Kedah,8,5,3
1/01/2024,Cyprus,Pulau Pinang,2,1,1
1/01/2024,Cyprus,Sabah,2,2,0
1/01/2024,Cyprus,Sarawak,2,0,2
1/01/2024,Cyprus,Selangor,80,48,32
1/01/2024,Czechia,Johor,106,54,52
1/01/2024,Czechia,Kedah,214,109,105
1/01/2024,Czechia,Perlis,18,14,4
1/01/2024,Czechia,Pulau Pinang,40,27,13
1/01/2024,Czechia,Sabah,17,11,6
1/01/2024,Czechia,Sarawak,22,13,9
1/01/2024,Czechia,Selangor,1140,644,496
1/01/2024,Czechia,W.P. Labuan,4,4,0
1/01/2024,Germany,Johor,2027,1247,780
1/01/2024,Germany,Kedah,1533,791,742
1/01/2024,Germany,Kelantan,9,8,1
1/01/2024,Germany,Melaka,4,4,0
1/01/2024,Germany,Negeri Sembilan,4,2,2
1/01/2024,Germany,Pahang,8,5,3
1/01/2024,Germany,Perak,23,17,6
1/01/2024,Germany,Perlis,185,115,70
1/01/2024,Germany,Pulau Pinang,975,674,301
1/01/2024,Germany,Sabah,144,83,61
1/01/2024,Germany,Sarawak,201,129,72
1/01/2024,Germany,Selangor,8986,5517,3469
1/01/2024,Germany,W.P. Labuan,13,4,9
1/01/2024,Djibouti,Selangor,12,7,5
1/01/2024,Dominica,Johor,5,5,0
1/01/2024,Dominica,Kedah,1,1,0
1/01/2024,Dominica,Pulau Pinang,2,1,1
1/01/2024,Dominica,Selangor,57,47,10
1/01/2024,Denmark,Johor,291,209,82
1/01/2024,Denmark,Kedah,382,185,197
1/01/2024,Denmark,Pahang,21,5,16
1/01/2024,Denmark,Perak,13,6,7
1/01/2024,Denmark,Perlis,26,17,9
1/01/2024,Denmark,Pulau Pinang,100,57,43
1/01/2024,Denmark,Sabah,43,25,18
1/01/2024,Denmark,Sarawak,22,13,9
1/01/2024,Denmark,Selangor,1921,1033,888
1/01/2024,Denmark,W.P. Labuan,2,1,1
1/01/2024,Dominican Republic,Johor,1,0,1
1/01/2024,Dominican Republic,Kedah,1,1,0
1/01/2024,Dominican Republic,Perlis,1,1,0
1/01/2024,Dominican Republic,Selangor,15,8,7
1/01/2024,Algeria,Johor,33,27,6
1/01/2024,Algeria,Kedah,10,8,2
1/01/2024,Algeria,Kelantan,4,4,0
1/01/2024,Algeria,Perlis,5,4,1
1/01/2024,Algeria,Sarawak,7,6,1
1/01/2024,Algeria,Selangor,958,604,354
1/01/2024,Algeria,W.P. Labuan,1,1,0
1/01/2024,Ecuador,Johor,20,12,8
1/01/2024,Ecuador,Kedah,4,2,2
1/01/2024,Ecuador,Pulau Pinang,1,1,0
1/01/2024,Ecuador,Sabah,1,1,0
1/01/2024,Ecuador,Selangor,52,28,24
1/01/2024,Egypt,Johor,181,133,48
1/01/2024,Egypt,Kedah,13,8,5
1/01/2024,Egypt,Perak,1,1,0
1/01/2024,Egypt,Perlis,2,2,0
1/01/2024,Egypt,Pulau Pinang,14,11,3
1/01/2024,Egypt,Sabah,6,2,4
1/01/2024,Egypt,Sarawak,87,62,25
1/01/2024,Egypt,Selangor,2088,1379,709
1/01/2024,Eritrea,Johor,1,1,0
1/01/2024,Eritrea,Selangor,16,9,7
1/01/2024,Spain,Johor,435,243,192
1/01/2024,Spain,Kedah,416,184,232
1/01/2024,Spain,Kelantan,1,1,0
1/01/2024,Spain,Pahang,6,4,2
1/01/2024,Spain,Perak,10,2,8
1/01/2024,Spain,Perlis,35,18,17
1/01/2024,Spain,Pulau Pinang,97,56,41
1/01/2024,Spain,Sabah,35,18,17
1/01/2024,Spain,Sarawak,51,35,16
1/01/2024,Spain,Selangor,2866,1619,1247
1/01/2024,Spain,W.P. Labuan,1,1,0
1/01/2024,Estonia,Johor,54,32,22
1/01/2024,Estonia,Kedah,106,49,57
1/01/2024,Estonia,Kelantan,3,1,2
1/01/2024,Estonia,Perlis,2,1,1
1/01/2024,Estonia,Pulau Pinang,20,10,10
1/01/2024,Estonia,Sabah,1,0,1
1/01/2024,Estonia,Sarawak,1,0,1
1/01/2024,Estonia,Selangor,440,209,231
1/01/2024,Ethiopia,Johor,1,0,1
1/01/2024,Ethiopia,Sarawak,2,1,1
1/01/2024,Ethiopia,Selangor,67,38,29
1/01/2024,Finland,Johor,267,142,125
1/01/2024,Finland,Kedah,334,167,167
1/01/2024,Finland,Perak,2,1,1
1/01/2024,Finland,Perlis,11,9,2
1/01/2024,Finland,Pulau Pinang,92,60,32
1/01/2024,Finland,Sabah,27,12,15
1/01/2024,Finland,Sarawak,14,5,9
1/01/2024,Finland,Selangor,1139,645,494
1/01/2024,Fiji,Johor,125,60,65
1/01/2024,Fiji,Perlis,1,0,1
1/01/2024,Fiji,Pulau Pinang,7,2,5
1/01/2024,Fiji,Selangor,196,98,98
1/01/2024,France,Johor,1497,964,533
1/01/2024,France,Kedah,1125,586,539
1/01/2024,France,Kelantan,16,10,6
1/01/2024,France,Melaka,3,2,1
1/01/2024,France,Negeri Sembilan,1,0,1
1/01/2024,France,Pahang,10,6,4
1/01/2024,France,Perak,31,19,12
1/01/2024,France,Perlis,132,85,47
1/01/2024,France,Pulau Pinang,479,309,170
1/01/2024,France,Sabah,93,59,34
1/01/2024,France,Sarawak,86,56,30
1/01/2024,France,Selangor,10580,6168,4412
1/01/2024,France,W.P. Labuan,2,2,0
1/01/2024,"Micronesia, Federated States of",Selangor,2,2,0
1/01/2024,Gabon,Johor,1,1,0
1/01/2024,Gabon,Selangor,10,5,5
1/01/2024,United Kingdom of Great Britain and Northern Ireland,Johor,4074,2603,1471
1/01/2024,United Kingdom of Great Britain and Northern Ireland,Kedah,5649,2811,2838
1/01/2024,United Kingdom of Great Britain and Northern Ireland,Kelantan,14,11,3
1/01/2024,United Kingdom of Great Britain and Northern Ireland,Melaka,4,2,2
1/01/2024,United Kingdom of Great Britain and Northern Ireland,Pahang,10,9,1
1/01/2024,United Kingdom of Great Britain and Northern Ireland,Perak,113,72,41
1/01/2024,United Kingdom of Great Britain and Northern Ireland,Perlis,249,166,83
1/01/2024,United Kingdom of Great Britain and Northern Ireland,Pulau Pinang,1979,1191,788
1/01/2024,United Kingdom of Great Britain and Northern Ireland,Sabah,430,243,187
1/01/2024,United Kingdom of Great Britain and Northern Ireland,Sarawak,841,537,304
1/01/2024,United Kingdom of Great Britain and Northern Ireland,Selangor,22403,13391,9012
1/01/2024,United Kingdom of Great Britain and Northern Ireland,W.P. Labuan,26,22,4
1/01/2024,Georgia,Johor,8,7,1
1/01/2024,Georgia,Kedah,4,0,4
1/01/2024,Georgia,Pulau Pinang,6,6,0
1/01/2024,Georgia,Selangor,88,45,43
1/01/2024,Ghana,Johor,6,6,0
1/01/2024,Ghana,Pulau Pinang,3,3,0
1/01/2024,Ghana,Selangor,70,51,19
1/01/2024,Guinea,Johor,5,5,0
1/01/2024,Guinea,Kedah,1,1,0
1/01/2024,Guinea,Sarawak,1,1,0
1/01/2024,Guinea,Selangor,68,40,28
1/01/2024,Gambia,Selangor,36,31,5
1/01/2024,Guinea-Bissau,Selangor,1,1,0
1/01/2024,Equatorial Guinea,Johor,1,1,0
1/01/2024,Equatorial Guinea,Selangor,1,1,0
1/01/2024,Greece,Johor,53,37,16
1/01/2024,Greece,Kedah,42,28,14
1/01/2024,Greece,Pahang,1,1,0
1/01/2024,Greece,Perak,2,1,1
1/01/2024,Greece,Perlis,5,4,1
1/01/2024,Greece,Pulau Pinang,17,9,8
1/01/2024,Greece,Sabah,3,2,1
1/01/2024,Greece,Sarawak,6,1,5
1/01/2024,Greece,Selangor,406,263,143
1/01/2024,Grenada,Johor,6,3,3
1/01/2024,Grenada,Selangor,15,12,3
1/01/2024,Guatemala,Johor,1,0,1
1/01/2024,Guatemala,Kedah,1,0,1
1/01/2024,Guatemala,Pulau Pinang,1,1,0
1/01/2024,Guatemala,Selangor,21,11,10
1/01/2024,Guyana,Johor,1,1,0
1/01/2024,Guyana,Selangor,7,6,1
1/01/2024,Hong Kong,Johor,2,0,2
1/01/2024,Hong Kong,Kedah,9,5,4
1/01/2024,Hong Kong,Pahang,1,0,1
1/01/2024,Hong Kong,Perak,50,24,26
1/01/2024,Hong Kong,Perlis,1,0,1
1/01/2024,Hong Kong,Sabah,12327,5388,6939
1/01/2024,Hong Kong,Selangor,752,349,403
1/01/2024,Honduras,Johor,7,6,1
1/01/2024,Honduras,Kedah,1,1,0
1/01/2024,Honduras,Selangor,21,14,7
1/01/2024,Croatia,Johor,32,22,10
1/01/2024,Croatia,Kedah,22,8,14
1/01/2024,Croatia,Perlis,1,1,0
1/01/2024,Croatia,Pulau Pinang,10,4,6
1/01/2024,Croatia,Sabah,4,4,0
1/01/2024,Croatia,Sarawak,1,1,0
1/01/2024,Croatia,Selangor,417,243,174
1/01/2024,Haiti,Johor,4,3,1
1/01/2024,Haiti,Selangor,12,9,3
1/01/2024,Hungary,Johor,104,68,36
1/01/2024,Hungary,Kedah,159,86,73
1/01/2024,Hungary,Perak,11,6,5
1/01/2024,Hungary,Perlis,10,6,4
1/01/2024,Hungary,Pulau Pinang,36,19,17
1/01/2024,Hungary,Sabah,42,21,21
1/01/2024,Hungary,Sarawak,17,10,7
1/01/2024,Hungary,Selangor,1273,671,602
1/01/2024,Indonesia,Johor,102215,47181,55034
1/01/2024,Indonesia,Kedah,7243,2820,4423
1/01/2024,Indonesia,Kelantan,109,59,50
1/01/2024,Indonesia,Melaka,3401,1596,1805
1/01/2024,Indonesia,Negeri Sembilan,4818,2786,2032
1/01/2024,Indonesia,Pahang,8,4,4
1/01/2024,Indonesia,Perak,138,53,85
1/01/2024,Indonesia,Perlis,902,259,643
1/01/2024,Indonesia,Pulau Pinang,45790,17228,28562
1/01/2024,Indonesia,Sabah,4598,2209,2389
1/01/2024,Indonesia,Sarawak,42070,21713,20357
1/01/2024,Indonesia,Selangor,169899,77105,92794
1/01/2024,Indonesia,W.P. Labuan,60,37,23
1/01/2024,India,Johor,18984,12989,5995
1/01/2024,India,Kedah,1224,736,488
1/01/2024,India,Kelantan,4,4,0
1/01/2024,India,Melaka,1,1,0
1/01/2024,India,Pahang,9,8,1
1/01/2024,India,Perak,245,185,60
1/01/2024,India,Perlis,90,71,19
1/01/2024,India,Pulau Pinang,1406,964,442
1/01/2024,India,Sabah,213,149,64
1/01/2024,India,Sarawak,2348,1914,434
1/01/2024,India,Selangor,70540,46989,23551
1/01/2024,India,W.P. Labuan,52,49,3
1/01/2024,Ireland,Johor,242,156,86
1/01/2024,Ireland,Kedah,144,72,72
1/01/2024,Ireland,Kelantan,2,1,1
1/01/2024,Ireland,Perak,7,4,3
1/01/2024,Ireland,Perlis,24,16,8
1/01/2024,Ireland,Pulau Pinang,168,120,48
1/01/2024,Ireland,Sabah,27,12,15
1/01/2024,Ireland,Sarawak,21,11,10
1/01/2024,Ireland,Selangor,1698,999,699
1/01/2024,"Iran, Islamic Republic of",Johor,274,146,128
1/01/2024,"Iran, Islamic Republic of",Kedah,9,4,5
1/01/2024,"Iran, Islamic Republic of",Perak,1,1,0
1/01/2024,"Iran, Islamic Republic of",Perlis,3,3,0
1/01/2024,"Iran, Islamic Republic of",Pulau Pinang,17,7,10
1/01/2024,"Iran, Islamic Republic of",Sabah,1,0,1
1/01/2024,"Iran, Islamic Republic of",Sarawak,2,2,0
1/01/2024,"Iran, Islamic Republic of",Selangor,2263,1244,1019
1/01/2024,Iraq,Johor,23,16,7
1/01/2024,Iraq,Kedah,4,2,2
1/01/2024,Iraq,Perlis,1,1,0
1/01/2024,Iraq,Pulau Pinang,11,10,1
1/01/2024,Iraq,Sabah,2,2,0
1/01/2024,Iraq,Selangor,1115,739,376
1/01/2024,Iceland,Johor,4,4,0
1/01/2024,Iceland,Kedah,7,3,4
1/01/2024,Iceland,Perak,2,1,1
1/01/2024,Iceland,Pulau Pinang,4,1,3
1/01/2024,Iceland,Selangor,51,30,21
1/01/2024,Italy,Johor,528,337,191
1/01/2024,Italy,Kedah,1073,545,528
1/01/2024,Italy,Kelantan,3,3,0
1/01/2024,Italy,Melaka,2,1,1
1/01/2024,Italy,Pahang,2,2,0
1/01/2024,Italy,Perak,12,8,4
1/01/2024,Italy,Perlis,45,31,14
1/01/2024,Italy,Pulau Pinang,172,117,55
1/01/2024,Italy,Sabah,51,33,18
1/01/2024,Italy,Sarawak,25,17,8
1/01/2024,Italy,Selangor,4427,2846,1581
1/01/2024,Jamaica,Johor,6,3,3
1/01/2024,Jamaica,Kedah,1,0,1
1/01/2024,Jamaica,Pulau Pinang,4,3,1
1/01/2024,Jamaica,Selangor,18,8,10
1/01/2024,Jordan,Johor,8,3,5
1/01/2024,Jordan,Kedah,1,1,0
1/01/2024,Jordan,Perlis,2,2,0
1/01/2024,Jordan,Pulau Pinang,4,4,0
1/01/2024,Jordan,Sabah,1,1,0
1/01/2024,Jordan,Selangor,898,551,347
1/01/2024,Japan,Johor,5512,3508,2004
1/01/2024,Japan,Kedah,576,284,292
1/01/2024,Japan,Kelantan,16,13,3
1/01/2024,Japan,Melaka,2,2,0
1/01/2024,Japan,Pahang,6,4,2
1/01/2024,Japan,Perak,74,44,30
1/01/2024,Japan,Perlis,113,85,28
1/01/2024,Japan,Pulau Pinang,1556,1045,511
1/01/2024,Japan,Sabah,383,187,196
1/01/2024,Japan,Sarawak,229,128,101
1/01/2024,Japan,Selangor,22006,13135,8871
1/01/2024,Japan,W.P. Labuan,16,13,3
1/01/2024,Kazakhstan,Johor,29,10,19
1/01/2024,Kazakhstan,Kedah,26,11,15
1/01/2024,Kazakhstan,Perlis,8,2,6
1/01/2024,Kazakhstan,Pulau Pinang,15,6,9
1/01/2024,Kazakhstan,Sabah,11,5,6
1/01/2024,Kazakhstan,Sarawak,6,4,2
1/01/2024,Kazakhstan,Selangor,1544,636,908
1/01/2024,Kenya,Johor,32,14,18
1/01/2024,Kenya,Kedah,1,1,0
1/01/2024,Kenya,Pulau Pinang,8,4,4
1/01/2024,Kenya,Sarawak,1,1,0
1/01/2024,Kenya,Selangor,433,214,219
1/01/2024,Kyrgyzstan,Johor,42,30,12
1/01/2024,Kyrgyzstan,Kedah,35,15,20
1/01/2024,Kyrgyzstan,Kelantan,4,4,0
1/01/2024,Kyrgyzstan,Perlis,1,0,1
1/01/2024,Kyrgyzstan,Pulau Pinang,8,5,3
1/01/2024,Kyrgyzstan,Sabah,6,4,2
1/01/2024,Kyrgyzstan,Selangor,586,262,324
1/01/2024,Cambodia,Johor,1736,710,1026
1/01/2024,Cambodia,Kedah,204,143,61
1/01/2024,Cambodia,Kelantan,740,577,163
1/01/2024,Cambodia,Melaka,1,1,0
1/01/2024,Cambodia,Perak,5,3,2
1/01/2024,Cambodia,Perlis,861,594,267
1/01/2024,Cambodia,Pulau Pinang,22,10,12
1/01/2024,Cambodia,Sabah,1,1,0
1/01/2024,Cambodia,Sarawak,8,4,4
1/01/2024,Cambodia,Selangor,3311,1600,1711
1/01/2024,Kiribati,Selangor,5,3,2
1/01/2024,Saint Kitts and Nevis,Johor,18,15,3
1/01/2024,Saint Kitts and Nevis,Selangor,59,46,13
1/01/2024,"Korea, Republic of",Johor,19717,9417,10300
1/01/2024,"Korea, Republic of",Kedah,551,261,290
1/01/2024,"Korea, Republic of",Kelantan,3,2,1
1/01/2024,"Korea, Republic of",Melaka,30,15,15
1/01/2024,"Korea, Republic of",Pahang,8,4,4
1/01/2024,"Korea, Republic of",Perak,32,16,16
1/01/2024,"Korea, Republic of",Perlis,108,79,29
1/01/2024,"Korea, Republic of",Pulau Pinang,1006,510,496
1/01/2024,"Korea, Republic of",Sabah,26519,11123,15396
1/01/2024,"Korea, Republic of",Sarawak,440,219,221
1/01/2024,"Korea, Republic of",Selangor,30481,15121,15360
1/01/2024,"Korea, Republic of",W.P. Labuan,5,4,1
1/01/2024,Kuwait,Johor,99,42,57
1/01/2024,Kuwait,Kedah,19,7,12
1/01/2024,Kuwait,Pulau Pinang,6,4,2
1/01/2024,Kuwait,Sabah,2,2,0
1/01/2024,Kuwait,Sarawak,1,1,0
1/01/2024,Kuwait,Selangor,1242,658,584
1/01/2024, Lao People's Democratic Republic,Johor,169,38,131
1/01/2024, Lao People's Democratic Republic,Kedah,1075,82,993
1/01/2024, Lao People's Democratic Republic,Kelantan,162,17,145
1/01/2024, Lao People's Democratic Republic,Perak,24,1,23
1/01/2024, Lao People's Democratic Republic,Perlis,331,93,238
1/01/2024, Lao People's Democratic Republic,Pulau Pinang,20,6,14
1/01/2024, Lao People's Democratic Republic,Sarawak,13,5,8
1/01/2024, Lao People's Democratic Republic,Selangor,255,81,174
1/01/2024,Lebanon,Johor,22,12,10
1/01/2024,Lebanon,Kedah,7,7,0
1/01/2024,Lebanon,Pulau Pinang,5,4,1
1/01/2024,Lebanon,Sabah,1,1,0
1/01/2024,Lebanon,Sarawak,7,7,0
1/01/2024,Lebanon,Selangor,323,195,128
1/01/2024,Liberia,Johor,1,1,0
1/01/2024,Liberia,Selangor,4,4,0
1/01/2024,Libya,Johor,2,1,1
1/01/2024,Libya,Perlis,3,3,0
1/01/2024,Libya,Pulau Pinang,1,1,0
1/01/2024,Libya,Sabah,1,0,1
1/01/2024,Libya,Selangor,425,300,125
1/01/2024,Saint Lucia,Johor,6,3,3
1/01/2024,Saint Lucia,Selangor,10,8,2
1/01/2024,Liechtenstein,Johor,1,0,1
1/01/2024,Liechtenstein,Kedah,2,1,1
1/01/2024,Liechtenstein,Pulau Pinang,2,2,0
1/01/2024,Liechtenstein,Selangor,9,9,0
1/01/2024,LKA,Johor,662,427,235
1/01/2024,LKA,Kedah,72,45,27
1/01/2024,LKA,Perak,10,10,0
1/01/2024,LKA,Perlis,2,2,0
1/01/2024,LKA,Pulau Pinang,28,21,7
1/01/2024,LKA,Sabah,10,6,4
1/01/2024,LKA,Sarawak,17,15,2
1/01/2024,LKA,Selangor,4369,2733,1636
1/01/2024,Lesotho,Selangor,7,0,7
1/01/2024,Lithuania,Johor,48,19,29
1/01/2024,Lithuania,Kedah,141,69,72
1/01/2024,Lithuania,Perlis,9,6,3
1/01/2024,Lithuania,Pulau Pinang,17,9,8
1/01/2024,Lithuania,Sabah,9,6,3
1/01/2024,Lithuania,Sarawak,12,4,8
1/01/2024,Lithuania,Selangor,792,377,415
1/01/2024,Luxembourg,Johor,5,3,2
1/01/2024,Luxembourg,Kedah,3,2,1
1/01/2024,Luxembourg,Pahang,2,2,0
1/01/2024,Luxembourg,Perlis,2,1,1
1/01/2024,Luxembourg,Pulau Pinang,5,3,2
1/01/2024,Luxembourg,Sarawak,5,3,2
1/01/2024,Luxembourg,Selangor,74,37,37
1/01/2024,Latvia,Johor,48,17,31
1/01/2024,Latvia,Kedah,24,11,13
1/01/2024,Latvia,Perlis,3,3,0
1/01/2024,Latvia,Pulau Pinang,10,4,6
1/01/2024,Latvia,Sabah,4,2,2
1/01/2024,Latvia,Sarawak,5,3,2
1/01/2024,Latvia,Selangor,346,167,179
1/01/2024,Macao,Johor,1,1,0
1/01/2024,Macao,Perak,1,1,0
1/01/2024,Macao,Selangor,1,0,1
1/01/2024,Morocco,Johor,92,56,36
1/01/2024,Morocco,Kedah,11,4,7
1/01/2024,Morocco,Perlis,1,0,1
1/01/2024,Morocco,Pulau Pinang,15,8,7
1/01/2024,Morocco,Sabah,10,5,5
1/01/2024,Morocco,Sarawak,8,6,2
1/01/2024,Morocco,Selangor,1123,607,516
1/01/2024,Monaco,Johor,2,1,1
1/01/2024,Monaco,Kedah,2,1,1
1/01/2024,Monaco,Selangor,3,3,0
1/01/2024,"Moldova, Republic of",Johor,4,4,0
1/01/2024,"Moldova, Republic of",Kedah,2,1,1
1/01/2024,"Moldova, Republic of",Sabah,2,0,2
1/01/2024,"Moldova, Republic of",Selangor,52,24,28
1/01/2024,Madagascar,Johor,25,12,13
1/01/2024,Madagascar,Kedah,1,0,1
1/01/2024,Madagascar,Sabah,1,0,1
1/01/2024,Madagascar,Sarawak,1,0,1
1/01/2024,Madagascar,Selangor,47,21,26
1/01/2024,Maldives,Johor,133,60,73
1/01/2024,Maldives,Kedah,6,2,4
1/01/2024,Maldives,Kelantan,1,1,0
1/01/2024,Maldives,Pulau Pinang,7,7,0
1/01/2024,Maldives,Sabah,1,1,0
1/01/2024,Maldives,Selangor,2991,1553,1438
1/01/2024,Mexico,Johor,143,76,67
1/01/2024,Mexico,Kedah,16,10,6
1/01/2024,Mexico,Perak,2,1,1
1/01/2024,Mexico,Perlis,2,2,0
1/01/2024,Mexico,Pulau Pinang,42,29,13
1/01/2024,Mexico,Sabah,9,7,2
1/01/2024,Mexico,Sarawak,2,2,0
1/01/2024,Mexico,Selangor,624,317,307
1/01/2024,Marshall Islands,Selangor,4,2,2
1/01/2024,North Macedonia,Johor,5,4,1
1/01/2024,North Macedonia,Kedah,8,4,4
1/01/2024,North Macedonia,Pulau Pinang,1,1,0
1/01/2024,North Macedonia,Selangor,90,51,39
1/01/2024,Mali,Selangor,9,5,4
1/01/2024,Malta,Johor,4,2,2
1/01/2024,Malta,Kedah,15,8,7
1/01/2024,Malta,Pulau Pinang,2,1,1
1/01/2024,Malta,Selangor,71,45,26
1/01/2024,Myanmar,Johor,4154,1282,2872
1/01/2024,Myanmar,Kedah,78,16,62
1/01/2024,Myanmar,Kelantan,5,2,3
1/01/2024,Myanmar,Pahang,3,0,3
1/01/2024,Myanmar,Perak,24,5,19
1/01/2024,Myanmar,Perlis,3,1,2
1/01/2024,Myanmar,Pulau Pinang,450,229,221
1/01/2024,Myanmar,Sabah,21,8,13
1/01/2024,Myanmar,Sarawak,76,40,36
1/01/2024,Myanmar,Selangor,6276,4235,2041
1/01/2024,Myanmar,W.P. Labuan,2,2,0
1/01/2024,Montenegro,Johor,10,9,1
1/01/2024,Montenegro,Pulau Pinang,1,1,0
1/01/2024,Montenegro,Selangor,26,16,10
1/01/2024,Mongolia,Johor,667,311,356
1/01/2024,Mongolia,Kedah,37,14,23
1/01/2024,Mongolia,Perlis,2,2,0
1/01/2024,Mongolia,Pulau Pinang,40,20,20
1/01/2024,Mongolia,Sabah,24,9,15
1/01/2024,Mongolia,Selangor,1327,592,735
1/01/2024,Mozambique,Johor,1,0,1
1/01/2024,Mozambique,Selangor,96,44,52
1/01/2024,Mauritania,Johor,3,3,0
1/01/2024,Mauritania,Selangor,29,20,9
1/01/2024,Mauritius,Johor,178,95,83
1/01/2024,Mauritius,Kedah,8,6,2
1/01/2024,Mauritius,Perak,1,0,1
1/01/2024,Mauritius,Perlis,1,1,0
1/01/2024,Mauritius,Pulau Pinang,11,4,7
1/01/2024,Mauritius,Sabah,3,1,2
1/01/2024,Mauritius,Selangor,1712,877,835
1/01/2024,Malawi,Johor,1,0,1
1/01/2024,Malawi,Selangor,23,14,9
1/01/2024,Namibia,Johor,1,1,0
1/01/2024,Namibia,Selangor,13,6,7
1/01/2024,Niger,Selangor,3,3,0
1/01/2024,Nigeria,Johor,17,17,0
1/01/2024,Nigeria,Kedah,1,0,1
1/01/2024,Nigeria,Pulau Pinang,7,7,0
1/01/2024,Nigeria,Sarawak,5,3,2
1/01/2024,Nigeria,Selangor,434,335,99
1/01/2024,Nicaragua,Johor,1,1,0
1/01/2024,Nicaragua,Selangor,4,2,2
1/01/2024,Netherlands,Johor,826,512,314
1/01/2024,Netherlands,Kedah,582,289,293
1/01/2024,Netherlands,Kelantan,3,2,1
1/01/2024,Netherlands,Melaka,1,1,0
1/01/2024,Netherlands,Pahang,3,3,0
1/01/2024,Netherlands,Perak,19,13,6
1/01/2024,Netherlands,Perlis,57,38,19
1/01/2024,Netherlands,Pulau Pinang,282,185,97
1/01/2024,Netherlands,Sabah,92,44,48
1/01/2024,Netherlands,Sarawak,135,87,48
1/01/2024,Netherlands,Selangor,5119,2981,2138
1/01/2024,Netherlands,W.P. Labuan,1,1,0
1/01/2024,Norway,Johor,139,82,57
1/01/2024,Norway,Kedah,130,55,75
1/01/2024,Norway,Perlis,8,4,4
1/01/2024,Norway,Pulau Pinang,72,43,29
1/01/2024,Norway,Sabah,14,7,7
1/01/2024,Norway,Sarawak,19,13,6
1/01/2024,Norway,Selangor,1123,657,466
1/01/2024,Nepal,Johor,808,586,222
1/01/2024,Nepal,Kedah,32,27,5
1/01/2024,Nepal,Perlis,1,1,0
1/01/2024,Nepal,Pulau Pinang,48,44,4
1/01/2024,Nepal,Sabah,5,2,3
1/01/2024,Nepal,Sarawak,196,136,60
1/01/2024,Nepal,Selangor,9756,9121,635
1/01/2024,Nepal,W.P. Labuan,62,59,3
1/01/2024,Nauru,Selangor,1,1,0
1/01/2024,New Zealand,Johor,959,546,413
1/01/2024,New Zealand,Kedah,234,121,113
1/01/2024,New Zealand,Kelantan,4,1,3
1/01/2024,New Zealand,Melaka,3,0,3
1/01/2024,New Zealand,Perak,26,15,11
1/01/2024,New Zealand,Perlis,23,9,14
1/01/2024,New Zealand,Pulau Pinang,278,150,128
1/01/2024,New Zealand,Sabah,62,32,30
1/01/2024,New Zealand,Sarawak,162,91,71
1/01/2024,New Zealand,Selangor,4346,2460,1886
1/01/2024,New Zealand,W.P. Labuan,1,1,0
1/01/2024,Oman,Johor,24,16,8
1/01/2024,Oman,Kedah,13,9,4
1/01/2024,Oman,Perlis,1,0,1
1/01/2024,Oman,Pulau Pinang,11,7,4
1/01/2024,Oman,Sabah,1,1,0
1/01/2024,Oman,Sarawak,4,3,1
1/01/2024,Oman,Selangor,3378,1770,1608
1/01/2024,Pakistan,Johor,692,520,172
1/01/2024,Pakistan,Kedah,97,78,19
1/01/2024,Pakistan,Kelantan,20,20,0
1/01/2024,Pakistan,Perak,7,7,0
1/01/2024,Pakistan,Perlis,28,26,2
1/01/2024,Pakistan,Pulau Pinang,90,73,17
1/01/2024,Pakistan,Sabah,21,19,2
1/01/2024,Pakistan,Sarawak,139,120,19
1/01/2024,Pakistan,Selangor,10855,8781,2074
1/01/2024,Pakistan,W.P. Labuan,1,1,0
1/01/2024,Panama,Johor,12,7,5
1/01/2024,Panama,Pulau Pinang,1,1,0
1/01/2024,Panama,Sarawak,2,2,0
1/01/2024,Panama,Selangor,35,20,15
1/01/2024,Peru,Johor,32,15,17
1/01/2024,Peru,Kedah,9,3,6
1/01/2024,Peru,Pulau Pinang,6,5,1
1/01/2024,Peru,Selangor,163,83,80
1/01/2024,Philippines,Johor,14022,4383,9639
1/01/2024,Philippines,Kedah,477,167,310
1/01/2024,Philippines,Kelantan,24,11,13
1/01/2024,Philippines,Negeri Sembilan,4,4,0
1/01/2024,Philippines,Pahang,13,11,2
1/01/2024,Philippines,Perak,69,33,36
1/01/2024,Philippines,Perlis,213,70,143
1/01/2024,Philippines,Pulau Pinang,657,304,353
1/01/2024,Philippines,Sabah,1990,835,1155
1/01/2024,Philippines,Sarawak,2820,1246,1574
1/01/2024,Philippines,Selangor,18073,7354,10719
1/01/2024,Philippines,W.P. Labuan,107,34,73
1/01/2024,Palau,Selangor,11,9,2
1/01/2024,Papua New Guinea,Johor,14,4,10
1/01/2024,Papua New Guinea,Pulau Pinang,2,0,2
1/01/2024,Papua New Guinea,Sarawak,18,8,10
1/01/2024,Papua New Guinea,Selangor,91,48,43
1/01/2024,Poland,Johor,684,363,321
1/01/2024,Poland,Kedah,530,265,265
1/01/2024,Poland,Kelantan,1,1,0
1/01/2024,Poland,Melaka,1,1,0
1/01/2024,Poland,Perak,3,2,1
1/01/2024,Poland,Perlis,42,23,19
1/01/2024,Poland,Pulau Pinang,149,67,82
1/01/2024,Poland,Sabah,69,36,33
1/01/2024,Poland,Sarawak,52,26,26
1/01/2024,Poland,Selangor,2850,1510,1340
1/01/2024,Poland,W.P. Labuan,22,9,13
1/01/2024,Portugal,Johor,136,75,61
1/01/2024,Portugal,Kedah,95,48,47
1/01/2024,Portugal,Perlis,3,3,0
1/01/2024,Portugal,Pulau Pinang,42,12,30
1/01/2024,Portugal,Sabah,12,9,3
1/01/2024,Portugal,Sarawak,8,6,2
1/01/2024,Portugal,Selangor,856,493,363
1/01/2024,Paraguay,Johor,4,0,4
1/01/2024,Paraguay,Kedah,4,0,4
1/01/2024,Paraguay,Perlis,1,1,0
1/01/2024,Paraguay,Pulau Pinang,1,0,1
1/01/2024,Paraguay,Sabah,2,1,1
1/01/2024,Paraguay,Selangor,22,15,7
1/01/2024,"Palestine, State of",Johor,20,20,0
1/01/2024,"Palestine, State of",Pulau Pinang,5,5,0
1/01/2024,"Palestine, State of",Selangor,237,172,65
1/01/2024,Qatar,Johor,2,1,1
1/01/2024,Qatar,Sarawak,1,1,0
1/01/2024,Qatar,Selangor,131,82,49
1/01/2024,Romania,Johor,169,100,69
1/01/2024,Romania,Kedah,200,101,99
1/01/2024,Romania,Kelantan,1,1,0
1/01/2024,Romania,Perlis,9,5,4
1/01/2024,Romania,Pulau Pinang,68,32,36
1/01/2024,Romania,Sabah,6,4,2
1/01/2024,Romania,Sarawak,10,7,3
1/01/2024,Romania,Selangor,1548,804,744
1/01/2024,Russian Federation (Russia),Johor,416,221,195
1/01/2024,Russian Federation (Russia),Kedah,749,358,391
1/01/2024,Russian Federation (Russia),Kelantan,9,5,4
1/01/2024,Russian Federation (Russia),Pahang,6,2,4
1/01/2024,Russian Federation (Russia),Perak,3,3,0
1/01/2024,Russian Federation (Russia),Perlis,84,48,36
1/01/2024,Russian Federation (Russia),Pulau Pinang,280,139,141
1/01/2024,Russian Federation (Russia),Sabah,165,76,89
1/01/2024,Russian Federation (Russia),Sarawak,57,30,27
1/01/2024,Russian Federation (Russia),Selangor,13391,6449,6942
1/01/2024,Russian Federation (Russia),W.P. Labuan,7,2,5
1/01/2024,Rwanda,Selangor,11,4,7
1/01/2024,Saudi Arabia,Johor,151,80,71
1/01/2024,Saudi Arabia,Kedah,38,18,20
1/01/2024,Saudi Arabia,Kelantan,4,3,1
1/01/2024,Saudi Arabia,Perak,2,1,1
1/01/2024,Saudi Arabia,Perlis,2,1,1
1/01/2024,Saudi Arabia,Pulau Pinang,45,27,18
1/01/2024,Saudi Arabia,Sabah,5,4,1
1/01/2024,Saudi Arabia,Sarawak,8,6,2
1/01/2024,Saudi Arabia,Selangor,6118,3404,2714
1/01/2024,Sudan,Johor,7,6,1
1/01/2024,Sudan,Kedah,2,2,0
1/01/2024,Sudan,Kelantan,2,2,0
1/01/2024,Sudan,Pulau Pinang,1,1,0
1/01/2024,Sudan,Sarawak,11,8,3
1/01/2024,Sudan,Selangor,1460,797,663
1/01/2024,Senegal,Johor,12,8,4
1/01/2024,Senegal,Perlis,1,1,0
1/01/2024,Senegal,Sabah,1,1,0
1/01/2024,Senegal,Selangor,57,44,13
1/01/2024,Singapore,Johor,871844,505563,366281
1/01/2024,Singapore,Kedah,3673,2000,1673
1/01/2024,Singapore,Kelantan,43,29,14
1/01/2024,Singapore,Melaka,24,20,4
1/01/2024,Singapore,Negeri Sembilan,7,5,2
1/01/2024,Singapore,Pahang,290,150,140
1/01/2024,Singapore,Perak,4291,2076,2215
1/01/2024,Singapore,Perlis,183,122,61
1/01/2024,Singapore,Pulau Pinang,14410,7407,7003
1/01/2024,Singapore,Sabah,2271,1214,1057
1/01/2024,Singapore,Sarawak,3071,1732,1339
1/01/2024,Singapore,Selangor,41630,21994,19636
1/01/2024,Singapore,W.P. Labuan,11,9,2
1/01/2024,Saint Helena,Johor,1,1,0
1/01/2024,Solomon Islands,Pulau Pinang,4,2,2
1/01/2024,Solomon Islands,Selangor,7,3,4
1/01/2024,Sierra Leone,Johor,4,2,2
1/01/2024,Sierra Leone,Kedah,2,1,1
1/01/2024,Sierra Leone,Selangor,20,11,9
1/01/2024,El Salvador,Johor,2,1,1
1/01/2024,El Salvador,Kedah,15,5,10
1/01/2024,El Salvador,Selangor,29,13,16
1/01/2024,San Marino,Selangor,5,5,0
1/01/2024,Somalia,Johor,1,1,0
1/01/2024,Somalia,Kedah,1,1,0
1/01/2024,Somalia,Selangor,240,119,121
1/01/2024,Saint Pierre and Miquelon,Johor,1,0,1
1/01/2024,Serbia,Johor,9,6,3
1/01/2024,Serbia,Kedah,14,5,9
1/01/2024,Serbia,Pulau Pinang,4,2,2
1/01/2024,Serbia,Selangor,181,85,96
1/01/2024,South Sudan,Selangor,46,33,13
1/01/2024,Sao Tome and Principe,Selangor,1,0,1
1/01/2024,Suriname,Johor,1,1,0
1/01/2024,Suriname,Pulau Pinang,1,1,0
1/01/2024,Suriname,Selangor,12,9,3
1/01/2024,Slovakia,Johor,49,24,25
1/01/2024,Slovakia,Kedah,106,49,57
1/01/2024,Slovakia,Kelantan,2,2,0
1/01/2024,Slovakia,Perak,2,2,0
1/01/2024,Slovakia,Perlis,4,3,1
1/01/2024,Slovakia,Pulau Pinang,36,18,18
1/01/2024,Slovakia,Sarawak,3,1,2
1/01/2024,Slovakia,Selangor,559,314,245
1/01/2024,Slovenia,Johor,17,8,9
1/01/2024,Slovenia,Kedah,71,39,32
1/01/2024,Slovenia,Perlis,7,3,4
1/01/2024,Slovenia,Pulau Pinang,7,2,5
1/01/2024,Slovenia,Sabah,4,2,2
1/01/2024,Slovenia,Selangor,318,170,148
1/01/2024,Sweden,Johor,311,154,157
1/01/2024,Sweden,Kedah,547,271,276
1/01/2024,Sweden,Kelantan,6,5,1
1/01/2024,Sweden,Perak,5,5,0
1/01/2024,Sweden,Perlis,39,29,10
1/01/2024,Sweden,Pulau Pinang,119,77,42
1/01/2024,Sweden,Sabah,27,12,15
1/01/2024,Sweden,Sarawak,18,9,9
1/01/2024,Sweden,Selangor,2018,1174,844
1/01/2024,Eswatini,Selangor,14,5,9
1/01/2024,Seychelles,Johor,17,5,12
1/01/2024,Seychelles,Pulau Pinang,2,2,0
1/01/2024,Seychelles,Selangor,152,64,88
1/01/2024,Syrian Arab Republic,Johor,9,5,4
1/01/2024,Syrian Arab Republic,Kedah,4,2,2
1/01/2024,Syrian Arab Republic,Pahang,6,6,0
1/01/2024,Syrian Arab Republic,Pulau Pinang,1,1,0
1/01/2024,Syrian Arab Republic,Sabah,2,2,0
1/01/2024,Syrian Arab Republic,Sarawak,1,1,0
1/01/2024,Syrian Arab Republic,Selangor,740,467,273
1/01/2024,TCD,Johor,11,10,1
1/01/2024,TCD,Selangor,29,20,9
1/01/2024,Togo,Johor,1,1,0
1/01/2024,Togo,Selangor,10,9,1
1/01/2024,Thailand,Johor,5582,1486,4096
1/01/2024,Thailand,Kedah,72272,43955,28317
1/01/2024,Thailand,Kelantan,52401,27259,25142
1/01/2024,Thailand,Pahang,3,1,2
1/01/2024,Thailand,Perak,10688,4919,5769
1/01/2024,Thailand,Perlis,53832,32478,21354
1/01/2024,Thailand,Pulau Pinang,2439,988,1451
1/01/2024,Thailand,Sabah,29,7,22
1/01/2024,Thailand,Sarawak,407,147,260
1/01/2024,Thailand,Selangor,13251,5035,8216
1/01/2024,Thailand,W.P. Labuan,7,4,3
1/01/2024,Tajikistan,Pulau Pinang,1,1,0
1/01/2024,Tajikistan,Sabah,1,1,0
1/01/2024,Tajikistan,Selangor,209,138,71
1/01/2024,Turkmenistan,Pulau Pinang,1,1,0
1/01/2024,Turkmenistan,Sabah,4,3,1
1/01/2024,Turkmenistan,Selangor,180,100,80
1/01/2024,Timor-Leste,Johor,20,12,8
1/01/2024,Timor-Leste,Pulau Pinang,2,2,0
1/01/2024,Timor-Leste,Sabah,1,0,1
1/01/2024,Timor-Leste,Selangor,253,117,136
1/01/2024,Tonga,Johor,12,7,5
1/01/2024,Tonga,Pulau Pinang,2,0,2
1/01/2024,Tonga,Selangor,27,15,12
1/01/2024,Trinidad and Tobago,Johor,3,2,1
1/01/2024,Trinidad and Tobago,Sarawak,3,0,3
1/01/2024,Trinidad and Tobago,Selangor,26,15,11
1/01/2024,Trinidad and Tobago,W.P. Labuan,1,1,0
1/01/2024,Tunisia,Johor,15,7,8
1/01/2024,Tunisia,Kelantan,1,1,0
1/01/2024,Tunisia,Pulau Pinang,10,10,0
1/01/2024,Tunisia,Sabah,1,0,1
1/01/2024,Tunisia,Selangor,833,464,369
1/01/2024,Türkiye,Johor,280,208,72
1/01/2024,Türkiye,Kedah,118,67,51
1/01/2024,Türkiye,Kelantan,2,2,0
1/01/2024,Türkiye,Melaka,1,1,0
1/01/2024,Türkiye,Perak,5,4,1
1/01/2024,Türkiye,Perlis,24,19,5
1/01/2024,Türkiye,Pulau Pinang,56,40,16
1/01/2024,Türkiye,Sabah,6,4,2
1/01/2024,Türkiye,Sarawak,19,13,6
1/01/2024,Türkiye,Selangor,2017,1281,736
1/01/2024,Tuvalu,Selangor,1,1,0
1/01/2024,"Taiwan, Province of China",Johor,6749,2907,3842
1/01/2024,"Taiwan, Province of China",Kedah,239,114,125
1/01/2024,"Taiwan, Province of China",Melaka,3,3,0
1/01/2024,"Taiwan, Province of China",Negeri Sembilan,6,3,3
1/01/2024,"Taiwan, Province of China",Pahang,5,3,2
1/01/2024,"Taiwan, Province of China",Perak,56,20,36
1/01/2024,"Taiwan, Province of China",Perlis,37,22,15
1/01/2024,"Taiwan, Province of China",Pulau Pinang,4522,2074,2448
1/01/2024,"Taiwan, Province of China",Sabah,2351,1060,1291
1/01/2024,"Taiwan, Province of China",Sarawak,469,194,275
1/01/2024,"Taiwan, Province of China",Selangor,19108,8892,10216
1/01/2024,"Taiwan, Province of China",W.P. Labuan,1,1,0
1/01/2024,"Tanzania, United Republic of",Johor,40,18,22
1/01/2024,"Tanzania, United Republic of",Pulau Pinang,1,0,1
1/01/2024,"Tanzania, United Republic of",Selangor,244,112,132
1/01/2024,Uganda,Johor,51,28,23
1/01/2024,Uganda,Kedah,2,1,1
1/01/2024,Uganda,Perlis,1,0,1
1/01/2024,Uganda,Pulau Pinang,3,1,2
1/01/2024,Uganda,Sabah,2,2,0
1/01/2024,Uganda,Sarawak,4,0,4
1/01/2024,Uganda,Selangor,164,81,83
1/01/2024,Ukraine,Johor,89,43,46
1/01/2024,Ukraine,Kedah,70,30,40
1/01/2024,Ukraine,Kelantan,3,1,2
1/01/2024,Ukraine,Pahang,1,0,1
1/01/2024,Ukraine,Perak,1,1,0
1/01/2024,Ukraine,Perlis,7,4,3
1/01/2024,Ukraine,Pulau Pinang,49,27,22
1/01/2024,Ukraine,Sabah,13,6,7
1/01/2024,Ukraine,Sarawak,3,2,1
1/01/2024,Ukraine,Selangor,1546,691,855
1/01/2024,Uruguay,Johor,18,4,14
1/01/2024,Uruguay,Kedah,8,3,5
1/01/2024,Uruguay,Pulau Pinang,1,0,1
1/01/2024,Uruguay,Selangor,55,28,27
1/01/2024,United States of America,Johor,4068,2281,1787
1/01/2024,United States of America,Kedah,1502,749,753
1/01/2024,United States of America,Kelantan,7,4,3
1/01/2024,United States of America,Melaka,1,1,0
1/01/2024,United States of America,Negeri Sembilan,2,1,1
1/01/2024,United States of America,Pahang,8,8,0
1/01/2024,United States of America,Perak,98,57,41
1/01/2024,United States of America,Perlis,114,76,38
1/01/2024,United States of America,Pulau Pinang,2863,1612,1251
1/01/2024,United States of America,Sabah,359,199,160
1/01/2024,United States of America,Sarawak,253,147,106
1/01/2024,United States of America,Selangor,16734,9807,6927
1/01/2024,United States of America,W.P. Labuan,5,3,2
1/01/2024,Uzbekistan,Johor,89,65,24
1/01/2024,Uzbekistan,Kedah,72,41,31
1/01/2024,Uzbekistan,Perak,1,1,0
1/01/2024,Uzbekistan,Perlis,1,1,0
1/01/2024,Uzbekistan,Pulau Pinang,9,6,3
1/01/2024,Uzbekistan,Sabah,3,2,1
1/01/2024,Uzbekistan,Selangor,3107,1949,1158
1/01/2024,Holy See,Pulau Pinang,1,1,0
1/01/2024,Saint Vincent and the Grenadines,Johor,2,2,0
1/01/2024,Saint Vincent and the Grenadines,Sabah,1,1,0
1/01/2024,Saint Vincent and the Grenadines,Selangor,4,4,0
1/01/2024,"Venezuela, Bolivarian Republic of",Johor,22,8,14
1/01/2024,"Venezuela, Bolivarian Republic of",Kedah,2,1,1
1/01/2024,"Venezuela, Bolivarian Republic of",Pulau Pinang,2,1,1
1/01/2024,"Venezuela, Bolivarian Republic of",Sarawak,1,1,0
1/01/2024,"Venezuela, Bolivarian Republic of",Selangor,88,51,37
1/01/2024,Viet Nam,Johor,9973,3085,6888
1/01/2024,Viet Nam,Kedah,276,33,243
1/01/2024,Viet Nam,Kelantan,8,3,5
1/01/2024,Viet Nam,Pahang,1,1,0
1/01/2024,Viet Nam,Perak,221,7,214
1/01/2024,Viet Nam,Perlis,216,17,199
1/01/2024,Viet Nam,Pulau Pinang,949,295,654
1/01/2024,Viet Nam,Sabah,59,22,37
1/01/2024,Viet Nam,Sarawak,351,74,277
1/01/2024,Viet Nam,Selangor,12157,4359,7798
1/01/2024,Viet Nam,Terengganu,14,14,0
1/01/2024,Viet Nam,W.P. Labuan,2,2,0
1/01/2024,Vanuatu,Johor,43,36,7
1/01/2024,Vanuatu,Pulau Pinang,2,2,0
1/01/2024,Vanuatu,Sabah,2,2,0
1/01/2024,Vanuatu,Selangor,73,65,8
1/01/2024, Samoa,Selangor,3,0,3
1/01/2024,Yemen,Johor,30,20,10
1/01/2024,Yemen,Kedah,7,5,2
1/01/2024,Yemen,Kelantan,2,1,1
1/01/2024,Yemen,Melaka,1,1,0
1/01/2024,Yemen,Perak,1,1,0
1/01/2024,Yemen,Perlis,3,3,0
1/01/2024,Yemen,Pulau Pinang,3,1,2
1/01/2024,Yemen,Sarawak,7,6,1
1/01/2024,Yemen,Selangor,1487,968,519
1/01/2024,South Africa,Johor,347,196,151
1/01/2024,South Africa,Kedah,68,31,37
1/01/2024,South Africa,Pahang,1,1,0
1/01/2024,South Africa,Perak,2,2,0
1/01/2024,South Africa,Perlis,4,1,3
1/01/2024,South Africa,Pulau Pinang,78,41,37
1/01/2024,South Africa,Sabah,37,20,17
1/01/2024,South Africa,Sarawak,56,30,26
1/01/2024,South Africa,Selangor,1549,814,735
1/01/2024,ZAR,Pulau Pinang,1,0,1
1/01/2024,ZAR,Selangor,1,0,1
1/01/2024,Zambia,Johor,10,5,5
1/01/2024,Zambia,Kedah,1,0,1
1/01/2024,Zambia,Pulau Pinang,5,1,4
1/01/2024,Zambia,Sarawak,2,1,1
1/01/2024,Zambia,Selangor,93,51,42
1/01/2024,Zimbabwe,Johor,13,5,8
1/01/2024,Zimbabwe,Kedah,1,1,0
1/01/2024,Zimbabwe,Pulau Pinang,2,0,2
1/01/2024,Zimbabwe,Sarawak,1,0,1
1/01/2024,Zimbabwe,Selangor,199,103,96
1/02/2024,Afghanistan,Perlis,1,0,1
1/02/2024,Afghanistan,Selangor,53,38,15
1/02/2024,Angola,Selangor,1,1,0
1/02/2024,Albania,Johor,14,10,4
1/02/2024,Albania,Kedah,2,1,1
1/02/2024,Albania,Pulau Pinang,2,1,1
1/02/2024,Albania,Selangor,28,17,11
1/02/2024,Andorra,Johor,1,0,1
1/02/2024,Andorra,Selangor,5,2,3
1/02/2024,United Arab Emirates,Johor,9,6,3
1/02/2024,United Arab Emirates,Kedah,5,4,1
1/02/2024,United Arab Emirates,Selangor,378,237,141
1/02/2024,Argentina,Johor,92,46,46
1/02/2024,Argentina,Kedah,98,47,51
1/02/2024,Argentina,Perak,1,1,0
1/02/2024,Argentina,Perlis,4,4,0
1/02/2024,Argentina,Pulau Pinang,6,4,2
1/02/2024,Argentina,Sabah,4,2,2
1/02/2024,Argentina,Selangor,576,294,282
1/02/2024,Argentina,Terengganu,1,1,0
1/02/2024,Armenia,Johor,1,0,1
1/02/2024,Armenia,Kedah,5,4,1
1/02/2024,Armenia,Pulau Pinang,3,0,3
1/02/2024,Armenia,Sabah,1,0,1
1/02/2024,Armenia,Selangor,166,61,105
1/02/2024,Antigua and Barbuda,Johor,4,2,2
1/02/2024,Antigua and Barbuda,Pulau Pinang,1,1,0
1/02/2024,Antigua and Barbuda,Selangor,20,13,7
1/02/2024,Australia,Johor,4763,2792,1971
1/02/2024,Australia,Kedah,613,336,277
1/02/2024,Australia,Kelantan,8,6,2
1/02/2024,Australia,Melaka,2,2,0
1/02/2024,Australia,Negeri Sembilan,2,1,1
1/02/2024,Australia,Pahang,14,9,5
1/02/2024,Australia,Perak,274,148,126
1/02/2024,Australia,Perlis,127,78,49
1/02/2024,Australia,Pulau Pinang,1851,1000,851
1/02/2024,Australia,Sabah,370,194,176
1/02/2024,Australia,Sarawak,603,359,244
1/02/2024,Australia,Selangor,21486,12654,8832
1/02/2024,Australia,Terengganu,3,1,2
1/02/2024,Australia,W.P. Labuan,12,5,7
1/02/2024,Austria,Johor,261,175,86
1/02/2024,Austria,Kedah,282,156,126
1/02/2024,Austria,Kelantan,4,3,1
1/02/2024,Austria,Perak,5,3,2
1/02/2024,Austria,Perlis,26,16,10
1/02/2024,Austria,Pulau Pinang,122,79,43
1/02/2024,Austria,Sabah,29,19,10
1/02/2024,Austria,Sarawak,33,20,13
1/02/2024,Austria,Selangor,1402,800,602
1/02/2024,Austria,W.P. Labuan,2,1,1
1/02/2024,Azerbaijan,Johor,13,8,5
1/02/2024,Azerbaijan,Kedah,5,2,3
1/02/2024,Azerbaijan,Kelantan,1,1,0
1/02/2024,Azerbaijan,Sabah,1,1,0
1/02/2024,Azerbaijan,Sarawak,3,1,2
1/02/2024,Azerbaijan,Selangor,118,65,53
1/02/2024,Burundi,Selangor,4,0,4
1/02/2024,Belgium,Johor,209,128,81
1/02/2024,Belgium,Kedah,186,93,93
1/02/2024,Belgium,Kelantan,2,1,1
1/02/2024,Belgium,Melaka,1,1,0
1/02/2024,Belgium,Pahang,2,0,2
1/02/2024,Belgium,Perak,1,1,0
1/02/2024,Belgium,Perlis,17,15,2
1/02/2024,Belgium,Pulau Pinang,92,60,32
1/02/2024,Belgium,Sabah,34,19,15
1/02/2024,Belgium,Sarawak,26,15,11
1/02/2024,Belgium,Selangor,1553,945,608
1/02/2024,Belgium,Terengganu,1,1,0
1/02/2024,Belgium,W.P. Labuan,5,2,3
1/02/2024,Benin,Selangor,10,9,1
1/02/2024,Burkina Faso,Johor,2,1,1
1/02/2024,Burkina Faso,Selangor,7,5,2
1/02/2024,Bangladesh,Johor,4241,3702,539
1/02/2024,Bangladesh,Kedah,130,78,52
1/02/2024,Bangladesh,Kelantan,4,4,0
1/02/2024,Bangladesh,Pahang,3,1,2
1/02/2024,Bangladesh,Perak,6,4,2
1/02/2024,Bangladesh,Perlis,3,3,0
1/02/2024,Bangladesh,Pulau Pinang,83,76,7
1/02/2024,Bangladesh,Sabah,4,3,1
1/02/2024,Bangladesh,Sarawak,111,76,35
1/02/2024,Bangladesh,Selangor,27189,25198,1991
1/02/2024,Bangladesh,Terengganu,1,1,0
1/02/2024,Bangladesh,W.P. Labuan,18,18,0
1/02/2024,Bulgaria,Johor,85,43,42
1/02/2024,Bulgaria,Kedah,17,8,9
1/02/2024,Bulgaria,Kelantan,1,1,0
1/02/2024,Bulgaria,Perak,1,1,0
1/02/2024,Bulgaria,Perlis,1,1,0
1/02/2024,Bulgaria,Pulau Pinang,17,12,5
1/02/2024,Bulgaria,Sabah,2,1,1
1/02/2024,Bulgaria,Sarawak,2,2,0
1/02/2024,Bulgaria,Selangor,474,223,251
1/02/2024,Bahrain,Johor,9,6,3
1/02/2024,Bahrain,Kedah,2,2,0
1/02/2024,Bahrain,Pulau Pinang,2,2,0
1/02/2024,Bahrain,Selangor,140,76,64
1/02/2024,Bahamas,Johor,2,2,0
1/02/2024,Bahamas,Pulau Pinang,1,0,1
1/02/2024,Bahamas,Selangor,8,2,6
1/02/2024,Bosnia and Herzegovina,Johor,8,5,3
1/02/2024,Bosnia and Herzegovina,Kedah,2,1,1
1/02/2024,Bosnia and Herzegovina,Pulau Pinang,1,1,0
1/02/2024,Bosnia and Herzegovina,Sabah,1,1,0
1/02/2024,Bosnia and Herzegovina,Sarawak,2,2,0
1/02/2024,Bosnia and Herzegovina,Selangor,76,49,27
1/02/2024,Belarus,Johor,19,9,10
1/02/2024,Belarus,Kedah,66,29,37
1/02/2024,Belarus,Kelantan,2,1,1
1/02/2024,Belarus,Perak,1,1,0
1/02/2024,Belarus,Pulau Pinang,14,8,6
1/02/2024,Belarus,Sabah,5,2,3
1/02/2024,Belarus,Sarawak,1,1,0
1/02/2024,Belarus,Selangor,592,282,310
1/02/2024,Belize,Johor,3,2,1
1/02/2024,Belize,Selangor,11,3,8
1/02/2024,Bolivia,Pulau Pinang,2,2,0
1/02/2024,Bolivia,Selangor,15,8,7
1/02/2024,Brazil,Johor,365,208,157
1/02/2024,Brazil,Kedah,98,49,49
1/02/2024,Brazil,Perak,5,3,2
1/02/2024,Brazil,Perlis,10,3,7
1/02/2024,Brazil,Pulau Pinang,48,22,26
1/02/2024,Brazil,Sabah,13,6,7
1/02/2024,Brazil,Sarawak,7,4,3
1/02/2024,Brazil,Selangor,929,530,399
1/02/2024,Barbados,Johor,2,2,0
1/02/2024,Barbados,Pulau Pinang,3,0,3
1/02/2024,Barbados,Selangor,8,2,6
1/02/2024,Brunei Darussalam,Johor,389,206,183
1/02/2024,Brunei Darussalam,Kedah,32,12,20
1/02/2024,Brunei Darussalam,Kelantan,6,2,4
1/02/2024,Brunei Darussalam,Perak,7,3,4
1/02/2024,Brunei Darussalam,Perlis,47,20,27
1/02/2024,Brunei Darussalam,Pulau Pinang,20,10,10
1/02/2024,Brunei Darussalam,Sabah,1109,460,649
1/02/2024,Brunei Darussalam,Sarawak,131382,70633,60749
1/02/2024,Brunei Darussalam,Selangor,5785,2764,3021
1/02/2024,Brunei Darussalam,W.P. Labuan,1729,1058,671
1/02/2024,Bhutan,Johor,3,3,0
1/02/2024,Bhutan,Kedah,1,1,0
1/02/2024,Bhutan,Perlis,3,1,2
1/02/2024,Bhutan,Pulau Pinang,1,1,0
1/02/2024,Bhutan,Sarawak,3,3,0
1/02/2024,Bhutan,Selangor,74,38,36
1/02/2024,Botswana,Johor,1,1,0
1/02/2024,Botswana,Selangor,16,7,9
1/02/2024,Canada,Johor,1764,958,806
1/02/2024,Canada,Kedah,418,217,201
1/02/2024,Canada,Kelantan,12,8,4
1/02/2024,Canada,Negeri Sembilan,7,5,2
1/02/2024,Canada,Pahang,2,2,0
1/02/2024,Canada,Perak,33,18,15
1/02/2024,Canada,Perlis,83,48,35
1/02/2024,Canada,Pulau Pinang,642,358,284
1/02/2024,Canada,Sabah,257,118,139
1/02/2024,Canada,Sarawak,368,190,178
1/02/2024,Canada,Selangor,6300,3539,2761
1/02/2024,Canada,W.P. Labuan,11,9,2
1/02/2024,Switzerland,Johor,491,285,206
1/02/2024,Switzerland,Kedah,316,169,147
1/02/2024,Switzerland,Kelantan,1,0,1
1/02/2024,Switzerland,Negeri Sembilan,1,1,0
1/02/2024,Switzerland,Pahang,1,1,0
1/02/2024,Switzerland,Perak,19,13,6
1/02/2024,Switzerland,Perlis,26,18,8
1/02/2024,Switzerland,Pulau Pinang,178,104,74
1/02/2024,Switzerland,Sabah,47,25,22
1/02/2024,Switzerland,Sarawak,40,18,22
1/02/2024,Switzerland,Selangor,1798,1037,761
1/02/2024,Switzerland,W.P. Labuan,1,1,0
1/02/2024,Chile,Johor,65,37,28
1/02/2024,Chile,Kedah,28,11,17
1/02/2024,Chile,Kelantan,1,1,0
1/02/2024,Chile,Perlis,5,4,1
1/02/2024,Chile,Pulau Pinang,11,5,6
1/02/2024,Chile,Sabah,6,3,3
1/02/2024,Chile,Sarawak,2,2,0
1/02/2024,Chile,Selangor,501,232,269
1/02/2024,China,Johor,78786,34787,43999
1/02/2024,China,Kedah,6529,2856,3673
1/02/2024,China,Kelantan,56,32,24
1/02/2024,China,Melaka,8,4,4
1/02/2024,China,Pahang,58,36,22
1/02/2024,China,Perak,288,122,166
1/02/2024,China,Perlis,620,336,284
1/02/2024,China,Pulau Pinang,13500,6614,6886
1/02/2024,China,Sabah,34953,15397,19556
1/02/2024,China,Sarawak,1919,885,1034
1/02/2024,China,Selangor,205226,97688,107538
1/02/2024,China,W.P. Labuan,60,46,14
1/02/2024,Côte d'Ivoire,Selangor,34,24,10
1/02/2024,Cameroon,Kedah,3,1,2
1/02/2024,Cameroon,Pulau Pinang,3,1,2
1/02/2024,Cameroon,Selangor,18,15,3
1/02/2024,Congo,Johor,2,2,0
1/02/2024,Congo,Selangor,17,13,4
1/02/2024,Congo,Selangor,6,5,1
1/02/2024,Colombia,Johor,29,17,12
1/02/2024,Colombia,Kedah,5,0,5
1/02/2024,Colombia,Perak,1,1,0
1/02/2024,Colombia,Pulau Pinang,5,4,1
1/02/2024,Colombia,Sabah,4,2,2
1/02/2024,Colombia,Selangor,160,89,71
1/02/2024,Comoros,Johor,1,1,0
1/02/2024,Comoros,Selangor,11,10,1
1/02/2024,Cabo Verde,Johor,1,0,1
1/02/2024,Cabo Verde,Selangor,6,4,2
1/02/2024,Costa Rica,Johor,10,6,4
1/02/2024,Costa Rica,Kedah,1,0,1
1/02/2024,Costa Rica,Pulau Pinang,7,2,5
1/02/2024,Costa Rica,Sabah,3,2,1
1/02/2024,Costa Rica,Selangor,69,40,29
1/02/2024,Cuba,Johor,6,4,2
1/02/2024,Cuba,Pulau Pinang,1,1,0
1/02/2024,Cuba,Sabah,1,1,0
1/02/2024,Cuba,Selangor,24,8,16
1/02/2024,Cyprus,Johor,4,3,1
1/02/2024,Cyprus,Pulau Pinang,1,1,0
1/02/2024,Cyprus,Selangor,90,57,33
1/02/2024,Czechia,Johor,201,90,111
1/02/2024,Czechia,Kedah,326,153,173
1/02/2024,Czechia,Perlis,18,9,9
1/02/2024,Czechia,Pulau Pinang,62,31,31
1/02/2024,Czechia,Sabah,22,12,10
1/02/2024,Czechia,Sarawak,18,12,6
1/02/2024,Czechia,Selangor,1244,692,552
1/02/2024,Germany,Johor,2768,1641,1127
1/02/2024,Germany,Kedah,3358,1657,1701
1/02/2024,Germany,Kelantan,19,14,5
1/02/2024,Germany,Melaka,3,2,1
1/02/2024,Germany,Negeri Sembilan,3,2,1
1/02/2024,Germany,Pahang,9,6,3
1/02/2024,Germany,Perak,30,21,9
1/02/2024,Germany,Perlis,229,140,89
1/02/2024,Germany,Pulau Pinang,889,605,284
1/02/2024,Germany,Sabah,139,92,47
1/02/2024,Germany,Sarawak,270,145,125
1/02/2024,Germany,Selangor,15593,8534,7059
1/02/2024,Germany,W.P. Labuan,16,11,5
1/02/2024,Djibouti,Kedah,2,1,1
1/02/2024,Djibouti,Selangor,6,2,4
1/02/2024,Dominica,Johor,3,2,1
1/02/2024,Dominica,Pulau Pinang,4,4,0
1/02/2024,Dominica,Sarawak,1,0,1
1/02/2024,Dominica,Selangor,45,34,11
1/02/2024,Denmark,Johor,354,230,124
1/02/2024,Denmark,Kedah,427,194,233
1/02/2024,Denmark,Kelantan,7,7,0
1/02/2024,Denmark,Perak,6,4,2
1/02/2024,Denmark,Perlis,16,9,7
1/02/2024,Denmark,Pulau Pinang,106,65,41
1/02/2024,Denmark,Sabah,38,19,19
1/02/2024,Denmark,Sarawak,20,11,9
1/02/2024,Denmark,Selangor,1627,917,710
1/02/2024,Denmark,W.P. Labuan,3,1,2
1/02/2024,Dominican Republic,Johor,2,0,2
1/02/2024,Dominican Republic,Sabah,1,0,1
1/02/2024,Dominican Republic,Selangor,15,10,5
1/02/2024,Algeria,Johor,37,30,7
1/02/2024,Algeria,Kedah,9,7,2
1/02/2024,Algeria,Kelantan,1,1,0
1/02/2024,Algeria,Perlis,1,0,1
1/02/2024,Algeria,Pulau Pinang,1,1,0
1/02/2024,Algeria,Sabah,2,1,1
1/02/2024,Algeria,Sarawak,3,3,0
1/02/2024,Algeria,Selangor,811,522,289
1/02/2024,Ecuador,Johor,10,5,5
1/02/2024,Ecuador,Pulau Pinang,1,0,1
1/02/2024,Ecuador,Selangor,75,42,33
1/02/2024,Egypt,Johor,167,142,25
1/02/2024,Egypt,Kedah,23,14,9
1/02/2024,Egypt,Kelantan,2,0,2
1/02/2024,Egypt,Perlis,1,1,0
1/02/2024,Egypt,Pulau Pinang,20,12,8
1/02/2024,Egypt,Sabah,5,4,1
1/02/2024,Egypt,Sarawak,139,78,61
1/02/2024,Egypt,Selangor,2355,1499,856
1/02/2024,Eritrea,Selangor,22,12,10
1/02/2024,Spain,Johor,547,340,207
1/02/2024,Spain,Kedah,279,140,139
1/02/2024,Spain,Kelantan,3,2,1
1/02/2024,Spain,Melaka,1,1,0
1/02/2024,Spain,Perak,2,1,1
1/02/2024,Spain,Perlis,31,18,13
1/02/2024,Spain,Pulau Pinang,170,99,71
1/02/2024,Spain,Sabah,81,50,31
1/02/2024,Spain,Sarawak,59,39,20
1/02/2024,Spain,Selangor,2441,1420,1021
1/02/2024,Spain,W.P. Labuan,5,3,2
1/02/2024,Estonia,Johor,91,47,44
1/02/2024,Estonia,Kedah,158,77,81
1/02/2024,Estonia,Perlis,2,1,1
1/02/2024,Estonia,Pulau Pinang,34,17,17
1/02/2024,Estonia,Sabah,6,2,4
1/02/2024,Estonia,Selangor,525,247,278
1/02/2024,Ethiopia,Johor,6,4,2
1/02/2024,Ethiopia,Pulau Pinang,1,1,0
1/02/2024,Ethiopia,Selangor,51,43,8
1/02/2024,Finland,Johor,324,181,143
1/02/2024,Finland,Kedah,291,125,166
1/02/2024,Finland,Kelantan,1,0,1
1/02/2024,Finland,Perak,6,3,3
1/02/2024,Finland,Perlis,25,15,10
1/02/2024,Finland,Pulau Pinang,63,36,27
1/02/2024,Finland,Sabah,35,17,18
1/02/2024,Finland,Sarawak,8,4,4
1/02/2024,Finland,Selangor,936,513,423
1/02/2024,Fiji,Johor,43,24,19
1/02/2024,Fiji,Kedah,2,1,1
1/02/2024,Fiji,Pulau Pinang,2,0,2
1/02/2024,Fiji,Selangor,69,34,35
1/02/2024,Fiji,Terengganu,1,1,0
1/02/2024,France,Johor,2574,1459,1115
1/02/2024,France,Kedah,1729,889,840
1/02/2024,France,Kelantan,28,17,11
1/02/2024,France,Melaka,8,5,3
1/02/2024,France,Pahang,18,7,11
1/02/2024,France,Perak,26,18,8
1/02/2024,France,Perlis,145,89,56
1/02/2024,France,Pulau Pinang,527,307,220
1/02/2024,France,Sabah,207,111,96
1/02/2024,France,Sarawak,96,68,28
1/02/2024,France,Selangor,12007,6802,5205
1/02/2024,France,W.P. Labuan,5,5,0
1/02/2024,"Micronesia, Federated States of",Johor,1,0,1
1/02/2024,Gabon,Sabah,1,0,1
1/02/2024,Gabon,Selangor,12,9,3
1/02/2024,United Kingdom of Great Britain and Northern Ireland,Johor,5087,3143,1944
1/02/2024,United Kingdom of Great Britain and Northern Ireland,Kedah,3642,1813,1829
1/02/2024,United Kingdom of Great Britain and Northern Ireland,Kelantan,29,16,13
1/02/2024,United Kingdom of Great Britain and Northern Ireland,Melaka,10,5,5
1/02/2024,United Kingdom of Great Britain and Northern Ireland,Negeri Sembilan,1,1,0
1/02/2024,United Kingdom of Great Britain and Northern Ireland,Pahang,18,13,5
1/02/2024,United Kingdom of Great Britain and Northern Ireland,Perak,137,85,52
1/02/2024,United Kingdom of Great Britain and Northern Ireland,Perlis,268,170,98
1/02/2024,United Kingdom of Great Britain and Northern Ireland,Pulau Pinang,2040,1194,846
1/02/2024,United Kingdom of Great Britain and Northern Ireland,Sabah,553,301,252
1/02/2024,United Kingdom of Great Britain and Northern Ireland,Sarawak,1250,748,502
1/02/2024,United Kingdom of Great Britain and Northern Ireland,Selangor,26155,15188,10967
1/02/2024,United Kingdom of Great Britain and Northern Ireland,W.P. Labuan,116,73,43
1/02/2024,Georgia,Johor,4,3,1
1/02/2024,Georgia,Kedah,7,3,4
1/02/2024,Georgia,Pulau Pinang,1,1,0
1/02/2024,Georgia,Sabah,2,0,2
1/02/2024,Georgia,Selangor,73,37,36
1/02/2024,Ghana,Johor,7,6,1
1/02/2024,Ghana,Pulau Pinang,1,1,0
1/02/2024,Ghana,Sabah,2,1,1
1/02/2024,Ghana,Selangor,86,60,26
1/02/2024,Guinea,Johor,7,4,3
1/02/2024,Guinea,Selangor,71,52,19
1/02/2024,Gambia,Johor,3,2,1
1/02/2024,Gambia,Sabah,1,1,0
1/02/2024,Gambia,Selangor,24,16,8
1/02/2024,Equatorial Guinea,Selangor,2,1,1
1/02/2024,Greece,Johor,55,35,20
1/02/2024,Greece,Kedah,38,19,19
1/02/2024,Greece,Perak,2,2,0
1/02/2024,Greece,Perlis,5,4,1
1/02/2024,Greece,Pulau Pinang,19,8,11
1/02/2024,Greece,Sabah,8,5,3
1/02/2024,Greece,Sarawak,4,1,3
1/02/2024,Greece,Selangor,331,212,119
1/02/2024,Grenada,Johor,7,4,3
1/02/2024,Grenada,Pulau Pinang,1,1,0
1/02/2024,Grenada,Selangor,3,2,1
1/02/2024,Greenland,Johor,1,0,1
1/02/2024,Guatemala,Johor,9,7,2
1/02/2024,Guatemala,Pulau Pinang,2,0,2
1/02/2024,Guatemala,Selangor,18,11,7
1/02/2024,Guyana,Johor,4,3,1
1/02/2024,Guyana,Sabah,1,1,0
1/02/2024,Guyana,Selangor,8,4,4
1/02/2024,Hong Kong,Johor,17,11,6
1/02/2024,Hong Kong,Pahang,1,0,1
1/02/2024,Hong Kong,Perak,20,12,8
1/02/2024,Hong Kong,Pulau Pinang,2,2,0
1/02/2024,Hong Kong,Sabah,1141,504,637
1/02/2024,Hong Kong,Selangor,380,188,192
1/02/2024,Honduras,Johor,6,4,2
1/02/2024,Honduras,Sabah,2,0,2
1/02/2024,Honduras,Selangor,17,8,9
1/02/2024,Croatia,Johor,29,22,7
1/02/2024,Croatia,Kedah,9,7,2
1/02/2024,Croatia,Perlis,2,1,1
1/02/2024,Croatia,Pulau Pinang,7,5,2
1/02/2024,Croatia,Sabah,6,4,2
1/02/2024,Croatia,Selangor,257,139,118
1/02/2024,Haiti,Sabah,1,1,0
1/02/2024,Haiti,Selangor,8,7,1
1/02/2024,Hungary,Johor,142,82,60
1/02/2024,Hungary,Kedah,157,77,80
1/02/2024,Hungary,Kelantan,1,1,0
1/02/2024,Hungary,Perak,1,1,0
1/02/2024,Hungary,Perlis,18,10,8
1/02/2024,Hungary,Pulau Pinang,49,22,27
1/02/2024,Hungary,Sabah,40,19,21
1/02/2024,Hungary,Sarawak,55,25,30
1/02/2024,Hungary,Selangor,1051,581,470
1/02/2024,Hungary,W.P. Labuan,1,0,1
1/02/2024,Indonesia,Johor,94247,42469,51778
1/02/2024,Indonesia,Kedah,6860,2604,4256
1/02/2024,Indonesia,Kelantan,180,101,79
1/02/2024,Indonesia,Melaka,3199,1425,1774
1/02/2024,Indonesia,Negeri Sembilan,4386,2547,1839
1/02/2024,Indonesia,Pahang,17,4,13
1/02/2024,Indonesia,Perak,242,63,179
1/02/2024,Indonesia,Perlis,806,248,558
1/02/2024,Indonesia,Pulau Pinang,35586,14042,21544
1/02/2024,Indonesia,Sabah,4787,2293,2494
1/02/2024,Indonesia,Sarawak,40468,20489,19979
1/02/2024,Indonesia,Selangor,142789,65413,77376
1/02/2024,Indonesia,Terengganu,1,1,0
1/02/2024,Indonesia,W.P. Labuan,57,27,30
1/02/2024,India,Johor,30844,22017,8827
1/02/2024,India,Kedah,1229,747,482
1/02/2024,India,Kelantan,14,10,4
1/02/2024,India,Melaka,2,2,0
1/02/2024,India,Negeri Sembilan,2,2,0
1/02/2024,India,Pahang,5,3,2
1/02/2024,India,Perak,190,140,50
1/02/2024,India,Perlis,93,76,17
1/02/2024,India,Pulau Pinang,964,683,281
1/02/2024,India,Sabah,186,123,63
1/02/2024,India,Sarawak,2755,2150,605
1/02/2024,India,Selangor,53318,36675,16643
1/02/2024,India,Terengganu,2,1,1
1/02/2024,India,W.P. Labuan,141,101,40
1/02/2024, British Indian Ocean Territory,Selangor,1,0,1
1/02/2024,Ireland,Johor,287,173,114
1/02/2024,Ireland,Kedah,127,66,61
1/02/2024,Ireland,Kelantan,1,1,0
1/02/2024,Ireland,Perak,9,3,6
1/02/2024,Ireland,Perlis,19,12,7
1/02/2024,Ireland,Pulau Pinang,163,111,52
1/02/2024,Ireland,Sabah,27,16,11
1/02/2024,Ireland,Sarawak,36,17,19
1/02/2024,Ireland,Selangor,1532,894,638
1/02/2024,Ireland,W.P. Labuan,6,5,1
1/02/2024,"Iran, Islamic Republic of",Johor,362,164,198
1/02/2024,"Iran, Islamic Republic of",Kedah,6,2,4
1/02/2024,"Iran, Islamic Republic of",Kelantan,4,3,1
1/02/2024,"Iran, Islamic Republic of",Pulau Pinang,10,6,4
1/02/2024,"Iran, Islamic Republic of",Sabah,5,2,3
1/02/2024,"Iran, Islamic Republic of",Sarawak,1,1,0
1/02/2024,"Iran, Islamic Republic of",Selangor,1754,896,858
1/02/2024,Iraq,Johor,45,25,20
1/02/2024,Iraq,Kelantan,2,1,1
1/02/2024,Iraq,Perlis,2,2,0
1/02/2024,Iraq,Pulau Pinang,2,1,1
1/02/2024,Iraq,Sarawak,10,6,4
1/02/2024,Iraq,Selangor,1755,1117,638
1/02/2024,Iceland,Johor,2,2,0
1/02/2024,Iceland,Kedah,6,4,2
1/02/2024,Iceland,Pulau Pinang,3,2,1
1/02/2024,Iceland,Sabah,3,2,1
1/02/2024,Iceland,Selangor,41,22,19
1/02/2024,Israel,Selangor,1,1,0
1/02/2024,Italy,Johor,580,373,207
1/02/2024,Italy,Kedah,838,450,388
1/02/2024,Italy,Kelantan,4,3,1
1/02/2024,Italy,Melaka,3,2,1
1/02/2024,Italy,Negeri Sembilan,1,1,0
1/02/2024,Italy,Pahang,2,2,0
1/02/2024,Italy,Perak,5,5,0
1/02/2024,Italy,Perlis,58,43,15
1/02/2024,Italy,Pulau Pinang,149,107,42
1/02/2024,Italy,Sabah,63,45,18
1/02/2024,Italy,Sarawak,61,41,20
1/02/2024,Italy,Selangor,3972,2480,1492
1/02/2024,Italy,Terengganu,2,1,1
1/02/2024,Italy,W.P. Labuan,3,2,1
1/02/2024,Jamaica,Johor,10,3,7
1/02/2024,Jamaica,Kedah,1,1,0
1/02/2024,Jamaica,Pulau Pinang,2,0,2
1/02/2024,Jamaica,Sabah,1,0,1
1/02/2024,Jamaica,Selangor,50,18,32
1/02/2024,Jordan,Johor,29,23,6
1/02/2024,Jordan,Kedah,12,6,6
1/02/2024,Jordan,Perak,1,0,1
1/02/2024,Jordan,Pulau Pinang,10,5,5
1/02/2024,Jordan,Sabah,2,2,0
1/02/2024,Jordan,Selangor,761,475,286
1/02/2024,Japan,Johor,5913,3749,2164
1/02/2024,Japan,Kedah,509,259,250
1/02/2024,Japan,Kelantan,17,12,5
1/02/2024,Japan,Pahang,8,4,4
1/02/2024,Japan,Perak,64,37,27
1/02/2024,Japan,Perlis,166,123,43
1/02/2024,Japan,Pulau Pinang,1607,1020,587
1/02/2024,Japan,Sabah,632,328,304
1/02/2024,Japan,Sarawak,210,129,81
1/02/2024,Japan,Selangor,22366,13330,9036
1/02/2024,Japan,Terengganu,3,3,0
1/02/2024,Japan,W.P. Labuan,23,12,11
1/02/2024,Kazakhstan,Johor,53,17,36
1/02/2024,Kazakhstan,Kedah,32,11,21
1/02/2024,Kazakhstan,Kelantan,1,1,0
1/02/2024,Kazakhstan,Perlis,6,4,2
1/02/2024,Kazakhstan,Pulau Pinang,14,7,7
1/02/2024,Kazakhstan,Sabah,5,3,2
1/02/2024,Kazakhstan,Sarawak,15,10,5
1/02/2024,Kazakhstan,Selangor,1524,654,870
1/02/2024,Kazakhstan,W.P. Labuan,1,1,0
1/02/2024,Kenya,Johor,28,14,14
1/02/2024,Kenya,Kedah,4,4,0
1/02/2024,Kenya,Perlis,2,0,2
1/02/2024,Kenya,Pulau Pinang,24,9,15
1/02/2024,Kenya,Sabah,6,2,4
1/02/2024,Kenya,Sarawak,3,2,1
1/02/2024,Kenya,Selangor,343,202,141
1/02/2024,Kyrgyzstan,Johor,40,27,13
1/02/2024,Kyrgyzstan,Kedah,4,3,1
1/02/2024,Kyrgyzstan,Pulau Pinang,3,0,3
1/02/2024,Kyrgyzstan,Sabah,2,1,1
1/02/2024,Kyrgyzstan,Selangor,374,176,198
1/02/2024,Cambodia,Johor,1442,614,828
1/02/2024,Cambodia,Kedah,299,235,64
1/02/2024,Cambodia,Kelantan,1379,1223,156
1/02/2024,Cambodia,Perak,7,6,1
1/02/2024,Cambodia,Perlis,1021,753,268
1/02/2024,Cambodia,Pulau Pinang,30,5,25
1/02/2024,Cambodia,Sabah,2,0,2
1/02/2024,Cambodia,Sarawak,4,1,3
1/02/2024,Cambodia,Selangor,3187,1500,1687
1/02/2024,Kiribati,Johor,5,2,3
1/02/2024,Saint Kitts and Nevis,Johor,18,11,7
1/02/2024,Saint Kitts and Nevis,Kedah,4,2,2
1/02/2024,Saint Kitts and Nevis,Pulau Pinang,1,1,0
1/02/2024,Saint Kitts and Nevis,Sarawak,1,1,0
1/02/2024,Saint Kitts and Nevis,Selangor,62,43,19
1/02/2024,"Korea, Republic of",Johor,14699,7432,7267
1/02/2024,"Korea, Republic of",Kedah,412,178,234
1/02/2024,"Korea, Republic of",Kelantan,7,5,2
1/02/2024,"Korea, Republic of",Melaka,2,1,1
1/02/2024,"Korea, Republic of",Negeri Sembilan,1,0,1
1/02/2024,"Korea, Republic of",Pahang,2,0,2
1/02/2024,"Korea, Republic of",Perak,31,11,20
1/02/2024,"Korea, Republic of",Perlis,62,49,13
1/02/2024,"Korea, Republic of",Pulau Pinang,614,341,273
1/02/2024,"Korea, Republic of",Sabah,16079,6940,9139
1/02/2024,"Korea, Republic of",Sarawak,305,164,141
1/02/2024,"Korea, Republic of",Selangor,18849,10064,8785
1/02/2024,"Korea, Republic of",W.P. Labuan,23,18,5
1/02/2024,Kuwait,Johor,6,2,4
1/02/2024,Kuwait,Kedah,4,2,2
1/02/2024,Kuwait,Kelantan,1,1,0
1/02/2024,Kuwait,Perlis,1,1,0
1/02/2024,Kuwait,Pulau Pinang,4,2,2
1/02/2024,Kuwait,Sarawak,1,1,0
1/02/2024,Kuwait,Selangor,393,253,140
1/02/2024,Kuwait,W.P. Labuan,1,1,0
1/02/2024, Lao People's Democratic Republic,Johor,133,28,105
1/02/2024, Lao People's Democratic Republic,Kedah,1228,96,1132
1/02/2024, Lao People's Democratic Republic,Kelantan,1075,971,104
1/02/2024, Lao People's Democratic Republic,Perak,37,1,36
1/02/2024, Lao People's Democratic Republic,Perlis,522,83,439
1/02/2024, Lao People's Democratic Republic,Pulau Pinang,18,2,16
1/02/2024, Lao People's Democratic Republic,Sarawak,16,7,9
1/02/2024, Lao People's Democratic Republic,Selangor,259,98,161
1/02/2024,Lebanon,Johor,27,21,6
1/02/2024,Lebanon,Kedah,7,3,4
1/02/2024,Lebanon,Pulau Pinang,4,3,1
1/02/2024,Lebanon,Sabah,4,4,0
1/02/2024,Lebanon,Sarawak,7,7,0
1/02/2024,Lebanon,Selangor,324,203,121
1/02/2024,Liberia,Selangor,6,5,1
1/02/2024,Libya,Johor,9,6,3
1/02/2024,Libya,Kedah,3,3,0
1/02/2024,Libya,Pulau Pinang,1,1,0
1/02/2024,Libya,Selangor,264,190,74
1/02/2024,Saint Lucia,Johor,2,2,0
1/02/2024,Saint Lucia,Pulau Pinang,1,1,0
1/02/2024,Saint Lucia,Selangor,16,11,5
1/02/2024,Liechtenstein,Johor,2,1,1
1/02/2024,Liechtenstein,Selangor,2,2,0
1/02/2024,LKA,Johor,688,442,246
1/02/2024,LKA,Kedah,16,14,2
1/02/2024,LKA,Melaka,1,1,0
1/02/2024,LKA,Perak,5,3,2
1/02/2024,LKA,Perlis,1,1,0
1/02/2024,LKA,Pulau Pinang,31,20,11
1/02/2024,LKA,Sabah,5,3,2
1/02/2024,LKA,Sarawak,24,15,9
1/02/2024,LKA,Selangor,3784,2425,1359
1/02/2024,Lesotho,Selangor,7,4,3
1/02/2024,Lithuania,Johor,123,55,68
1/02/2024,Lithuania,Kedah,194,90,104
1/02/2024,Lithuania,Kelantan,1,1,0
1/02/2024,Lithuania,Perlis,14,6,8
1/02/2024,Lithuania,Pulau Pinang,35,14,21
1/02/2024,Lithuania,Sabah,19,10,9
1/02/2024,Lithuania,Sarawak,10,4,6
1/02/2024,Lithuania,Selangor,1510,697,813
1/02/2024,Lithuania,W.P. Labuan,31,11,20
1/02/2024,Luxembourg,Johor,19,13,6
1/02/2024,Luxembourg,Kedah,9,5,4
1/02/2024,Luxembourg,Pulau Pinang,4,4,0
1/02/2024,Luxembourg,Sabah,5,2,3
1/02/2024,Luxembourg,Sarawak,3,2,1
1/02/2024,Luxembourg,Selangor,56,31,25
1/02/2024,Latvia,Johor,60,25,35
1/02/2024,Latvia,Kedah,62,25,37
1/02/2024,Latvia,Perlis,2,1,1
1/02/2024,Latvia,Pulau Pinang,6,3,3
1/02/2024,Latvia,Sabah,36,7,29
1/02/2024,Latvia,Sarawak,53,19,34
1/02/2024,Latvia,Selangor,346,172,174
1/02/2024,Macao,Johor,1,0,1
1/02/2024,Macao,Perak,2,2,0
1/02/2024,Macao,Selangor,18,7,11
1/02/2024,Morocco,Johor,69,42,27
1/02/2024,Morocco,Kedah,17,10,7
1/02/2024,Morocco,Kelantan,1,1,0
1/02/2024,Morocco,Perlis,1,1,0
1/02/2024,Morocco,Pulau Pinang,11,7,4
1/02/2024,Morocco,Sabah,2,2,0
1/02/2024,Morocco,Sarawak,9,6,3
1/02/2024,Morocco,Selangor,1079,615,464
1/02/2024,Monaco,Pulau Pinang,1,1,0
1/02/2024,Monaco,Selangor,7,4,3
1/02/2024,"Moldova, Republic of",Johor,5,2,3
1/02/2024,"Moldova, Republic of",Kedah,5,1,4
1/02/2024,"Moldova, Republic of",Sarawak,2,0,2
1/02/2024,"Moldova, Republic of",Selangor,37,15,22
1/02/2024,Madagascar,Johor,14,6,8
1/02/2024,Madagascar,Kedah,1,1,0
1/02/2024,Madagascar,Selangor,48,24,24
1/02/2024,Maldives,Johor,153,70,83
1/02/2024,Maldives,Kedah,2,2,0
1/02/2024,Maldives,Sabah,1,1,0
1/02/2024,Maldives,Sarawak,5,1,4
1/02/2024,Maldives,Selangor,2466,1338,1128
1/02/2024,Mexico,Johor,153,76,77
1/02/2024,Mexico,Kedah,8,2,6
1/02/2024,Mexico,Kelantan,1,0,1
1/02/2024,Mexico,Perlis,2,1,1
1/02/2024,Mexico,Pulau Pinang,24,23,1
1/02/2024,Mexico,Sabah,11,6,5
1/02/2024,Mexico,Sarawak,4,3,1
1/02/2024,Mexico,Selangor,650,319,331
1/02/2024,Marshall Islands,Johor,1,1,0
1/02/2024,Marshall Islands,Selangor,7,6,1
1/02/2024,North Macedonia,Johor,9,6,3
1/02/2024,North Macedonia,Kedah,7,4,3
1/02/2024,North Macedonia,Selangor,61,25,36
1/02/2024,Mali,Selangor,22,16,6
1/02/2024,Malta,Johor,3,1,2
1/02/2024,Malta,Kedah,2,1,1
1/02/2024,Malta,Perlis,1,1,0
1/02/2024,Malta,Selangor,51,31,20
1/02/2024,Myanmar,Johor,6855,2155,4700
1/02/2024,Myanmar,Kedah,107,24,83
1/02/2024,Myanmar,Kelantan,4,2,2
1/02/2024,Myanmar,Melaka,1,0,1
1/02/2024,Myanmar,Negeri Sembilan,1,1,0
1/02/2024,Myanmar,Pahang,3,2,1
1/02/2024,Myanmar,Perak,32,5,27
1/02/2024,Myanmar,Perlis,14,1,13
1/02/2024,Myanmar,Pulau Pinang,379,184,195
1/02/2024,Myanmar,Sabah,26,5,21
1/02/2024,Myanmar,Sarawak,107,44,63
1/02/2024,Myanmar,Selangor,5438,3506,1932
1/02/2024,Myanmar,W.P. Labuan,7,1,6
1/02/2024,Montenegro,Pulau Pinang,1,1,0
1/02/2024,Montenegro,Selangor,19,14,5
1/02/2024,Mongolia,Johor,282,118,164
1/02/2024,Mongolia,Kedah,6,3,3
1/02/2024,Mongolia,Perak,1,0,1
1/02/2024,Mongolia,Perlis,2,0,2
1/02/2024,Mongolia,Pulau Pinang,3,1,2
1/02/2024,Mongolia,Sabah,5,0,5
1/02/2024,Mongolia,Selangor,407,179,228
1/02/2024,Mozambique,Selangor,23,9,14
1/02/2024,Mauritania,Johor,3,2,1
1/02/2024,Mauritania,Sabah,1,1,0
1/02/2024,Mauritania,Selangor,28,19,9
1/02/2024,Mauritius,Johor,115,59,56
1/02/2024,Mauritius,Kedah,5,4,1
1/02/2024,Mauritius,Kelantan,3,2,1
1/02/2024,Mauritius,Pulau Pinang,3,1,2
1/02/2024,Mauritius,Sarawak,3,1,2
1/02/2024,Mauritius,Selangor,1476,732,744
1/02/2024,Malawi,Pulau Pinang,1,0,1
1/02/2024,Malawi,Sabah,1,1,0
1/02/2024,Malawi,Sarawak,1,0,1
1/02/2024,Malawi,Selangor,18,9,9
1/02/2024,Namibia,Selangor,12,7,5
1/02/2024,New Caledonia,Selangor,1,1,0
1/02/2024,Niger,Johor,4,4,0
1/02/2024,Niger,Selangor,3,3,0
1/02/2024,Nigeria,Johor,23,19,4
1/02/2024,Nigeria,Kedah,2,2,0
1/02/2024,Nigeria,Kelantan,3,2,1
1/02/2024,Nigeria,Pulau Pinang,4,3,1
1/02/2024,Nigeria,Sabah,1,1,0
1/02/2024,Nigeria,Sarawak,18,14,4
1/02/2024,Nigeria,Selangor,363,294,69
1/02/2024,Nicaragua,Johor,2,1,1
1/02/2024,Nicaragua,Selangor,11,4,7
1/02/2024,Netherlands,Johor,1028,687,341
1/02/2024,Netherlands,Kedah,548,297,251
1/02/2024,Netherlands,Kelantan,9,6,3
1/02/2024,Netherlands,Melaka,1,1,0
1/02/2024,Netherlands,Negeri Sembilan,1,1,0
1/02/2024,Netherlands,Perak,17,10,7
1/02/2024,Netherlands,Perlis,70,46,24
1/02/2024,Netherlands,Pulau Pinang,329,206,123
1/02/2024,Netherlands,Sabah,76,43,33
1/02/2024,Netherlands,Sarawak,139,86,53
1/02/2024,Netherlands,Selangor,4942,2834,2108
1/02/2024,Netherlands,W.P. Labuan,10,7,3
1/02/2024,Norway,Johor,199,117,82
1/02/2024,Norway,Kedah,193,77,116
1/02/2024,Norway,Perak,2,0,2
1/02/2024,Norway,Perlis,23,11,12
1/02/2024,Norway,Pulau Pinang,62,34,28
1/02/2024,Norway,Sabah,8,6,2
1/02/2024,Norway,Sarawak,17,13,4
1/02/2024,Norway,Selangor,1112,608,504
1/02/2024,Norway,W.P. Labuan,1,1,0
1/02/2024,Nepal,Johor,1336,1028,308
1/02/2024,Nepal,Kedah,16,14,2
1/02/2024,Nepal,Kelantan,1,1,0
1/02/2024,Nepal,Perlis,2,2,0
1/02/2024,Nepal,Pulau Pinang,44,41,3
1/02/2024,Nepal,Sabah,1,1,0
1/02/2024,Nepal,Sarawak,196,134,62
1/02/2024,Nepal,Selangor,7542,6998,544
1/02/2024,Nepal,W.P. Labuan,91,77,14
1/02/2024,Nauru,Selangor,1,1,0
1/02/2024,New Zealand,Johor,809,468,341
1/02/2024,New Zealand,Kedah,79,46,33
1/02/2024,New Zealand,Kelantan,4,3,1
1/02/2024,New Zealand,Melaka,2,1,1
1/02/2024,New Zealand,Perak,17,10,7
1/02/2024,New Zealand,Perlis,17,9,8
1/02/2024,New Zealand,Pulau Pinang,184,101,83
1/02/2024,New Zealand,Sabah,75,44,31
1/02/2024,New Zealand,Sarawak,110,62,48
1/02/2024,New Zealand,Selangor,2534,1536,998
1/02/2024,New Zealand,Terengganu,2,1,1
1/02/2024,New Zealand,W.P. Labuan,6,3,3
1/02/2024,Oman,Johor,30,20,10
1/02/2024,Oman,Kedah,9,7,2
1/02/2024,Oman,Perak,2,1,1
1/02/2024,Oman,Perlis,7,5,2
1/02/2024,Oman,Sarawak,16,9,7
1/02/2024,Oman,Selangor,1168,709,459
1/02/2024,Pakistan,Johor,721,558,163
1/02/2024,Pakistan,Kedah,122,101,21
1/02/2024,Pakistan,Kelantan,25,24,1
1/02/2024,Pakistan,Perak,3,1,2
1/02/2024,Pakistan,Perlis,25,22,3
1/02/2024,Pakistan,Pulau Pinang,107,101,6
1/02/2024,Pakistan,Sabah,18,15,3
1/02/2024,Pakistan,Sarawak,116,90,26
1/02/2024,Pakistan,Selangor,10478,8760,1718
1/02/2024,Pakistan,W.P. Labuan,4,3,1
1/02/2024,Panama,Johor,8,5,3
1/02/2024,Panama,Kedah,2,1,1
1/02/2024,Panama,Pulau Pinang,3,2,1
1/02/2024,Panama,Selangor,45,15,30
1/02/2024,Peru,Johor,42,22,20
1/02/2024,Peru,Kedah,3,3,0
1/02/2024,Peru,Perlis,4,3,1
1/02/2024,Peru,Pulau Pinang,3,2,1
1/02/2024,Peru,Sarawak,3,1,2
1/02/2024,Peru,Selangor,139,65,74
1/02/2024,Philippines,Johor,20285,5943,14342
1/02/2024,Philippines,Kedah,448,122,326
1/02/2024,Philippines,Kelantan,16,7,9
1/02/2024,Philippines,Melaka,1,0,1
1/02/2024,Philippines,Negeri Sembilan,2,2,0
1/02/2024,Philippines,Pahang,19,16,3
1/02/2024,Philippines,Perak,49,10,39
1/02/2024,Philippines,Perlis,283,86,197
1/02/2024,Philippines,Pulau Pinang,633,242,391
1/02/2024,Philippines,Sabah,1445,584,861
1/02/2024,Philippines,Sarawak,3229,1334,1895
1/02/2024,Philippines,Selangor,14564,5668,8896
1/02/2024,Philippines,Terengganu,2,0,2
1/02/2024,Philippines,W.P. Labuan,111,47,64
1/02/2024,Papua New Guinea,Johor,17,5,12
1/02/2024,Papua New Guinea,Perak,1,1,0
1/02/2024,Papua New Guinea,Pulau Pinang,1,1,0
1/02/2024,Papua New Guinea,Sarawak,10,5,5
1/02/2024,Papua New Guinea,Selangor,88,51,37
1/02/2024,Poland,Johor,943,486,457
1/02/2024,Poland,Kedah,601,299,302
1/02/2024,Poland,Kelantan,11,6,5
1/02/2024,Poland,Melaka,1,1,0
1/02/2024,Poland,Perak,1,0,1
1/02/2024,Poland,Perlis,49,28,21
1/02/2024,Poland,Pulau Pinang,110,56,54
1/02/2024,Poland,Sabah,110,49,61
1/02/2024,Poland,Sarawak,47,27,20
1/02/2024,Poland,Selangor,2980,1499,1481
1/02/2024,Poland,W.P. Labuan,3,3,0
1/02/2024,Portugal,Johor,281,152,129
1/02/2024,Portugal,Kedah,124,63,61
1/02/2024,Portugal,Kelantan,1,1,0
1/02/2024,Portugal,Perak,1,1,0
1/02/2024,Portugal,Perlis,6,3,3
1/02/2024,Portugal,Pulau Pinang,55,29,26
1/02/2024,Portugal,Sabah,20,11,9
1/02/2024,Portugal,Sarawak,9,6,3
1/02/2024,Portugal,Selangor,811,435,376
1/02/2024,Paraguay,Johor,5,1,4
1/02/2024,Paraguay,Perlis,1,0,1
1/02/2024,Paraguay,Pulau Pinang,2,1,1
1/02/2024,Paraguay,Selangor,12,5,7
1/02/2024,"Palestine, State of",Johor,14,14,0
1/02/2024,"Palestine, State of",Kedah,2,1,1
1/02/2024,"Palestine, State of",Sarawak,2,2,0
1/02/2024,"Palestine, State of",Selangor,272,193,79
1/02/2024,Qatar,Johor,5,5,0
1/02/2024,Qatar,Kedah,1,1,0
1/02/2024,Qatar,Selangor,150,121,29
1/02/2024,Romania,Johor,145,94,51
1/02/2024,Romania,Kedah,92,42,50
1/02/2024,Romania,Perak,1,0,1
1/02/2024,Romania,Perlis,4,3,1
1/02/2024,Romania,Pulau Pinang,36,19,17
1/02/2024,Romania,Sabah,16,13,3
1/02/2024,Romania,Sarawak,10,8,2
1/02/2024,Romania,Selangor,1226,603,623
1/02/2024,Russian Federation (Russia),Johor,409,201,208
1/02/2024,Russian Federation (Russia),Kedah,690,329,361
1/02/2024,Russian Federation (Russia),Kelantan,29,11,18
1/02/2024,Russian Federation (Russia),Melaka,1,1,0
1/02/2024,Russian Federation (Russia),Perak,3,1,2
1/02/2024,Russian Federation (Russia),Perlis,114,64,50
1/02/2024,Russian Federation (Russia),Pulau Pinang,204,101,103
1/02/2024,Russian Federation (Russia),Sabah,76,40,36
1/02/2024,Russian Federation (Russia),Sarawak,75,40,35
1/02/2024,Russian Federation (Russia),Selangor,12209,5796,6413
1/02/2024,Russian Federation (Russia),W.P. Labuan,5,3,2
1/02/2024,Rwanda,Selangor,6,3,3
1/02/2024,Saudi Arabia,Johor,202,124,78
1/02/2024,Saudi Arabia,Kedah,57,32,25
1/02/2024,Saudi Arabia,Kelantan,3,2,1
1/02/2024,Saudi Arabia,Perlis,8,4,4
1/02/2024,Saudi Arabia,Pulau Pinang,37,23,14
1/02/2024,Saudi Arabia,Sarawak,24,14,10
1/02/2024,Saudi Arabia,Selangor,4286,2428,1858
1/02/2024,Sudan,Johor,11,5,6
1/02/2024,Sudan,Kedah,6,3,3
1/02/2024,Sudan,Pulau Pinang,12,4,8
1/02/2024,Sudan,Sabah,2,2,0
1/02/2024,Sudan,Sarawak,1,1,0
1/02/2024,Sudan,Selangor,1077,607,470
1/02/2024,Sudan,W.P. Labuan,1,1,0
1/02/2024,Senegal,Johor,6,5,1
1/02/2024,Senegal,Sabah,1,1,0
1/02/2024,Senegal,Selangor,73,51,22
1/02/2024,Singapore,Johor,1069298,614417,454881
1/02/2024,Singapore,Kedah,3712,2013,1699
1/02/2024,Singapore,Kelantan,155,80,75
1/02/2024,Singapore,Melaka,25,14,11
1/02/2024,Singapore,Negeri Sembilan,1,1,0
1/02/2024,Singapore,Pahang,511,250,261
1/02/2024,Singapore,Perak,5490,2694,2796
1/02/2024,Singapore,Perlis,266,166,100
1/02/2024,Singapore,Pulau Pinang,15992,8254,7738
1/02/2024,Singapore,Sabah,2383,1215,1168
1/02/2024,Singapore,Sarawak,4161,2212,1949
1/02/2024,Singapore,Selangor,44117,23037,21080
1/02/2024,Singapore,W.P. Labuan,14,10,4
1/02/2024,Solomon Islands,Johor,3,2,1
1/02/2024,Solomon Islands,Pulau Pinang,1,0,1
1/02/2024,Solomon Islands,Sarawak,6,1,5
1/02/2024,Solomon Islands,Selangor,10,6,4
1/02/2024,Sierra Leone,Johor,4,3,1
1/02/2024,Sierra Leone,Kedah,1,1,0
1/02/2024,Sierra Leone,Selangor,15,13,2
1/02/2024,El Salvador,Johor,8,5,3
1/02/2024,El Salvador,Sarawak,1,1,0
1/02/2024,El Salvador,Selangor,12,9,3
1/02/2024,San Marino,Selangor,6,4,2
1/02/2024,Somalia,Johor,3,3,0
1/02/2024,Somalia,Kelantan,1,1,0
1/02/2024,Somalia,Selangor,265,145,120
1/02/2024,Serbia,Johor,13,9,4
1/02/2024,Serbia,Kedah,10,4,6
1/02/2024,Serbia,Perlis,1,0,1
1/02/2024,Serbia,Pulau Pinang,14,13,1
1/02/2024,Serbia,Sabah,2,1,1
1/02/2024,Serbia,Selangor,181,87,94
1/02/2024,South Sudan,Sarawak,3,1,2
1/02/2024,South Sudan,Selangor,40,29,11
1/02/2024,Suriname,Pulau Pinang,1,1,0
1/02/2024,Suriname,Selangor,13,7,6
1/02/2024,Slovakia,Johor,51,33,18
1/02/2024,Slovakia,Kedah,185,92,93
1/02/2024,Slovakia,Pahang,1,0,1
1/02/2024,Slovakia,Perlis,2,1,1
1/02/2024,Slovakia,Pulau Pinang,28,20,8
1/02/2024,Slovakia,Sabah,12,5,7
1/02/2024,Slovakia,Sarawak,4,2,2
1/02/2024,Slovakia,Selangor,641,350,291
1/02/2024,Slovakia,W.P. Labuan,1,1,0
1/02/2024,Slovenia,Johor,26,15,11
1/02/2024,Slovenia,Kedah,75,40,35
1/02/2024,Slovenia,Perlis,1,1,0
1/02/2024,Slovenia,Pulau Pinang,7,5,2
1/02/2024,Slovenia,Sabah,3,1,2
1/02/2024,Slovenia,Selangor,387,215,172
1/02/2024,Sweden,Johor,336,184,152
1/02/2024,Sweden,Kedah,539,235,304
1/02/2024,Sweden,Kelantan,12,10,2
1/02/2024,Sweden,Melaka,1,0,1
1/02/2024,Sweden,Perak,4,2,2
1/02/2024,Sweden,Perlis,28,19,9
1/02/2024,Sweden,Pulau Pinang,110,67,43
1/02/2024,Sweden,Sabah,46,30,16
1/02/2024,Sweden,Sarawak,8,7,1
1/02/2024,Sweden,Selangor,1928,1050,878
1/02/2024,Eswatini,Johor,3,1,2
1/02/2024,Eswatini,Selangor,13,5,8
1/02/2024,Seychelles,Johor,13,2,11
1/02/2024,Seychelles,Selangor,88,32,56
1/02/2024,Syrian Arab Republic,Johor,22,14,8
1/02/2024,Syrian Arab Republic,Kedah,8,5,3
1/02/2024,Syrian Arab Republic,Pulau Pinang,15,12,3
1/02/2024,Syrian Arab Republic,Sabah,1,1,0
1/02/2024,Syrian Arab Republic,Sarawak,1,1,0
1/02/2024,Syrian Arab Republic,Selangor,737,472,265
1/02/2024,Turks and Caicos Islands,Selangor,1,0,1
1/02/2024,TCD,Johor,5,4,1
1/02/2024,TCD,Selangor,30,23,7
1/02/2024,Togo,Selangor,5,2,3
1/02/2024,Thailand,Johor,6228,1632,4596
1/02/2024,Thailand,Kedah,63910,37844,26066
1/02/2024,Thailand,Kelantan,52876,26261,26615
1/02/2024,Thailand,Pahang,2,0,2
1/02/2024,Thailand,Perak,11982,5506,6476
1/02/2024,Thailand,Perlis,52916,30639,22277
1/02/2024,Thailand,Pulau Pinang,2123,735,1388
1/02/2024,Thailand,Sabah,58,16,42
1/02/2024,Thailand,Sarawak,479,148,331
1/02/2024,Thailand,Selangor,12217,4642,7575
1/02/2024,Thailand,W.P. Labuan,8,4,4
1/02/2024,Tajikistan,Johor,2,1,1
1/02/2024,Tajikistan,Kedah,4,2,2
1/02/2024,Tajikistan,Pulau Pinang,1,1,0
1/02/2024,Tajikistan,Sabah,5,3,2
1/02/2024,Tajikistan,Selangor,218,149,69
1/02/2024,Turkmenistan,Johor,5,5,0
1/02/2024,Turkmenistan,Kedah,1,0,1
1/02/2024,Turkmenistan,Sarawak,1,1,0
1/02/2024,Turkmenistan,Selangor,541,322,219
1/02/2024,Timor-Leste,Johor,13,6,7
1/02/2024,Timor-Leste,Pulau Pinang,5,3,2
1/02/2024,Timor-Leste,Sarawak,1,0,1
1/02/2024,Timor-Leste,Selangor,186,110,76
1/02/2024,Tonga,Johor,1,1,0
1/02/2024,Tonga,Pulau Pinang,1,1,0
1/02/2024,Tonga,Sabah,1,0,1
1/02/2024,Tonga,Selangor,18,14,4
1/02/2024,Trinidad and Tobago,Johor,2,1,1
1/02/2024,Trinidad and Tobago,Kedah,3,0,3
1/02/2024,Trinidad and Tobago,Pulau Pinang,3,1,2
1/02/2024,Trinidad and Tobago,Selangor,46,28,18
1/02/2024,Tunisia,Johor,12,7,5
1/02/2024,Tunisia,Kedah,9,8,1
1/02/2024,Tunisia,Melaka,2,0,2
1/02/2024,Tunisia,Pulau Pinang,13,8,5
1/02/2024,Tunisia,Sabah,1,1,0
1/02/2024,Tunisia,Sarawak,1,1,0
1/02/2024,Tunisia,Selangor,723,380,343
1/02/2024,Türkiye,Johor,349,235,114
1/02/2024,Türkiye,Kedah,70,44,26
1/02/2024,Türkiye,Kelantan,5,3,2
1/02/2024,Türkiye,Pahang,2,2,0
1/02/2024,Türkiye,Perak,1,1,0
1/02/2024,Türkiye,Perlis,27,21,6
1/02/2024,Türkiye,Pulau Pinang,34,26,8
1/02/2024,Türkiye,Sabah,8,6,2
1/02/2024,Türkiye,Sarawak,29,24,5
1/02/2024,Türkiye,Selangor,2033,1392,641
1/02/2024,Türkiye,Terengganu,1,1,0
1/02/2024,"Taiwan, Province of China",Johor,7987,3561,4426
1/02/2024,"Taiwan, Province of China",Kedah,350,160,190
1/02/2024,"Taiwan, Province of China",Kelantan,4,0,4
1/02/2024,"Taiwan, Province of China",Melaka,5,2,3
1/02/2024,"Taiwan, Province of China",Pahang,7,2,5
1/02/2024,"Taiwan, Province of China",Perak,97,57,40
1/02/2024,"Taiwan, Province of China",Perlis,50,22,28
1/02/2024,"Taiwan, Province of China",Pulau Pinang,4226,2064,2162
1/02/2024,"Taiwan, Province of China",Sabah,2958,1358,1600
1/02/2024,"Taiwan, Province of China",Sarawak,512,198,314
1/02/2024,"Taiwan, Province of China",Selangor,18869,9041,9828
1/02/2024,"Taiwan, Province of China",W.P. Labuan,3,2,1
1/02/2024,"Tanzania, United Republic of",Johor,30,9,21
1/02/2024,"Tanzania, United Republic of",Kedah,1,0,1
1/02/2024,"Tanzania, United Republic of",Sabah,3,3,0
1/02/2024,"Tanzania, United Republic of",Sarawak,2,2,0
1/02/2024,"Tanzania, United Republic of",Selangor,201,104,97
1/02/2024,Uganda,Johor,22,11,11
1/02/2024,Uganda,Pahang,1,0,1
1/02/2024,Uganda,Perlis,1,1,0
1/02/2024,Uganda,Pulau Pinang,1,0,1
1/02/2024,Uganda,Sarawak,2,1,1
1/02/2024,Uganda,Selangor,99,38,61
1/02/2024,Ukraine,Johor,124,52,72
1/02/2024,Ukraine,Kedah,75,30,45
1/02/2024,Ukraine,Kelantan,29,14,15
1/02/2024,Ukraine,Pahang,3,3,0
1/02/2024,Ukraine,Perlis,21,9,12
1/02/2024,Ukraine,Pulau Pinang,50,20,30
1/02/2024,Ukraine,Sabah,15,8,7
1/02/2024,Ukraine,Sarawak,1,1,0
1/02/2024,Ukraine,Selangor,1411,604,807
1/02/2024,Ukraine,W.P. Labuan,1,0,1
1/02/2024,Uruguay,Johor,10,7,3
1/02/2024,Uruguay,Kedah,4,3,1
1/02/2024,Uruguay,Perlis,1,0,1
1/02/2024,Uruguay,Sarawak,1,0,1
1/02/2024,Uruguay,Selangor,43,23,20
1/02/2024,United States of America,Johor,4880,2780,2100
1/02/2024,United States of America,Kedah,712,397,315
1/02/2024,United States of America,Kelantan,34,12,22
1/02/2024,United States of America,Melaka,6,5,1
1/02/2024,United States of America,Negeri Sembilan,2,2,0
1/02/2024,United States of America,Pahang,4,4,0
1/02/2024,United States of America,Perak,146,77,69
1/02/2024,United States of America,Perlis,157,108,49
1/02/2024,United States of America,Pulau Pinang,2250,1383,867
1/02/2024,United States of America,Sabah,505,293,212
1/02/2024,United States of America,Sarawak,333,161,172
1/02/2024,United States of America,Selangor,16666,9622,7044
1/02/2024,United States of America,Terengganu,3,1,2
1/02/2024,United States of America,W.P. Labuan,12,6,6
1/02/2024,Uzbekistan,Johor,68,52,16
1/02/2024,Uzbekistan,Kedah,29,18,11
1/02/2024,Uzbekistan,Perlis,1,0,1
1/02/2024,Uzbekistan,Pulau Pinang,8,5,3
1/02/2024,Uzbekistan,Sabah,4,3,1
1/02/2024,Uzbekistan,Sarawak,1,0,1
1/02/2024,Uzbekistan,Selangor,2049,1304,745
1/02/2024,Holy See,Selangor,1,1,0
1/02/2024,Saint Vincent and the Grenadines,Pulau Pinang,1,1,0
1/02/2024,Saint Vincent and the Grenadines,Selangor,1,1,0
1/02/2024,"Venezuela, Bolivarian Republic of",Johor,17,11,6
1/02/2024,"Venezuela, Bolivarian Republic of",Kedah,2,1,1
1/02/2024,"Venezuela, Bolivarian Republic of",Pulau Pinang,2,1,1
1/02/2024,"Venezuela, Bolivarian Republic of",Sabah,2,0,2
1/02/2024,"Venezuela, Bolivarian Republic of",Sarawak,2,1,1
1/02/2024,"Venezuela, Bolivarian Republic of",Selangor,98,56,42
1/02/2024,Viet Nam,Johor,11772,3810,7962
1/02/2024,Viet Nam,Kedah,336,56,280
1/02/2024,Viet Nam,Kelantan,18,7,11
1/02/2024,Viet Nam,Pahang,1,0,1
1/02/2024,Viet Nam,Perak,215,8,207
1/02/2024,Viet Nam,Perlis,224,21,203
1/02/2024,Viet Nam,Pulau Pinang,1151,266,885
1/02/2024,Viet Nam,Sabah,25,12,13
1/02/2024,Viet Nam,Sarawak,367,76,291
1/02/2024,Viet Nam,Selangor,18917,6545,12372
1/02/2024,Viet Nam,W.P. Labuan,7,4,3
1/02/2024,Vanuatu,Johor,36,28,8
1/02/2024,Vanuatu,Kedah,2,2,0
1/02/2024,Vanuatu,Pulau Pinang,4,4,0
1/02/2024,Vanuatu,Sabah,1,1,0
1/02/2024,Vanuatu,Sarawak,1,1,0
1/02/2024,Vanuatu,Selangor,106,92,14
1/02/2024, Samoa,Selangor,2,1,1
1/02/2024,Yemen,Johor,39,31,8
1/02/2024,Yemen,Kedah,10,8,2
1/02/2024,Yemen,Kelantan,1,1,0
1/02/2024,Yemen,Melaka,5,3,2
1/02/2024,Yemen,Pulau Pinang,12,8,4
1/02/2024,Yemen,Sabah,4,3,1
1/02/2024,Yemen,Sarawak,9,7,2
1/02/2024,Yemen,Selangor,1339,952,387
1/02/2024,South Africa,Johor,221,140,81
1/02/2024,South Africa,Kedah,24,14,10
1/02/2024,South Africa,Kelantan,3,2,1
1/02/2024,South Africa,Perak,3,2,1
1/02/2024,South Africa,Perlis,16,10,6
1/02/2024,South Africa,Pulau Pinang,57,33,24
1/02/2024,South Africa,Sabah,23,11,12
1/02/2024,South Africa,Sarawak,134,62,72
1/02/2024,South Africa,Selangor,1010,571,439
1/02/2024,South Africa,Terengganu,1,1,0
1/02/2024,South Africa,W.P. Labuan,21,6,15
1/02/2024,ZAR,Selangor,2,1,1
1/02/2024,Zambia,Johor,1,1,0
1/02/2024,Zambia,Selangor,42,13,29
1/02/2024,Zimbabwe,Johor,21,2,19
1/02/2024,Zimbabwe,Kedah,3,2,1
1/02/2024,Zimbabwe,Pulau Pinang,9,4,5
1/02/2024,Zimbabwe,Selangor,153,77,76
1/03/2024,Afghanistan,Perlis,2,2,0
1/03/2024,Afghanistan,Pulau Pinang,1,1,0
1/03/2024,Afghanistan,Selangor,44,39,5
1/03/2024,Angola,Selangor,10,4,6
1/03/2024,Anguilla,Selangor,1,0,1
1/03/2024,Albania,Johor,12,8,4
1/03/2024,Albania,Perak,1,1,0
1/03/2024,Albania,Pulau Pinang,48,14,34
1/03/2024,Albania,Sabah,1,1,0
1/03/2024,Albania,Selangor,40,25,15
1/03/2024,Andorra,Pulau Pinang,1,1,0
1/03/2024,Andorra,Selangor,13,7,6
1/03/2024,United Arab Emirates,Johor,11,5,6
1/03/2024,United Arab Emirates,Kedah,7,4,3
1/03/2024,United Arab Emirates,Pulau Pinang,4,3,1
1/03/2024,United Arab Emirates,Selangor,154,98,56
1/03/2024,Argentina,Johor,100,52,48
1/03/2024,Argentina,Kedah,85,42,43
1/03/2024,Argentina,Kelantan,1,1,0
1/03/2024,Argentina,Perlis,7,4,3
1/03/2024,Argentina,Pulau Pinang,23,13,10
1/03/2024,Argentina,Sabah,9,3,6
1/03/2024,Argentina,Sarawak,4,4,0
1/03/2024,Argentina,Selangor,538,286,252
1/03/2024,Armenia,Johor,2,1,1
1/03/2024,Armenia,Kedah,1,0,1
1/03/2024,Armenia,Pulau Pinang,2,1,1
1/03/2024,Armenia,Sabah,2,0,2
1/03/2024,Armenia,Selangor,60,21,39
1/03/2024,Antarctica,Selangor,1,1,0
1/03/2024,Antigua and Barbuda,Johor,1,1,0
1/03/2024,Antigua and Barbuda,Pulau Pinang,1,1,0
1/03/2024,Antigua and Barbuda,Selangor,10,4,6
1/03/2024,Australia,Johor,5612,3252,2360
1/03/2024,Australia,Kedah,687,380,307
1/03/2024,Australia,Kelantan,10,5,5
1/03/2024,Australia,Melaka,2,2,0
1/03/2024,Australia,Negeri Sembilan,4,3,1
1/03/2024,Australia,Pahang,33,15,18
1/03/2024,Australia,Perak,309,155,154
1/03/2024,Australia,Perlis,78,43,35
1/03/2024,Australia,Pulau Pinang,2709,1374,1335
1/03/2024,Australia,Sabah,518,280,238
1/03/2024,Australia,Sarawak,631,345,286
1/03/2024,Australia,Selangor,23682,13755,9927
1/03/2024,Australia,Terengganu,7,3,4
1/03/2024,Australia,W.P. Labuan,6,4,2
1/03/2024,Austria,Johor,264,182,82
1/03/2024,Austria,Kedah,161,73,88
1/03/2024,Austria,Kelantan,3,3,0
1/03/2024,Austria,Perak,5,3,2
1/03/2024,Austria,Perlis,9,5,4
1/03/2024,Austria,Pulau Pinang,108,79,29
1/03/2024,Austria,Sabah,26,13,13
1/03/2024,Austria,Sarawak,15,10,5
1/03/2024,Austria,Selangor,1013,586,427
1/03/2024,Austria,W.P. Labuan,3,2,1
1/03/2024,Azerbaijan,Johor,44,16,28
1/03/2024,Azerbaijan,Kedah,20,9,11
1/03/2024,Azerbaijan,Pulau Pinang,14,10,4
1/03/2024,Azerbaijan,Sarawak,1,0,1
1/03/2024,Azerbaijan,Selangor,317,144,173
1/03/2024,Azerbaijan,W.P. Labuan,1,0,1
1/03/2024,Burundi,Pulau Pinang,1,1,0
1/03/2024,Burundi,Selangor,4,4,0
1/03/2024,Belgium,Johor,308,170,138
1/03/2024,Belgium,Kedah,165,83,82
1/03/2024,Belgium,Kelantan,5,0,5
1/03/2024,Belgium,Pahang,2,2,0
1/03/2024,Belgium,Perak,4,3,1
1/03/2024,Belgium,Perlis,19,9,10
1/03/2024,Belgium,Pulau Pinang,113,71,42
1/03/2024,Belgium,Sabah,24,13,11
1/03/2024,Belgium,Sarawak,26,19,7
1/03/2024,Belgium,Selangor,1513,923,590
1/03/2024,Benin,Johor,3,2,1
1/03/2024,Benin,Selangor,13,8,5
1/03/2024,Burkina Faso,Selangor,1,0,1
1/03/2024,Bangladesh,Johor,1999,1565,434
1/03/2024,Bangladesh,Kedah,69,48,21
1/03/2024,Bangladesh,Kelantan,3,3,0
1/03/2024,Bangladesh,Negeri Sembilan,2,2,0
1/03/2024,Bangladesh,Perak,4,4,0
1/03/2024,Bangladesh,Perlis,2,2,0
1/03/2024,Bangladesh,Pulau Pinang,73,60,13
1/03/2024,Bangladesh,Sabah,3,3,0
1/03/2024,Bangladesh,Sarawak,114,92,22
1/03/2024,Bangladesh,Selangor,24350,22705,1645
1/03/2024,Bangladesh,W.P. Labuan,6,6,0
1/03/2024,Bulgaria,Johor,56,34,22
1/03/2024,Bulgaria,Kedah,20,9,11
1/03/2024,Bulgaria,Kelantan,1,1,0
1/03/2024,Bulgaria,Perlis,1,1,0
1/03/2024,Bulgaria,Pulau Pinang,30,25,5
1/03/2024,Bulgaria,Sabah,1,1,0
1/03/2024,Bulgaria,Sarawak,4,3,1
1/03/2024,Bulgaria,Selangor,476,238,238
1/03/2024,Bahrain,Johor,6,3,3
1/03/2024,Bahrain,Kedah,1,1,0
1/03/2024,Bahrain,Perlis,1,1,0
1/03/2024,Bahrain,Selangor,29,19,10
1/03/2024,Bahamas,Selangor,11,7,4
1/03/2024,Bosnia and Herzegovina,Johor,7,4,3
1/03/2024,Bosnia and Herzegovina,Kedah,1,1,0
1/03/2024,Bosnia and Herzegovina,Selangor,51,32,19
1/03/2024,Belarus,Johor,10,2,8
1/03/2024,Belarus,Kedah,39,17,22
1/03/2024,Belarus,Kelantan,3,2,1
1/03/2024,Belarus,Pulau Pinang,22,7,15
1/03/2024,Belarus,Sabah,9,4,5
1/03/2024,Belarus,Selangor,674,323,351
1/03/2024,Belarus,W.P. Labuan,1,1,0
1/03/2024,Belize,Johor,2,2,0
1/03/2024,Belize,Selangor,9,4,5
1/03/2024,Bolivia,Johor,1,0,1
1/03/2024,Bolivia,Sarawak,1,1,0
1/03/2024,Bolivia,Selangor,18,12,6
1/03/2024,Brazil,Johor,287,165,122
1/03/2024,Brazil,Kedah,150,76,74
1/03/2024,Brazil,Kelantan,1,1,0
1/03/2024,Brazil,Pahang,1,0,1
1/03/2024,Brazil,Perak,3,1,2
1/03/2024,Brazil,Perlis,10,4,6
1/03/2024,Brazil,Pulau Pinang,51,29,22
1/03/2024,Brazil,Sabah,18,9,9
1/03/2024,Brazil,Sarawak,8,5,3
1/03/2024,Brazil,Selangor,1148,667,481
1/03/2024,Barbados,Selangor,6,2,4
1/03/2024,Brunei Darussalam,Johor,445,210,235
1/03/2024,Brunei Darussalam,Kedah,39,28,11
1/03/2024,Brunei Darussalam,Kelantan,14,7,7
1/03/2024,Brunei Darussalam,Perak,5,2,3
1/03/2024,Brunei Darussalam,Perlis,27,13,14
1/03/2024,Brunei Darussalam,Pulau Pinang,41,15,26
1/03/2024,Brunei Darussalam,Sabah,1043,439,604
1/03/2024,Brunei Darussalam,Sarawak,157523,82638,74885
1/03/2024,Brunei Darussalam,Selangor,6365,2912,3453
1/03/2024,Brunei Darussalam,W.P. Labuan,988,659,329
1/03/2024,Bhutan,Johor,7,7,0
1/03/2024,Bhutan,Kedah,3,3,0
1/03/2024,Bhutan,Pulau Pinang,4,4,0
1/03/2024,Bhutan,Selangor,53,35,18
1/03/2024,Botswana,Selangor,25,11,14
1/03/2024,Central African Republic,Selangor,1,1,0
1/03/2024,Canada,Johor,1949,1046,903
1/03/2024,Canada,Kedah,366,196,170
1/03/2024,Canada,Kelantan,7,5,2
1/03/2024,Canada,Pahang,7,4,3
1/03/2024,Canada,Perak,30,15,15
1/03/2024,Canada,Perlis,47,30,17
1/03/2024,Canada,Pulau Pinang,887,465,422
1/03/2024,Canada,Sabah,253,131,122
1/03/2024,Canada,Sarawak,445,238,207
1/03/2024,Canada,Selangor,5842,3335,2507
1/03/2024,Canada,Terengganu,1,1,0
1/03/2024,Canada,W.P. Labuan,6,3,3
1/03/2024,Switzerland,Johor,508,316,192
1/03/2024,Switzerland,Kedah,282,154,128
1/03/2024,Switzerland,Kelantan,4,1,3
1/03/2024,Switzerland,Negeri Sembilan,2,1,1
1/03/2024,Switzerland,Pahang,2,1,1
1/03/2024,Switzerland,Perak,10,7,3
1/03/2024,Switzerland,Perlis,31,20,11
1/03/2024,Switzerland,Pulau Pinang,186,102,84
1/03/2024,Switzerland,Sabah,69,36,33
1/03/2024,Switzerland,Sarawak,59,27,32
1/03/2024,Switzerland,Selangor,1795,1040,755
1/03/2024,Chile,Johor,48,24,24
1/03/2024,Chile,Kedah,23,12,11
1/03/2024,Chile,Kelantan,1,1,0
1/03/2024,Chile,Perlis,2,1,1
1/03/2024,Chile,Pulau Pinang,14,8,6
1/03/2024,Chile,Sabah,4,2,2
1/03/2024,Chile,Selangor,384,168,216
1/03/2024,China,Johor,91075,39596,51479
1/03/2024,China,Kedah,2101,927,1174
1/03/2024,China,Kelantan,12,8,4
1/03/2024,China,Melaka,5,5,0
1/03/2024,China,Negeri Sembilan,5,5,0
1/03/2024,China,Pahang,54,35,19
1/03/2024,China,Perak,344,131,213
1/03/2024,China,Perlis,444,243,201
1/03/2024,China,Pulau Pinang,13137,6529,6608
1/03/2024,China,Sabah,18833,7888,10945
1/03/2024,China,Sarawak,1693,878,815
1/03/2024,China,Selangor,135069,68396,66673
1/03/2024,China,W.P. Labuan,54,46,8
1/03/2024,Côte d'Ivoire,Johor,2,1,1
1/03/2024,Côte d'Ivoire,Pulau Pinang,1,0,1
1/03/2024,Côte d'Ivoire,Sabah,1,0,1
1/03/2024,Côte d'Ivoire,Selangor,9,5,4
1/03/2024,Cameroon,Kedah,1,0,1
1/03/2024,Cameroon,Selangor,27,16,11
1/03/2024,Congo,Johor,3,3,0
1/03/2024,Congo,Sabah,2,2,0
1/03/2024,Congo,Selangor,19,17,2
1/03/2024,Colombia,Johor,52,21,31
1/03/2024,Colombia,Kedah,10,4,6
1/03/2024,Colombia,Pulau Pinang,15,7,8
1/03/2024,Colombia,Sabah,4,2,2
1/03/2024,Colombia,Sarawak,1,1,0
1/03/2024,Colombia,Selangor,225,123,102
1/03/2024,Comoros,Selangor,6,2,4
1/03/2024,Cabo Verde,Selangor,1,0,1
1/03/2024,Costa Rica,Johor,17,11,6
1/03/2024,Costa Rica,Pulau Pinang,26,21,5
1/03/2024,Costa Rica,Sabah,2,1,1
1/03/2024,Costa Rica,Selangor,87,40,47
1/03/2024,Cuba,Johor,9,6,3
1/03/2024,Cuba,Selangor,25,13,12
1/03/2024,Cyprus,Johor,10,8,2
1/03/2024,Cyprus,Kedah,1,1,0
1/03/2024,Cyprus,Sabah,2,1,1
1/03/2024,Cyprus,Sarawak,1,1,0
1/03/2024,Cyprus,Selangor,87,56,31
1/03/2024,Czechia,Johor,181,103,78
1/03/2024,Czechia,Kedah,322,147,175
1/03/2024,Czechia,Kelantan,3,3,0
1/03/2024,Czechia,Perlis,10,5,5
1/03/2024,Czechia,Pulau Pinang,45,26,19
1/03/2024,Czechia,Sabah,11,4,7
1/03/2024,Czechia,Sarawak,13,10,3
1/03/2024,Czechia,Selangor,987,562,425
1/03/2024,Czechia,W.P. Labuan,15,4,11
1/03/2024,Germany,Johor,3173,1876,1297
1/03/2024,Germany,Kedah,1907,975,932
1/03/2024,Germany,Kelantan,11,6,5
1/03/2024,Germany,Melaka,8,6,2
1/03/2024,Germany,Pahang,15,8,7
1/03/2024,Germany,Perak,34,25,9
1/03/2024,Germany,Perlis,178,104,74
1/03/2024,Germany,Pulau Pinang,1156,784,372
1/03/2024,Germany,Sabah,203,108,95
1/03/2024,Germany,Sarawak,278,160,118
1/03/2024,Germany,Selangor,11716,6773,4943
1/03/2024,Germany,W.P. Labuan,11,7,4
1/03/2024,Djibouti,Johor,4,2,2
1/03/2024,Djibouti,Selangor,22,15,7
1/03/2024,Dominica,Johor,10,6,4
1/03/2024,Dominica,Kedah,8,3,5
1/03/2024,Dominica,Pulau Pinang,1,1,0
1/03/2024,Dominica,Selangor,55,41,14
1/03/2024,Denmark,Johor,359,236,123
1/03/2024,Denmark,Kedah,403,184,219
1/03/2024,Denmark,Kelantan,4,2,2
1/03/2024,Denmark,Perak,2,2,0
1/03/2024,Denmark,Perlis,9,6,3
1/03/2024,Denmark,Pulau Pinang,106,68,38
1/03/2024,Denmark,Sabah,67,29,38
1/03/2024,Denmark,Sarawak,17,10,7
1/03/2024,Denmark,Selangor,1588,917,671
1/03/2024,Dominican Republic,Johor,7,0,7
1/03/2024,Dominican Republic,Pulau Pinang,2,0,2
1/03/2024,Dominican Republic,Selangor,17,11,6
1/03/2024,Algeria,Johor,24,16,8
1/03/2024,Algeria,Kedah,4,1,3
1/03/2024,Algeria,Kelantan,1,1,0
1/03/2024,Algeria,Pulau Pinang,4,2,2
1/03/2024,Algeria,Sabah,2,0,2
1/03/2024,Algeria,Sarawak,5,4,1
1/03/2024,Algeria,Selangor,355,270,85
1/03/2024,Ecuador,Johor,6,3,3
1/03/2024,Ecuador,Kedah,1,0,1
1/03/2024,Ecuador,Pulau Pinang,5,0,5
1/03/2024,Ecuador,Sabah,1,0,1
1/03/2024,Ecuador,Selangor,77,29,48
1/03/2024,Egypt,Johor,194,173,21
1/03/2024,Egypt,Kedah,18,12,6
1/03/2024,Egypt,Melaka,1,1,0
1/03/2024,Egypt,Pulau Pinang,28,23,5
1/03/2024,Egypt,Sabah,2,2,0
1/03/2024,Egypt,Sarawak,83,55,28
1/03/2024,Egypt,Selangor,1124,857,267
1/03/2024,Eritrea,Johor,1,1,0
1/03/2024,Eritrea,Selangor,20,5,15
1/03/2024,Spain,Johor,619,371,248
1/03/2024,Spain,Kedah,289,148,141
1/03/2024,Spain,Kelantan,8,6,2
1/03/2024,Spain,Negeri Sembilan,6,3,3
1/03/2024,Spain,Pahang,3,3,0
1/03/2024,Spain,Perak,11,7,4
1/03/2024,Spain,Perlis,17,8,9
1/03/2024,Spain,Pulau Pinang,180,90,90
1/03/2024,Spain,Sabah,73,38,35
1/03/2024,Spain,Sarawak,32,18,14
1/03/2024,Spain,Selangor,3257,1785,1472
1/03/2024,Spain,W.P. Labuan,4,1,3
1/03/2024,Estonia,Johor,47,24,23
1/03/2024,Estonia,Kedah,87,40,47
1/03/2024,Estonia,Perlis,4,3,1
1/03/2024,Estonia,Pulau Pinang,10,6,4
1/03/2024,Estonia,Sabah,6,4,2
1/03/2024,Estonia,Sarawak,3,2,1
1/03/2024,Estonia,Selangor,390,202,188
1/03/2024,Estonia,W.P. Labuan,3,1,2
1/03/2024,Ethiopia,Johor,5,5,0
1/03/2024,Ethiopia,Pulau Pinang,2,1,1
1/03/2024,Ethiopia,Selangor,24,10,14
1/03/2024,Finland,Johor,340,178,162
1/03/2024,Finland,Kedah,217,98,119
1/03/2024,Finland,Kelantan,2,2,0
1/03/2024,Finland,Perak,1,0,1
1/03/2024,Finland,Perlis,13,11,2
1/03/2024,Finland,Pulau Pinang,87,59,28
1/03/2024,Finland,Sabah,17,11,6
1/03/2024,Finland,Sarawak,20,9,11
1/03/2024,Finland,Selangor,744,400,344
1/03/2024,Finland,W.P. Labuan,3,2,1
1/03/2024,Fiji,Johor,53,27,26
1/03/2024,Fiji,Pulau Pinang,4,3,1
1/03/2024,Fiji,Selangor,102,44,58
1/03/2024,France,Johor,2690,1620,1070
1/03/2024,France,Kedah,1383,697,686
1/03/2024,France,Kelantan,43,25,18
1/03/2024,France,Melaka,1,0,1
1/03/2024,France,Negeri Sembilan,2,1,1
1/03/2024,France,Pahang,43,26,17
1/03/2024,France,Perak,32,20,12
1/03/2024,France,Perlis,114,75,39
1/03/2024,France,Pulau Pinang,552,318,234
1/03/2024,France,Sabah,193,104,89
1/03/2024,France,Sarawak,131,79,52
1/03/2024,France,Selangor,9820,5816,4004
1/03/2024,France,Terengganu,1,1,0
1/03/2024,France,W.P. Labuan,4,3,1
1/03/2024,"Micronesia, Federated States of",Selangor,3,3,0
1/03/2024,Gabon,Johor,1,1,0
1/03/2024,Gabon,Selangor,5,3,2
1/03/2024,United Kingdom of Great Britain and Northern Ireland,Johor,6084,3807,2277
1/03/2024,United Kingdom of Great Britain and Northern Ireland,Kedah,2514,1295,1219
1/03/2024,United Kingdom of Great Britain and Northern Ireland,Kelantan,30,25,5
1/03/2024,United Kingdom of Great Britain and Northern Ireland,Melaka,5,2,3
1/03/2024,United Kingdom of Great Britain and Northern Ireland,Negeri Sembilan,4,4,0
1/03/2024,United Kingdom of Great Britain and Northern Ireland,Pahang,34,19,15
1/03/2024,United Kingdom of Great Britain and Northern Ireland,Perak,123,70,53
1/03/2024,United Kingdom of Great Britain and Northern Ireland,Perlis,221,145,76
1/03/2024,United Kingdom of Great Britain and Northern Ireland,Pulau Pinang,5327,2756,2571
1/03/2024,United Kingdom of Great Britain and Northern Ireland,Sabah,913,472,441
1/03/2024,United Kingdom of Great Britain and Northern Ireland,Sarawak,1589,958,631
1/03/2024,United Kingdom of Great Britain and Northern Ireland,Selangor,27149,15609,11540
1/03/2024,United Kingdom of Great Britain and Northern Ireland,Terengganu,1,1,0
1/03/2024,United Kingdom of Great Britain and Northern Ireland,W.P. Labuan,46,30,16
1/03/2024,Georgia,Johor,6,3,3
1/03/2024,Georgia,Kedah,3,1,2
1/03/2024,Georgia,Pulau Pinang,2,1,1
1/03/2024,Georgia,Sabah,3,1,2
1/03/2024,Georgia,Sarawak,1,0,1
1/03/2024,Georgia,Selangor,63,30,33
1/03/2024,Ghana,Johor,8,8,0
1/03/2024,Ghana,Kedah,3,3,0
1/03/2024,Ghana,Perak,1,1,0
1/03/2024,Ghana,Pulau Pinang,21,16,5
1/03/2024,Ghana,Sarawak,1,1,0
1/03/2024,Ghana,Selangor,83,58,25
1/03/2024,Guinea,Johor,6,5,1
1/03/2024,Guinea,Kedah,2,2,0
1/03/2024,Guinea,Pulau Pinang,2,1,1
1/03/2024,Guinea,Selangor,43,32,11
1/03/2024,Gambia,Johor,1,1,0
1/03/2024,Gambia,Selangor,23,19,4
1/03/2024,Guinea-Bissau,Selangor,1,1,0
1/03/2024,Equatorial Guinea,Selangor,3,1,2
1/03/2024,Greece,Johor,83,62,21
1/03/2024,Greece,Kedah,18,12,6
1/03/2024,Greece,Negeri Sembilan,1,1,0
1/03/2024,Greece,Perak,1,1,0
1/03/2024,Greece,Perlis,1,0,1
1/03/2024,Greece,Pulau Pinang,15,7,8
1/03/2024,Greece,Sabah,5,4,1
1/03/2024,Greece,Sarawak,3,1,2
1/03/2024,Greece,Selangor,334,228,106
1/03/2024,Greece,W.P. Labuan,2,2,0
1/03/2024,Grenada,Johor,3,3,0
1/03/2024,Grenada,Selangor,9,8,1
1/03/2024,Greenland,Selangor,1,1,0
1/03/2024,Guatemala,Johor,4,3,1
1/03/2024,Guatemala,Kedah,1,1,0
1/03/2024,Guatemala,Pulau Pinang,1,1,0
1/03/2024,Guatemala,Sabah,1,1,0
1/03/2024,Guatemala,Selangor,29,17,12
1/03/2024,Guyana,Johor,1,1,0
1/03/2024,Guyana,Pulau Pinang,4,0,4
1/03/2024,Guyana,Selangor,10,7,3
1/03/2024,Hong Kong,Johor,8,4,4
1/03/2024,Hong Kong,Kedah,1,0,1
1/03/2024,Hong Kong,Pahang,3,2,1
1/03/2024,Hong Kong,Perak,37,15,22
1/03/2024,Hong Kong,Pulau Pinang,133,56,77
1/03/2024,Hong Kong,Sabah,170,75,95
1/03/2024,Hong Kong,Selangor,79,41,38
1/03/2024,Hong Kong,W.P. Labuan,2,2,0
1/03/2024,Honduras,Johor,9,4,5
1/03/2024,Honduras,Selangor,16,11,5
1/03/2024,Croatia,Johor,42,33,9
1/03/2024,Croatia,Kedah,9,4,5
1/03/2024,Croatia,Perlis,1,0,1
1/03/2024,Croatia,Pulau Pinang,14,10,4
1/03/2024,Croatia,Sabah,1,1,0
1/03/2024,Croatia,Sarawak,1,1,0
1/03/2024,Croatia,Selangor,266,152,114
1/03/2024,Haiti,Selangor,14,9,5
1/03/2024,Hungary,Johor,146,83,63
1/03/2024,Hungary,Kedah,101,47,54
1/03/2024,Hungary,Kelantan,3,3,0
1/03/2024,Hungary,Perlis,5,4,1
1/03/2024,Hungary,Pulau Pinang,50,30,20
1/03/2024,Hungary,Sabah,9,6,3
1/03/2024,Hungary,Sarawak,25,14,11
1/03/2024,Hungary,Selangor,1048,540,508
1/03/2024,Indonesia,Johor,93412,40044,53368
1/03/2024,Indonesia,Kedah,3830,1463,2367
1/03/2024,Indonesia,Kelantan,151,104,47
1/03/2024,Indonesia,Melaka,2994,1357,1637
1/03/2024,Indonesia,Negeri Sembilan,4894,2767,2127
1/03/2024,Indonesia,Pahang,20,13,7
1/03/2024,Indonesia,Perak,161,50,111
1/03/2024,Indonesia,Perlis,508,199,309
1/03/2024,Indonesia,Pulau Pinang,43542,17443,26099
1/03/2024,Indonesia,Sabah,4945,2485,2460
1/03/2024,Indonesia,Sarawak,38775,19579,19196
1/03/2024,Indonesia,Selangor,122614,57603,65011
1/03/2024,Indonesia,W.P. Labuan,39,22,17
1/03/2024,India,Johor,37284,23812,13472
1/03/2024,India,Kedah,2083,1110,973
1/03/2024,India,Kelantan,13,10,3
1/03/2024,India,Melaka,4,3,1
1/03/2024,India,Negeri Sembilan,9,9,0
1/03/2024,India,Pahang,15,13,2
1/03/2024,India,Perak,253,178,75
1/03/2024,India,Perlis,68,60,8
1/03/2024,India,Pulau Pinang,3357,2000,1357
1/03/2024,India,Sabah,314,198,116
1/03/2024,India,Sarawak,2378,1947,431
1/03/2024,India,Selangor,66629,44197,22432
1/03/2024,India,Terengganu,2,1,1
1/03/2024,India,W.P. Labuan,33,30,3
1/03/2024, British Indian Ocean Territory,Selangor,1,1,0
1/03/2024,Ireland,Johor,352,212,140
1/03/2024,Ireland,Kedah,147,71,76
1/03/2024,Ireland,Kelantan,2,1,1
1/03/2024,Ireland,Perak,7,5,2
1/03/2024,Ireland,Perlis,26,20,6
1/03/2024,Ireland,Pulau Pinang,226,123,103
1/03/2024,Ireland,Sabah,44,23,21
1/03/2024,Ireland,Sarawak,30,15,15
1/03/2024,Ireland,Selangor,1626,951,675
1/03/2024,"Iran, Islamic Republic of",Johor,765,362,403
1/03/2024,"Iran, Islamic Republic of",Kedah,38,19,19
1/03/2024,"Iran, Islamic Republic of",Perlis,4,4,0
1/03/2024,"Iran, Islamic Republic of",Pulau Pinang,39,19,20
1/03/2024,"Iran, Islamic Republic of",Sabah,4,0,4
1/03/2024,"Iran, Islamic Republic of",Sarawak,2,2,0
1/03/2024,"Iran, Islamic Republic of",Selangor,5497,2702,2795
1/03/2024,Iraq,Johor,39,33,6
1/03/2024,Iraq,Kedah,2,2,0
1/03/2024,Iraq,Pulau Pinang,1,1,0
1/03/2024,Iraq,Sarawak,6,4,2
1/03/2024,Iraq,Selangor,802,555,247
1/03/2024,Iceland,Johor,3,1,2
1/03/2024,Iceland,Kedah,6,1,5
1/03/2024,Iceland,Negeri Sembilan,1,0,1
1/03/2024,Iceland,Perlis,1,0,1
1/03/2024,Iceland,Pulau Pinang,5,3,2
1/03/2024,Iceland,Selangor,46,25,21
1/03/2024,Italy,Johor,747,520,227
1/03/2024,Italy,Kedah,598,323,275
1/03/2024,Italy,Kelantan,6,6,0
1/03/2024,Italy,Pahang,1,1,0
1/03/2024,Italy,Perak,9,5,4
1/03/2024,Italy,Perlis,35,22,13
1/03/2024,Italy,Pulau Pinang,198,148,50
1/03/2024,Italy,Sabah,66,40,26
1/03/2024,Italy,Sarawak,43,28,15
1/03/2024,Italy,Selangor,3641,2371,1270
1/03/2024,Italy,W.P. Labuan,4,4,0
1/03/2024,Jamaica,Johor,4,0,4
1/03/2024,Jamaica,Selangor,16,11,5
1/03/2024,Jordan,Johor,18,14,4
1/03/2024,Jordan,Kedah,4,4,0
1/03/2024,Jordan,Pulau Pinang,4,4,0
1/03/2024,Jordan,Selangor,414,310,104
1/03/2024,Japan,Johor,8379,5268,3111
1/03/2024,Japan,Kedah,498,255,243
1/03/2024,Japan,Kelantan,11,10,1
1/03/2024,Japan,Melaka,1,1,0
1/03/2024,Japan,Negeri Sembilan,12,10,2
1/03/2024,Japan,Pahang,24,15,9
1/03/2024,Japan,Perak,64,39,25
1/03/2024,Japan,Perlis,137,115,22
1/03/2024,Japan,Pulau Pinang,3232,1783,1449
1/03/2024,Japan,Sabah,780,394,386
1/03/2024,Japan,Sarawak,210,127,83
1/03/2024,Japan,Selangor,23771,14159,9612
1/03/2024,Japan,W.P. Labuan,11,7,4
1/03/2024,Kazakhstan,Johor,62,21,41
1/03/2024,Kazakhstan,Kedah,51,27,24
1/03/2024,Kazakhstan,Kelantan,5,2,3
1/03/2024,Kazakhstan,Perlis,11,5,6
1/03/2024,Kazakhstan,Pulau Pinang,15,7,8
1/03/2024,Kazakhstan,Sabah,6,1,5
1/03/2024,Kazakhstan,Sarawak,8,1,7
1/03/2024,Kazakhstan,Selangor,3044,1253,1791
1/03/2024,Kenya,Johor,31,11,20
1/03/2024,Kenya,Kedah,4,1,3
1/03/2024,Kenya,Pulau Pinang,17,7,10
1/03/2024,Kenya,Selangor,337,194,143
1/03/2024,Kyrgyzstan,Johor,37,27,10
1/03/2024,Kyrgyzstan,Kedah,5,3,2
1/03/2024,Kyrgyzstan,Kelantan,2,2,0
1/03/2024,Kyrgyzstan,Pulau Pinang,3,0,3
1/03/2024,Kyrgyzstan,Sabah,1,1,0
1/03/2024,Kyrgyzstan,Selangor,490,205,285
1/03/2024,Cambodia,Johor,1921,830,1091
1/03/2024,Cambodia,Kedah,147,77,70
1/03/2024,Cambodia,Kelantan,624,463,161
1/03/2024,Cambodia,Melaka,3,2,1
1/03/2024,Cambodia,Perak,5,1,4
1/03/2024,Cambodia,Perlis,725,411,314
1/03/2024,Cambodia,Pulau Pinang,42,15,27
1/03/2024,Cambodia,Sabah,2,1,1
1/03/2024,Cambodia,Sarawak,10,7,3
1/03/2024,Cambodia,Selangor,3361,1630,1731
1/03/2024,Saint Kitts and Nevis,Johor,11,8,3
1/03/2024,Saint Kitts and Nevis,Kedah,4,3,1
1/03/2024,Saint Kitts and Nevis,Pulau Pinang,2,2,0
1/03/2024,Saint Kitts and Nevis,Sabah,1,0,1
1/03/2024,Saint Kitts and Nevis,Selangor,60,47,13
1/03/2024,"Korea, Republic of",Johor,10615,5810,4805
1/03/2024,"Korea, Republic of",Kedah,293,132,161
1/03/2024,"Korea, Republic of",Kelantan,1,0,1
1/03/2024,"Korea, Republic of",Negeri Sembilan,1,1,0
1/03/2024,"Korea, Republic of",Perak,24,11,13
1/03/2024,"Korea, Republic of",Perlis,79,52,27
1/03/2024,"Korea, Republic of",Pulau Pinang,1421,680,741
1/03/2024,"Korea, Republic of",Sabah,13537,5160,8377
1/03/2024,"Korea, Republic of",Sarawak,175,101,74
1/03/2024,"Korea, Republic of",Selangor,12886,7246,5640
1/03/2024,"Korea, Republic of",W.P. Labuan,17,11,6
1/03/2024,Kuwait,Johor,13,9,4
1/03/2024,Kuwait,Kedah,1,1,0
1/03/2024,Kuwait,Kelantan,1,0,1
1/03/2024,Kuwait,Pulau Pinang,1,0,1
1/03/2024,Kuwait,Selangor,109,79,30
1/03/2024, Lao People's Democratic Republic,Johor,156,33,123
1/03/2024, Lao People's Democratic Republic,Kedah,1302,107,1195
1/03/2024, Lao People's Democratic Republic,Kelantan,508,391,117
1/03/2024, Lao People's Democratic Republic,Perak,26,3,23
1/03/2024, Lao People's Democratic Republic,Perlis,406,65,341
1/03/2024, Lao People's Democratic Republic,Pulau Pinang,31,11,20
1/03/2024, Lao People's Democratic Republic,Sarawak,14,10,4
1/03/2024, Lao People's Democratic Republic,Selangor,271,95,176
1/03/2024,Lebanon,Johor,36,23,13
1/03/2024,Lebanon,Kedah,9,5,4
1/03/2024,Lebanon,Pulau Pinang,8,4,4
1/03/2024,Lebanon,Sabah,2,2,0
1/03/2024,Lebanon,Sarawak,7,7,0
1/03/2024,Lebanon,Selangor,210,140,70
1/03/2024,Liberia,Johor,2,2,0
1/03/2024,Liberia,Selangor,10,7,3
1/03/2024,Libya,Perlis,1,1,0
1/03/2024,Libya,Pulau Pinang,1,1,0
1/03/2024,Libya,Selangor,197,146,51
1/03/2024,Saint Lucia,Johor,4,3,1
1/03/2024,Saint Lucia,Kedah,1,1,0
1/03/2024,Saint Lucia,Pulau Pinang,4,4,0
1/03/2024,Saint Lucia,Selangor,14,8,6
1/03/2024,Liechtenstein,Pulau Pinang,2,1,1
1/03/2024,Liechtenstein,Selangor,5,4,1
1/03/2024,LKA,Johor,674,427,247
1/03/2024,LKA,Kedah,47,29,18
1/03/2024,LKA,Melaka,1,1,0
1/03/2024,LKA,Perak,4,1,3
1/03/2024,LKA,Perlis,8,6,2
1/03/2024,LKA,Pulau Pinang,45,22,23
1/03/2024,LKA,Sabah,5,3,2
1/03/2024,LKA,Sarawak,36,28,8
1/03/2024,LKA,Selangor,3380,2117,1263
1/03/2024,Lesotho,Johor,1,0,1
1/03/2024,Lesotho,Selangor,4,3,1
1/03/2024,Lithuania,Johor,83,32,51
1/03/2024,Lithuania,Kedah,153,66,87
1/03/2024,Lithuania,Pahang,1,1,0
1/03/2024,Lithuania,Perlis,2,2,0
1/03/2024,Lithuania,Pulau Pinang,18,9,9
1/03/2024,Lithuania,Sabah,7,1,6
1/03/2024,Lithuania,Sarawak,15,7,8
1/03/2024,Lithuania,Selangor,1102,527,575
1/03/2024,Lithuania,W.P. Labuan,12,3,9
1/03/2024,Luxembourg,Johor,11,8,3
1/03/2024,Luxembourg,Kedah,5,2,3
1/03/2024,Luxembourg,Pulau Pinang,3,1,2
1/03/2024,Luxembourg,Sabah,3,2,1
1/03/2024,Luxembourg,Sarawak,2,1,1
1/03/2024,Luxembourg,Selangor,68,37,31
1/03/2024,Latvia,Johor,69,32,37
1/03/2024,Latvia,Kedah,33,15,18
1/03/2024,Latvia,Perak,2,1,1
1/03/2024,Latvia,Perlis,3,2,1
1/03/2024,Latvia,Pulau Pinang,11,6,5
1/03/2024,Latvia,Sabah,5,3,2
1/03/2024,Latvia,Sarawak,2,0,2
1/03/2024,Latvia,Selangor,327,178,149
1/03/2024,Latvia,W.P. Labuan,18,7,11
1/03/2024,Macao,Pulau Pinang,1,0,1
1/03/2024,Morocco,Johor,84,47,37
1/03/2024,Morocco,Kedah,15,11,4
1/03/2024,Morocco,Kelantan,5,4,1
1/03/2024,Morocco,Perlis,2,2,0
1/03/2024,Morocco,Pulau Pinang,13,6,7
1/03/2024,Morocco,Sabah,3,0,3
1/03/2024,Morocco,Sarawak,5,4,1
1/03/2024,Morocco,Selangor,516,324,192
1/03/2024,Monaco,Johor,1,1,0
1/03/2024,Monaco,Selangor,2,2,0
1/03/2024,"Moldova, Republic of",Johor,9,1,8
1/03/2024,"Moldova, Republic of",Kedah,1,0,1
1/03/2024,"Moldova, Republic of",Kelantan,1,1,0
1/03/2024,"Moldova, Republic of",Sarawak,1,1,0
1/03/2024,"Moldova, Republic of",Selangor,59,24,35
1/03/2024,Madagascar,Johor,8,6,2
1/03/2024,Madagascar,Selangor,111,55,56
1/03/2024,Maldives,Johor,108,47,61
1/03/2024,Maldives,Pulau Pinang,24,21,3
1/03/2024,Maldives,Sabah,1,1,0
1/03/2024,Maldives,Selangor,1618,916,702
1/03/2024,Mexico,Johor,260,124,136
1/03/2024,Mexico,Kedah,11,5,6
1/03/2024,Mexico,Kelantan,1,0,1
1/03/2024,Mexico,Perak,1,1,0
1/03/2024,Mexico,Perlis,3,2,1
1/03/2024,Mexico,Pulau Pinang,75,42,33
1/03/2024,Mexico,Sabah,10,5,5
1/03/2024,Mexico,Sarawak,1,0,1
1/03/2024,Mexico,Selangor,1021,498,523
1/03/2024,Marshall Islands,Sabah,1,1,0
1/03/2024,North Macedonia,Johor,10,7,3
1/03/2024,North Macedonia,Kedah,1,0,1
1/03/2024,North Macedonia,Pulau Pinang,1,0,1
1/03/2024,North Macedonia,Sabah,1,1,0
1/03/2024,North Macedonia,Sarawak,2,1,1
1/03/2024,North Macedonia,Selangor,32,15,17
1/03/2024,Mali,Selangor,5,4,1
1/03/2024,Malta,Johor,17,8,9
1/03/2024,Malta,Kedah,14,10,4
1/03/2024,Malta,Perlis,2,0,2
1/03/2024,Malta,Pulau Pinang,9,6,3
1/03/2024,Malta,Sarawak,1,0,1
1/03/2024,Malta,Selangor,50,30,20
1/03/2024,Myanmar,Johor,8072,2349,5723
1/03/2024,Myanmar,Kedah,128,26,102
1/03/2024,Myanmar,Kelantan,4,2,2
1/03/2024,Myanmar,Pahang,4,2,2
1/03/2024,Myanmar,Perak,33,7,26
1/03/2024,Myanmar,Perlis,9,1,8
1/03/2024,Myanmar,Pulau Pinang,453,162,291
1/03/2024,Myanmar,Sabah,18,6,12
1/03/2024,Myanmar,Sarawak,95,48,47
1/03/2024,Myanmar,Selangor,8089,5371,2718
1/03/2024,Montenegro,Johor,3,3,0
1/03/2024,Montenegro,Pulau Pinang,1,0,1
1/03/2024,Montenegro,Selangor,18,12,6
1/03/2024,Mongolia,Johor,153,60,93
1/03/2024,Mongolia,Kedah,7,5,2
1/03/2024,Mongolia,Perlis,6,2,4
1/03/2024,Mongolia,Pulau Pinang,22,12,10
1/03/2024,Mongolia,Sabah,2,0,2
1/03/2024,Mongolia,Sarawak,1,0,1
1/03/2024,Mongolia,Selangor,443,201,242
1/03/2024,Mozambique,Selangor,26,14,12
1/03/2024,Mauritania,Johor,5,4,1
1/03/2024,Mauritania,Selangor,21,18,3
1/03/2024,Mauritius,Johor,130,62,68
1/03/2024,Mauritius,Kedah,5,2,3
1/03/2024,Mauritius,Pahang,6,2,4
1/03/2024,Mauritius,Perlis,1,0,1
1/03/2024,Mauritius,Pulau Pinang,16,10,6
1/03/2024,Mauritius,Sabah,3,2,1
1/03/2024,Mauritius,Selangor,1376,726,650
1/03/2024,Malawi,Pulau Pinang,3,2,1
1/03/2024,Malawi,Selangor,20,14,6
1/03/2024,Namibia,Johor,3,2,1
1/03/2024,Namibia,Selangor,12,8,4
1/03/2024,Niger,Selangor,2,1,1
1/03/2024,Nigeria,Johor,30,27,3
1/03/2024,Nigeria,Kedah,1,1,0
1/03/2024,Nigeria,Pulau Pinang,18,11,7
1/03/2024,Nigeria,Sarawak,7,7,0
1/03/2024,Nigeria,Selangor,473,392,81
1/03/2024,Nicaragua,Johor,5,3,2
1/03/2024,Nicaragua,Kedah,2,1,1
1/03/2024,Nicaragua,Selangor,9,5,4
1/03/2024,Netherlands,Johor,1120,746,374
1/03/2024,Netherlands,Kedah,515,256,259
1/03/2024,Netherlands,Kelantan,7,6,1
1/03/2024,Netherlands,Melaka,1,1,0
1/03/2024,Netherlands,Pahang,5,3,2
1/03/2024,Netherlands,Perak,21,11,10
1/03/2024,Netherlands,Perlis,56,28,28
1/03/2024,Netherlands,Pulau Pinang,382,223,159
1/03/2024,Netherlands,Sabah,70,38,32
1/03/2024,Netherlands,Sarawak,125,84,41
1/03/2024,Netherlands,Selangor,4284,2507,1777
1/03/2024,Netherlands,W.P. Labuan,4,2,2
1/03/2024,Norway,Johor,218,130,88
1/03/2024,Norway,Kedah,181,78,103
1/03/2024,Norway,Kelantan,1,1,0
1/03/2024,Norway,Perak,3,3,0
1/03/2024,Norway,Perlis,12,6,6
1/03/2024,Norway,Pulau Pinang,53,28,25
1/03/2024,Norway,Sabah,26,14,12
1/03/2024,Norway,Sarawak,16,13,3
1/03/2024,Norway,Selangor,1053,541,512
1/03/2024,Nepal,Johor,697,458,239
1/03/2024,Nepal,Kedah,24,12,12
1/03/2024,Nepal,Perlis,1,1,0
1/03/2024,Nepal,Pulau Pinang,34,25,9
1/03/2024,Nepal,Sabah,4,2,2
1/03/2024,Nepal,Sarawak,296,203,93
1/03/2024,Nepal,Selangor,10524,9813,711
1/03/2024,Nepal,W.P. Labuan,74,70,4
1/03/2024,New Zealand,Johor,800,484,316
1/03/2024,New Zealand,Kedah,109,53,56
1/03/2024,New Zealand,Kelantan,2,2,0
1/03/2024,New Zealand,Pahang,3,3,0
1/03/2024,New Zealand,Perak,24,13,11
1/03/2024,New Zealand,Perlis,28,16,12
1/03/2024,New Zealand,Pulau Pinang,284,149,135
1/03/2024,New Zealand,Sabah,62,36,26
1/03/2024,New Zealand,Sarawak,113,62,51
1/03/2024,New Zealand,Selangor,2673,1645,1028
1/03/2024,New Zealand,W.P. Labuan,1,1,0
1/03/2024,Oman,Johor,2,1,1
1/03/2024,Oman,Perlis,1,1,0
1/03/2024,Oman,Pulau Pinang,3,1,2
1/03/2024,Oman,Sabah,1,1,0
1/03/2024,Oman,Sarawak,6,4,2
1/03/2024,Oman,Selangor,232,163,69
1/03/2024,Pakistan,Johor,574,453,121
1/03/2024,Pakistan,Kedah,88,72,16
1/03/2024,Pakistan,Kelantan,20,20,0
1/03/2024,Pakistan,Perak,5,5,0
1/03/2024,Pakistan,Perlis,14,14,0
1/03/2024,Pakistan,Pulau Pinang,73,69,4
1/03/2024,Pakistan,Sabah,7,6,1
1/03/2024,Pakistan,Sarawak,154,134,20
1/03/2024,Pakistan,Selangor,7606,6586,1020
1/03/2024,Pakistan,W.P. Labuan,4,2,2
1/03/2024,Panama,Johor,7,4,3
1/03/2024,Panama,Kedah,4,3,1
1/03/2024,Panama,Sabah,3,0,3
1/03/2024,Panama,Selangor,27,12,15
1/03/2024,Peru,Johor,30,21,9
1/03/2024,Peru,Kedah,12,7,5
1/03/2024,Peru,Kelantan,2,1,1
1/03/2024,Peru,Pulau Pinang,4,2,2
1/03/2024,Peru,Sabah,1,1,0
1/03/2024,Peru,Sarawak,1,1,0
1/03/2024,Peru,Selangor,132,74,58
1/03/2024,Philippines,Johor,33147,10008,23139
1/03/2024,Philippines,Kedah,587,170,417
1/03/2024,Philippines,Kelantan,31,13,18
1/03/2024,Philippines,Melaka,1,0,1
1/03/2024,Philippines,Pahang,14,12,2
1/03/2024,Philippines,Perak,83,21,62
1/03/2024,Philippines,Perlis,177,67,110
1/03/2024,Philippines,Pulau Pinang,1846,772,1074
1/03/2024,Philippines,Sabah,2848,1111,1737
1/03/2024,Philippines,Sarawak,3224,1321,1903
1/03/2024,Philippines,Selangor,19596,7329,12267
1/03/2024,Philippines,W.P. Labuan,117,47,70
1/03/2024,Papua New Guinea,Johor,13,4,9
1/03/2024,Papua New Guinea,Perak,3,2,1
1/03/2024,Papua New Guinea,Pulau Pinang,1,0,1
1/03/2024,Papua New Guinea,Selangor,85,57,28
1/03/2024,Poland,Johor,555,319,236
1/03/2024,Poland,Kedah,349,174,175
1/03/2024,Poland,Kelantan,2,0,2
1/03/2024,Poland,Melaka,1,1,0
1/03/2024,Poland,Pahang,2,1,1
1/03/2024,Poland,Perak,3,1,2
1/03/2024,Poland,Perlis,48,24,24
1/03/2024,Poland,Pulau Pinang,115,60,55
1/03/2024,Poland,Sabah,33,16,17
1/03/2024,Poland,Sarawak,70,33,37
1/03/2024,Poland,Selangor,2549,1353,1196
1/03/2024,Poland,W.P. Labuan,1,1,0
1/03/2024,Portugal,Johor,211,119,92
1/03/2024,Portugal,Kedah,110,58,52
1/03/2024,Portugal,Melaka,3,2,1
1/03/2024,Portugal,Pahang,2,1,1
1/03/2024,Portugal,Perak,3,2,1
1/03/2024,Portugal,Perlis,9,8,1
1/03/2024,Portugal,Pulau Pinang,60,32,28
1/03/2024,Portugal,Sabah,32,15,17
1/03/2024,Portugal,Sarawak,14,10,4
1/03/2024,Portugal,Selangor,1072,576,496
1/03/2024,Paraguay,Johor,6,5,1
1/03/2024,Paraguay,Pulau Pinang,1,0,1
1/03/2024,Paraguay,Selangor,12,5,7
1/03/2024,"Palestine, State of",Johor,23,21,2
1/03/2024,"Palestine, State of",Kedah,3,3,0
1/03/2024,"Palestine, State of",Pulau Pinang,1,1,0
1/03/2024,"Palestine, State of",Selangor,187,133,54
1/03/2024,Qatar,Sarawak,2,1,1
1/03/2024,Qatar,Selangor,27,25,2
1/03/2024,Romania,Johor,184,102,82
1/03/2024,Romania,Kedah,106,48,58
1/03/2024,Romania,Kelantan,1,1,0
1/03/2024,Romania,Perak,3,3,0
1/03/2024,Romania,Perlis,1,1,0
1/03/2024,Romania,Pulau Pinang,38,19,19
1/03/2024,Romania,Sabah,23,12,11
1/03/2024,Romania,Sarawak,6,5,1
1/03/2024,Romania,Selangor,982,501,481
1/03/2024,Russian Federation (Russia),Johor,531,251,280
1/03/2024,Russian Federation (Russia),Kedah,736,350,386
1/03/2024,Russian Federation (Russia),Kelantan,47,24,23
1/03/2024,Russian Federation (Russia),Melaka,2,2,0
1/03/2024,Russian Federation (Russia),Perak,17,8,9
1/03/2024,Russian Federation (Russia),Perlis,94,61,33
1/03/2024,Russian Federation (Russia),Pulau Pinang,181,84,97
1/03/2024,Russian Federation (Russia),Sabah,75,36,39
1/03/2024,Russian Federation (Russia),Sarawak,45,24,21
1/03/2024,Russian Federation (Russia),Selangor,13160,6212,6948
1/03/2024,Russian Federation (Russia),W.P. Labuan,14,5,9
1/03/2024,Rwanda,Johor,1,0,1
1/03/2024,Rwanda,Selangor,12,9,3
1/03/2024,Saudi Arabia,Johor,141,79,62
1/03/2024,Saudi Arabia,Kedah,6,5,1
1/03/2024,Saudi Arabia,Kelantan,2,2,0
1/03/2024,Saudi Arabia,Pulau Pinang,13,11,2
1/03/2024,Saudi Arabia,Sarawak,23,14,9
1/03/2024,Saudi Arabia,Selangor,954,647,307
1/03/2024,Sudan,Johor,14,11,3
1/03/2024,Sudan,Kedah,5,2,3
1/03/2024,Sudan,Pulau Pinang,6,2,4
1/03/2024,Sudan,Sarawak,7,4,3
1/03/2024,Sudan,Selangor,856,554,302
1/03/2024,Senegal,Johor,5,5,0
1/03/2024,Senegal,Selangor,44,30,14
1/03/2024,Singapore,Johor,1526600,847751,678849
1/03/2024,Singapore,Kedah,4647,2479,2168
1/03/2024,Singapore,Kelantan,79,53,26
1/03/2024,Singapore,Melaka,16,12,4
1/03/2024,Singapore,Negeri Sembilan,7,5,2
1/03/2024,Singapore,Pahang,773,399,374
1/03/2024,Singapore,Perak,7501,3513,3988
1/03/2024,Singapore,Perlis,214,123,91
1/03/2024,Singapore,Pulau Pinang,29565,14270,15295
1/03/2024,Singapore,Sabah,2587,1296,1291
1/03/2024,Singapore,Sarawak,4245,2244,2001
1/03/2024,Singapore,Selangor,50305,26052,24253
1/03/2024,Singapore,W.P. Labuan,13,12,1
1/03/2024,Solomon Islands,Johor,1,1,0
1/03/2024,Solomon Islands,Pulau Pinang,1,1,0
1/03/2024,Solomon Islands,Sarawak,20,2,18
1/03/2024,Solomon Islands,Selangor,10,7,3
1/03/2024,Sierra Leone,Johor,2,2,0
1/03/2024,Sierra Leone,Selangor,28,24,4
1/03/2024,El Salvador,Johor,1,1,0
1/03/2024,El Salvador,Pulau Pinang,1,0,1
1/03/2024,El Salvador,Sarawak,1,1,0
1/03/2024,El Salvador,Selangor,13,9,4
1/03/2024,San Marino,Kedah,2,1,1
1/03/2024,San Marino,Selangor,3,2,1
1/03/2024,Somalia,Selangor,230,135,95
1/03/2024,Serbia,Johor,15,12,3
1/03/2024,Serbia,Kedah,7,5,2
1/03/2024,Serbia,Pulau Pinang,4,2,2
1/03/2024,Serbia,Sabah,1,0,1
1/03/2024,Serbia,Sarawak,2,0,2
1/03/2024,Serbia,Selangor,124,62,62
1/03/2024,South Sudan,Sabah,1,1,0
1/03/2024,South Sudan,Sarawak,3,1,2
1/03/2024,South Sudan,Selangor,27,17,10
1/03/2024,Suriname,Johor,1,1,0
1/03/2024,Suriname,Kedah,4,1,3
1/03/2024,Suriname,Pulau Pinang,2,2,0
1/03/2024,Suriname,Selangor,16,15,1
1/03/2024,Slovakia,Johor,49,29,20
1/03/2024,Slovakia,Kedah,266,146,120
1/03/2024,Slovakia,Kelantan,3,2,1
1/03/2024,Slovakia,Perak,2,1,1
1/03/2024,Slovakia,Perlis,1,1,0
1/03/2024,Slovakia,Pulau Pinang,30,15,15
1/03/2024,Slovakia,Sabah,17,7,10
1/03/2024,Slovakia,Sarawak,4,3,1
1/03/2024,Slovakia,Selangor,671,336,335
1/03/2024,Slovakia,W.P. Labuan,12,8,4
1/03/2024,Slovenia,Johor,31,16,15
1/03/2024,Slovenia,Kedah,60,30,30
1/03/2024,Slovenia,Perak,2,1,1
1/03/2024,Slovenia,Perlis,3,2,1
1/03/2024,Slovenia,Pulau Pinang,3,2,1
1/03/2024,Slovenia,Sabah,5,3,2
1/03/2024,Slovenia,Sarawak,1,0,1
1/03/2024,Slovenia,Selangor,269,137,132
1/03/2024,Slovenia,W.P. Labuan,2,1,1
1/03/2024,Sweden,Johor,296,172,124
1/03/2024,Sweden,Kedah,429,190,239
1/03/2024,Sweden,Perak,7,6,1
1/03/2024,Sweden,Perlis,18,13,5
1/03/2024,Sweden,Pulau Pinang,109,72,37
1/03/2024,Sweden,Sabah,41,19,22
1/03/2024,Sweden,Sarawak,16,11,5
1/03/2024,Sweden,Selangor,1518,862,656
1/03/2024,Sweden,W.P. Labuan,2,2,0
1/03/2024,Eswatini,Johor,1,1,0
1/03/2024,Eswatini,Pulau Pinang,1,1,0
1/03/2024,Eswatini,Selangor,22,10,12
1/03/2024,Seychelles,Johor,3,2,1
1/03/2024,Seychelles,Selangor,56,19,37
1/03/2024,Syrian Arab Republic,Johor,22,19,3
1/03/2024,Syrian Arab Republic,Kedah,9,6,3
1/03/2024,Syrian Arab Republic,Kelantan,1,0,1
1/03/2024,Syrian Arab Republic,Pahang,1,1,0
1/03/2024,Syrian Arab Republic,Pulau Pinang,8,4,4
1/03/2024,Syrian Arab Republic,Sabah,4,4,0
1/03/2024,Syrian Arab Republic,Sarawak,4,4,0
1/03/2024,Syrian Arab Republic,Selangor,414,283,131
1/03/2024,TCD,Johor,3,2,1
1/03/2024,TCD,Selangor,26,20,6
1/03/2024,Togo,Pulau Pinang,1,1,0
1/03/2024,Togo,Selangor,10,9,1
1/03/2024,Thailand,Johor,7453,1938,5515
1/03/2024,Thailand,Kedah,70841,41721,29120
1/03/2024,Thailand,Kelantan,59952,29221,30731
1/03/2024,Thailand,Melaka,1,1,0
1/03/2024,Thailand,Negeri Sembilan,2,2,0
1/03/2024,Thailand,Pahang,10,10,0
1/03/2024,Thailand,Perak,12720,5999,6721
1/03/2024,Thailand,Perlis,55102,32181,22921
1/03/2024,Thailand,Pulau Pinang,3414,1357,2057
1/03/2024,Thailand,Sabah,46,20,26
1/03/2024,Thailand,Sarawak,457,152,305
1/03/2024,Thailand,Selangor,15000,5812,9188
1/03/2024,Thailand,Terengganu,2,2,0
1/03/2024,Thailand,W.P. Labuan,12,6,6
1/03/2024,Tajikistan,Johor,2,2,0
1/03/2024,Tajikistan,Sabah,2,2,0
1/03/2024,Tajikistan,Selangor,104,60,44
1/03/2024,Turkmenistan,Johor,11,5,6
1/03/2024,Turkmenistan,Kelantan,1,1,0
1/03/2024,Turkmenistan,Selangor,1093,456,637
1/03/2024,Timor-Leste,Johor,3,3,0
1/03/2024,Timor-Leste,Kedah,6,1,5
1/03/2024,Timor-Leste,Pulau Pinang,1,1,0
1/03/2024,Timor-Leste,Sabah,1,0,1
1/03/2024,Timor-Leste,Sarawak,7,7,0
1/03/2024,Timor-Leste,Selangor,288,142,146
1/03/2024,Tonga,Pulau Pinang,2,0,2
1/03/2024,Tonga,Selangor,12,6,6
1/03/2024,Trinidad and Tobago,Johor,4,2,2
1/03/2024,Trinidad and Tobago,Pulau Pinang,2,1,1
1/03/2024,Trinidad and Tobago,Sabah,2,0,2
1/03/2024,Trinidad and Tobago,Selangor,30,17,13
1/03/2024,Tunisia,Johor,17,9,8
1/03/2024,Tunisia,Kedah,13,7,6
1/03/2024,Tunisia,Perlis,2,0,2
1/03/2024,Tunisia,Pulau Pinang,4,2,2
1/03/2024,Tunisia,Sabah,4,3,1
1/03/2024,Tunisia,Sarawak,1,1,0
1/03/2024,Tunisia,Selangor,332,202,130
1/03/2024,Türkiye,Johor,324,249,75
1/03/2024,Türkiye,Kedah,64,43,21
1/03/2024,Türkiye,Kelantan,8,7,1
1/03/2024,Türkiye,Melaka,1,1,0
1/03/2024,Türkiye,Pahang,3,2,1
1/03/2024,Türkiye,Perak,2,1,1
1/03/2024,Türkiye,Perlis,21,15,6
1/03/2024,Türkiye,Pulau Pinang,45,32,13
1/03/2024,Türkiye,Sabah,6,3,3
1/03/2024,Türkiye,Sarawak,26,19,7
1/03/2024,Türkiye,Selangor,1769,1281,488
1/03/2024,Tuvalu,Selangor,2,1,1
1/03/2024,"Taiwan, Province of China",Johor,7056,3014,4042
1/03/2024,"Taiwan, Province of China",Kedah,204,103,101
1/03/2024,"Taiwan, Province of China",Kelantan,2,1,1
1/03/2024,"Taiwan, Province of China",Melaka,8,5,3
1/03/2024,"Taiwan, Province of China",Pahang,6,6,0
1/03/2024,"Taiwan, Province of China",Perak,63,23,40
1/03/2024,"Taiwan, Province of China",Perlis,27,14,13
1/03/2024,"Taiwan, Province of China",Pulau Pinang,4309,2023,2286
1/03/2024,"Taiwan, Province of China",Sabah,2173,992,1181
1/03/2024,"Taiwan, Province of China",Sarawak,473,200,273
1/03/2024,"Taiwan, Province of China",Selangor,16818,7775,9043
1/03/2024,"Taiwan, Province of China",W.P. Labuan,2,1,1
1/03/2024,"Tanzania, United Republic of",Johor,25,12,13
1/03/2024,"Tanzania, United Republic of",Kedah,3,1,2
1/03/2024,"Tanzania, United Republic of",Pulau Pinang,4,3,1
1/03/2024,"Tanzania, United Republic of",Sarawak,1,1,0
1/03/2024,"Tanzania, United Republic of",Selangor,168,93,75
1/03/2024,Uganda,Johor,44,29,15
1/03/2024,Uganda,Kedah,2,0,2
1/03/2024,Uganda,Pulau Pinang,9,7,2
1/03/2024,Uganda,Sarawak,1,1,0
1/03/2024,Uganda,Selangor,123,50,73
1/03/2024,Ukraine,Johor,134,56,78
1/03/2024,Ukraine,Kedah,63,26,37
1/03/2024,Ukraine,Kelantan,21,9,12
1/03/2024,Ukraine,Pahang,2,2,0
1/03/2024,Ukraine,Perak,1,0,1
1/03/2024,Ukraine,Perlis,9,2,7
1/03/2024,Ukraine,Pulau Pinang,36,17,19
1/03/2024,Ukraine,Sabah,7,2,5
1/03/2024,Ukraine,Selangor,1528,685,843
1/03/2024,Uruguay,Johor,85,39,46
1/03/2024,Uruguay,Kedah,4,3,1
1/03/2024,Uruguay,Pulau Pinang,1,0,1
1/03/2024,Uruguay,Selangor,81,43,38
1/03/2024,United States of America,Johor,5854,3228,2626
1/03/2024,United States of America,Kedah,645,331,314
1/03/2024,United States of America,Kelantan,18,13,5
1/03/2024,United States of America,Melaka,9,5,4
1/03/2024,United States of America,Negeri Sembilan,2,2,0
1/03/2024,United States of America,Pahang,20,12,8
1/03/2024,United States of America,Perak,122,73,49
1/03/2024,United States of America,Perlis,134,85,49
1/03/2024,United States of America,Pulau Pinang,3836,2089,1747
1/03/2024,United States of America,Sabah,535,278,257
1/03/2024,United States of America,Sarawak,344,205,139
1/03/2024,United States of America,Selangor,17483,10097,7386
1/03/2024,United States of America,Terengganu,2,1,1
1/03/2024,United States of America,W.P. Labuan,1,0,1
1/03/2024,Uzbekistan,Johor,106,83,23
1/03/2024,Uzbekistan,Kedah,15,8,7
1/03/2024,Uzbekistan,Kelantan,6,5,1
1/03/2024,Uzbekistan,Perlis,1,0,1
1/03/2024,Uzbekistan,Pulau Pinang,4,3,1
1/03/2024,Uzbekistan,Sabah,6,2,4
1/03/2024,Uzbekistan,Sarawak,1,0,1
1/03/2024,Uzbekistan,Selangor,1092,602,490
1/03/2024,Holy See,Johor,1,1,0
1/03/2024,Saint Vincent and the Grenadines,Selangor,5,3,2
1/03/2024,"Venezuela, Bolivarian Republic of",Johor,17,5,12
1/03/2024,"Venezuela, Bolivarian Republic of",Kedah,1,1,0
1/03/2024,"Venezuela, Bolivarian Republic of",Kelantan,1,0,1
1/03/2024,"Venezuela, Bolivarian Republic of",Pulau Pinang,1,1,0
1/03/2024,"Venezuela, Bolivarian Republic of",Sabah,2,0,2
1/03/2024,"Venezuela, Bolivarian Republic of",Sarawak,2,2,0
1/03/2024,"Venezuela, Bolivarian Republic of",Selangor,112,60,52
1/03/2024,Viet Nam,Johor,14980,4606,10374
1/03/2024,Viet Nam,Kedah,346,45,301
1/03/2024,Viet Nam,Kelantan,10,7,3
1/03/2024,Viet Nam,Melaka,3,1,2
1/03/2024,Viet Nam,Pahang,2,0,2
1/03/2024,Viet Nam,Perak,113,2,111
1/03/2024,Viet Nam,Perlis,231,19,212
1/03/2024,Viet Nam,Pulau Pinang,1509,462,1047
1/03/2024,Viet Nam,Sabah,39,9,30
1/03/2024,Viet Nam,Sarawak,369,57,312
1/03/2024,Viet Nam,Selangor,18672,6372,12300
1/03/2024,Viet Nam,W.P. Labuan,4,4,0
1/03/2024,Vanuatu,Johor,32,21,11
1/03/2024,Vanuatu,Kedah,1,1,0
1/03/2024,Vanuatu,Perlis,1,1,0
1/03/2024,Vanuatu,Pulau Pinang,6,4,2
1/03/2024,Vanuatu,Sabah,5,4,1
1/03/2024,Vanuatu,Selangor,84,72,12
1/03/2024, Samoa,Sarawak,1,0,1
1/03/2024, Samoa,Selangor,2,1,1
1/03/2024,Yemen,Johor,24,19,5
1/03/2024,Yemen,Kedah,3,2,1
1/03/2024,Yemen,Kelantan,1,0,1
1/03/2024,Yemen,Melaka,3,2,1
1/03/2024,Yemen,Pulau Pinang,7,7,0
1/03/2024,Yemen,Selangor,801,626,175
1/03/2024,South Africa,Johor,245,150,95
1/03/2024,South Africa,Kedah,68,40,28
1/03/2024,South Africa,Perak,2,2,0
1/03/2024,South Africa,Perlis,18,9,9
1/03/2024,South Africa,Pulau Pinang,111,54,57
1/03/2024,South Africa,Sabah,33,16,17
1/03/2024,South Africa,Sarawak,142,60,82
1/03/2024,South Africa,Selangor,1020,588,432
1/03/2024,South Africa,W.P. Labuan,38,21,17
1/03/2024,ZAR,Selangor,1,1,0
1/03/2024,Zambia,Johor,3,1,2
1/03/2024,Zambia,Pulau Pinang,2,0,2
1/03/2024,Zambia,Selangor,69,39,30
1/03/2024,Zimbabwe,Johor,21,11,10
1/03/2024,Zimbabwe,Kelantan,1,0,1
1/03/2024,Zimbabwe,Pulau Pinang,4,1,3
1/03/2024,Zimbabwe,Selangor,114,57,57
1/04/2024,Afghanistan,Pulau Pinang,1,1,0
1/04/2024,Afghanistan,Sarawak,1,1,0
1/04/2024,Afghanistan,Selangor,75,54,21
1/04/2024,Angola,Selangor,2,1,1
1/04/2024,Albania,Johor,14,9,5
1/04/2024,Albania,Perlis,1,0,1
1/04/2024,Albania,Selangor,36,19,17
1/04/2024,Andorra,Selangor,5,3,2
1/04/2024,United Arab Emirates,Johor,20,8,12
1/04/2024,United Arab Emirates,Kedah,14,9,5
1/04/2024,United Arab Emirates,Pulau Pinang,5,5,0
1/04/2024,United Arab Emirates,Sabah,3,3,0
1/04/2024,United Arab Emirates,Selangor,486,278,208
1/04/2024,Argentina,Johor,91,51,40
1/04/2024,Argentina,Kedah,75,35,40
1/04/2024,Argentina,Perak,1,0,1
1/04/2024,Argentina,Perlis,5,2,3
1/04/2024,Argentina,Pulau Pinang,9,4,5
1/04/2024,Argentina,Sarawak,6,3,3
1/04/2024,Argentina,Selangor,470,228,242
1/04/2024,Armenia,Johor,32,9,23
1/04/2024,Armenia,Kedah,1,0,1
1/04/2024,Armenia,Pulau Pinang,1,1,0
1/04/2024,Armenia,Sabah,1,0,1
1/04/2024,Armenia,Selangor,74,24,50
1/04/2024,Antigua and Barbuda,Johor,2,1,1
1/04/2024,Antigua and Barbuda,Pulau Pinang,1,1,0
1/04/2024,Antigua and Barbuda,Selangor,11,6,5
1/04/2024,Australia,Johor,6363,3674,2689
1/04/2024,Australia,Kedah,872,436,436
1/04/2024,Australia,Kelantan,37,30,7
1/04/2024,Australia,Negeri Sembilan,3,3,0
1/04/2024,Australia,Pahang,38,19,19
1/04/2024,Australia,Perak,198,102,96
1/04/2024,Australia,Perlis,98,67,31
1/04/2024,Australia,Pulau Pinang,1762,940,822
1/04/2024,Australia,Sabah,440,213,227
1/04/2024,Australia,Sarawak,541,318,223
1/04/2024,Australia,Selangor,22503,12906,9597
1/04/2024,Australia,W.P. Labuan,13,7,6
1/04/2024,Austria,Johor,178,122,56
1/04/2024,Austria,Kedah,73,39,34
1/04/2024,Austria,Kelantan,3,3,0
1/04/2024,Austria,Perak,2,1,1
1/04/2024,Austria,Perlis,3,2,1
1/04/2024,Austria,Pulau Pinang,58,37,21
1/04/2024,Austria,Sabah,11,7,4
1/04/2024,Austria,Sarawak,44,25,19
1/04/2024,Austria,Selangor,790,472,318
1/04/2024,Azerbaijan,Johor,14,9,5
1/04/2024,Azerbaijan,Kedah,3,2,1
1/04/2024,Azerbaijan,Pulau Pinang,1,0,1
1/04/2024,Azerbaijan,Sarawak,2,2,0
1/04/2024,Azerbaijan,Selangor,145,88,57
1/04/2024,Burundi,Selangor,4,2,2
1/04/2024,Belgium,Johor,285,167,118
1/04/2024,Belgium,Kedah,133,71,62
1/04/2024,Belgium,Kelantan,2,2,0
1/04/2024,Belgium,Melaka,2,0,2
1/04/2024,Belgium,Perak,3,2,1
1/04/2024,Belgium,Perlis,12,10,2
1/04/2024,Belgium,Pulau Pinang,79,45,34
1/04/2024,Belgium,Sabah,27,16,11
1/04/2024,Belgium,Sarawak,32,20,12
1/04/2024,Belgium,Selangor,1378,813,565
1/04/2024,Benin,Johor,1,1,0
1/04/2024,Benin,Selangor,11,5,6
1/04/2024,Burkina Faso,Selangor,6,5,1
1/04/2024,Bangladesh,Johor,2893,2245,648
1/04/2024,Bangladesh,Kedah,132,77,55
1/04/2024,Bangladesh,Kelantan,2,2,0
1/04/2024,Bangladesh,Perak,4,4,0
1/04/2024,Bangladesh,Perlis,3,3,0
1/04/2024,Bangladesh,Pulau Pinang,124,95,29
1/04/2024,Bangladesh,Sabah,2,2,0
1/04/2024,Bangladesh,Sarawak,115,81,34
1/04/2024,Bangladesh,Selangor,25169,22729,2440
1/04/2024,Bangladesh,W.P. Labuan,5,2,3
1/04/2024,Bulgaria,Johor,76,42,34
1/04/2024,Bulgaria,Kedah,23,13,10
1/04/2024,Bulgaria,Kelantan,1,1,0
1/04/2024,Bulgaria,Perak,4,3,1
1/04/2024,Bulgaria,Pulau Pinang,1,1,0
1/04/2024,Bulgaria,Sabah,1,1,0
1/04/2024,Bulgaria,Sarawak,1,0,1
1/04/2024,Bulgaria,Selangor,302,158,144
1/04/2024,Bahrain,Johor,15,10,5
1/04/2024,Bahrain,Kedah,12,4,8
1/04/2024,Bahrain,Pulau Pinang,2,1,1
1/04/2024,Bahrain,Selangor,79,48,31
1/04/2024,Bahamas,Johor,1,0,1
1/04/2024,Bahamas,Selangor,12,7,5
1/04/2024,Bosnia and Herzegovina,Johor,11,6,5
1/04/2024,Bosnia and Herzegovina,Kedah,3,0,3
1/04/2024,Bosnia and Herzegovina,Pulau Pinang,3,1,2
1/04/2024,Bosnia and Herzegovina,Sabah,1,1,0
1/04/2024,Bosnia and Herzegovina,Sarawak,3,3,0
1/04/2024,Bosnia and Herzegovina,Selangor,50,30,20
1/04/2024,Belarus,Johor,11,5,6
1/04/2024,Belarus,Kedah,19,8,11
1/04/2024,Belarus,Kelantan,2,1,1
1/04/2024,Belarus,Perlis,1,1,0
1/04/2024,Belarus,Pulau Pinang,9,4,5
1/04/2024,Belarus,Sabah,3,1,2
1/04/2024,Belarus,Sarawak,5,2,3
1/04/2024,Belarus,Selangor,493,218,275
1/04/2024,Belize,Johor,3,2,1
1/04/2024,Belize,Selangor,3,2,1
1/04/2024,Bermuda,Selangor,3,0,3
1/04/2024,Bolivia,Johor,1,1,0
1/04/2024,Bolivia,Pulau Pinang,3,1,2
1/04/2024,Bolivia,Sarawak,5,3,2
1/04/2024,Bolivia,Selangor,22,10,12
1/04/2024,Brazil,Johor,281,142,139
1/04/2024,Brazil,Kedah,105,47,58
1/04/2024,Brazil,Pahang,3,1,2
1/04/2024,Brazil,Perak,3,1,2
1/04/2024,Brazil,Perlis,5,1,4
1/04/2024,Brazil,Pulau Pinang,25,20,5
1/04/2024,Brazil,Sabah,11,4,7
1/04/2024,Brazil,Sarawak,9,6,3
1/04/2024,Brazil,Selangor,1077,592,485
1/04/2024,Barbados,Johor,1,0,1
1/04/2024,Barbados,Kedah,1,1,0
1/04/2024,Barbados,Selangor,8,5,3
1/04/2024,Brunei Darussalam,Johor,389,200,189
1/04/2024,Brunei Darussalam,Kedah,24,16,8
1/04/2024,Brunei Darussalam,Kelantan,23,9,14
1/04/2024,Brunei Darussalam,Melaka,5,2,3
1/04/2024,Brunei Darussalam,Perak,2,2,0
1/04/2024,Brunei Darussalam,Perlis,10,6,4
1/04/2024,Brunei Darussalam,Pulau Pinang,15,7,8
1/04/2024,Brunei Darussalam,Sabah,1126,473,653
1/04/2024,Brunei Darussalam,Sarawak,160441,84838,75603
1/04/2024,Brunei Darussalam,Selangor,5530,2753,2777
1/04/2024,Brunei Darussalam,W.P. Labuan,1402,840,562
1/04/2024,Bhutan,Johor,15,12,3
1/04/2024,Bhutan,Pulau Pinang,1,1,0
1/04/2024,Bhutan,Selangor,38,22,16
1/04/2024,Botswana,Johor,1,1,0
1/04/2024,Botswana,Pulau Pinang,1,0,1
1/04/2024,Botswana,Selangor,11,3,8
1/04/2024,Canada,Johor,1586,887,699
1/04/2024,Canada,Kedah,253,132,121
1/04/2024,Canada,Kelantan,7,5,2
1/04/2024,Canada,Negeri Sembilan,6,3,3
1/04/2024,Canada,Pahang,7,3,4
1/04/2024,Canada,Perak,33,17,16
1/04/2024,Canada,Perlis,50,34,16
1/04/2024,Canada,Pulau Pinang,485,259,226
1/04/2024,Canada,Sabah,159,87,72
1/04/2024,Canada,Sarawak,415,242,173
1/04/2024,Canada,Selangor,4897,2741,2156
1/04/2024,Canada,W.P. Labuan,9,3,6
1/04/2024,Switzerland,Johor,539,303,236
1/04/2024,Switzerland,Kedah,241,115,126
1/04/2024,Switzerland,Kelantan,3,2,1
1/04/2024,Switzerland,Negeri Sembilan,2,1,1
1/04/2024,Switzerland,Pahang,9,4,5
1/04/2024,Switzerland,Perak,10,8,2
1/04/2024,Switzerland,Perlis,47,23,24
1/04/2024,Switzerland,Pulau Pinang,155,94,61
1/04/2024,Switzerland,Sabah,41,24,17
1/04/2024,Switzerland,Sarawak,42,22,20
1/04/2024,Switzerland,Selangor,1589,909,680
1/04/2024,Chile,Johor,35,17,18
1/04/2024,Chile,Kedah,28,11,17
1/04/2024,Chile,Kelantan,2,0,2
1/04/2024,Chile,Perlis,1,0,1
1/04/2024,Chile,Pulau Pinang,10,6,4
1/04/2024,Chile,Sabah,6,3,3
1/04/2024,Chile,Selangor,307,157,150
1/04/2024,China,Johor,76729,33387,43342
1/04/2024,China,Kedah,2005,843,1162
1/04/2024,China,Kelantan,38,21,17
1/04/2024,China,Melaka,6,6,0
1/04/2024,China,Negeri Sembilan,1,1,0
1/04/2024,China,Pahang,31,16,15
1/04/2024,China,Perak,402,190,212
1/04/2024,China,Perlis,443,241,202
1/04/2024,China,Pulau Pinang,9358,4725,4633
1/04/2024,China,Sabah,12460,5379,7081
1/04/2024,China,Sarawak,1634,825,809
1/04/2024,China,Selangor,125281,62052,63229
1/04/2024,China,W.P. Labuan,38,33,5
1/04/2024,Côte d'Ivoire,Johor,3,3,0
1/04/2024,Côte d'Ivoire,Sabah,1,0,1
1/04/2024,Côte d'Ivoire,Sarawak,1,0,1
1/04/2024,Côte d'Ivoire,Selangor,21,12,9
1/04/2024,Cameroon,Pulau Pinang,1,1,0
1/04/2024,Cameroon,Selangor,38,15,23
1/04/2024,Congo,Johor,2,2,0
1/04/2024,Congo,Selangor,32,14,18
1/04/2024,Congo,Selangor,1,0,1
1/04/2024,Colombia,Johor,33,15,18
1/04/2024,Colombia,Kedah,9,6,3
1/04/2024,Colombia,Perak,2,2,0
1/04/2024,Colombia,Pulau Pinang,3,2,1
1/04/2024,Colombia,Sabah,1,0,1
1/04/2024,Colombia,Sarawak,7,3,4
1/04/2024,Colombia,Selangor,246,120,126
1/04/2024,Comoros,Johor,5,2,3
1/04/2024,Comoros,Selangor,21,15,6
1/04/2024,Costa Rica,Johor,13,7,6
1/04/2024,Costa Rica,Kedah,2,1,1
1/04/2024,Costa Rica,Pulau Pinang,10,6,4
1/04/2024,Costa Rica,Sabah,1,1,0
1/04/2024,Costa Rica,Selangor,66,37,29
1/04/2024,Cuba,Johor,9,5,4
1/04/2024,Cuba,Sabah,1,0,1
1/04/2024,Cuba,Selangor,17,14,3
1/04/2024,Cyprus,Johor,9,4,5
1/04/2024,Cyprus,Kedah,2,1,1
1/04/2024,Cyprus,Pulau Pinang,4,4,0
1/04/2024,Cyprus,Selangor,63,38,25
1/04/2024,Czechia,Johor,110,66,44
1/04/2024,Czechia,Kedah,49,23,26
1/04/2024,Czechia,Perak,2,1,1
1/04/2024,Czechia,Perlis,9,6,3
1/04/2024,Czechia,Pulau Pinang,33,19,14
1/04/2024,Czechia,Sabah,17,10,7
1/04/2024,Czechia,Sarawak,10,7,3
1/04/2024,Czechia,Selangor,576,319,257
1/04/2024,Germany,Johor,2634,1573,1061
1/04/2024,Germany,Kedah,1076,556,520
1/04/2024,Germany,Kelantan,12,8,4
1/04/2024,Germany,Pahang,8,4,4
1/04/2024,Germany,Perak,30,20,10
1/04/2024,Germany,Perlis,105,58,47
1/04/2024,Germany,Pulau Pinang,627,430,197
1/04/2024,Germany,Sabah,150,83,67
1/04/2024,Germany,Sarawak,236,133,103
1/04/2024,Germany,Selangor,9864,5527,4337
1/04/2024,Germany,W.P. Labuan,7,6,1
1/04/2024,Djibouti,Selangor,9,6,3
1/04/2024,Dominica,Johor,2,2,0
1/04/2024,Dominica,Kedah,2,1,1
1/04/2024,Dominica,Pulau Pinang,1,1,0
1/04/2024,Dominica,Sarawak,2,1,1
1/04/2024,Dominica,Selangor,64,44,20
1/04/2024,Denmark,Johor,293,216,77
1/04/2024,Denmark,Kedah,166,81,85
1/04/2024,Denmark,Kelantan,3,1,2
1/04/2024,Denmark,Perak,2,1,1
1/04/2024,Denmark,Perlis,6,3,3
1/04/2024,Denmark,Pulau Pinang,51,32,19
1/04/2024,Denmark,Sabah,16,9,7
1/04/2024,Denmark,Sarawak,8,6,2
1/04/2024,Denmark,Selangor,1167,639,528
1/04/2024,Denmark,Terengganu,19,4,15
1/04/2024,Dominican Republic,Johor,1,0,1
1/04/2024,Dominican Republic,Pulau Pinang,1,1,0
1/04/2024,Dominican Republic,Sabah,1,0,1
1/04/2024,Dominican Republic,Selangor,11,4,7
1/04/2024,Algeria,Johor,28,19,9
1/04/2024,Algeria,Kedah,3,1,2
1/04/2024,Algeria,Sabah,1,1,0
1/04/2024,Algeria,Sarawak,2,2,0
1/04/2024,Algeria,Selangor,479,313,166
1/04/2024,Ecuador,Johor,12,7,5
1/04/2024,Ecuador,Kedah,1,0,1
1/04/2024,Ecuador,Pulau Pinang,6,2,4
1/04/2024,Ecuador,Selangor,118,49,69
1/04/2024,Egypt,Johor,262,221,41
1/04/2024,Egypt,Kedah,39,22,17
1/04/2024,Egypt,Kelantan,4,2,2
1/04/2024,Egypt,Perlis,1,1,0
1/04/2024,Egypt,Pulau Pinang,18,13,5
1/04/2024,Egypt,Sabah,3,3,0
1/04/2024,Egypt,Sarawak,162,105,57
1/04/2024,Egypt,Selangor,1469,967,502
1/04/2024,Eritrea,Selangor,15,10,5
1/04/2024,Spain,Johor,511,323,188
1/04/2024,Spain,Kedah,175,84,91
1/04/2024,Spain,Kelantan,8,5,3
1/04/2024,Spain,Melaka,1,0,1
1/04/2024,Spain,Pahang,1,1,0
1/04/2024,Spain,Perak,3,1,2
1/04/2024,Spain,Perlis,21,12,9
1/04/2024,Spain,Pulau Pinang,84,52,32
1/04/2024,Spain,Sabah,35,22,13
1/04/2024,Spain,Sarawak,42,31,11
1/04/2024,Spain,Selangor,2749,1556,1193
1/04/2024,Spain,W.P. Labuan,1,1,0
1/04/2024,Estonia,Johor,24,13,11
1/04/2024,Estonia,Kedah,19,8,11
1/04/2024,Estonia,Perlis,2,2,0
1/04/2024,Estonia,Pulau Pinang,11,7,4
1/04/2024,Estonia,Sabah,4,2,2
1/04/2024,Estonia,Sarawak,9,4,5
1/04/2024,Estonia,Selangor,135,80,55
1/04/2024,Estonia,W.P. Labuan,1,0,1
1/04/2024,Ethiopia,Johor,5,3,2
1/04/2024,Ethiopia,Selangor,26,20,6
1/04/2024,Finland,Johor,238,134,104
1/04/2024,Finland,Kedah,69,29,40
1/04/2024,Finland,Perak,9,4,5
1/04/2024,Finland,Perlis,2,2,0
1/04/2024,Finland,Pulau Pinang,34,21,13
1/04/2024,Finland,Sabah,8,5,3
1/04/2024,Finland,Sarawak,2,0,2
1/04/2024,Finland,Selangor,434,222,212
1/04/2024,Fiji,Johor,71,30,41
1/04/2024,Fiji,Kedah,2,2,0
1/04/2024,Fiji,Perlis,1,0,1
1/04/2024,Fiji,Pulau Pinang,5,4,1
1/04/2024,Fiji,Selangor,149,70,79
1/04/2024,France,Johor,2567,1498,1069
1/04/2024,France,Kedah,942,474,468
1/04/2024,France,Kelantan,20,11,9
1/04/2024,France,Melaka,9,5,4
1/04/2024,France,Negeri Sembilan,2,1,1
1/04/2024,France,Pahang,56,28,28
1/04/2024,France,Perak,28,16,12
1/04/2024,France,Perlis,91,59,32
1/04/2024,France,Pulau Pinang,342,198,144
1/04/2024,France,Sabah,166,96,70
1/04/2024,France,Sarawak,141,86,55
1/04/2024,France,Selangor,10465,5753,4712
1/04/2024,France,W.P. Labuan,9,4,5
1/04/2024,Gabon,Johor,3,1,2
1/04/2024,Gabon,Selangor,9,4,5
1/04/2024,United Kingdom of Great Britain and Northern Ireland,Johor,5383,3339,2044
1/04/2024,United Kingdom of Great Britain and Northern Ireland,Kedah,2112,1118,994
1/04/2024,United Kingdom of Great Britain and Northern Ireland,Kelantan,9,8,1
1/04/2024,United Kingdom of Great Britain and Northern Ireland,Melaka,2,1,1
1/04/2024,United Kingdom of Great Britain and Northern Ireland,Pahang,10,9,1
1/04/2024,United Kingdom of Great Britain and Northern Ireland,Perak,114,68,46
1/04/2024,United Kingdom of Great Britain and Northern Ireland,Perlis,173,112,61
1/04/2024,United Kingdom of Great Britain and Northern Ireland,Pulau Pinang,5968,2945,3023
1/04/2024,United Kingdom of Great Britain and Northern Ireland,Sabah,654,349,305
1/04/2024,United Kingdom of Great Britain and Northern Ireland,Sarawak,1134,676,458
1/04/2024,United Kingdom of Great Britain and Northern Ireland,Selangor,19008,11101,7907
1/04/2024,United Kingdom of Great Britain and Northern Ireland,W.P. Labuan,39,31,8
1/04/2024,Georgia,Johor,22,17,5
1/04/2024,Georgia,Kelantan,1,1,0
1/04/2024,Georgia,Perlis,1,1,0
1/04/2024,Georgia,Pulau Pinang,2,1,1
1/04/2024,Georgia,Sabah,2,1,1
1/04/2024,Georgia,Sarawak,1,0,1
1/04/2024,Georgia,Selangor,45,29,16
1/04/2024,Ghana,Johor,4,3,1
1/04/2024,Ghana,Kedah,1,1,0
1/04/2024,Ghana,Pulau Pinang,1,0,1
1/04/2024,Ghana,Selangor,95,59,36
1/04/2024,Guinea,Johor,4,3,1
1/04/2024,Guinea,Selangor,34,28,6
1/04/2024,Gambia,Selangor,20,16,4
1/04/2024,Guinea-Bissau,Selangor,2,1,1
1/04/2024,Equatorial Guinea,Johor,1,1,0
1/04/2024,Equatorial Guinea,Selangor,2,1,1
1/04/2024,Greece,Johor,53,36,17
1/04/2024,Greece,Kedah,11,10,1
1/04/2024,Greece,Perak,1,1,0
1/04/2024,Greece,Perlis,2,2,0
1/04/2024,Greece,Pulau Pinang,8,4,4
1/04/2024,Greece,Sabah,4,3,1
1/04/2024,Greece,Sarawak,4,3,1
1/04/2024,Greece,Selangor,298,190,108
1/04/2024,Grenada,Johor,6,2,4
1/04/2024,Grenada,Kedah,4,2,2
1/04/2024,Grenada,Selangor,7,5,2
1/04/2024,Guatemala,Johor,2,1,1
1/04/2024,Guatemala,Kedah,1,1,0
1/04/2024,Guatemala,Pulau Pinang,1,0,1
1/04/2024,Guatemala,Sabah,1,1,0
1/04/2024,Guatemala,Selangor,25,13,12
1/04/2024,Guyana,Selangor,8,5,3
1/04/2024,Hong Kong,Johor,6,4,2
1/04/2024,Hong Kong,Pahang,1,1,0
1/04/2024,Hong Kong,Perak,44,21,23
1/04/2024,Hong Kong,Perlis,3,2,1
1/04/2024,Hong Kong,Pulau Pinang,3,0,3
1/04/2024,Hong Kong,Sabah,22,13,9
1/04/2024,Hong Kong,Selangor,52,23,29
1/04/2024,Honduras,Johor,3,3,0
1/04/2024,Honduras,Selangor,22,15,7
1/04/2024,Croatia,Johor,32,24,8
1/04/2024,Croatia,Kedah,9,4,5
1/04/2024,Croatia,Perlis,1,1,0
1/04/2024,Croatia,Pulau Pinang,7,7,0
1/04/2024,Croatia,Sabah,7,6,1
1/04/2024,Croatia,Sarawak,4,2,2
1/04/2024,Croatia,Selangor,215,129,86
1/04/2024,Haiti,Sabah,1,1,0
1/04/2024,Haiti,Selangor,11,5,6
1/04/2024,Hungary,Johor,128,74,54
1/04/2024,Hungary,Kedah,35,15,20
1/04/2024,Hungary,Perlis,4,2,2
1/04/2024,Hungary,Pulau Pinang,13,9,4
1/04/2024,Hungary,Sabah,2,1,1
1/04/2024,Hungary,Sarawak,29,15,14
1/04/2024,Hungary,Selangor,549,301,248
1/04/2024,Indonesia,Johor,100989,46197,54792
1/04/2024,Indonesia,Kedah,2583,962,1621
1/04/2024,Indonesia,Kelantan,167,80,87
1/04/2024,Indonesia,Melaka,4697,2070,2627
1/04/2024,Indonesia,Negeri Sembilan,5176,3149,2027
1/04/2024,Indonesia,Pahang,19,14,5
1/04/2024,Indonesia,Perak,217,77,140
1/04/2024,Indonesia,Perlis,707,263,444
1/04/2024,Indonesia,Pulau Pinang,36706,15143,21563
1/04/2024,Indonesia,Sabah,6268,3121,3147
1/04/2024,Indonesia,Sarawak,54088,28166,25922
1/04/2024,Indonesia,Selangor,166132,77610,88522
1/04/2024,Indonesia,W.P. Labuan,66,24,42
1/04/2024,India,Johor,32493,20972,11521
1/04/2024,India,Kedah,1701,942,759
1/04/2024,India,Kelantan,4,4,0
1/04/2024,India,Melaka,3,3,0
1/04/2024,India,Negeri Sembilan,1,1,0
1/04/2024,India,Pahang,11,9,2
1/04/2024,India,Perak,200,119,81
1/04/2024,India,Perlis,79,61,18
1/04/2024,India,Pulau Pinang,1870,1186,684
1/04/2024,India,Sabah,234,139,95
1/04/2024,India,Sarawak,2593,1994,599
1/04/2024,India,Selangor,75329,48165,27164
1/04/2024,India,W.P. Labuan,75,63,12
1/04/2024, British Indian Ocean Territory,Selangor,1,0,1
1/04/2024,Ireland,Johor,315,197,118
1/04/2024,Ireland,Kedah,142,70,72
1/04/2024,Ireland,Kelantan,4,3,1
1/04/2024,Ireland,Perak,7,6,1
1/04/2024,Ireland,Perlis,12,5,7
1/04/2024,Ireland,Pulau Pinang,134,74,60
1/04/2024,Ireland,Sabah,27,12,15
1/04/2024,Ireland,Sarawak,31,14,17
1/04/2024,Ireland,Selangor,1409,804,605
1/04/2024,Ireland,W.P. Labuan,1,0,1
1/04/2024,"Iran, Islamic Republic of",Johor,336,166,170
1/04/2024,"Iran, Islamic Republic of",Kedah,15,2,13
1/04/2024,"Iran, Islamic Republic of",Melaka,1,1,0
1/04/2024,"Iran, Islamic Republic of",Perak,1,0,1
1/04/2024,"Iran, Islamic Republic of",Perlis,10,6,4
1/04/2024,"Iran, Islamic Republic of",Pulau Pinang,11,5,6
1/04/2024,"Iran, Islamic Republic of",Sabah,2,1,1
1/04/2024,"Iran, Islamic Republic of",Sarawak,7,7,0
1/04/2024,"Iran, Islamic Republic of",Selangor,1965,1060,905
1/04/2024,Iraq,Johor,32,27,5
1/04/2024,Iraq,Kedah,10,8,2
1/04/2024,Iraq,Pulau Pinang,6,4,2
1/04/2024,Iraq,Sabah,1,0,1
1/04/2024,Iraq,Sarawak,3,1,2
1/04/2024,Iraq,Selangor,1193,839,354
1/04/2024,Iceland,Johor,6,2,4
1/04/2024,Iceland,Perak,2,1,1
1/04/2024,Iceland,Pulau Pinang,4,2,2
1/04/2024,Iceland,Selangor,31,14,17
1/04/2024,Israel,Selangor,6,6,0
1/04/2024,Italy,Johor,639,421,218
1/04/2024,Italy,Kedah,240,135,105
1/04/2024,Italy,Kelantan,3,2,1
1/04/2024,Italy,Melaka,1,1,0
1/04/2024,Italy,Negeri Sembilan,3,3,0
1/04/2024,Italy,Pahang,1,1,0
1/04/2024,Italy,Perak,17,6,11
1/04/2024,Italy,Perlis,21,14,7
1/04/2024,Italy,Pulau Pinang,83,57,26
1/04/2024,Italy,Sabah,57,35,22
1/04/2024,Italy,Sarawak,57,35,22
1/04/2024,Italy,Selangor,3403,2022,1381
1/04/2024,Italy,W.P. Labuan,2,0,2
1/04/2024,Jamaica,Johor,4,2,2
1/04/2024,Jamaica,Kedah,5,1,4
1/04/2024,Jamaica,Pulau Pinang,1,0,1
1/04/2024,Jamaica,Selangor,20,8,12
1/04/2024,Jordan,Johor,13,6,7
1/04/2024,Jordan,Kedah,12,8,4
1/04/2024,Jordan,Kelantan,1,1,0
1/04/2024,Jordan,Pahang,1,1,0
1/04/2024,Jordan,Perlis,1,0,1
1/04/2024,Jordan,Pulau Pinang,12,7,5
1/04/2024,Jordan,Sarawak,5,3,2
1/04/2024,Jordan,Selangor,862,530,332
1/04/2024,Japan,Johor,5777,3801,1976
1/04/2024,Japan,Kedah,463,234,229
1/04/2024,Japan,Kelantan,9,8,1
1/04/2024,Japan,Pahang,12,7,5
1/04/2024,Japan,Perak,60,35,25
1/04/2024,Japan,Perlis,85,57,28
1/04/2024,Japan,Pulau Pinang,1143,753,390
1/04/2024,Japan,Sabah,581,291,290
1/04/2024,Japan,Sarawak,144,84,60
1/04/2024,Japan,Selangor,18647,10830,7817
1/04/2024,Japan,W.P. Labuan,13,10,3
1/04/2024,Kazakhstan,Johor,48,16,32
1/04/2024,Kazakhstan,Kedah,55,21,34
1/04/2024,Kazakhstan,Kelantan,2,0,2
1/04/2024,Kazakhstan,Perlis,11,2,9
1/04/2024,Kazakhstan,Pulau Pinang,8,3,5
1/04/2024,Kazakhstan,Sabah,4,2,2
1/04/2024,Kazakhstan,Sarawak,18,9,9
1/04/2024,Kazakhstan,Selangor,3521,1378,2143
1/04/2024,Kenya,Johor,56,21,35
1/04/2024,Kenya,Kedah,9,4,5
1/04/2024,Kenya,Melaka,1,0,1
1/04/2024,Kenya,Pulau Pinang,5,2,3
1/04/2024,Kenya,Sarawak,1,1,0
1/04/2024,Kenya,Selangor,344,162,182
1/04/2024,Kyrgyzstan,Johor,33,22,11
1/04/2024,Kyrgyzstan,Kedah,13,5,8
1/04/2024,Kyrgyzstan,Perlis,1,1,0
1/04/2024,Kyrgyzstan,Pulau Pinang,8,0,8
1/04/2024,Kyrgyzstan,Sarawak,2,2,0
1/04/2024,Kyrgyzstan,Selangor,467,205,262
1/04/2024,Cambodia,Johor,2424,1048,1376
1/04/2024,Cambodia,Kedah,194,162,32
1/04/2024,Cambodia,Kelantan,357,200,157
1/04/2024,Cambodia,Perak,6,1,5
1/04/2024,Cambodia,Perlis,822,531,291
1/04/2024,Cambodia,Pulau Pinang,25,5,20
1/04/2024,Cambodia,Sarawak,5,3,2
1/04/2024,Cambodia,Selangor,4428,2115,2313
1/04/2024,Kiribati,Johor,2,0,2
1/04/2024,Saint Kitts and Nevis,Johor,25,14,11
1/04/2024,Saint Kitts and Nevis,Kedah,9,3,6
1/04/2024,Saint Kitts and Nevis,Pulau Pinang,1,1,0
1/04/2024,Saint Kitts and Nevis,Selangor,53,38,15
1/04/2024,"Korea, Republic of",Johor,9475,5211,4264
1/04/2024,"Korea, Republic of",Kedah,269,109,160
1/04/2024,"Korea, Republic of",Kelantan,5,2,3
1/04/2024,"Korea, Republic of",Melaka,1,1,0
1/04/2024,"Korea, Republic of",Perak,25,13,12
1/04/2024,"Korea, Republic of",Perlis,65,43,22
1/04/2024,"Korea, Republic of",Pulau Pinang,557,300,257
1/04/2024,"Korea, Republic of",Sabah,11009,4304,6705
1/04/2024,"Korea, Republic of",Sarawak,216,123,93
1/04/2024,"Korea, Republic of",Selangor,12860,6999,5861
1/04/2024,"Korea, Republic of",W.P. Labuan,3,2,1
1/04/2024,Kuwait,Johor,14,5,9
1/04/2024,Kuwait,Kedah,11,7,4
1/04/2024,Kuwait,Pulau Pinang,4,3,1
1/04/2024,Kuwait,Selangor,201,127,74
1/04/2024, Lao People's Democratic Republic,Johor,214,62,152
1/04/2024, Lao People's Democratic Republic,Kedah,676,51,625
1/04/2024, Lao People's Democratic Republic,Kelantan,177,44,133
1/04/2024, Lao People's Democratic Republic,Perak,33,5,28
1/04/2024, Lao People's Democratic Republic,Perlis,264,45,219
1/04/2024, Lao People's Democratic Republic,Pulau Pinang,20,4,16
1/04/2024, Lao People's Democratic Republic,Sarawak,17,9,8
1/04/2024, Lao People's Democratic Republic,Selangor,310,125,185
1/04/2024,Lebanon,Johor,28,18,10
1/04/2024,Lebanon,Kedah,16,10,6
1/04/2024,Lebanon,Pulau Pinang,14,7,7
1/04/2024,Lebanon,Sabah,2,1,1
1/04/2024,Lebanon,Sarawak,4,3,1
1/04/2024,Lebanon,Selangor,352,223,129
1/04/2024,Liberia,Johor,2,2,0
1/04/2024,Liberia,Selangor,4,3,1
1/04/2024,Libya,Johor,6,6,0
1/04/2024,Libya,Kedah,2,2,0
1/04/2024,Libya,Sabah,1,0,1
1/04/2024,Libya,Selangor,283,204,79
1/04/2024,Saint Lucia,Johor,3,1,2
1/04/2024,Saint Lucia,Pulau Pinang,4,1,3
1/04/2024,Saint Lucia,Selangor,7,4,3
1/04/2024,Liechtenstein,Kedah,7,1,6
1/04/2024,Liechtenstein,Perak,1,1,0
1/04/2024,Liechtenstein,Selangor,12,7,5
1/04/2024,LKA,Johor,721,427,294
1/04/2024,LKA,Kedah,6,6,0
1/04/2024,LKA,Perlis,1,1,0
1/04/2024,LKA,Pulau Pinang,30,18,12
1/04/2024,LKA,Sabah,7,6,1
1/04/2024,LKA,Sarawak,37,27,10
1/04/2024,LKA,Selangor,4904,2875,2029
1/04/2024,LKA,W.P. Labuan,1,1,0
1/04/2024,Lesotho,Selangor,12,5,7
1/04/2024,Lithuania,Johor,92,49,43
1/04/2024,Lithuania,Kedah,41,18,23
1/04/2024,Lithuania,Perlis,4,2,2
1/04/2024,Lithuania,Pulau Pinang,15,7,8
1/04/2024,Lithuania,Sabah,4,3,1
1/04/2024,Lithuania,Sarawak,2,1,1
1/04/2024,Lithuania,Selangor,357,186,171
1/04/2024,Lithuania,Terengganu,1,1,0
1/04/2024,Lithuania,W.P. Labuan,6,1,5
1/04/2024,Luxembourg,Johor,11,8,3
1/04/2024,Luxembourg,Kedah,13,7,6
1/04/2024,Luxembourg,Perlis,1,1,0
1/04/2024,Luxembourg,Pulau Pinang,3,3,0
1/04/2024,Luxembourg,Sabah,1,1,0
1/04/2024,Luxembourg,Selangor,75,40,35
1/04/2024,Latvia,Johor,52,24,28
1/04/2024,Latvia,Kedah,10,5,5
1/04/2024,Latvia,Perlis,4,3,1
1/04/2024,Latvia,Pulau Pinang,10,5,5
1/04/2024,Latvia,Sabah,1,0,1
1/04/2024,Latvia,Sarawak,1,1,0
1/04/2024,Latvia,Selangor,186,78,108
1/04/2024,Latvia,W.P. Labuan,5,2,3
1/04/2024,Macao,Perak,1,1,0
1/04/2024,Macao,Selangor,2,1,1
1/04/2024,Morocco,Johor,111,70,41
1/04/2024,Morocco,Kedah,16,10,6
1/04/2024,Morocco,Kelantan,2,0,2
1/04/2024,Morocco,Perlis,4,2,2
1/04/2024,Morocco,Pulau Pinang,12,7,5
1/04/2024,Morocco,Sabah,2,1,1
1/04/2024,Morocco,Sarawak,7,3,4
1/04/2024,Morocco,Selangor,978,526,452
1/04/2024,Monaco,Selangor,6,4,2
1/04/2024,"Moldova, Republic of",Johor,6,2,4
1/04/2024,"Moldova, Republic of",Sabah,1,1,0
1/04/2024,"Moldova, Republic of",Selangor,34,16,18
1/04/2024,Madagascar,Johor,7,2,5
1/04/2024,Madagascar,Selangor,133,58,75
1/04/2024,Maldives,Johor,134,67,67
1/04/2024,Maldives,Sabah,4,3,1
1/04/2024,Maldives,Sarawak,6,4,2
1/04/2024,Maldives,Selangor,3206,1725,1481
1/04/2024,Mexico,Johor,233,95,138
1/04/2024,Mexico,Kedah,15,7,8
1/04/2024,Mexico,Perlis,5,3,2
1/04/2024,Mexico,Pulau Pinang,31,23,8
1/04/2024,Mexico,Sabah,5,3,2
1/04/2024,Mexico,Selangor,841,391,450
1/04/2024,Marshall Islands,Selangor,2,2,0
1/04/2024,North Macedonia,Johor,8,3,5
1/04/2024,North Macedonia,Kedah,3,2,1
1/04/2024,North Macedonia,Perlis,2,2,0
1/04/2024,North Macedonia,Pulau Pinang,4,1,3
1/04/2024,North Macedonia,Sarawak,3,2,1
1/04/2024,North Macedonia,Selangor,49,20,29
1/04/2024,Mali,Pulau Pinang,1,0,1
1/04/2024,Mali,Selangor,9,8,1
1/04/2024,Malta,Johor,9,5,4
1/04/2024,Malta,Sabah,1,1,0
1/04/2024,Malta,Selangor,55,35,20
1/04/2024,Myanmar,Johor,6833,2245,4588
1/04/2024,Myanmar,Kedah,79,21,58
1/04/2024,Myanmar,Kelantan,5,2,3
1/04/2024,Myanmar,Melaka,1,0,1
1/04/2024,Myanmar,Pahang,4,0,4
1/04/2024,Myanmar,Perak,27,7,20
1/04/2024,Myanmar,Perlis,15,2,13
1/04/2024,Myanmar,Pulau Pinang,215,89,126
1/04/2024,Myanmar,Sabah,9,4,5
1/04/2024,Myanmar,Sarawak,65,35,30
1/04/2024,Myanmar,Selangor,6877,4522,2355
1/04/2024,Montenegro,Johor,3,3,0
1/04/2024,Montenegro,Pulau Pinang,3,2,1
1/04/2024,Montenegro,Selangor,19,14,5
1/04/2024,Mongolia,Johor,170,72,98
1/04/2024,Mongolia,Kedah,11,7,4
1/04/2024,Mongolia,Perak,4,1,3
1/04/2024,Mongolia,Pulau Pinang,3,1,2
1/04/2024,Mongolia,Sabah,3,1,2
1/04/2024,Mongolia,Sarawak,1,0,1
1/04/2024,Mongolia,Selangor,354,147,207
1/04/2024,Mozambique,Johor,1,0,1
1/04/2024,Mozambique,Selangor,20,10,10
1/04/2024,Mauritania,Johor,1,1,0
1/04/2024,Mauritania,Selangor,14,12,2
1/04/2024,Mauritius,Johor,290,139,151
1/04/2024,Mauritius,Kedah,13,7,6
1/04/2024,Mauritius,Perlis,3,3,0
1/04/2024,Mauritius,Pulau Pinang,10,5,5
1/04/2024,Mauritius,Sabah,1,1,0
1/04/2024,Mauritius,Sarawak,1,0,1
1/04/2024,Mauritius,Selangor,2205,1094,1111
1/04/2024,Malawi,Pulau Pinang,3,2,1
1/04/2024,Malawi,Selangor,22,12,10
1/04/2024,Namibia,Johor,1,1,0
1/04/2024,Namibia,Selangor,8,3,5
1/04/2024,Niger,Selangor,4,0,4
1/04/2024,Nigeria,Johor,19,17,2
1/04/2024,Nigeria,Pulau Pinang,8,8,0
1/04/2024,Nigeria,Sabah,2,2,0
1/04/2024,Nigeria,Sarawak,6,5,1
1/04/2024,Nigeria,Selangor,428,332,96
1/04/2024,Nicaragua,Johor,3,2,1
1/04/2024,Nicaragua,Kedah,1,0,1
1/04/2024,Nicaragua,Pulau Pinang,2,1,1
1/04/2024,Nicaragua,Selangor,3,2,1
1/04/2024,Netherlands,Johor,1123,694,429
1/04/2024,Netherlands,Kedah,428,210,218
1/04/2024,Netherlands,Kelantan,4,3,1
1/04/2024,Netherlands,Melaka,2,2,0
1/04/2024,Netherlands,Negeri Sembilan,1,1,0
1/04/2024,Netherlands,Pahang,5,3,2
1/04/2024,Netherlands,Perak,12,6,6
1/04/2024,Netherlands,Perlis,41,20,21
1/04/2024,Netherlands,Pulau Pinang,247,143,104
1/04/2024,Netherlands,Sabah,96,55,41
1/04/2024,Netherlands,Sarawak,146,90,56
1/04/2024,Netherlands,Selangor,4591,2597,1994
1/04/2024,Netherlands,W.P. Labuan,1,1,0
1/04/2024,Norway,Johor,173,110,63
1/04/2024,Norway,Kedah,66,20,46
1/04/2024,Norway,Kelantan,1,1,0
1/04/2024,Norway,Perak,1,1,0
1/04/2024,Norway,Perlis,17,8,9
1/04/2024,Norway,Pulau Pinang,35,27,8
1/04/2024,Norway,Sabah,7,4,3
1/04/2024,Norway,Sarawak,18,13,5
1/04/2024,Norway,Selangor,630,371,259
1/04/2024,Norway,W.P. Labuan,1,1,0
1/04/2024,Nepal,Johor,1077,835,242
1/04/2024,Nepal,Kedah,17,10,7
1/04/2024,Nepal,Perak,1,1,0
1/04/2024,Nepal,Perlis,10,10,0
1/04/2024,Nepal,Pulau Pinang,9,8,1
1/04/2024,Nepal,Sabah,2,2,0
1/04/2024,Nepal,Sarawak,306,206,100
1/04/2024,Nepal,Selangor,10072,9561,511
1/04/2024,Nepal,W.P. Labuan,56,50,6
1/04/2024,Nauru,Selangor,4,3,1
1/04/2024,New Zealand,Johor,915,559,356
1/04/2024,New Zealand,Kedah,149,81,68
1/04/2024,New Zealand,Kelantan,1,1,0
1/04/2024,New Zealand,Negeri Sembilan,1,1,0
1/04/2024,New Zealand,Pahang,11,5,6
1/04/2024,New Zealand,Perak,26,18,8
1/04/2024,New Zealand,Perlis,20,11,9
1/04/2024,New Zealand,Pulau Pinang,196,104,92
1/04/2024,New Zealand,Sabah,72,32,40
1/04/2024,New Zealand,Sarawak,130,73,57
1/04/2024,New Zealand,Selangor,2802,1640,1162
1/04/2024,New Zealand,Terengganu,1,0,1
1/04/2024,New Zealand,W.P. Labuan,6,3,3
1/04/2024,Oman,Johor,18,9,9
1/04/2024,Oman,Kedah,5,3,2
1/04/2024,Oman,Kelantan,1,1,0
1/04/2024,Oman,Perak,1,1,0
1/04/2024,Oman,Pulau Pinang,2,2,0
1/04/2024,Oman,Sarawak,10,3,7
1/04/2024,Oman,Selangor,682,427,255
1/04/2024,Pakistan,Johor,602,463,139
1/04/2024,Pakistan,Kedah,90,59,31
1/04/2024,Pakistan,Kelantan,16,15,1
1/04/2024,Pakistan,Pahang,2,2,0
1/04/2024,Pakistan,Perak,3,3,0
1/04/2024,Pakistan,Perlis,18,17,1
1/04/2024,Pakistan,Pulau Pinang,74,60,14
1/04/2024,Pakistan,Sabah,23,18,5
1/04/2024,Pakistan,Sarawak,218,177,41
1/04/2024,Pakistan,Selangor,6853,5607,1246
1/04/2024,Pakistan,W.P. Labuan,3,3,0
1/04/2024,Panama,Johor,10,4,6
1/04/2024,Panama,Sabah,2,0,2
1/04/2024,Panama,Sarawak,1,0,1
1/04/2024,Panama,Selangor,28,15,13
1/04/2024,Peru,Johor,24,13,11
1/04/2024,Peru,Kedah,7,3,4
1/04/2024,Peru,Perak,2,1,1
1/04/2024,Peru,Perlis,1,0,1
1/04/2024,Peru,Pulau Pinang,1,1,0
1/04/2024,Peru,Sabah,1,0,1
1/04/2024,Peru,Selangor,148,78,70
1/04/2024,Philippines,Johor,23651,7539,16112
1/04/2024,Philippines,Kedah,410,121,289
1/04/2024,Philippines,Kelantan,49,24,25
1/04/2024,Philippines,Negeri Sembilan,6,5,1
1/04/2024,Philippines,Pahang,17,9,8
1/04/2024,Philippines,Perak,63,22,41
1/04/2024,Philippines,Perlis,180,49,131
1/04/2024,Philippines,Pulau Pinang,670,278,392
1/04/2024,Philippines,Sabah,1084,560,524
1/04/2024,Philippines,Sarawak,3189,1262,1927
1/04/2024,Philippines,Selangor,15292,6063,9229
1/04/2024,Philippines,W.P. Labuan,146,46,100
1/04/2024,Papua New Guinea,Johor,13,6,7
1/04/2024,Papua New Guinea,Sabah,4,2,2
1/04/2024,Papua New Guinea,Sarawak,3,2,1
1/04/2024,Papua New Guinea,Selangor,81,48,33
1/04/2024,Poland,Johor,377,223,154
1/04/2024,Poland,Kedah,194,94,100
1/04/2024,Poland,Kelantan,3,3,0
1/04/2024,Poland,Pahang,1,0,1
1/04/2024,Poland,Perak,4,1,3
1/04/2024,Poland,Perlis,13,9,4
1/04/2024,Poland,Pulau Pinang,88,47,41
1/04/2024,Poland,Sabah,59,27,32
1/04/2024,Poland,Sarawak,67,38,29
1/04/2024,Poland,Selangor,1570,807,763
1/04/2024,Poland,W.P. Labuan,3,2,1
1/04/2024,Puerto Rico,Sabah,1,0,1
1/04/2024,Portugal,Johor,208,117,91
1/04/2024,Portugal,Kedah,128,62,66
1/04/2024,Portugal,Kelantan,1,0,1
1/04/2024,Portugal,Pahang,1,1,0
1/04/2024,Portugal,Perak,2,1,1
1/04/2024,Portugal,Perlis,10,3,7
1/04/2024,Portugal,Pulau Pinang,46,30,16
1/04/2024,Portugal,Sabah,97,54,43
1/04/2024,Portugal,Sarawak,14,8,6
1/04/2024,Portugal,Selangor,961,557,404
1/04/2024,Paraguay,Johor,3,2,1
1/04/2024,Paraguay,Sabah,3,2,1
1/04/2024,Paraguay,Selangor,9,5,4
1/04/2024,"Palestine, State of",Johor,29,28,1
1/04/2024,"Palestine, State of",Kedah,2,1,1
1/04/2024,"Palestine, State of",Pulau Pinang,2,2,0
1/04/2024,"Palestine, State of",Sabah,1,1,0
1/04/2024,"Palestine, State of",Sarawak,1,1,0
1/04/2024,"Palestine, State of",Selangor,270,205,65
1/04/2024,Qatar,Johor,2,2,0
1/04/2024,Qatar,Kedah,2,1,1
1/04/2024,Qatar,Selangor,137,86,51
1/04/2024,Romania,Johor,215,110,105
1/04/2024,Romania,Kedah,27,12,15
1/04/2024,Romania,Pahang,2,2,0
1/04/2024,Romania,Perak,3,1,2
1/04/2024,Romania,Perlis,2,2,0
1/04/2024,Romania,Pulau Pinang,14,9,5
1/04/2024,Romania,Sabah,9,6,3
1/04/2024,Romania,Sarawak,8,7,1
1/04/2024,Romania,Selangor,765,365,400
1/04/2024,Russian Federation (Russia),Johor,465,222,243
1/04/2024,Russian Federation (Russia),Kedah,454,214,240
1/04/2024,Russian Federation (Russia),Kelantan,29,16,13
1/04/2024,Russian Federation (Russia),Melaka,1,0,1
1/04/2024,Russian Federation (Russia),Pahang,3,1,2
1/04/2024,Russian Federation (Russia),Perak,6,3,3
1/04/2024,Russian Federation (Russia),Perlis,86,51,35
1/04/2024,Russian Federation (Russia),Pulau Pinang,147,83,64
1/04/2024,Russian Federation (Russia),Sabah,54,27,27
1/04/2024,Russian Federation (Russia),Sarawak,49,28,21
1/04/2024,Russian Federation (Russia),Selangor,10143,4933,5210
1/04/2024,Russian Federation (Russia),W.P. Labuan,7,3,4
1/04/2024,Rwanda,Johor,5,1,4
1/04/2024,Rwanda,Selangor,9,6,3
1/04/2024,Saudi Arabia,Johor,157,79,78
1/04/2024,Saudi Arabia,Kedah,21,16,5
1/04/2024,Saudi Arabia,Kelantan,2,2,0
1/04/2024,Saudi Arabia,Perlis,2,2,0
1/04/2024,Saudi Arabia,Pulau Pinang,12,8,4
1/04/2024,Saudi Arabia,Sabah,4,2,2
1/04/2024,Saudi Arabia,Sarawak,12,7,5
1/04/2024,Saudi Arabia,Selangor,2426,1444,982
1/04/2024,Sudan,Johor,18,13,5
1/04/2024,Sudan,Kedah,6,2,4
1/04/2024,Sudan,Pulau Pinang,3,2,1
1/04/2024,Sudan,Sarawak,7,5,2
1/04/2024,Sudan,Selangor,819,499,320
1/04/2024,Sudan,W.P. Labuan,2,2,0
1/04/2024,Senegal,Johor,2,2,0
1/04/2024,Senegal,Selangor,82,50,32
1/04/2024,Singapore,Johor,1306727,756435,550292
1/04/2024,Singapore,Kedah,2536,1314,1222
1/04/2024,Singapore,Kelantan,49,33,16
1/04/2024,Singapore,Melaka,39,27,12
1/04/2024,Singapore,Negeri Sembilan,1,0,1
1/04/2024,Singapore,Pahang,423,224,199
1/04/2024,Singapore,Perak,5174,2415,2759
1/04/2024,Singapore,Perlis,159,107,52
1/04/2024,Singapore,Pulau Pinang,14246,7028,7218
1/04/2024,Singapore,Sabah,1504,788,716
1/04/2024,Singapore,Sarawak,3293,1867,1426
1/04/2024,Singapore,Selangor,45315,23122,22193
1/04/2024,Singapore,W.P. Labuan,3,3,0
1/04/2024,Solomon Islands,Johor,3,3,0
1/04/2024,Solomon Islands,Pulau Pinang,1,0,1
1/04/2024,Solomon Islands,Sarawak,10,2,8
1/04/2024,Solomon Islands,Selangor,5,4,1
1/04/2024,Sierra Leone,Johor,2,1,1
1/04/2024,Sierra Leone,Selangor,10,6,4
1/04/2024,El Salvador,Kedah,1,0,1
1/04/2024,El Salvador,Selangor,15,11,4
1/04/2024,San Marino,Selangor,7,5,2
1/04/2024,Somalia,Kelantan,2,0,2
1/04/2024,Somalia,Pulau Pinang,5,1,4
1/04/2024,Somalia,Selangor,194,107,87
1/04/2024,Serbia,Johor,15,11,4
1/04/2024,Serbia,Kedah,1,1,0
1/04/2024,Serbia,Pahang,1,1,0
1/04/2024,Serbia,Perak,1,1,0
1/04/2024,Serbia,Perlis,1,0,1
1/04/2024,Serbia,Pulau Pinang,2,2,0
1/04/2024,Serbia,Sabah,1,1,0
1/04/2024,Serbia,Sarawak,4,2,2
1/04/2024,Serbia,Selangor,87,51,36
1/04/2024,South Sudan,Sarawak,3,1,2
1/04/2024,South Sudan,Selangor,29,13,16
1/04/2024,South Sudan,W.P. Labuan,3,1,2
1/04/2024,Sao Tome and Principe,Selangor,1,0,1
1/04/2024,Suriname,Johor,3,2,1
1/04/2024,Suriname,Pulau Pinang,3,2,1
1/04/2024,Suriname,Selangor,23,14,9
1/04/2024,Slovakia,Johor,56,31,25
1/04/2024,Slovakia,Kedah,77,41,36
1/04/2024,Slovakia,Perlis,2,1,1
1/04/2024,Slovakia,Pulau Pinang,20,14,6
1/04/2024,Slovakia,Sabah,3,3,0
1/04/2024,Slovakia,Sarawak,6,3,3
1/04/2024,Slovakia,Selangor,327,163,164
1/04/2024,Slovenia,Johor,38,16,22
1/04/2024,Slovenia,Kedah,14,6,8
1/04/2024,Slovenia,Sabah,1,0,1
1/04/2024,Slovenia,Sarawak,2,0,2
1/04/2024,Slovenia,Selangor,205,110,95
1/04/2024,Sweden,Johor,243,147,96
1/04/2024,Sweden,Kedah,160,61,99
1/04/2024,Sweden,Kelantan,5,5,0
1/04/2024,Sweden,Perak,6,3,3
1/04/2024,Sweden,Perlis,5,4,1
1/04/2024,Sweden,Pulau Pinang,64,42,22
1/04/2024,Sweden,Sabah,14,10,4
1/04/2024,Sweden,Sarawak,18,13,5
1/04/2024,Sweden,Selangor,965,558,407
1/04/2024,Sweden,W.P. Labuan,1,1,0
1/04/2024,Eswatini,Johor,1,1,0
1/04/2024,Eswatini,Selangor,21,8,13
1/04/2024,Seychelles,Johor,10,4,6
1/04/2024,Seychelles,Selangor,132,57,75
1/04/2024,Syrian Arab Republic,Johor,27,20,7
1/04/2024,Syrian Arab Republic,Kedah,24,9,15
1/04/2024,Syrian Arab Republic,Perlis,1,1,0
1/04/2024,Syrian Arab Republic,Pulau Pinang,7,6,1
1/04/2024,Syrian Arab Republic,Sabah,1,1,0
1/04/2024,Syrian Arab Republic,Sarawak,2,2,0
1/04/2024,Syrian Arab Republic,Selangor,529,345,184
1/04/2024,TCD,Selangor,22,18,4
1/04/2024,Togo,Johor,1,1,0
1/04/2024,Togo,Sarawak,1,0,1
1/04/2024,Togo,Selangor,7,3,4
1/04/2024,Thailand,Johor,10451,3285,7166
1/04/2024,Thailand,Kedah,46961,26232,20729
1/04/2024,Thailand,Kelantan,54643,27067,27576
1/04/2024,Thailand,Negeri Sembilan,1,0,1
1/04/2024,Thailand,Pahang,7,4,3
1/04/2024,Thailand,Perak,11918,5467,6451
1/04/2024,Thailand,Perlis,51523,29059,22464
1/04/2024,Thailand,Pulau Pinang,2627,977,1650
1/04/2024,Thailand,Sabah,32,13,19
1/04/2024,Thailand,Sarawak,405,123,282
1/04/2024,Thailand,Selangor,15232,5653,9579
1/04/2024,Thailand,W.P. Labuan,11,5,6
1/04/2024,Tajikistan,Johor,1,0,1
1/04/2024,Tajikistan,Kedah,3,3,0
1/04/2024,Tajikistan,Sabah,5,4,1
1/04/2024,Tajikistan,Selangor,108,70,38
1/04/2024,Turkmenistan,Johor,6,3,3
1/04/2024,Turkmenistan,Kedah,8,4,4
1/04/2024,Turkmenistan,Sarawak,1,1,0
1/04/2024,Turkmenistan,Selangor,325,173,152
1/04/2024,Timor-Leste,Johor,5,4,1
1/04/2024,Timor-Leste,Pulau Pinang,6,3,3
1/04/2024,Timor-Leste,Sarawak,6,5,1
1/04/2024,Timor-Leste,Selangor,178,101,77
1/04/2024,Tonga,Johor,1,1,0
1/04/2024,Tonga,Kedah,1,0,1
1/04/2024,Tonga,Pulau Pinang,2,0,2
1/04/2024,Tonga,Selangor,21,8,13
1/04/2024,Trinidad and Tobago,Johor,8,3,5
1/04/2024,Trinidad and Tobago,Sarawak,1,1,0
1/04/2024,Trinidad and Tobago,Selangor,28,14,14
1/04/2024,Tunisia,Johor,17,11,6
1/04/2024,Tunisia,Kedah,4,2,2
1/04/2024,Tunisia,Pulau Pinang,6,1,5
1/04/2024,Tunisia,Sabah,1,1,0
1/04/2024,Tunisia,Sarawak,1,1,0
1/04/2024,Tunisia,Selangor,655,338,317
1/04/2024,Türkiye,Johor,404,238,166
1/04/2024,Türkiye,Kedah,61,39,22
1/04/2024,Türkiye,Kelantan,2,2,0
1/04/2024,Türkiye,Melaka,1,1,0
1/04/2024,Türkiye,Perak,3,3,0
1/04/2024,Türkiye,Perlis,22,17,5
1/04/2024,Türkiye,Pulau Pinang,41,31,10
1/04/2024,Türkiye,Sabah,4,2,2
1/04/2024,Türkiye,Sarawak,30,22,8
1/04/2024,Türkiye,Selangor,2000,1280,720
1/04/2024,Tuvalu,Johor,1,1,0
1/04/2024,"Taiwan, Province of China",Johor,7988,3317,4671
1/04/2024,"Taiwan, Province of China",Kedah,232,96,136
1/04/2024,"Taiwan, Province of China",Kelantan,11,10,1
1/04/2024,"Taiwan, Province of China",Pahang,3,3,0
1/04/2024,"Taiwan, Province of China",Perak,89,38,51
1/04/2024,"Taiwan, Province of China",Perlis,36,21,15
1/04/2024,"Taiwan, Province of China",Pulau Pinang,3454,1741,1713
1/04/2024,"Taiwan, Province of China",Sabah,2136,1016,1120
1/04/2024,"Taiwan, Province of China",Sarawak,328,125,203
1/04/2024,"Taiwan, Province of China",Selangor,14443,6867,7576
1/04/2024,"Taiwan, Province of China",W.P. Labuan,2,1,1
1/04/2024,"Tanzania, United Republic of",Johor,16,9,7
1/04/2024,"Tanzania, United Republic of",Perak,1,1,0
1/04/2024,"Tanzania, United Republic of",Selangor,148,81,67
1/04/2024,Uganda,Johor,11,6,5
1/04/2024,Uganda,Kedah,1,1,0
1/04/2024,Uganda,Sarawak,2,2,0
1/04/2024,Uganda,Selangor,109,41,68
1/04/2024,Ukraine,Johor,114,50,64
1/04/2024,Ukraine,Kedah,46,24,22
1/04/2024,Ukraine,Kelantan,6,3,3
1/04/2024,Ukraine,Pahang,1,1,0
1/04/2024,Ukraine,Perak,2,2,0
1/04/2024,Ukraine,Perlis,11,7,4
1/04/2024,Ukraine,Pulau Pinang,18,8,10
1/04/2024,Ukraine,Sabah,8,5,3
1/04/2024,Ukraine,Sarawak,5,4,1
1/04/2024,Ukraine,Selangor,1165,568,597
1/04/2024,Ukraine,W.P. Labuan,1,1,0
1/04/2024,Uruguay,Johor,62,25,37
1/04/2024,Uruguay,Kedah,4,3,1
1/04/2024,Uruguay,Selangor,112,37,75
1/04/2024,United States of America,Johor,4625,2661,1964
1/04/2024,United States of America,Kedah,490,271,219
1/04/2024,United States of America,Kelantan,16,16,0
1/04/2024,United States of America,Melaka,1,1,0
1/04/2024,United States of America,Pahang,6,3,3
1/04/2024,United States of America,Perak,125,72,53
1/04/2024,United States of America,Perlis,117,82,35
1/04/2024,United States of America,Pulau Pinang,1890,1121,769
1/04/2024,United States of America,Sabah,441,226,215
1/04/2024,United States of America,Sarawak,263,151,112
1/04/2024,United States of America,Selangor,15326,8680,6646
1/04/2024,United States of America,W.P. Labuan,4,3,1
1/04/2024,Uzbekistan,Johor,77,63,14
1/04/2024,Uzbekistan,Kedah,12,4,8
1/04/2024,Uzbekistan,Kelantan,2,1,1
1/04/2024,Uzbekistan,Perlis,1,1,0
1/04/2024,Uzbekistan,Sabah,6,5,1
1/04/2024,Uzbekistan,Sarawak,1,0,1
1/04/2024,Uzbekistan,Selangor,1006,633,373
1/04/2024,Holy See,Johor,2,2,0
1/04/2024,Holy See,Selangor,1,1,0
1/04/2024,Saint Vincent and the Grenadines,Selangor,2,2,0
1/04/2024,"Venezuela, Bolivarian Republic of",Johor,19,11,8
1/04/2024,"Venezuela, Bolivarian Republic of",Kedah,8,6,2
1/04/2024,"Venezuela, Bolivarian Republic of",Pulau Pinang,1,1,0
1/04/2024,"Venezuela, Bolivarian Republic of",Sarawak,5,2,3
1/04/2024,"Venezuela, Bolivarian Republic of",Selangor,99,51,48
1/04/2024,Viet Nam,Johor,13689,4083,9606
1/04/2024,Viet Nam,Kedah,289,52,237
1/04/2024,Viet Nam,Kelantan,10,5,5
1/04/2024,Viet Nam,Perak,117,7,110
1/04/2024,Viet Nam,Perlis,188,18,170
1/04/2024,Viet Nam,Pulau Pinang,1295,367,928
1/04/2024,Viet Nam,Sabah,27,7,20
1/04/2024,Viet Nam,Sarawak,428,72,356
1/04/2024,Viet Nam,Selangor,16746,5613,11133
1/04/2024,Viet Nam,W.P. Labuan,1,0,1
1/04/2024,Vanuatu,Johor,24,20,4
1/04/2024,Vanuatu,Kedah,1,1,0
1/04/2024,Vanuatu,Perlis,1,1,0
1/04/2024,Vanuatu,Pulau Pinang,6,5,1
1/04/2024,Vanuatu,Selangor,92,80,12
1/04/2024, Samoa,Selangor,3,0,3
1/04/2024,Yemen,Johor,30,25,5
1/04/2024,Yemen,Kedah,4,3,1
1/04/2024,Yemen,Melaka,2,1,1
1/04/2024,Yemen,Perlis,1,1,0
1/04/2024,Yemen,Pulau Pinang,2,1,1
1/04/2024,Yemen,Sarawak,4,4,0
1/04/2024,Yemen,Selangor,1081,746,335
1/04/2024,South Africa,Johor,248,153,95
1/04/2024,South Africa,Kedah,38,24,14
1/04/2024,South Africa,Kelantan,1,0,1
1/04/2024,South Africa,Perlis,6,4,2
1/04/2024,South Africa,Pulau Pinang,55,27,28
1/04/2024,South Africa,Sabah,28,15,13
1/04/2024,South Africa,Sarawak,95,38,57
1/04/2024,South Africa,Selangor,943,516,427
1/04/2024,South Africa,W.P. Labuan,15,5,10
1/04/2024,ZAR,Selangor,2,1,1
1/04/2024,Zambia,Johor,4,3,1
1/04/2024,Zambia,Kedah,2,1,1
1/04/2024,Zambia,Perak,1,0,1
1/04/2024,Zambia,Pulau Pinang,2,1,1
1/04/2024,Zambia,Selangor,56,25,31
1/04/2024,Zimbabwe,Johor,20,7,13
1/04/2024,Zimbabwe,Kedah,2,0,2
1/04/2024,Zimbabwe,Pulau Pinang,1,0,1
1/04/2024,Zimbabwe,Selangor,144,63,81
1/05/2024,Afghanistan,Johor,1,1,0
1/05/2024,Afghanistan,Pulau Pinang,2,2,0
1/05/2024,Afghanistan,Selangor,42,26,16
1/05/2024,Angola,Selangor,2,2,0
1/05/2024,Albania,Johor,14,12,2
1/05/2024,Albania,Pulau Pinang,1,1,0
1/05/2024,Albania,Sabah,1,1,0
1/05/2024,Albania,Selangor,26,11,15
1/05/2024,Andorra,Perlis,1,1,0
1/05/2024,Andorra,Pulau Pinang,1,1,0
1/05/2024,Andorra,Selangor,13,11,2
1/05/2024,United Arab Emirates,Johor,20,7,13
1/05/2024,United Arab Emirates,Kedah,6,5,1
1/05/2024,United Arab Emirates,Perak,1,1,0
1/05/2024,United Arab Emirates,Pulau Pinang,7,5,2
1/05/2024,United Arab Emirates,Sabah,2,1,1
1/05/2024,United Arab Emirates,Selangor,284,182,102
1/05/2024,Argentina,Johor,85,51,34
1/05/2024,Argentina,Kedah,48,27,21
1/05/2024,Argentina,Kelantan,1,0,1
1/05/2024,Argentina,Perak,1,1,0
1/05/2024,Argentina,Perlis,1,0,1
1/05/2024,Argentina,Pulau Pinang,8,6,2
1/05/2024,Argentina,Sarawak,5,5,0
1/05/2024,Argentina,Selangor,422,217,205
1/05/2024,Armenia,Johor,1,1,0
1/05/2024,Armenia,Kedah,3,0,3
1/05/2024,Armenia,Pulau Pinang,1,0,1
1/05/2024,Armenia,Selangor,63,36,27
1/05/2024,Antigua and Barbuda,Johor,7,6,1
1/05/2024,Antigua and Barbuda,Pulau Pinang,1,1,0
1/05/2024,Antigua and Barbuda,Sabah,1,0,1
1/05/2024,Antigua and Barbuda,Selangor,11,10,1
1/05/2024,Australia,Johor,4697,2892,1805
1/05/2024,Australia,Kedah,566,328,238
1/05/2024,Australia,Kelantan,5,4,1
1/05/2024,Australia,Melaka,4,3,1
1/05/2024,Australia,Pahang,55,25,30
1/05/2024,Australia,Perak,170,90,80
1/05/2024,Australia,Perlis,60,40,20
1/05/2024,Australia,Pulau Pinang,1719,915,804
1/05/2024,Australia,Sabah,310,165,145
1/05/2024,Australia,Sarawak,575,341,234
1/05/2024,Australia,Selangor,18706,11064,7642
1/05/2024,Australia,W.P. Labuan,3,3,0
1/05/2024,Austria,Johor,196,136,60
1/05/2024,Austria,Kedah,49,27,22
1/05/2024,Austria,Kelantan,9,7,2
1/05/2024,Austria,Pahang,1,0,1
1/05/2024,Austria,Perak,2,2,0
1/05/2024,Austria,Perlis,8,5,3
1/05/2024,Austria,Pulau Pinang,66,46,20
1/05/2024,Austria,Sabah,13,5,8
1/05/2024,Austria,Sarawak,17,12,5
1/05/2024,Austria,Selangor,736,453,283
1/05/2024,Azerbaijan,Johor,7,5,2
1/05/2024,Azerbaijan,Kedah,4,1,3
1/05/2024,Azerbaijan,Perlis,1,1,0
1/05/2024,Azerbaijan,Pulau Pinang,1,1,0
1/05/2024,Azerbaijan,Selangor,68,33,35
1/05/2024,Burundi,Pulau Pinang,1,1,0
1/05/2024,Burundi,Selangor,2,2,0
1/05/2024,Belgium,Johor,302,185,117
1/05/2024,Belgium,Kedah,64,30,34
1/05/2024,Belgium,Kelantan,2,1,1
1/05/2024,Belgium,Pahang,1,0,1
1/05/2024,Belgium,Perak,3,2,1
1/05/2024,Belgium,Perlis,11,5,6
1/05/2024,Belgium,Pulau Pinang,75,55,20
1/05/2024,Belgium,Sabah,31,15,16
1/05/2024,Belgium,Sarawak,31,16,15
1/05/2024,Belgium,Selangor,1470,839,631
1/05/2024,Benin,Johor,3,1,2
1/05/2024,Benin,Pulau Pinang,1,1,0
1/05/2024,Benin,Selangor,13,10,3
1/05/2024,Burkina Faso,Selangor,5,5,0
1/05/2024,Bangladesh,Johor,2612,2060,552
1/05/2024,Bangladesh,Kedah,82,52,30
1/05/2024,Bangladesh,Kelantan,1,1,0
1/05/2024,Bangladesh,Perak,2,2,0
1/05/2024,Bangladesh,Perlis,5,1,4
1/05/2024,Bangladesh,Pulau Pinang,590,556,34
1/05/2024,Bangladesh,Sabah,9,8,1
1/05/2024,Bangladesh,Sarawak,144,116,28
1/05/2024,Bangladesh,Selangor,63866,62404,1462
1/05/2024,Bangladesh,W.P. Labuan,5,4,1
1/05/2024,Bulgaria,Johor,51,29,22
1/05/2024,Bulgaria,Kedah,7,3,4
1/05/2024,Bulgaria,Perak,2,1,1
1/05/2024,Bulgaria,Sabah,3,1,2
1/05/2024,Bulgaria,Sarawak,1,1,0
1/05/2024,Bulgaria,Selangor,253,132,121
1/05/2024,Bahrain,Johor,3,2,1
1/05/2024,Bahrain,Kedah,2,2,0
1/05/2024,Bahrain,Sarawak,1,1,0
1/05/2024,Bahrain,Selangor,101,76,25
1/05/2024,Bahamas,Johor,2,1,1
1/05/2024,Bahamas,Selangor,8,4,4
1/05/2024,Bosnia and Herzegovina,Johor,9,7,2
1/05/2024,Bosnia and Herzegovina,Kedah,1,0,1
1/05/2024,Bosnia and Herzegovina,Pulau Pinang,2,2,0
1/05/2024,Bosnia and Herzegovina,Sarawak,1,1,0
1/05/2024,Bosnia and Herzegovina,Selangor,86,40,46
1/05/2024,Belarus,Johor,18,10,8
1/05/2024,Belarus,Kedah,9,2,7
1/05/2024,Belarus,Kelantan,6,4,2
1/05/2024,Belarus,Perlis,1,0,1
1/05/2024,Belarus,Pulau Pinang,2,1,1
1/05/2024,Belarus,Sabah,4,2,2
1/05/2024,Belarus,Selangor,349,162,187
1/05/2024,Belize,Johor,2,2,0
1/05/2024,Belize,Selangor,4,1,3
1/05/2024,Bolivia,Johor,6,2,4
1/05/2024,Bolivia,Selangor,21,11,10
1/05/2024,Brazil,Johor,307,155,152
1/05/2024,Brazil,Kedah,68,36,32
1/05/2024,Brazil,Kelantan,1,1,0
1/05/2024,Brazil,Perak,5,2,3
1/05/2024,Brazil,Perlis,10,3,7
1/05/2024,Brazil,Pulau Pinang,22,14,8
1/05/2024,Brazil,Sabah,7,1,6
1/05/2024,Brazil,Sarawak,3,3,0
1/05/2024,Brazil,Selangor,958,560,398
1/05/2024,Barbados,Johor,2,0,2
1/05/2024,Barbados,Selangor,11,5,6
1/05/2024,Brunei Darussalam,Johor,369,190,179
1/05/2024,Brunei Darussalam,Kedah,41,25,16
1/05/2024,Brunei Darussalam,Kelantan,15,7,8
1/05/2024,Brunei Darussalam,Perak,7,4,3
1/05/2024,Brunei Darussalam,Perlis,17,7,10
1/05/2024,Brunei Darussalam,Pulau Pinang,9,3,6
1/05/2024,Brunei Darussalam,Sabah,1066,488,578
1/05/2024,Brunei Darussalam,Sarawak,136931,74214,62717
1/05/2024,Brunei Darussalam,Selangor,4778,2312,2466
1/05/2024,Brunei Darussalam,W.P. Labuan,1549,907,642
1/05/2024,Bhutan,Johor,13,9,4
1/05/2024,Bhutan,Perak,2,1,1
1/05/2024,Bhutan,Pulau Pinang,78,38,40
1/05/2024,Bhutan,Sabah,1,0,1
1/05/2024,Bhutan,Selangor,155,104,51
1/05/2024,Botswana,Selangor,7,5,2
1/05/2024,Canada,Johor,1608,908,700
1/05/2024,Canada,Kedah,149,78,71
1/05/2024,Canada,Kelantan,8,7,1
1/05/2024,Canada,Pahang,5,4,1
1/05/2024,Canada,Perak,26,12,14
1/05/2024,Canada,Perlis,19,9,10
1/05/2024,Canada,Pulau Pinang,466,259,207
1/05/2024,Canada,Sabah,151,73,78
1/05/2024,Canada,Sarawak,413,234,179
1/05/2024,Canada,Selangor,4131,2351,1780
1/05/2024,Canada,W.P. Labuan,3,1,2
1/05/2024,Cocos (Keeling) Islands,Selangor,1,0,1
1/05/2024,Switzerland,Johor,426,264,162
1/05/2024,Switzerland,Kedah,107,58,49
1/05/2024,Switzerland,Kelantan,5,3,2
1/05/2024,Switzerland,Perak,12,6,6
1/05/2024,Switzerland,Perlis,14,5,9
1/05/2024,Switzerland,Pulau Pinang,150,112,38
1/05/2024,Switzerland,Sabah,26,11,15
1/05/2024,Switzerland,Sarawak,34,18,16
1/05/2024,Switzerland,Selangor,1244,777,467
1/05/2024,Chile,Johor,30,13,17
1/05/2024,Chile,Kedah,18,10,8
1/05/2024,Chile,Kelantan,1,1,0
1/05/2024,Chile,Perlis,4,3,1
1/05/2024,Chile,Pulau Pinang,5,3,2
1/05/2024,Chile,Sabah,4,1,3
1/05/2024,Chile,Sarawak,3,2,1
1/05/2024,Chile,Selangor,295,160,135
1/05/2024,China,Johor,80957,35666,45291
1/05/2024,China,Kedah,2085,907,1178
1/05/2024,China,Kelantan,36,18,18
1/05/2024,China,Melaka,15,12,3
1/05/2024,China,Negeri Sembilan,2,2,0
1/05/2024,China,Pahang,70,49,21
1/05/2024,China,Perak,457,211,246
1/05/2024,China,Perlis,375,200,175
1/05/2024,China,Pulau Pinang,12562,6366,6196
1/05/2024,China,Sabah,19901,8484,11417
1/05/2024,China,Sarawak,1718,924,794
1/05/2024,China,Selangor,151040,75790,75250
1/05/2024,China,W.P. Labuan,38,33,5
1/05/2024,Côte d'Ivoire,Sarawak,1,1,0
1/05/2024,Côte d'Ivoire,Selangor,29,17,12
1/05/2024,Cameroon,Johor,1,0,1
1/05/2024,Cameroon,Selangor,36,23,13
1/05/2024,Congo,Johor,2,1,1
1/05/2024,Congo,Selangor,14,11,3
1/05/2024,Congo,Selangor,5,4,1
1/05/2024,Colombia,Johor,32,14,18
1/05/2024,Colombia,Kedah,2,0,2
1/05/2024,Colombia,Pulau Pinang,6,5,1
1/05/2024,Colombia,Sabah,3,1,2
1/05/2024,Colombia,Sarawak,1,1,0
1/05/2024,Colombia,Selangor,185,100,85
1/05/2024,Comoros,Kedah,1,0,1
1/05/2024,Comoros,Pulau Pinang,1,1,0
1/05/2024,Comoros,Selangor,18,10,8
1/05/2024,Cabo Verde,Selangor,2,1,1
1/05/2024,Costa Rica,Johor,17,9,8
1/05/2024,Costa Rica,Pulau Pinang,4,4,0
1/05/2024,Costa Rica,Sarawak,2,2,0
1/05/2024,Costa Rica,Selangor,57,29,28
1/05/2024,Cuba,Johor,12,9,3
1/05/2024,Cuba,Kedah,1,0,1
1/05/2024,Cuba,Pulau Pinang,3,0,3
1/05/2024,Cuba,Selangor,20,10,10
1/05/2024,Cyprus,Johor,6,5,1
1/05/2024,Cyprus,Pulau Pinang,4,0,4
1/05/2024,Cyprus,Sabah,1,0,1
1/05/2024,Cyprus,Selangor,83,59,24
1/05/2024,Czechia,Johor,82,37,45
1/05/2024,Czechia,Kedah,55,24,31
1/05/2024,Czechia,Perak,2,1,1
1/05/2024,Czechia,Perlis,4,3,1
1/05/2024,Czechia,Pulau Pinang,26,12,14
1/05/2024,Czechia,Sabah,9,4,5
1/05/2024,Czechia,Sarawak,18,11,7
1/05/2024,Czechia,Selangor,385,239,146
1/05/2024,Germany,Johor,2233,1349,884
1/05/2024,Germany,Kedah,659,346,313
1/05/2024,Germany,Kelantan,11,9,2
1/05/2024,Germany,Pahang,19,10,9
1/05/2024,Germany,Perak,28,19,9
1/05/2024,Germany,Perlis,68,42,26
1/05/2024,Germany,Pulau Pinang,618,422,196
1/05/2024,Germany,Sabah,129,69,60
1/05/2024,Germany,Sarawak,226,138,88
1/05/2024,Germany,Selangor,9314,5358,3956
1/05/2024,Germany,W.P. Labuan,4,2,2
1/05/2024,Djibouti,Selangor,15,5,10
1/05/2024,Dominica,Johor,10,5,5
1/05/2024,Dominica,Kedah,1,1,0
1/05/2024,Dominica,Perak,1,1,0
1/05/2024,Dominica,Pulau Pinang,5,3,2
1/05/2024,Dominica,Sabah,2,1,1
1/05/2024,Dominica,Selangor,43,31,12
1/05/2024,Denmark,Johor,274,216,58
1/05/2024,Denmark,Kedah,66,31,35
1/05/2024,Denmark,Kelantan,2,2,0
1/05/2024,Denmark,Melaka,1,1,0
1/05/2024,Denmark,Pahang,1,1,0
1/05/2024,Denmark,Perak,1,1,0
1/05/2024,Denmark,Perlis,6,1,5
1/05/2024,Denmark,Pulau Pinang,61,40,21
1/05/2024,Denmark,Sabah,12,9,3
1/05/2024,Denmark,Sarawak,7,5,2
1/05/2024,Denmark,Selangor,678,430,248
1/05/2024,Dominican Republic,Johor,1,0,1
1/05/2024,Dominican Republic,Pulau Pinang,2,0,2
1/05/2024,Dominican Republic,Sabah,2,2,0
1/05/2024,Dominican Republic,Selangor,24,10,14
1/05/2024,Algeria,Johor,36,30,6
1/05/2024,Algeria,Kedah,8,5,3
1/05/2024,Algeria,Kelantan,1,1,0
1/05/2024,Algeria,Pulau Pinang,3,3,0
1/05/2024,Algeria,Sabah,4,2,2
1/05/2024,Algeria,Sarawak,4,3,1
1/05/2024,Algeria,Selangor,906,582,324
1/05/2024,Ecuador,Johor,7,3,4
1/05/2024,Ecuador,Pulau Pinang,1,1,0
1/05/2024,Ecuador,Selangor,87,45,42
1/05/2024,Egypt,Johor,233,196,37
1/05/2024,Egypt,Kedah,12,8,4
1/05/2024,Egypt,Kelantan,2,1,1
1/05/2024,Egypt,Pulau Pinang,9,8,1
1/05/2024,Egypt,Sabah,2,2,0
1/05/2024,Egypt,Sarawak,134,96,38
1/05/2024,Egypt,Selangor,1639,1141,498
1/05/2024,Eritrea,Selangor,19,12,7
1/05/2024,Spain,Johor,493,317,176
1/05/2024,Spain,Kedah,88,49,39
1/05/2024,Spain,Kelantan,6,4,2
1/05/2024,Spain,Pahang,2,1,1
1/05/2024,Spain,Perak,5,5,0
1/05/2024,Spain,Perlis,18,11,7
1/05/2024,Spain,Pulau Pinang,137,89,48
1/05/2024,Spain,Sabah,32,17,15
1/05/2024,Spain,Sarawak,59,37,22
1/05/2024,Spain,Selangor,2548,1456,1092
1/05/2024,Spain,W.P. Labuan,4,2,2
1/05/2024,Estonia,Johor,33,14,19
1/05/2024,Estonia,Kedah,5,1,4
1/05/2024,Estonia,Kelantan,3,3,0
1/05/2024,Estonia,Perlis,1,1,0
1/05/2024,Estonia,Pulau Pinang,2,2,0
1/05/2024,Estonia,Sabah,3,1,2
1/05/2024,Estonia,Sarawak,1,0,1
1/05/2024,Estonia,Selangor,85,58,27
1/05/2024,Ethiopia,Johor,8,7,1
1/05/2024,Ethiopia,Pulau Pinang,4,1,3
1/05/2024,Ethiopia,Selangor,30,24,6
1/05/2024,Finland,Johor,226,133,93
1/05/2024,Finland,Kedah,39,19,20
1/05/2024,Finland,Perak,3,2,1
1/05/2024,Finland,Perlis,1,1,0
1/05/2024,Finland,Pulau Pinang,30,20,10
1/05/2024,Finland,Sabah,10,8,2
1/05/2024,Finland,Sarawak,11,5,6
1/05/2024,Finland,Selangor,379,223,156
1/05/2024,Fiji,Johor,217,93,124
1/05/2024,Fiji,Kedah,1,1,0
1/05/2024,Fiji,Pulau Pinang,2,0,2
1/05/2024,Fiji,Sarawak,2,2,0
1/05/2024,Fiji,Selangor,147,72,75
1/05/2024,France,Johor,2476,1490,986
1/05/2024,France,Kedah,743,385,358
1/05/2024,France,Kelantan,32,18,14
1/05/2024,France,Melaka,2,1,1
1/05/2024,France,Negeri Sembilan,2,1,1
1/05/2024,France,Pahang,32,13,19
1/05/2024,France,Perak,36,25,11
1/05/2024,France,Perlis,74,53,21
1/05/2024,France,Pulau Pinang,391,270,121
1/05/2024,France,Sabah,114,66,48
1/05/2024,France,Sarawak,117,69,48
1/05/2024,France,Selangor,9455,5310,4145
1/05/2024,France,W.P. Labuan,1,1,0
1/05/2024,"Micronesia, Federated States of",Johor,1,0,1
1/05/2024,"Micronesia, Federated States of",Selangor,1,0,1
1/05/2024,Gabon,Johor,7,4,3
1/05/2024,Gabon,Selangor,7,5,2
1/05/2024,United Kingdom of Great Britain and Northern Ireland,Johor,5541,3574,1967
1/05/2024,United Kingdom of Great Britain and Northern Ireland,Kedah,1144,577,567
1/05/2024,United Kingdom of Great Britain and Northern Ireland,Kelantan,13,8,5
1/05/2024,United Kingdom of Great Britain and Northern Ireland,Melaka,2,1,1
1/05/2024,United Kingdom of Great Britain and Northern Ireland,Pahang,29,19,10
1/05/2024,United Kingdom of Great Britain and Northern Ireland,Perak,96,54,42
1/05/2024,United Kingdom of Great Britain and Northern Ireland,Perlis,138,90,48
1/05/2024,United Kingdom of Great Britain and Northern Ireland,Pulau Pinang,1367,814,553
1/05/2024,United Kingdom of Great Britain and Northern Ireland,Sabah,482,243,239
1/05/2024,United Kingdom of Great Britain and Northern Ireland,Sarawak,1621,1018,603
1/05/2024,United Kingdom of Great Britain and Northern Ireland,Selangor,17493,10538,6955
1/05/2024,United Kingdom of Great Britain and Northern Ireland,W.P. Labuan,47,26,21
1/05/2024,Georgia,Johor,19,3,16
1/05/2024,Georgia,Selangor,71,37,34
1/05/2024,Ghana,Johor,5,5,0
1/05/2024,Ghana,Pulau Pinang,29,11,18
1/05/2024,Ghana,Sarawak,1,1,0
1/05/2024,Ghana,Selangor,166,105,61
1/05/2024,Guinea,Johor,3,2,1
1/05/2024,Guinea,Selangor,65,49,16
1/05/2024,Gambia,Johor,4,2,2
1/05/2024,Gambia,Sabah,1,1,0
1/05/2024,Gambia,Selangor,26,20,6
1/05/2024,Guinea-Bissau,Selangor,1,1,0
1/05/2024,Equatorial Guinea,Selangor,2,1,1
1/05/2024,Greece,Johor,58,43,15
1/05/2024,Greece,Kedah,10,6,4
1/05/2024,Greece,Perak,2,1,1
1/05/2024,Greece,Pulau Pinang,10,7,3
1/05/2024,Greece,Sabah,2,1,1
1/05/2024,Greece,Sarawak,3,2,1
1/05/2024,Greece,Selangor,262,178,84
1/05/2024,Grenada,Johor,8,5,3
1/05/2024,Grenada,Selangor,12,12,0
1/05/2024,Guatemala,Johor,3,2,1
1/05/2024,Guatemala,Kedah,1,1,0
1/05/2024,Guatemala,Pulau Pinang,1,1,0
1/05/2024,Guatemala,Selangor,26,16,10
1/05/2024,Guyana,Johor,2,1,1
1/05/2024,Guyana,Selangor,10,6,4
1/05/2024,Hong Kong,Johor,3,2,1
1/05/2024,Hong Kong,Pahang,2,2,0
1/05/2024,Hong Kong,Perak,71,31,40
1/05/2024,Hong Kong,Perlis,1,1,0
1/05/2024,Hong Kong,Pulau Pinang,5,2,3
1/05/2024,Hong Kong,Sabah,108,58,50
1/05/2024,Hong Kong,Selangor,17,9,8
1/05/2024,Honduras,Johor,2,2,0
1/05/2024,Honduras,Kedah,1,1,0
1/05/2024,Honduras,Pulau Pinang,1,1,0
1/05/2024,Honduras,Selangor,18,9,9
1/05/2024,Croatia,Johor,32,28,4
1/05/2024,Croatia,Kedah,2,1,1
1/05/2024,Croatia,Kelantan,1,1,0
1/05/2024,Croatia,Perlis,2,1,1
1/05/2024,Croatia,Pulau Pinang,7,5,2
1/05/2024,Croatia,Sabah,4,4,0
1/05/2024,Croatia,Sarawak,2,2,0
1/05/2024,Croatia,Selangor,154,110,44
1/05/2024,Haiti,Johor,2,1,1
1/05/2024,Haiti,Selangor,17,12,5
1/05/2024,Hungary,Johor,84,55,29
1/05/2024,Hungary,Kedah,24,8,16
1/05/2024,Hungary,Kelantan,2,1,1
1/05/2024,Hungary,Perlis,2,2,0
1/05/2024,Hungary,Pulau Pinang,51,30,21
1/05/2024,Hungary,Sabah,8,4,4
1/05/2024,Hungary,Sarawak,6,2,4
1/05/2024,Hungary,Selangor,332,190,142
1/05/2024,Indonesia,Johor,107867,50906,56961
1/05/2024,Indonesia,Kedah,4552,1554,2998
1/05/2024,Indonesia,Kelantan,122,61,61
1/05/2024,Indonesia,Melaka,3906,1716,2190
1/05/2024,Indonesia,Negeri Sembilan,9682,6421,3261
1/05/2024,Indonesia,Pahang,69,45,24
1/05/2024,Indonesia,Perak,213,81,132
1/05/2024,Indonesia,Perlis,636,218,418
1/05/2024,Indonesia,Pulau Pinang,38621,15442,23179
1/05/2024,Indonesia,Sabah,6524,3401,3123
1/05/2024,Indonesia,Sarawak,52364,29522,22842
1/05/2024,Indonesia,Selangor,150031,71800,78231
1/05/2024,Indonesia,W.P. Labuan,66,31,35
1/05/2024,India,Johor,51512,30254,21258
1/05/2024,India,Kedah,3071,1676,1395
1/05/2024,India,Kelantan,7,6,1
1/05/2024,India,Melaka,3,2,1
1/05/2024,India,Pahang,26,20,6
1/05/2024,India,Perak,225,140,85
1/05/2024,India,Perlis,66,50,16
1/05/2024,India,Pulau Pinang,4192,2575,1617
1/05/2024,India,Sabah,201,148,53
1/05/2024,India,Sarawak,2653,2025,628
1/05/2024,India,Selangor,104981,66299,38682
1/05/2024,India,W.P. Labuan,50,37,13
1/05/2024,Ireland,Johor,302,200,102
1/05/2024,Ireland,Kedah,74,38,36
1/05/2024,Ireland,Pahang,2,1,1
1/05/2024,Ireland,Perak,6,5,1
1/05/2024,Ireland,Perlis,10,10,0
1/05/2024,Ireland,Pulau Pinang,119,71,48
1/05/2024,Ireland,Sabah,22,14,8
1/05/2024,Ireland,Sarawak,29,15,14
1/05/2024,Ireland,Selangor,1326,796,530
1/05/2024,Ireland,W.P. Labuan,4,2,2
1/05/2024,"Iran, Islamic Republic of",Johor,163,93,70
1/05/2024,"Iran, Islamic Republic of",Kedah,14,6,8
1/05/2024,"Iran, Islamic Republic of",Perak,1,1,0
1/05/2024,"Iran, Islamic Republic of",Perlis,3,2,1
1/05/2024,"Iran, Islamic Republic of",Pulau Pinang,22,16,6
1/05/2024,"Iran, Islamic Republic of",Sabah,1,1,0
1/05/2024,"Iran, Islamic Republic of",Sarawak,7,5,2
1/05/2024,"Iran, Islamic Republic of",Selangor,1193,670,523
1/05/2024,Iraq,Johor,34,22,12
1/05/2024,Iraq,Pulau Pinang,11,7,4
1/05/2024,Iraq,Sabah,1,1,0
1/05/2024,Iraq,Sarawak,6,3,3
1/05/2024,Iraq,Selangor,967,635,332
1/05/2024,Iceland,Johor,4,2,2
1/05/2024,Iceland,Kedah,1,1,0
1/05/2024,Iceland,Pulau Pinang,4,1,3
1/05/2024,Iceland,Selangor,28,17,11
1/05/2024,Italy,Johor,587,368,219
1/05/2024,Italy,Kedah,127,61,66
1/05/2024,Italy,Perak,11,8,3
1/05/2024,Italy,Perlis,13,9,4
1/05/2024,Italy,Pulau Pinang,111,82,29
1/05/2024,Italy,Sabah,24,14,10
1/05/2024,Italy,Sarawak,67,39,28
1/05/2024,Italy,Selangor,2738,1771,967
1/05/2024,Italy,W.P. Labuan,4,3,1
1/05/2024,Jamaica,Johor,12,3,9
1/05/2024,Jamaica,Pulau Pinang,1,0,1
1/05/2024,Jamaica,Sarawak,3,1,2
1/05/2024,Jamaica,Selangor,26,16,10
1/05/2024,Jordan,Johor,8,4,4
1/05/2024,Jordan,Kedah,10,6,4
1/05/2024,Jordan,Pahang,4,3,1
1/05/2024,Jordan,Perlis,1,1,0
1/05/2024,Jordan,Pulau Pinang,15,8,7
1/05/2024,Jordan,Sarawak,1,1,0
1/05/2024,Jordan,Selangor,765,485,280
1/05/2024,Japan,Johor,6543,4368,2175
1/05/2024,Japan,Kedah,302,157,145
1/05/2024,Japan,Kelantan,6,6,0
1/05/2024,Japan,Pahang,16,12,4
1/05/2024,Japan,Perak,78,51,27
1/05/2024,Japan,Perlis,77,52,25
1/05/2024,Japan,Pulau Pinang,1382,1017,365
1/05/2024,Japan,Sabah,328,168,160
1/05/2024,Japan,Sarawak,249,156,93
1/05/2024,Japan,Selangor,18766,11453,7313
1/05/2024,Japan,W.P. Labuan,18,14,4
1/05/2024,Kazakhstan,Johor,46,16,30
1/05/2024,Kazakhstan,Kedah,24,6,18
1/05/2024,Kazakhstan,Kelantan,1,1,0
1/05/2024,Kazakhstan,Perlis,3,3,0
1/05/2024,Kazakhstan,Pulau Pinang,9,5,4
1/05/2024,Kazakhstan,Sabah,2,1,1
1/05/2024,Kazakhstan,Sarawak,7,1,6
1/05/2024,Kazakhstan,Selangor,3198,1234,1964
1/05/2024,Kenya,Johor,221,77,144
1/05/2024,Kenya,Kedah,3,1,2
1/05/2024,Kenya,Pulau Pinang,11,6,5
1/05/2024,Kenya,Sarawak,2,2,0
1/05/2024,Kenya,Selangor,546,247,299
1/05/2024,Kyrgyzstan,Johor,37,24,13
1/05/2024,Kyrgyzstan,Kedah,10,6,4
1/05/2024,Kyrgyzstan,Pulau Pinang,5,3,2
1/05/2024,Kyrgyzstan,Selangor,468,221,247
1/05/2024,Cambodia,Johor,1719,798,921
1/05/2024,Cambodia,Kedah,228,143,85
1/05/2024,Cambodia,Kelantan,594,371,223
1/05/2024,Cambodia,Perak,13,6,7
1/05/2024,Cambodia,Perlis,666,382,284
1/05/2024,Cambodia,Pulau Pinang,63,27,36
1/05/2024,Cambodia,Sabah,1,0,1
1/05/2024,Cambodia,Sarawak,8,4,4
1/05/2024,Cambodia,Selangor,3651,1794,1857
1/05/2024,Cambodia,W.P. Labuan,2,2,0
1/05/2024,Saint Kitts and Nevis,Johor,35,25,10
1/05/2024,Saint Kitts and Nevis,Pulau Pinang,1,1,0
1/05/2024,Saint Kitts and Nevis,Sabah,1,0,1
1/05/2024,Saint Kitts and Nevis,Selangor,41,36,5
1/05/2024,"Korea, Republic of",Johor,9188,5165,4023
1/05/2024,"Korea, Republic of",Kedah,229,118,111
1/05/2024,"Korea, Republic of",Kelantan,3,3,0
1/05/2024,"Korea, Republic of",Melaka,2,1,1
1/05/2024,"Korea, Republic of",Negeri Sembilan,14,5,9
1/05/2024,"Korea, Republic of",Perak,17,8,9
1/05/2024,"Korea, Republic of",Perlis,34,19,15
1/05/2024,"Korea, Republic of",Pulau Pinang,505,294,211
1/05/2024,"Korea, Republic of",Sabah,11551,4754,6797
1/05/2024,"Korea, Republic of",Sarawak,229,123,106
1/05/2024,"Korea, Republic of",Selangor,11944,7122,4822
1/05/2024,"Korea, Republic of",W.P. Labuan,5,5,0
1/05/2024,Kuwait,Johor,14,7,7
1/05/2024,Kuwait,Kedah,1,1,0
1/05/2024,Kuwait,Pulau Pinang,6,5,1
1/05/2024,Kuwait,Selangor,312,197,115
1/05/2024, Lao People's Democratic Republic,Johor,142,29,113
1/05/2024, Lao People's Democratic Republic,Kedah,1240,98,1142
1/05/2024, Lao People's Democratic Republic,Kelantan,238,63,175
1/05/2024, Lao People's Democratic Republic,Perak,38,4,34
1/05/2024, Lao People's Democratic Republic,Perlis,285,81,204
1/05/2024, Lao People's Democratic Republic,Pulau Pinang,30,8,22
1/05/2024, Lao People's Democratic Republic,Sabah,1,0,1
1/05/2024, Lao People's Democratic Republic,Sarawak,20,11,9
1/05/2024, Lao People's Democratic Republic,Selangor,272,108,164
1/05/2024,Lebanon,Johor,16,9,7
1/05/2024,Lebanon,Kedah,4,1,3
1/05/2024,Lebanon,Pulau Pinang,7,6,1
1/05/2024,Lebanon,Sabah,2,2,0
1/05/2024,Lebanon,Sarawak,3,3,0
1/05/2024,Lebanon,Selangor,283,185,98
1/05/2024,Liberia,Johor,1,1,0
1/05/2024,Liberia,Sarawak,1,1,0
1/05/2024,Liberia,Selangor,10,6,4
1/05/2024,Libya,Johor,1,1,0
1/05/2024,Libya,Selangor,438,286,152
1/05/2024,Saint Lucia,Johor,3,1,2
1/05/2024,Saint Lucia,Pulau Pinang,2,2,0
1/05/2024,Saint Lucia,Sarawak,1,0,1
1/05/2024,Saint Lucia,Selangor,16,11,5
1/05/2024,Liechtenstein,Johor,2,0,2
1/05/2024,Liechtenstein,Kedah,2,0,2
1/05/2024,Liechtenstein,Pulau Pinang,4,4,0
1/05/2024,Liechtenstein,Selangor,6,5,1
1/05/2024,LKA,Johor,637,419,218
1/05/2024,LKA,Kedah,62,35,27
1/05/2024,LKA,Pahang,2,2,0
1/05/2024,LKA,Perak,9,4,5
1/05/2024,LKA,Pulau Pinang,49,32,17
1/05/2024,LKA,Sabah,11,5,6
1/05/2024,LKA,Sarawak,21,13,8
1/05/2024,LKA,Selangor,5307,3292,2015
1/05/2024,LKA,W.P. Labuan,4,3,1
1/05/2024,Lesotho,Kedah,1,0,1
1/05/2024,Lesotho,Selangor,5,3,2
1/05/2024,Lithuania,Johor,56,37,19
1/05/2024,Lithuania,Kedah,19,6,13
1/05/2024,Lithuania,Perak,1,1,0
1/05/2024,Lithuania,Perlis,2,1,1
1/05/2024,Lithuania,Pulau Pinang,7,5,2
1/05/2024,Lithuania,Sabah,22,10,12
1/05/2024,Lithuania,Sarawak,4,3,1
1/05/2024,Lithuania,Selangor,266,138,128
1/05/2024,Luxembourg,Johor,3,2,1
1/05/2024,Luxembourg,Kedah,4,2,2
1/05/2024,Luxembourg,Kelantan,1,1,0
1/05/2024,Luxembourg,Pulau Pinang,2,1,1
1/05/2024,Luxembourg,Sabah,1,1,0
1/05/2024,Luxembourg,Sarawak,2,1,1
1/05/2024,Luxembourg,Selangor,50,29,21
1/05/2024,Latvia,Johor,12,5,7
1/05/2024,Latvia,Kedah,7,4,3
1/05/2024,Latvia,Pulau Pinang,7,7,0
1/05/2024,Latvia,Sabah,2,1,1
1/05/2024,Latvia,Sarawak,4,1,3
1/05/2024,Latvia,Selangor,165,101,64
1/05/2024,Macao,Pulau Pinang,1,0,1
1/05/2024,Macao,Selangor,1,0,1
1/05/2024,Morocco,Johor,116,63,53
1/05/2024,Morocco,Kedah,10,5,5
1/05/2024,Morocco,Kelantan,1,1,0
1/05/2024,Morocco,Pahang,1,1,0
1/05/2024,Morocco,Perlis,2,1,1
1/05/2024,Morocco,Pulau Pinang,8,3,5
1/05/2024,Morocco,Sabah,2,0,2
1/05/2024,Morocco,Sarawak,7,3,4
1/05/2024,Morocco,Selangor,1652,843,809
1/05/2024,Monaco,Johor,4,4,0
1/05/2024,Monaco,Perlis,1,0,1
1/05/2024,Monaco,Selangor,2,2,0
1/05/2024,"Moldova, Republic of",Johor,5,1,4
1/05/2024,"Moldova, Republic of",Selangor,37,15,22
1/05/2024,Madagascar,Johor,13,3,10
1/05/2024,Madagascar,Pulau Pinang,2,1,1
1/05/2024,Madagascar,Sabah,1,0,1
1/05/2024,Madagascar,Selangor,99,41,58
1/05/2024,Maldives,Johor,437,210,227
1/05/2024,Maldives,Kedah,6,2,4
1/05/2024,Maldives,Perak,5,0,5
1/05/2024,Maldives,Pulau Pinang,3,1,2
1/05/2024,Maldives,Sabah,1,0,1
1/05/2024,Maldives,Selangor,5278,2653,2625
1/05/2024,Mexico,Johor,152,78,74
1/05/2024,Mexico,Kedah,21,12,9
1/05/2024,Mexico,Pulau Pinang,37,29,8
1/05/2024,Mexico,Sabah,7,2,5
1/05/2024,Mexico,Sarawak,6,4,2
1/05/2024,Mexico,Selangor,660,312,348
1/05/2024,Marshall Islands,Johor,2,2,0
1/05/2024,Marshall Islands,Pulau Pinang,2,1,1
1/05/2024,Marshall Islands,Selangor,1,1,0
1/05/2024,North Macedonia,Johor,7,5,2
1/05/2024,North Macedonia,Sarawak,5,2,3
1/05/2024,North Macedonia,Selangor,56,25,31
1/05/2024,Mali,Johor,1,1,0
1/05/2024,Mali,Sarawak,1,1,0
1/05/2024,Mali,Selangor,12,7,5
1/05/2024,Malta,Johor,2,1,1
1/05/2024,Malta,Pulau Pinang,3,3,0
1/05/2024,Malta,Selangor,45,23,22
1/05/2024,Myanmar,Johor,7267,2050,5217
1/05/2024,Myanmar,Kedah,87,15,72
1/05/2024,Myanmar,Kelantan,3,1,2
1/05/2024,Myanmar,Pahang,3,1,2
1/05/2024,Myanmar,Perak,37,6,31
1/05/2024,Myanmar,Perlis,9,1,8
1/05/2024,Myanmar,Pulau Pinang,349,153,196
1/05/2024,Myanmar,Sabah,17,2,15
1/05/2024,Myanmar,Sarawak,81,39,42
1/05/2024,Myanmar,Selangor,11520,8112,3408
1/05/2024,Myanmar,W.P. Labuan,1,1,0
1/05/2024,Montenegro,Johor,4,4,0
1/05/2024,Montenegro,Selangor,17,16,1
1/05/2024,Mongolia,Johor,128,39,89
1/05/2024,Mongolia,Kedah,7,3,4
1/05/2024,Mongolia,Perak,1,1,0
1/05/2024,Mongolia,Perlis,2,2,0
1/05/2024,Mongolia,Pulau Pinang,7,6,1
1/05/2024,Mongolia,Sarawak,2,2,0
1/05/2024,Mongolia,Selangor,353,138,215
1/05/2024,Mozambique,Selangor,58,38,20
1/05/2024,Mauritania,Johor,1,1,0
1/05/2024,Mauritania,Kedah,2,1,1
1/05/2024,Mauritania,Selangor,20,14,6
1/05/2024,Mauritius,Johor,182,90,92
1/05/2024,Mauritius,Kedah,9,5,4
1/05/2024,Mauritius,Pahang,1,1,0
1/05/2024,Mauritius,Perlis,4,3,1
1/05/2024,Mauritius,Pulau Pinang,16,6,10
1/05/2024,Mauritius,Sabah,2,2,0
1/05/2024,Mauritius,Selangor,921,501,420
1/05/2024,Malawi,Johor,1,1,0
1/05/2024,Malawi,Pulau Pinang,1,0,1
1/05/2024,Malawi,Selangor,18,15,3
1/05/2024,Namibia,Selangor,18,10,8
1/05/2024,Niger,Selangor,1,1,0
1/05/2024,Nigeria,Johor,14,13,1
1/05/2024,Nigeria,Kedah,2,2,0
1/05/2024,Nigeria,Pulau Pinang,10,7,3
1/05/2024,Nigeria,Sarawak,13,12,1
1/05/2024,Nigeria,Selangor,505,407,98
1/05/2024,Nicaragua,Johor,2,1,1
1/05/2024,Nicaragua,Selangor,4,2,2
1/05/2024,Netherlands,Johor,1239,755,484
1/05/2024,Netherlands,Kedah,376,188,188
1/05/2024,Netherlands,Kelantan,11,7,4
1/05/2024,Netherlands,Melaka,1,1,0
1/05/2024,Netherlands,Pahang,6,4,2
1/05/2024,Netherlands,Perak,19,10,9
1/05/2024,Netherlands,Perlis,43,26,17
1/05/2024,Netherlands,Pulau Pinang,266,175,91
1/05/2024,Netherlands,Sabah,93,57,36
1/05/2024,Netherlands,Sarawak,169,99,70
1/05/2024,Netherlands,Selangor,4230,2455,1775
1/05/2024,Netherlands,W.P. Labuan,2,1,1
1/05/2024,Norway,Johor,136,84,52
1/05/2024,Norway,Kedah,36,16,20
1/05/2024,Norway,Kelantan,1,1,0
1/05/2024,Norway,Perak,1,0,1
1/05/2024,Norway,Perlis,6,1,5
1/05/2024,Norway,Pulau Pinang,20,13,7
1/05/2024,Norway,Sabah,8,5,3
1/05/2024,Norway,Sarawak,32,20,12
1/05/2024,Norway,Selangor,529,331,198
1/05/2024,Nepal,Johor,665,421,244
1/05/2024,Nepal,Kedah,24,14,10
1/05/2024,Nepal,Perak,5,3,2
1/05/2024,Nepal,Pulau Pinang,29,22,7
1/05/2024,Nepal,Sabah,3,1,2
1/05/2024,Nepal,Sarawak,268,189,79
1/05/2024,Nepal,Selangor,20680,19936,744
1/05/2024,Nepal,W.P. Labuan,77,77,0
1/05/2024,Nauru,Selangor,2,2,0
1/05/2024,New Zealand,Johor,763,467,296
1/05/2024,New Zealand,Kedah,87,52,35
1/05/2024,New Zealand,Kelantan,4,2,2
1/05/2024,New Zealand,Melaka,1,0,1
1/05/2024,New Zealand,Pahang,5,5,0
1/05/2024,New Zealand,Perak,19,9,10
1/05/2024,New Zealand,Perlis,22,14,8
1/05/2024,New Zealand,Pulau Pinang,241,133,108
1/05/2024,New Zealand,Sabah,55,28,27
1/05/2024,New Zealand,Sarawak,141,89,52
1/05/2024,New Zealand,Selangor,2485,1487,998
1/05/2024,Oman,Johor,24,23,1
1/05/2024,Oman,Perak,4,3,1
1/05/2024,Oman,Pulau Pinang,4,4,0
1/05/2024,Oman,Sarawak,8,7,1
1/05/2024,Oman,Selangor,965,607,358
1/05/2024,Pakistan,Johor,617,455,162
1/05/2024,Pakistan,Kedah,129,96,33
1/05/2024,Pakistan,Kelantan,15,15,0
1/05/2024,Pakistan,Pahang,2,2,0
1/05/2024,Pakistan,Perak,1,0,1
1/05/2024,Pakistan,Perlis,18,17,1
1/05/2024,Pakistan,Pulau Pinang,278,240,38
1/05/2024,Pakistan,Sabah,13,12,1
1/05/2024,Pakistan,Sarawak,182,148,34
1/05/2024,Pakistan,Selangor,13638,12047,1591
1/05/2024,Pakistan,W.P. Labuan,2,2,0
1/05/2024,Panama,Johor,5,4,1
1/05/2024,Panama,Kedah,1,0,1
1/05/2024,Panama,Selangor,14,7,7
1/05/2024,Peru,Johor,29,14,15
1/05/2024,Peru,Kedah,4,3,1
1/05/2024,Peru,Perlis,3,2,1
1/05/2024,Peru,Pulau Pinang,10,6,4
1/05/2024,Peru,Sarawak,3,3,0
1/05/2024,Peru,Selangor,191,104,87
1/05/2024,Philippines,Johor,25289,7974,17315
1/05/2024,Philippines,Kedah,498,146,352
1/05/2024,Philippines,Kelantan,65,31,34
1/05/2024,Philippines,Pahang,22,14,8
1/05/2024,Philippines,Perak,88,31,57
1/05/2024,Philippines,Perlis,125,45,80
1/05/2024,Philippines,Pulau Pinang,1024,392,632
1/05/2024,Philippines,Sabah,1422,718,704
1/05/2024,Philippines,Sarawak,2747,1046,1701
1/05/2024,Philippines,Selangor,16032,6565,9467
1/05/2024,Philippines,W.P. Labuan,112,27,85
1/05/2024,Palau,Johor,2,2,0
1/05/2024,Papua New Guinea,Johor,17,10,7
1/05/2024,Papua New Guinea,Kedah,1,1,0
1/05/2024,Papua New Guinea,Sarawak,6,6,0
1/05/2024,Papua New Guinea,Selangor,54,30,24
1/05/2024,Poland,Johor,283,159,124
1/05/2024,Poland,Kedah,85,44,41
1/05/2024,Poland,Kelantan,1,1,0
1/05/2024,Poland,Perak,6,5,1
1/05/2024,Poland,Perlis,16,12,4
1/05/2024,Poland,Pulau Pinang,55,27,28
1/05/2024,Poland,Sabah,34,16,18
1/05/2024,Poland,Sarawak,53,29,24
1/05/2024,Poland,Selangor,1270,654,616
1/05/2024,Poland,W.P. Labuan,2,2,0
1/05/2024,Portugal,Johor,145,89,56
1/05/2024,Portugal,Kedah,55,26,29
1/05/2024,Portugal,Pahang,1,1,0
1/05/2024,Portugal,Perak,2,1,1
1/05/2024,Portugal,Perlis,1,1,0
1/05/2024,Portugal,Pulau Pinang,41,25,16
1/05/2024,Portugal,Sabah,12,8,4
1/05/2024,Portugal,Sarawak,9,6,3
1/05/2024,Portugal,Selangor,861,516,345
1/05/2024,Paraguay,Johor,4,1,3
1/05/2024,Paraguay,Sabah,1,1,0
1/05/2024,Paraguay,Selangor,14,2,12
1/05/2024,"Palestine, State of",Johor,30,20,10
1/05/2024,"Palestine, State of",Kedah,4,2,2
1/05/2024,"Palestine, State of",Perak,1,1,0
1/05/2024,"Palestine, State of",Pulau Pinang,3,3,0
1/05/2024,"Palestine, State of",Selangor,352,230,122
1/05/2024,Qatar,Johor,6,6,0
1/05/2024,Qatar,Selangor,112,83,29
1/05/2024,Romania,Johor,128,69,59
1/05/2024,Romania,Kedah,21,9,12
1/05/2024,Romania,Kelantan,4,2,2
1/05/2024,Romania,Melaka,1,1,0
1/05/2024,Romania,Perak,1,0,1
1/05/2024,Romania,Perlis,1,0,1
1/05/2024,Romania,Pulau Pinang,34,17,17
1/05/2024,Romania,Sabah,5,3,2
1/05/2024,Romania,Sarawak,9,5,4
1/05/2024,Romania,Selangor,628,337,291
1/05/2024,Russian Federation (Russia),Johor,437,226,211
1/05/2024,Russian Federation (Russia),Kedah,250,114,136
1/05/2024,Russian Federation (Russia),Kelantan,36,21,15
1/05/2024,Russian Federation (Russia),Pahang,1,0,1
1/05/2024,Russian Federation (Russia),Perak,5,2,3
1/05/2024,Russian Federation (Russia),Perlis,53,37,16
1/05/2024,Russian Federation (Russia),Pulau Pinang,109,63,46
1/05/2024,Russian Federation (Russia),Sabah,38,19,19
1/05/2024,Russian Federation (Russia),Sarawak,47,24,23
1/05/2024,Russian Federation (Russia),Selangor,7876,3930,3946
1/05/2024,Russian Federation (Russia),W.P. Labuan,3,2,1
1/05/2024,Rwanda,Pulau Pinang,1,1,0
1/05/2024,Rwanda,Selangor,6,6,0
1/05/2024,Saudi Arabia,Johor,164,93,71
1/05/2024,Saudi Arabia,Kedah,28,21,7
1/05/2024,Saudi Arabia,Kelantan,1,1,0
1/05/2024,Saudi Arabia,Perak,8,8,0
1/05/2024,Saudi Arabia,Perlis,1,1,0
1/05/2024,Saudi Arabia,Pulau Pinang,22,13,9
1/05/2024,Saudi Arabia,Sarawak,16,7,9
1/05/2024,Saudi Arabia,Selangor,3984,2474,1510
1/05/2024,Sudan,Johor,11,8,3
1/05/2024,Sudan,Kedah,2,1,1
1/05/2024,Sudan,Pulau Pinang,2,1,1
1/05/2024,Sudan,Sarawak,8,2,6
1/05/2024,Sudan,Selangor,811,482,329
1/05/2024,Sudan,W.P. Labuan,1,1,0
1/05/2024,Senegal,Johor,14,12,2
1/05/2024,Senegal,Selangor,90,63,27
1/05/2024,Singapore,Johor,1432787,817386,615401
1/05/2024,Singapore,Kedah,5368,2742,2626
1/05/2024,Singapore,Kelantan,99,64,35
1/05/2024,Singapore,Melaka,22,18,4
1/05/2024,Singapore,Pahang,696,363,333
1/05/2024,Singapore,Perak,6096,2748,3348
1/05/2024,Singapore,Perlis,240,144,96
1/05/2024,Singapore,Pulau Pinang,21664,10285,11379
1/05/2024,Singapore,Sabah,2770,1356,1414
1/05/2024,Singapore,Sarawak,4386,2597,1789
1/05/2024,Singapore,Selangor,52931,27341,25590
1/05/2024,Singapore,W.P. Labuan,6,4,2
1/05/2024,Solomon Islands,Johor,5,5,0
1/05/2024,Solomon Islands,Pulau Pinang,1,1,0
1/05/2024,Solomon Islands,Sarawak,10,3,7
1/05/2024,Solomon Islands,Selangor,8,5,3
1/05/2024,Sierra Leone,Johor,7,5,2
1/05/2024,Sierra Leone,Kedah,1,1,0
1/05/2024,Sierra Leone,Pulau Pinang,5,1,4
1/05/2024,Sierra Leone,Selangor,25,12,13
1/05/2024,El Salvador,Johor,2,2,0
1/05/2024,El Salvador,Selangor,13,6,7
1/05/2024,San Marino,Selangor,3,2,1
1/05/2024,Somalia,Selangor,208,116,92
1/05/2024,Serbia,Johor,5,5,0
1/05/2024,Serbia,Kedah,2,0,2
1/05/2024,Serbia,Perak,1,1,0
1/05/2024,Serbia,Pulau Pinang,5,5,0
1/05/2024,Serbia,Selangor,180,82,98
1/05/2024,South Sudan,Johor,1,1,0
1/05/2024,South Sudan,Sarawak,4,2,2
1/05/2024,South Sudan,Selangor,29,14,15
1/05/2024,Sao Tome and Principe,Selangor,2,0,2
1/05/2024,Suriname,Johor,4,3,1
1/05/2024,Suriname,Pulau Pinang,2,1,1
1/05/2024,Suriname,Selangor,27,13,14
1/05/2024,Slovakia,Johor,53,29,24
1/05/2024,Slovakia,Kedah,47,22,25
1/05/2024,Slovakia,Perlis,2,1,1
1/05/2024,Slovakia,Pulau Pinang,15,13,2
1/05/2024,Slovakia,Sabah,10,4,6
1/05/2024,Slovakia,Sarawak,9,8,1
1/05/2024,Slovakia,Selangor,256,146,110
1/05/2024,Slovenia,Johor,13,9,4
1/05/2024,Slovenia,Kedah,8,3,5
1/05/2024,Slovenia,Perak,1,1,0
1/05/2024,Slovenia,Pulau Pinang,1,1,0
1/05/2024,Slovenia,Sabah,3,2,1
1/05/2024,Slovenia,Sarawak,4,0,4
1/05/2024,Slovenia,Selangor,129,72,57
1/05/2024,Sweden,Johor,184,114,70
1/05/2024,Sweden,Kedah,64,36,28
1/05/2024,Sweden,Kelantan,1,1,0
1/05/2024,Sweden,Perak,1,1,0
1/05/2024,Sweden,Perlis,5,3,2
1/05/2024,Sweden,Pulau Pinang,81,59,22
1/05/2024,Sweden,Sabah,20,13,7
1/05/2024,Sweden,Sarawak,30,23,7
1/05/2024,Sweden,Selangor,704,455,249
1/05/2024,Sweden,W.P. Labuan,2,1,1
1/05/2024,Eswatini,Johor,2,2,0
1/05/2024,Eswatini,Selangor,28,12,16
1/05/2024,Seychelles,Johor,3,1,2
1/05/2024,Seychelles,Pahang,1,1,0
1/05/2024,Seychelles,Selangor,59,27,32
1/05/2024,Syrian Arab Republic,Johor,37,32,5
1/05/2024,Syrian Arab Republic,Kedah,6,4,2
1/05/2024,Syrian Arab Republic,Pulau Pinang,11,10,1
1/05/2024,Syrian Arab Republic,Sarawak,11,9,2
1/05/2024,Syrian Arab Republic,Selangor,618,398,220
1/05/2024,TCD,Johor,4,3,1
1/05/2024,TCD,Selangor,32,26,6
1/05/2024,Togo,Kedah,1,1,0
1/05/2024,Togo,Selangor,12,9,3
1/05/2024,Thailand,Johor,8267,2210,6057
1/05/2024,Thailand,Kedah,64267,35657,28610
1/05/2024,Thailand,Kelantan,55889,28354,27535
1/05/2024,Thailand,Melaka,4,1,3
1/05/2024,Thailand,Pahang,21,11,10
1/05/2024,Thailand,Perak,8614,4017,4597
1/05/2024,Thailand,Perlis,47853,27639,20214
1/05/2024,Thailand,Pulau Pinang,3045,1105,1940
1/05/2024,Thailand,Sabah,23,5,18
1/05/2024,Thailand,Sarawak,500,180,320
1/05/2024,Thailand,Selangor,14834,5812,9022
1/05/2024,Thailand,Terengganu,1,1,0
1/05/2024,Thailand,W.P. Labuan,14,6,8
1/05/2024,Tajikistan,Johor,7,5,2
1/05/2024,Tajikistan,Kedah,2,1,1
1/05/2024,Tajikistan,Sabah,1,1,0
1/05/2024,Tajikistan,Selangor,140,110,30
1/05/2024,Turkmenistan,Johor,4,3,1
1/05/2024,Turkmenistan,Kedah,6,1,5
1/05/2024,Turkmenistan,Pulau Pinang,2,2,0
1/05/2024,Turkmenistan,Sarawak,1,1,0
1/05/2024,Turkmenistan,Selangor,333,205,128
1/05/2024,Timor-Leste,Johor,15,7,8
1/05/2024,Timor-Leste,Kedah,1,0,1
1/05/2024,Timor-Leste,Perak,3,0,3
1/05/2024,Timor-Leste,Pulau Pinang,10,5,5
1/05/2024,Timor-Leste,Sabah,1,0,1
1/05/2024,Timor-Leste,Selangor,197,105,92
1/05/2024,Tonga,Johor,1,1,0
1/05/2024,Tonga,Kedah,1,1,0
1/05/2024,Tonga,Pulau Pinang,1,0,1
1/05/2024,Tonga,Sarawak,1,1,0
1/05/2024,Tonga,Selangor,12,6,6
1/05/2024,Trinidad and Tobago,Johor,7,4,3
1/05/2024,Trinidad and Tobago,Kedah,1,0,1
1/05/2024,Trinidad and Tobago,Perak,1,1,0
1/05/2024,Trinidad and Tobago,Sarawak,2,0,2
1/05/2024,Trinidad and Tobago,Selangor,34,17,17
1/05/2024,Tunisia,Johor,26,15,11
1/05/2024,Tunisia,Kedah,2,0,2
1/05/2024,Tunisia,Kelantan,1,1,0
1/05/2024,Tunisia,Pulau Pinang,12,5,7
1/05/2024,Tunisia,Sarawak,1,1,0
1/05/2024,Tunisia,Selangor,816,435,381
1/05/2024,Türkiye,Johor,327,228,99
1/05/2024,Türkiye,Kedah,38,23,15
1/05/2024,Türkiye,Kelantan,11,9,2
1/05/2024,Türkiye,Perak,3,1,2
1/05/2024,Türkiye,Perlis,15,13,2
1/05/2024,Türkiye,Pulau Pinang,35,29,6
1/05/2024,Türkiye,Sabah,7,6,1
1/05/2024,Türkiye,Sarawak,25,16,9
1/05/2024,Türkiye,Selangor,1772,1302,470
1/05/2024,Türkiye,W.P. Labuan,1,0,1
1/05/2024,Tuvalu,Pulau Pinang,2,0,2
1/05/2024,Tuvalu,Selangor,2,1,1
1/05/2024,"Taiwan, Province of China",Johor,8338,3582,4756
1/05/2024,"Taiwan, Province of China",Kedah,168,87,81
1/05/2024,"Taiwan, Province of China",Kelantan,4,3,1
1/05/2024,"Taiwan, Province of China",Melaka,13,9,4
1/05/2024,"Taiwan, Province of China",Pahang,5,3,2
1/05/2024,"Taiwan, Province of China",Perak,60,25,35
1/05/2024,"Taiwan, Province of China",Perlis,23,16,7
1/05/2024,"Taiwan, Province of China",Pulau Pinang,4147,2036,2111
1/05/2024,"Taiwan, Province of China",Sabah,1517,706,811
1/05/2024,"Taiwan, Province of China",Sarawak,269,132,137
1/05/2024,"Taiwan, Province of China",Selangor,14570,7068,7502
1/05/2024,"Taiwan, Province of China",W.P. Labuan,4,3,1
1/05/2024,"Tanzania, United Republic of",Johor,12,9,3
1/05/2024,"Tanzania, United Republic of",Pulau Pinang,2,1,1
1/05/2024,"Tanzania, United Republic of",Sarawak,4,3,1
1/05/2024,"Tanzania, United Republic of",Selangor,167,75,92
1/05/2024,Uganda,Johor,308,127,181
1/05/2024,Uganda,Kedah,1,0,1
1/05/2024,Uganda,Sarawak,2,2,0
1/05/2024,Uganda,Selangor,390,148,242
1/05/2024,Ukraine,Johor,120,61,59
1/05/2024,Ukraine,Kedah,36,16,20
1/05/2024,Ukraine,Kelantan,12,5,7
1/05/2024,Ukraine,Pahang,3,2,1
1/05/2024,Ukraine,Perlis,6,3,3
1/05/2024,Ukraine,Pulau Pinang,19,7,12
1/05/2024,Ukraine,Sabah,5,3,2
1/05/2024,Ukraine,Sarawak,4,2,2
1/05/2024,Ukraine,Selangor,1101,530,571
1/05/2024,Uruguay,Johor,14,6,8
1/05/2024,Uruguay,Kedah,2,1,1
1/05/2024,Uruguay,Sabah,2,1,1
1/05/2024,Uruguay,Selangor,51,21,30
1/05/2024,United States of America,Johor,5196,2974,2222
1/05/2024,United States of America,Kedah,522,279,243
1/05/2024,United States of America,Kelantan,24,17,7
1/05/2024,United States of America,Melaka,5,3,2
1/05/2024,United States of America,Pahang,9,7,2
1/05/2024,United States of America,Perak,143,84,59
1/05/2024,United States of America,Perlis,107,56,51
1/05/2024,United States of America,Pulau Pinang,2332,1419,913
1/05/2024,United States of America,Sabah,320,164,156
1/05/2024,United States of America,Sarawak,313,206,107
1/05/2024,United States of America,Selangor,14291,8418,5873
1/05/2024,United States of America,W.P. Labuan,5,4,1
1/05/2024,Uzbekistan,Johor,82,58,24
1/05/2024,Uzbekistan,Kedah,8,7,1
1/05/2024,Uzbekistan,Kelantan,2,2,0
1/05/2024,Uzbekistan,Perlis,1,1,0
1/05/2024,Uzbekistan,Pulau Pinang,13,11,2
1/05/2024,Uzbekistan,Sabah,6,4,2
1/05/2024,Uzbekistan,Selangor,924,580,344
1/05/2024,Holy See,Selangor,1,1,0
1/05/2024,Saint Vincent and the Grenadines,Selangor,1,1,0
1/05/2024,"Venezuela, Bolivarian Republic of",Johor,12,8,4
1/05/2024,"Venezuela, Bolivarian Republic of",Kedah,1,0,1
1/05/2024,"Venezuela, Bolivarian Republic of",Pulau Pinang,1,1,0
1/05/2024,"Venezuela, Bolivarian Republic of",Sabah,2,1,1
1/05/2024,"Venezuela, Bolivarian Republic of",Sarawak,4,1,3
1/05/2024,"Venezuela, Bolivarian Republic of",Selangor,106,56,50
1/05/2024,Viet Nam,Johor,15481,4745,10736
1/05/2024,Viet Nam,Kedah,372,43,329
1/05/2024,Viet Nam,Kelantan,29,14,15
1/05/2024,Viet Nam,Pahang,10,9,1
1/05/2024,Viet Nam,Perak,142,34,108
1/05/2024,Viet Nam,Perlis,220,14,206
1/05/2024,Viet Nam,Pulau Pinang,1837,482,1355
1/05/2024,Viet Nam,Sabah,16,2,14
1/05/2024,Viet Nam,Sarawak,361,47,314
1/05/2024,Viet Nam,Selangor,14207,4898,9309
1/05/2024,Viet Nam,W.P. Labuan,4,2,2
1/05/2024,Vanuatu,Johor,19,11,8
1/05/2024,Vanuatu,Pulau Pinang,5,5,0
1/05/2024,Vanuatu,Sabah,1,1,0
1/05/2024,Vanuatu,Selangor,102,89,13
1/05/2024, Samoa,Johor,1,0,1
1/05/2024, Samoa,Pulau Pinang,1,0,1
1/05/2024,Yemen,Johor,39,29,10
1/05/2024,Yemen,Kedah,6,4,2
1/05/2024,Yemen,Kelantan,3,3,0
1/05/2024,Yemen,Perlis,1,1,0
1/05/2024,Yemen,Pulau Pinang,4,3,1
1/05/2024,Yemen,Sarawak,3,2,1
1/05/2024,Yemen,Selangor,1203,832,371
1/05/2024,South Africa,Johor,293,187,106
1/05/2024,South Africa,Kedah,46,26,20
1/05/2024,South Africa,Kelantan,2,2,0
1/05/2024,South Africa,Perak,3,2,1
1/05/2024,South Africa,Perlis,4,2,2
1/05/2024,South Africa,Pulau Pinang,71,41,30
1/05/2024,South Africa,Sabah,19,11,8
1/05/2024,South Africa,Sarawak,101,41,60
1/05/2024,South Africa,Selangor,814,489,325
1/05/2024,ZAR,Selangor,4,2,2
1/05/2024,Zambia,Johor,7,4,3
1/05/2024,Zambia,Kedah,1,1,0
1/05/2024,Zambia,Pulau Pinang,1,0,1
1/05/2024,Zambia,Selangor,44,28,16
1/05/2024,Zimbabwe,Johor,14,8,6
1/05/2024,Zimbabwe,Kedah,2,0,2
1/05/2024,Zimbabwe,Pulau Pinang,6,4,2
1/05/2024,Zimbabwe,Sabah,2,1,1
1/05/2024,Zimbabwe,Selangor,139,70,69
1/06/2024,Afghanistan,Sarawak,2,2,0
1/06/2024,Afghanistan,Selangor,34,25,9
1/06/2024,Angola,Selangor,9,7,2
1/06/2024,Anguilla,Selangor,1,1,0
1/06/2024,Albania,Johor,11,7,4
1/06/2024,Albania,Kedah,1,1,0
1/06/2024,Albania,Pulau Pinang,1,1,0
1/06/2024,Albania,Sarawak,1,1,0
1/06/2024,Albania,Selangor,32,18,14
1/06/2024,Andorra,Pulau Pinang,1,1,0
1/06/2024,Andorra,Selangor,13,9,4
1/06/2024,United Arab Emirates,Johor,36,17,19
1/06/2024,United Arab Emirates,Kedah,19,13,6
1/06/2024,United Arab Emirates,Kelantan,1,0,1
1/06/2024,United Arab Emirates,Pulau Pinang,11,9,2
1/06/2024,United Arab Emirates,Selangor,659,371,288
1/06/2024,Argentina,Johor,93,46,47
1/06/2024,Argentina,Kedah,11,5,6
1/06/2024,Argentina,Kelantan,1,0,1
1/06/2024,Argentina,Perlis,7,3,4
1/06/2024,Argentina,Pulau Pinang,6,2,4
1/06/2024,Argentina,Sabah,3,2,1
1/06/2024,Argentina,Sarawak,11,9,2
1/06/2024,Argentina,Selangor,417,225,192
1/06/2024,Armenia,Johor,2,1,1
1/06/2024,Armenia,Kedah,3,2,1
1/06/2024,Armenia,Pulau Pinang,2,1,1
1/06/2024,Armenia,Selangor,63,33,30
1/06/2024,Antigua and Barbuda,Johor,5,2,3
1/06/2024,Antigua and Barbuda,Sabah,1,0,1
1/06/2024,Antigua and Barbuda,Selangor,16,8,8
1/06/2024,Australia,Johor,5362,3141,2221
1/06/2024,Australia,Kedah,505,277,228
1/06/2024,Australia,Kelantan,13,8,5
1/06/2024,Australia,Melaka,2,1,1
1/06/2024,Australia,Pahang,62,34,28
1/06/2024,Australia,Perak,212,110,102
1/06/2024,Australia,Perlis,75,43,32
1/06/2024,Australia,Pulau Pinang,2182,1125,1057
1/06/2024,Australia,Sabah,583,303,280
1/06/2024,Australia,Sarawak,631,360,271
1/06/2024,Australia,Selangor,29383,16434,12949
1/06/2024,Australia,W.P. Labuan,12,10,2
1/06/2024,Austria,Johor,136,98,38
1/06/2024,Austria,Kedah,12,6,6
1/06/2024,Austria,Kelantan,7,7,0
1/06/2024,Austria,Negeri Sembilan,2,1,1
1/06/2024,Austria,Perak,2,2,0
1/06/2024,Austria,Perlis,2,2,0
1/06/2024,Austria,Pulau Pinang,48,35,13
1/06/2024,Austria,Sabah,9,5,4
1/06/2024,Austria,Sarawak,11,5,6
1/06/2024,Austria,Selangor,568,369,199
1/06/2024,Azerbaijan,Johor,7,4,3
1/06/2024,Azerbaijan,Kedah,11,3,8
1/06/2024,Azerbaijan,Selangor,203,100,103
1/06/2024,Burundi,Johor,1,1,0
1/06/2024,Burundi,Selangor,1,0,1
1/06/2024,Belgium,Johor,288,174,114
1/06/2024,Belgium,Kedah,150,80,70
1/06/2024,Belgium,Kelantan,2,1,1
1/06/2024,Belgium,Pahang,1,0,1
1/06/2024,Belgium,Perak,1,1,0
1/06/2024,Belgium,Perlis,13,8,5
1/06/2024,Belgium,Pulau Pinang,80,56,24
1/06/2024,Belgium,Sabah,29,14,15
1/06/2024,Belgium,Sarawak,42,20,22
1/06/2024,Belgium,Selangor,1754,1006,748
1/06/2024,Belgium,W.P. Labuan,1,1,0
1/06/2024,Benin,Selangor,8,6,2
1/06/2024,Burkina Faso,Pulau Pinang,1,1,0
1/06/2024,Burkina Faso,Selangor,29,26,3
1/06/2024,Bangladesh,Johor,3628,2861,767
1/06/2024,Bangladesh,Kedah,162,104,58
1/06/2024,Bangladesh,Kelantan,3,3,0
1/06/2024,Bangladesh,Perak,2,2,0
1/06/2024,Bangladesh,Perlis,1,1,0
1/06/2024,Bangladesh,Pulau Pinang,227,187,40
1/06/2024,Bangladesh,Sabah,2,1,1
1/06/2024,Bangladesh,Sarawak,140,101,39
1/06/2024,Bangladesh,Selangor,25217,21920,3297
1/06/2024,Bangladesh,W.P. Labuan,5,5,0
1/06/2024,Bulgaria,Johor,44,22,22
1/06/2024,Bulgaria,Pulau Pinang,4,3,1
1/06/2024,Bulgaria,Sabah,4,2,2
1/06/2024,Bulgaria,Sarawak,5,5,0
1/06/2024,Bulgaria,Selangor,173,101,72
1/06/2024,Bahrain,Johor,43,22,21
1/06/2024,Bahrain,Kedah,2,1,1
1/06/2024,Bahrain,Pulau Pinang,20,5,15
1/06/2024,Bahrain,Sabah,1,0,1
1/06/2024,Bahrain,Selangor,427,211,216
1/06/2024,Bahamas,Perlis,1,1,0
1/06/2024,Bahamas,Selangor,3,1,2
1/06/2024,Bosnia and Herzegovina,Johor,6,4,2
1/06/2024,Bosnia and Herzegovina,Pulau Pinang,1,1,0
1/06/2024,Bosnia and Herzegovina,Selangor,67,42,25
1/06/2024,Belarus,Johor,10,6,4
1/06/2024,Belarus,Kedah,11,4,7
1/06/2024,Belarus,Kelantan,4,1,3
1/06/2024,Belarus,Pulau Pinang,2,0,2
1/06/2024,Belarus,Sarawak,1,1,0
1/06/2024,Belarus,Selangor,343,147,196
1/06/2024,Belize,Johor,4,4,0
1/06/2024,Belize,Selangor,5,4,1
1/06/2024,Bolivia,Johor,7,2,5
1/06/2024,Bolivia,Pulau Pinang,2,1,1
1/06/2024,Bolivia,Sarawak,4,1,3
1/06/2024,Bolivia,Selangor,19,8,11
1/06/2024,Brazil,Johor,316,182,134
1/06/2024,Brazil,Kedah,31,19,12
1/06/2024,Brazil,Kelantan,1,1,0
1/06/2024,Brazil,Perlis,8,3,5
1/06/2024,Brazil,Pulau Pinang,21,17,4
1/06/2024,Brazil,Sabah,5,4,1
1/06/2024,Brazil,Sarawak,5,3,2
1/06/2024,Brazil,Selangor,966,581,385
1/06/2024,Barbados,Johor,10,2,8
1/06/2024,Barbados,Kedah,1,1,0
1/06/2024,Barbados,Selangor,5,2,3
1/06/2024,Brunei Darussalam,Johor,367,191,176
1/06/2024,Brunei Darussalam,Kedah,12,7,5
1/06/2024,Brunei Darussalam,Kelantan,5,2,3
1/06/2024,Brunei Darussalam,Perak,4,2,2
1/06/2024,Brunei Darussalam,Perlis,29,14,15
1/06/2024,Brunei Darussalam,Pulau Pinang,18,7,11
1/06/2024,Brunei Darussalam,Sabah,1087,454,633
1/06/2024,Brunei Darussalam,Sarawak,131317,71327,59990
1/06/2024,Brunei Darussalam,Selangor,4831,2452,2379
1/06/2024,Brunei Darussalam,W.P. Labuan,1059,701,358
1/06/2024,Bhutan,Johor,11,6,5
1/06/2024,Bhutan,Selangor,50,39,11
1/06/2024,Botswana,Kedah,3,1,2
1/06/2024,Botswana,Sarawak,1,1,0
1/06/2024,Botswana,Selangor,15,5,10
1/06/2024,Canada,Johor,1461,830,631
1/06/2024,Canada,Kedah,125,68,57
1/06/2024,Canada,Kelantan,3,3,0
1/06/2024,Canada,Melaka,2,2,0
1/06/2024,Canada,Pahang,9,5,4
1/06/2024,Canada,Perak,25,13,12
1/06/2024,Canada,Perlis,22,13,9
1/06/2024,Canada,Pulau Pinang,459,259,200
1/06/2024,Canada,Sabah,175,90,85
1/06/2024,Canada,Sarawak,281,151,130
1/06/2024,Canada,Selangor,3855,2232,1623
1/06/2024,Canada,W.P. Labuan,7,4,3
1/06/2024,Switzerland,Johor,366,217,149
1/06/2024,Switzerland,Kedah,41,23,18
1/06/2024,Switzerland,Negeri Sembilan,3,2,1
1/06/2024,Switzerland,Pahang,5,3,2
1/06/2024,Switzerland,Perak,5,2,3
1/06/2024,Switzerland,Perlis,29,17,12
1/06/2024,Switzerland,Pulau Pinang,113,80,33
1/06/2024,Switzerland,Sabah,39,18,21
1/06/2024,Switzerland,Sarawak,47,23,24
1/06/2024,Switzerland,Selangor,1340,796,544
1/06/2024,Chile,Johor,59,24,35
1/06/2024,Chile,Kedah,8,3,5
1/06/2024,Chile,Kelantan,2,1,1
1/06/2024,Chile,Pahang,1,1,0
1/06/2024,Chile,Perlis,9,7,2
1/06/2024,Chile,Pulau Pinang,8,6,2
1/06/2024,Chile,Sabah,2,1,1
1/06/2024,Chile,Selangor,318,178,140
1/06/2024,China,Johor,81971,35785,46186
1/06/2024,China,Kedah,1450,647,803
1/06/2024,China,Kelantan,36,26,10
1/06/2024,China,Melaka,12,11,1
1/06/2024,China,Negeri Sembilan,2,2,0
1/06/2024,China,Pahang,45,21,24
1/06/2024,China,Perak,380,187,193
1/06/2024,China,Perlis,504,243,261
1/06/2024,China,Pulau Pinang,15103,7353,7750
1/06/2024,China,Sabah,24694,10340,14354
1/06/2024,China,Sarawak,1706,891,815
1/06/2024,China,Selangor,184267,87650,96617
1/06/2024,China,W.P. Labuan,34,25,9
1/06/2024,Côte d'Ivoire,Selangor,5,4,1
1/06/2024,Cameroon,Johor,3,1,2
1/06/2024,Cameroon,Selangor,24,20,4
1/06/2024,Congo,Johor,6,5,1
1/06/2024,Congo,Selangor,14,11,3
1/06/2024,Congo,Selangor,1,1,0
1/06/2024,Colombia,Johor,27,13,14
1/06/2024,Colombia,Kedah,15,7,8
1/06/2024,Colombia,Perak,1,1,0
1/06/2024,Colombia,Pulau Pinang,5,3,2
1/06/2024,Colombia,Sabah,3,2,1
1/06/2024,Colombia,Sarawak,1,0,1
1/06/2024,Colombia,Selangor,227,118,109
1/06/2024,Colombia,W.P. Labuan,1,1,0
1/06/2024,Comoros,Kedah,1,0,1
1/06/2024,Comoros,Selangor,38,16,22
1/06/2024,Cabo Verde,Johor,2,1,1
1/06/2024,Cabo Verde,Selangor,5,3,2
1/06/2024,Costa Rica,Johor,13,10,3
1/06/2024,Costa Rica,Kedah,1,0,1
1/06/2024,Costa Rica,Pulau Pinang,10,9,1
1/06/2024,Costa Rica,Sabah,1,0,1
1/06/2024,Costa Rica,Sarawak,2,2,0
1/06/2024,Costa Rica,Selangor,41,19,22
1/06/2024,Cuba,Johor,12,7,5
1/06/2024,Cuba,Pulau Pinang,3,3,0
1/06/2024,Cuba,Selangor,22,12,10
1/06/2024,Cyprus,Johor,6,3,3
1/06/2024,Cyprus,Kedah,1,0,1
1/06/2024,Cyprus,Pulau Pinang,5,2,3
1/06/2024,Cyprus,Selangor,79,60,19
1/06/2024,Czechia,Johor,86,50,36
1/06/2024,Czechia,Kedah,39,20,19
1/06/2024,Czechia,Kelantan,2,2,0
1/06/2024,Czechia,Perlis,1,0,1
1/06/2024,Czechia,Pulau Pinang,13,9,4
1/06/2024,Czechia,Sabah,3,2,1
1/06/2024,Czechia,Sarawak,17,12,5
1/06/2024,Czechia,Selangor,484,281,203
1/06/2024,Germany,Johor,2004,1255,749
1/06/2024,Germany,Kedah,295,166,129
1/06/2024,Germany,Kelantan,10,7,3
1/06/2024,Germany,Melaka,3,0,3
1/06/2024,Germany,Negeri Sembilan,6,2,4
1/06/2024,Germany,Pahang,11,9,2
1/06/2024,Germany,Perak,36,25,11
1/06/2024,Germany,Perlis,84,49,35
1/06/2024,Germany,Pulau Pinang,527,370,157
1/06/2024,Germany,Sabah,158,85,73
1/06/2024,Germany,Sarawak,217,132,85
1/06/2024,Germany,Selangor,6228,3790,2438
1/06/2024,Germany,W.P. Labuan,1,0,1
1/06/2024,Djibouti,Selangor,14,11,3
1/06/2024,Dominica,Johor,4,2,2
1/06/2024,Dominica,Kedah,1,1,0
1/06/2024,Dominica,Pulau Pinang,2,2,0
1/06/2024,Dominica,Selangor,44,34,10
1/06/2024,Denmark,Johor,271,209,62
1/06/2024,Denmark,Kedah,24,15,9
1/06/2024,Denmark,Kelantan,4,3,1
1/06/2024,Denmark,Pahang,3,2,1
1/06/2024,Denmark,Perlis,12,9,3
1/06/2024,Denmark,Pulau Pinang,61,42,19
1/06/2024,Denmark,Sabah,18,13,5
1/06/2024,Denmark,Sarawak,19,9,10
1/06/2024,Denmark,Selangor,897,535,362
1/06/2024,Dominican Republic,Johor,7,1,6
1/06/2024,Dominican Republic,Pulau Pinang,1,0,1
1/06/2024,Dominican Republic,Sabah,1,0,1
1/06/2024,Dominican Republic,Selangor,12,8,4
1/06/2024,Algeria,Johor,31,24,7
1/06/2024,Algeria,Kedah,10,6,4
1/06/2024,Algeria,Perlis,1,0,1
1/06/2024,Algeria,Pulau Pinang,3,3,0
1/06/2024,Algeria,Selangor,770,488,282
1/06/2024,Ecuador,Johor,32,14,18
1/06/2024,Ecuador,Kedah,1,1,0
1/06/2024,Ecuador,Perlis,1,0,1
1/06/2024,Ecuador,Pulau Pinang,3,2,1
1/06/2024,Ecuador,Sabah,1,0,1
1/06/2024,Ecuador,Sarawak,2,2,0
1/06/2024,Ecuador,Selangor,81,46,35
1/06/2024,Egypt,Johor,255,216,39
1/06/2024,Egypt,Kedah,15,7,8
1/06/2024,Egypt,Kelantan,1,1,0
1/06/2024,Egypt,Perlis,1,1,0
1/06/2024,Egypt,Pulau Pinang,37,22,15
1/06/2024,Egypt,Sabah,4,2,2
1/06/2024,Egypt,Sarawak,96,70,26
1/06/2024,Egypt,Selangor,2160,1291,869
1/06/2024,Eritrea,Selangor,34,20,14
1/06/2024,Spain,Johor,541,321,220
1/06/2024,Spain,Kedah,71,35,36
1/06/2024,Spain,Kelantan,5,3,2
1/06/2024,Spain,Perak,5,2,3
1/06/2024,Spain,Perlis,12,5,7
1/06/2024,Spain,Pulau Pinang,120,59,61
1/06/2024,Spain,Sabah,50,24,26
1/06/2024,Spain,Sarawak,79,39,40
1/06/2024,Spain,Selangor,3625,1959,1666
1/06/2024,Spain,W.P. Labuan,10,7,3
1/06/2024,Estonia,Johor,22,13,9
1/06/2024,Estonia,Kelantan,1,0,1
1/06/2024,Estonia,Pulau Pinang,5,2,3
1/06/2024,Estonia,Sabah,4,2,2
1/06/2024,Estonia,Sarawak,1,0,1
1/06/2024,Estonia,Selangor,106,65,41
1/06/2024,Ethiopia,Pulau Pinang,2,1,1
1/06/2024,Ethiopia,Selangor,37,21,16
1/06/2024,Finland,Johor,180,107,73
1/06/2024,Finland,Kedah,29,13,16
1/06/2024,Finland,Kelantan,3,1,2
1/06/2024,Finland,Perak,2,2,0
1/06/2024,Finland,Perlis,5,4,1
1/06/2024,Finland,Pulau Pinang,46,30,16
1/06/2024,Finland,Sabah,5,2,3
1/06/2024,Finland,Sarawak,8,4,4
1/06/2024,Finland,Selangor,349,200,149
1/06/2024,Fiji,Johor,60,26,34
1/06/2024,Fiji,Pulau Pinang,4,1,3
1/06/2024,Fiji,Sabah,4,3,1
1/06/2024,Fiji,Sarawak,4,4,0
1/06/2024,Fiji,Selangor,94,54,40
1/06/2024,Fiji,W.P. Labuan,1,1,0
1/06/2024,France,Johor,2395,1439,956
1/06/2024,France,Kedah,267,141,126
1/06/2024,France,Kelantan,36,26,10
1/06/2024,France,Melaka,7,4,3
1/06/2024,France,Negeri Sembilan,1,0,1
1/06/2024,France,Pahang,10,4,6
1/06/2024,France,Perak,23,16,7
1/06/2024,France,Perlis,94,49,45
1/06/2024,France,Pulau Pinang,406,246,160
1/06/2024,France,Sabah,121,66,55
1/06/2024,France,Sarawak,144,77,67
1/06/2024,France,Selangor,9921,5520,4401
1/06/2024,France,Terengganu,1,1,0
1/06/2024,France,W.P. Labuan,3,2,1
1/06/2024,"Micronesia, Federated States of",Selangor,1,0,1
1/06/2024,Gabon,Johor,5,2,3
1/06/2024,United Kingdom of Great Britain and Northern Ireland,Johor,4939,3195,1744
1/06/2024,United Kingdom of Great Britain and Northern Ireland,Kedah,764,414,350
1/06/2024,United Kingdom of Great Britain and Northern Ireland,Kelantan,22,14,8
1/06/2024,United Kingdom of Great Britain and Northern Ireland,Melaka,6,5,1
1/06/2024,United Kingdom of Great Britain and Northern Ireland,Negeri Sembilan,2,2,0
1/06/2024,United Kingdom of Great Britain and Northern Ireland,Pahang,23,21,2
1/06/2024,United Kingdom of Great Britain and Northern Ireland,Perak,104,61,43
1/06/2024,United Kingdom of Great Britain and Northern Ireland,Perlis,190,118,72
1/06/2024,United Kingdom of Great Britain and Northern Ireland,Pulau Pinang,1403,836,567
1/06/2024,United Kingdom of Great Britain and Northern Ireland,Sabah,563,309,254
1/06/2024,United Kingdom of Great Britain and Northern Ireland,Sarawak,1145,773,372
1/06/2024,United Kingdom of Great Britain and Northern Ireland,Selangor,19486,11397,8089
1/06/2024,United Kingdom of Great Britain and Northern Ireland,Terengganu,1,1,0
1/06/2024,United Kingdom of Great Britain and Northern Ireland,W.P. Labuan,20,17,3
1/06/2024,Georgia,Johor,12,3,9
1/06/2024,Georgia,Sarawak,3,1,2
1/06/2024,Georgia,Selangor,57,36,21
1/06/2024,Ghana,Johor,10,8,2
1/06/2024,Ghana,Pulau Pinang,2,1,1
1/06/2024,Ghana,Selangor,105,68,37
1/06/2024,Guinea,Johor,10,9,1
1/06/2024,Guinea,Kedah,1,1,0
1/06/2024,Guinea,Kelantan,1,1,0
1/06/2024,Guinea,Selangor,54,40,14
1/06/2024,Gambia,Johor,5,0,5
1/06/2024,Gambia,Selangor,27,14,13
1/06/2024,Guinea-Bissau,Selangor,1,1,0
1/06/2024,Equatorial Guinea,Selangor,2,1,1
1/06/2024,Greece,Johor,97,78,19
1/06/2024,Greece,Kedah,4,3,1
1/06/2024,Greece,Kelantan,1,1,0
1/06/2024,Greece,Pulau Pinang,6,4,2
1/06/2024,Greece,Sabah,4,2,2
1/06/2024,Greece,Sarawak,5,5,0
1/06/2024,Greece,Selangor,199,137,62
1/06/2024,Grenada,Johor,7,5,2
1/06/2024,Grenada,Selangor,9,6,3
1/06/2024,Guatemala,Johor,8,6,2
1/06/2024,Guatemala,Pulau Pinang,2,1,1
1/06/2024,Guatemala,Sabah,1,0,1
1/06/2024,Guatemala,Selangor,23,16,7
1/06/2024,Guyana,Johor,1,1,0
1/06/2024,Guyana,Selangor,3,2,1
1/06/2024,Hong Kong,Johor,6,4,2
1/06/2024,Hong Kong,Perak,61,20,41
1/06/2024,Hong Kong,Perlis,1,1,0
1/06/2024,Hong Kong,Pulau Pinang,6,1,5
1/06/2024,Hong Kong,Sarawak,1,1,0
1/06/2024,Hong Kong,Selangor,93,70,23
1/06/2024,Honduras,Johor,3,2,1
1/06/2024,Honduras,Pulau Pinang,2,1,1
1/06/2024,Honduras,Selangor,14,7,7
1/06/2024,Croatia,Johor,29,27,2
1/06/2024,Croatia,Kedah,2,2,0
1/06/2024,Croatia,Kelantan,1,1,0
1/06/2024,Croatia,Sabah,2,2,0
1/06/2024,Croatia,Sarawak,2,1,1
1/06/2024,Croatia,Selangor,150,102,48
1/06/2024,Haiti,Johor,1,1,0
1/06/2024,Haiti,Selangor,16,13,3
1/06/2024,Hungary,Johor,76,51,25
1/06/2024,Hungary,Kedah,7,3,4
1/06/2024,Hungary,Perlis,1,1,0
1/06/2024,Hungary,Pulau Pinang,30,19,11
1/06/2024,Hungary,Sabah,7,5,2
1/06/2024,Hungary,Sarawak,7,3,4
1/06/2024,Hungary,Selangor,430,230,200
1/06/2024,Indonesia,Johor,117386,51562,65824
1/06/2024,Indonesia,Kedah,5316,1843,3473
1/06/2024,Indonesia,Kelantan,213,112,101
1/06/2024,Indonesia,Melaka,5262,2356,2906
1/06/2024,Indonesia,Negeri Sembilan,7155,4291,2864
1/06/2024,Indonesia,Pahang,25,13,12
1/06/2024,Indonesia,Perak,202,38,164
1/06/2024,Indonesia,Perlis,702,188,514
1/06/2024,Indonesia,Pulau Pinang,42689,17075,25614
1/06/2024,Indonesia,Sabah,6036,2910,3126
1/06/2024,Indonesia,Sarawak,54953,27092,27861
1/06/2024,Indonesia,Selangor,165487,74754,90733
1/06/2024,Indonesia,W.P. Labuan,63,39,24
1/06/2024,India,Johor,50758,31531,19227
1/06/2024,India,Kedah,1905,1059,846
1/06/2024,India,Kelantan,5,4,1
1/06/2024,India,Melaka,2,2,0
1/06/2024,India,Pahang,18,17,1
1/06/2024,India,Perak,284,155,129
1/06/2024,India,Perlis,114,90,24
1/06/2024,India,Pulau Pinang,1854,1091,763
1/06/2024,India,Sabah,219,135,84
1/06/2024,India,Sarawak,2493,1907,586
1/06/2024,India,Selangor,89482,56049,33433
1/06/2024,India,W.P. Labuan,79,57,22
1/06/2024,Ireland,Johor,304,197,107
1/06/2024,Ireland,Kedah,54,31,23
1/06/2024,Ireland,Kelantan,1,1,0
1/06/2024,Ireland,Pahang,1,0,1
1/06/2024,Ireland,Perak,7,4,3
1/06/2024,Ireland,Perlis,24,15,9
1/06/2024,Ireland,Pulau Pinang,166,93,73
1/06/2024,Ireland,Sabah,28,17,11
1/06/2024,Ireland,Sarawak,31,23,8
1/06/2024,Ireland,Selangor,1755,986,769
1/06/2024,Ireland,W.P. Labuan,1,0,1
1/06/2024,"Iran, Islamic Republic of",Johor,200,115,85
1/06/2024,"Iran, Islamic Republic of",Kedah,14,4,10
1/06/2024,"Iran, Islamic Republic of",Perlis,8,7,1
1/06/2024,"Iran, Islamic Republic of",Pulau Pinang,12,8,4
1/06/2024,"Iran, Islamic Republic of",Sabah,1,1,0
1/06/2024,"Iran, Islamic Republic of",Sarawak,3,1,2
1/06/2024,"Iran, Islamic Republic of",Selangor,1672,899,773
1/06/2024,Iraq,Johor,39,30,9
1/06/2024,Iraq,Kedah,14,5,9
1/06/2024,Iraq,Pulau Pinang,2,1,1
1/06/2024,Iraq,Selangor,2478,1560,918
1/06/2024,Iceland,Johor,3,2,1
1/06/2024,Iceland,Selangor,42,22,20
1/06/2024,Italy,Johor,643,408,235
1/06/2024,Italy,Kedah,57,35,22
1/06/2024,Italy,Kelantan,3,2,1
1/06/2024,Italy,Melaka,2,2,0
1/06/2024,Italy,Pahang,2,2,0
1/06/2024,Italy,Perak,5,2,3
1/06/2024,Italy,Perlis,15,11,4
1/06/2024,Italy,Pulau Pinang,103,73,30
1/06/2024,Italy,Sabah,57,32,25
1/06/2024,Italy,Sarawak,54,30,24
1/06/2024,Italy,Selangor,3628,2215,1413
1/06/2024,Italy,W.P. Labuan,2,1,1
1/06/2024,Jamaica,Johor,3,1,2
1/06/2024,Jamaica,Pulau Pinang,1,1,0
1/06/2024,Jamaica,Selangor,13,8,5
1/06/2024,Jordan,Johor,25,18,7
1/06/2024,Jordan,Kedah,24,14,10
1/06/2024,Jordan,Kelantan,1,1,0
1/06/2024,Jordan,Pahang,1,1,0
1/06/2024,Jordan,Pulau Pinang,15,7,8
1/06/2024,Jordan,Sarawak,1,1,0
1/06/2024,Jordan,Selangor,1600,870,730
1/06/2024,Japan,Johor,6192,4164,2028
1/06/2024,Japan,Kedah,142,76,66
1/06/2024,Japan,Kelantan,7,4,3
1/06/2024,Japan,Melaka,2,2,0
1/06/2024,Japan,Pahang,16,12,4
1/06/2024,Japan,Perak,63,43,20
1/06/2024,Japan,Perlis,83,61,22
1/06/2024,Japan,Pulau Pinang,1259,924,335
1/06/2024,Japan,Sabah,347,163,184
1/06/2024,Japan,Sarawak,192,111,81
1/06/2024,Japan,Selangor,20914,12345,8569
1/06/2024,Japan,W.P. Labuan,10,6,4
1/06/2024,Kazakhstan,Johor,74,37,37
1/06/2024,Kazakhstan,Kedah,13,6,7
1/06/2024,Kazakhstan,Kelantan,2,0,2
1/06/2024,Kazakhstan,Perlis,5,2,3
1/06/2024,Kazakhstan,Pulau Pinang,10,6,4
1/06/2024,Kazakhstan,Sabah,3,2,1
1/06/2024,Kazakhstan,Sarawak,4,1,3
1/06/2024,Kazakhstan,Selangor,3717,1485,2232
1/06/2024,Kazakhstan,W.P. Labuan,1,1,0
1/06/2024,Kenya,Johor,56,27,29
1/06/2024,Kenya,Kedah,7,2,5
1/06/2024,Kenya,Pulau Pinang,10,5,5
1/06/2024,Kenya,Sabah,2,0,2
1/06/2024,Kenya,Sarawak,2,2,0
1/06/2024,Kenya,Selangor,872,423,449
1/06/2024,Kyrgyzstan,Johor,34,25,9
1/06/2024,Kyrgyzstan,Kedah,6,3,3
1/06/2024,Kyrgyzstan,Kelantan,1,0,1
1/06/2024,Kyrgyzstan,Pulau Pinang,9,5,4
1/06/2024,Kyrgyzstan,Sabah,4,2,2
1/06/2024,Kyrgyzstan,Selangor,371,180,191
1/06/2024,Cambodia,Johor,1562,659,903
1/06/2024,Cambodia,Kedah,152,97,55
1/06/2024,Cambodia,Kelantan,431,229,202
1/06/2024,Cambodia,Perak,11,4,7
1/06/2024,Cambodia,Perlis,727,419,308
1/06/2024,Cambodia,Pulau Pinang,42,15,27
1/06/2024,Cambodia,Sabah,4,0,4
1/06/2024,Cambodia,Sarawak,18,10,8
1/06/2024,Cambodia,Selangor,3813,1852,1961
1/06/2024,Saint Kitts and Nevis,Johor,22,14,8
1/06/2024,Saint Kitts and Nevis,Kedah,2,0,2
1/06/2024,Saint Kitts and Nevis,Pulau Pinang,1,1,0
1/06/2024,Saint Kitts and Nevis,Selangor,59,48,11
1/06/2024,"Korea, Republic of",Johor,9723,5374,4349
1/06/2024,"Korea, Republic of",Kedah,116,67,49
1/06/2024,"Korea, Republic of",Kelantan,7,4,3
1/06/2024,"Korea, Republic of",Pahang,2,2,0
1/06/2024,"Korea, Republic of",Perak,14,10,4
1/06/2024,"Korea, Republic of",Perlis,66,47,19
1/06/2024,"Korea, Republic of",Pulau Pinang,580,348,232
1/06/2024,"Korea, Republic of",Sabah,15562,6116,9446
1/06/2024,"Korea, Republic of",Sarawak,262,159,103
1/06/2024,"Korea, Republic of",Selangor,15547,8567,6980
1/06/2024,"Korea, Republic of",W.P. Labuan,3,0,3
1/06/2024,Kuwait,Johor,88,45,43
1/06/2024,Kuwait,Kedah,21,10,11
1/06/2024,Kuwait,Perlis,1,1,0
1/06/2024,Kuwait,Pulau Pinang,26,16,10
1/06/2024,Kuwait,Selangor,1117,608,509
1/06/2024, Lao People's Democratic Republic,Johor,185,61,124
1/06/2024, Lao People's Democratic Republic,Kedah,1041,84,957
1/06/2024, Lao People's Democratic Republic,Kelantan,168,18,150
1/06/2024, Lao People's Democratic Republic,Perak,43,5,38
1/06/2024, Lao People's Democratic Republic,Perlis,458,94,364
1/06/2024, Lao People's Democratic Republic,Pulau Pinang,66,30,36
1/06/2024, Lao People's Democratic Republic,Sabah,1,0,1
1/06/2024, Lao People's Democratic Republic,Sarawak,25,17,8
1/06/2024, Lao People's Democratic Republic,Selangor,361,115,246
1/06/2024,Lebanon,Johor,21,12,9
1/06/2024,Lebanon,Kedah,7,2,5
1/06/2024,Lebanon,Pulau Pinang,5,2,3
1/06/2024,Lebanon,Sabah,1,1,0
1/06/2024,Lebanon,Sarawak,2,2,0
1/06/2024,Lebanon,Selangor,402,234,168
1/06/2024,Liberia,Johor,2,2,0
1/06/2024,Liberia,Sarawak,1,1,0
1/06/2024,Liberia,Selangor,5,4,1
1/06/2024,Libya,Johor,4,2,2
1/06/2024,Libya,Kedah,1,1,0
1/06/2024,Libya,Selangor,363,254,109
1/06/2024,Saint Lucia,Johor,4,4,0
1/06/2024,Saint Lucia,Pulau Pinang,3,3,0
1/06/2024,Saint Lucia,Sarawak,4,2,2
1/06/2024,Saint Lucia,Selangor,13,9,4
1/06/2024,Liechtenstein,Johor,1,1,0
1/06/2024,Liechtenstein,Sabah,1,0,1
1/06/2024,Liechtenstein,Selangor,2,1,1
1/06/2024,LKA,Johor,804,494,310
1/06/2024,LKA,Kedah,37,21,16
1/06/2024,LKA,Kelantan,1,1,0
1/06/2024,LKA,Melaka,1,1,0
1/06/2024,LKA,Pahang,1,0,1
1/06/2024,LKA,Perlis,7,3,4
1/06/2024,LKA,Pulau Pinang,114,73,41
1/06/2024,LKA,Sabah,5,1,4
1/06/2024,LKA,Sarawak,31,22,9
1/06/2024,LKA,Selangor,4448,2720,1728
1/06/2024,LKA,W.P. Labuan,1,1,0
1/06/2024,Lesotho,Selangor,7,5,2
1/06/2024,Lithuania,Johor,40,24,16
1/06/2024,Lithuania,Kedah,10,4,6
1/06/2024,Lithuania,Pahang,1,1,0
1/06/2024,Lithuania,Perlis,2,1,1
1/06/2024,Lithuania,Pulau Pinang,9,4,5
1/06/2024,Lithuania,Sabah,2,2,0
1/06/2024,Lithuania,Sarawak,2,2,0
1/06/2024,Lithuania,Selangor,267,125,142
1/06/2024,Luxembourg,Johor,5,4,1
1/06/2024,Luxembourg,Kedah,2,0,2
1/06/2024,Luxembourg,Kelantan,1,1,0
1/06/2024,Luxembourg,Perlis,1,1,0
1/06/2024,Luxembourg,Pulau Pinang,1,0,1
1/06/2024,Luxembourg,Sabah,3,2,1
1/06/2024,Luxembourg,Sarawak,2,2,0
1/06/2024,Luxembourg,Selangor,52,28,24
1/06/2024,Latvia,Johor,9,7,2
1/06/2024,Latvia,Perak,1,0,1
1/06/2024,Latvia,Pulau Pinang,2,1,1
1/06/2024,Latvia,Sabah,3,1,2
1/06/2024,Latvia,Sarawak,5,4,1
1/06/2024,Latvia,Selangor,141,62,79
1/06/2024,Latvia,W.P. Labuan,3,2,1
1/06/2024,Macao,Perak,1,0,1
1/06/2024,Macao,Pulau Pinang,1,0,1
1/06/2024,Macao,Selangor,1,0,1
1/06/2024,Morocco,Johor,92,54,38
1/06/2024,Morocco,Kedah,12,7,5
1/06/2024,Morocco,Pulau Pinang,16,11,5
1/06/2024,Morocco,Sabah,4,1,3
1/06/2024,Morocco,Sarawak,11,6,5
1/06/2024,Morocco,Selangor,1226,694,532
1/06/2024,Monaco,Johor,1,1,0
1/06/2024,Monaco,Selangor,1,1,0
1/06/2024,"Moldova, Republic of",Johor,11,4,7
1/06/2024,"Moldova, Republic of",Kedah,2,1,1
1/06/2024,"Moldova, Republic of",Pahang,1,1,0
1/06/2024,"Moldova, Republic of",Pulau Pinang,1,0,1
1/06/2024,"Moldova, Republic of",Sabah,1,1,0
1/06/2024,"Moldova, Republic of",Selangor,26,16,10
1/06/2024,Madagascar,Johor,18,7,11
1/06/2024,Madagascar,Selangor,120,45,75
1/06/2024,Maldives,Johor,142,85,57
1/06/2024,Maldives,Kedah,1,1,0
1/06/2024,Maldives,Kelantan,1,1,0
1/06/2024,Maldives,Perlis,1,1,0
1/06/2024,Maldives,Pulau Pinang,6,3,3
1/06/2024,Maldives,Sarawak,1,1,0
1/06/2024,Maldives,Selangor,4053,2193,1860
1/06/2024,Mexico,Johor,148,73,75
1/06/2024,Mexico,Kedah,20,12,8
1/06/2024,Mexico,Kelantan,2,1,1
1/06/2024,Mexico,Perak,3,3,0
1/06/2024,Mexico,Perlis,3,2,1
1/06/2024,Mexico,Pulau Pinang,27,17,10
1/06/2024,Mexico,Sabah,3,2,1
1/06/2024,Mexico,Sarawak,2,2,0
1/06/2024,Mexico,Selangor,639,323,316
1/06/2024,Marshall Islands,Selangor,6,3,3
1/06/2024,North Macedonia,Johor,11,9,2
1/06/2024,North Macedonia,Kedah,3,2,1
1/06/2024,North Macedonia,Pulau Pinang,1,0,1
1/06/2024,North Macedonia,Sarawak,3,2,1
1/06/2024,North Macedonia,Selangor,25,14,11
1/06/2024,Mali,Johor,3,3,0
1/06/2024,Mali,Selangor,7,4,3
1/06/2024,Malta,Johor,12,5,7
1/06/2024,Malta,Kedah,5,3,2
1/06/2024,Malta,Pulau Pinang,2,2,0
1/06/2024,Malta,Sabah,1,1,0
1/06/2024,Malta,Sarawak,3,3,0
1/06/2024,Malta,Selangor,50,29,21
1/06/2024,Myanmar,Johor,10838,3120,7718
1/06/2024,Myanmar,Kedah,105,27,78
1/06/2024,Myanmar,Kelantan,1,0,1
1/06/2024,Myanmar,Pahang,4,3,1
1/06/2024,Myanmar,Perak,44,7,37
1/06/2024,Myanmar,Perlis,8,3,5
1/06/2024,Myanmar,Pulau Pinang,355,134,221
1/06/2024,Myanmar,Sabah,36,15,21
1/06/2024,Myanmar,Sarawak,115,52,63
1/06/2024,Myanmar,Selangor,4861,2798,2063
1/06/2024,Montenegro,Johor,4,3,1
1/06/2024,Montenegro,Selangor,7,2,5
1/06/2024,Mongolia,Johor,211,73,138
1/06/2024,Mongolia,Kedah,9,6,3
1/06/2024,Mongolia,Pulau Pinang,4,2,2
1/06/2024,Mongolia,Selangor,407,151,256
1/06/2024,Mozambique,Selangor,21,8,13
1/06/2024,Mauritania,Selangor,26,22,4
1/06/2024,Mauritius,Johor,126,71,55
1/06/2024,Mauritius,Kedah,7,4,3
1/06/2024,Mauritius,Kelantan,2,1,1
1/06/2024,Mauritius,Pahang,1,1,0
1/06/2024,Mauritius,Perlis,4,2,2
1/06/2024,Mauritius,Pulau Pinang,3,1,2
1/06/2024,Mauritius,Sabah,1,1,0
1/06/2024,Mauritius,Sarawak,1,1,0
1/06/2024,Mauritius,Selangor,1223,656,567
1/06/2024,Malawi,Johor,1,1,0
1/06/2024,Malawi,Selangor,19,12,7
1/06/2024,Namibia,Johor,4,2,2
1/06/2024,Namibia,Pulau Pinang,1,1,0
1/06/2024,Namibia,Selangor,19,11,8
1/06/2024,Nigeria,Johor,37,27,10
1/06/2024,Nigeria,Pulau Pinang,3,2,1
1/06/2024,Nigeria,Sarawak,8,7,1
1/06/2024,Nigeria,Selangor,429,331,98
1/06/2024,Nicaragua,Johor,3,2,1
1/06/2024,Nicaragua,Kedah,4,1,3
1/06/2024,Nicaragua,Sabah,1,1,0
1/06/2024,Nicaragua,Selangor,7,2,5
1/06/2024,Netherlands,Johor,948,620,328
1/06/2024,Netherlands,Kedah,165,94,71
1/06/2024,Netherlands,Kelantan,4,3,1
1/06/2024,Netherlands,Melaka,1,1,0
1/06/2024,Netherlands,Negeri Sembilan,2,0,2
1/06/2024,Netherlands,Pahang,1,0,1
1/06/2024,Netherlands,Perak,14,9,5
1/06/2024,Netherlands,Perlis,38,19,19
1/06/2024,Netherlands,Pulau Pinang,193,117,76
1/06/2024,Netherlands,Sabah,86,49,37
1/06/2024,Netherlands,Sarawak,92,63,29
1/06/2024,Netherlands,Selangor,4142,2424,1718
1/06/2024,Norway,Johor,218,132,86
1/06/2024,Norway,Kedah,18,12,6
1/06/2024,Norway,Pahang,1,1,0
1/06/2024,Norway,Perak,5,3,2
1/06/2024,Norway,Perlis,3,3,0
1/06/2024,Norway,Pulau Pinang,48,30,18
1/06/2024,Norway,Sabah,10,8,2
1/06/2024,Norway,Sarawak,18,14,4
1/06/2024,Norway,Selangor,974,573,401
1/06/2024,Nepal,Johor,1126,789,337
1/06/2024,Nepal,Kedah,24,13,11
1/06/2024,Nepal,Perlis,1,1,0
1/06/2024,Nepal,Pulau Pinang,25,22,3
1/06/2024,Nepal,Sabah,3,1,2
1/06/2024,Nepal,Sarawak,143,91,52
1/06/2024,Nepal,Selangor,2965,2593,372
1/06/2024,Nepal,W.P. Labuan,78,75,3
1/06/2024,Nauru,Selangor,4,3,1
1/06/2024,New Zealand,Johor,870,512,358
1/06/2024,New Zealand,Kedah,68,39,29
1/06/2024,New Zealand,Kelantan,1,0,1
1/06/2024,New Zealand,Pahang,4,2,2
1/06/2024,New Zealand,Perak,25,16,9
1/06/2024,New Zealand,Perlis,12,8,4
1/06/2024,New Zealand,Pulau Pinang,301,151,150
1/06/2024,New Zealand,Sabah,77,36,41
1/06/2024,New Zealand,Sarawak,144,87,57
1/06/2024,New Zealand,Selangor,3262,1904,1358
1/06/2024,New Zealand,Terengganu,1,1,0
1/06/2024,New Zealand,W.P. Labuan,5,3,2
1/06/2024,Oman,Johor,87,59,28
1/06/2024,Oman,Kedah,21,10,11
1/06/2024,Oman,Perlis,6,2,4
1/06/2024,Oman,Pulau Pinang,50,47,3
1/06/2024,Oman,Sabah,1,0,1
1/06/2024,Oman,Sarawak,20,19,1
1/06/2024,Oman,Selangor,2375,1303,1072
1/06/2024,Pakistan,Johor,711,484,227
1/06/2024,Pakistan,Kedah,189,114,75
1/06/2024,Pakistan,Kelantan,9,8,1
1/06/2024,Pakistan,Melaka,1,1,0
1/06/2024,Pakistan,Perak,4,4,0
1/06/2024,Pakistan,Perlis,11,10,1
1/06/2024,Pakistan,Pulau Pinang,101,69,32
1/06/2024,Pakistan,Sabah,15,9,6
1/06/2024,Pakistan,Sarawak,185,161,24
1/06/2024,Pakistan,Selangor,11403,8760,2643
1/06/2024,Pakistan,W.P. Labuan,3,3,0
1/06/2024,Panama,Johor,10,4,6
1/06/2024,Panama,Pulau Pinang,4,3,1
1/06/2024,Panama,Selangor,23,9,14
1/06/2024,Peru,Johor,26,15,11
1/06/2024,Peru,Kedah,3,2,1
1/06/2024,Peru,Perak,1,0,1
1/06/2024,Peru,Perlis,2,2,0
1/06/2024,Peru,Pulau Pinang,3,3,0
1/06/2024,Peru,Sabah,3,1,2
1/06/2024,Peru,Selangor,131,71,60
1/06/2024,Philippines,Johor,36097,11682,24415
1/06/2024,Philippines,Kedah,563,181,382
1/06/2024,Philippines,Kelantan,89,45,44
1/06/2024,Philippines,Melaka,2,1,1
1/06/2024,Philippines,Pahang,30,22,8
1/06/2024,Philippines,Perak,127,46,81
1/06/2024,Philippines,Perlis,282,101,181
1/06/2024,Philippines,Pulau Pinang,958,364,594
1/06/2024,Philippines,Sabah,1453,688,765
1/06/2024,Philippines,Sarawak,3054,1232,1822
1/06/2024,Philippines,Selangor,21674,8398,13276
1/06/2024,Philippines,W.P. Labuan,138,56,82
1/06/2024,Palau,Johor,3,3,0
1/06/2024,Palau,Pulau Pinang,1,1,0
1/06/2024,Palau,Selangor,1,0,1
1/06/2024,Papua New Guinea,Johor,47,7,40
1/06/2024,Papua New Guinea,Pulau Pinang,1,0,1
1/06/2024,Papua New Guinea,Sabah,1,1,0
1/06/2024,Papua New Guinea,Sarawak,3,1,2
1/06/2024,Papua New Guinea,Selangor,142,67,75
1/06/2024,Poland,Johor,342,201,141
1/06/2024,Poland,Kedah,60,31,29
1/06/2024,Poland,Kelantan,1,1,0
1/06/2024,Poland,Pahang,2,2,0
1/06/2024,Poland,Perak,4,2,2
1/06/2024,Poland,Perlis,3,2,1
1/06/2024,Poland,Pulau Pinang,45,23,22
1/06/2024,Poland,Sabah,30,16,14
1/06/2024,Poland,Sarawak,46,27,19
1/06/2024,Poland,Selangor,1529,772,757
1/06/2024,Portugal,Johor,184,105,79
1/06/2024,Portugal,Kedah,17,8,9
1/06/2024,Portugal,Kelantan,1,1,0
1/06/2024,Portugal,Perlis,2,0,2
1/06/2024,Portugal,Pulau Pinang,30,17,13
1/06/2024,Portugal,Sabah,26,12,14
1/06/2024,Portugal,Sarawak,12,6,6
1/06/2024,Portugal,Selangor,782,447,335
1/06/2024,Portugal,W.P. Labuan,3,1,2
1/06/2024,Paraguay,Johor,1,1,0
1/06/2024,Paraguay,Selangor,21,12,9
1/06/2024,"Palestine, State of",Johor,12,11,1
1/06/2024,"Palestine, State of",Kedah,13,9,4
1/06/2024,"Palestine, State of",Pulau Pinang,3,2,1
1/06/2024,"Palestine, State of",Selangor,491,293,198
1/06/2024,Qatar,Johor,24,8,16
1/06/2024,Qatar,Kedah,7,3,4
1/06/2024,Qatar,Perlis,2,2,0
1/06/2024,Qatar,Pulau Pinang,6,4,2
1/06/2024,Qatar,Sarawak,1,1,0
1/06/2024,Qatar,Selangor,389,230,159
1/06/2024,Romania,Johor,115,69,46
1/06/2024,Romania,Kedah,13,5,8
1/06/2024,Romania,Pahang,1,1,0
1/06/2024,Romania,Perak,1,0,1
1/06/2024,Romania,Perlis,3,2,1
1/06/2024,Romania,Pulau Pinang,23,12,11
1/06/2024,Romania,Sabah,7,1,6
1/06/2024,Romania,Sarawak,2,0,2
1/06/2024,Romania,Selangor,480,272,208
1/06/2024,Russian Federation (Russia),Johor,473,216,257
1/06/2024,Russian Federation (Russia),Kedah,129,72,57
1/06/2024,Russian Federation (Russia),Kelantan,34,19,15
1/06/2024,Russian Federation (Russia),Melaka,1,1,0
1/06/2024,Russian Federation (Russia),Pahang,1,0,1
1/06/2024,Russian Federation (Russia),Perak,5,3,2
1/06/2024,Russian Federation (Russia),Perlis,57,39,18
1/06/2024,Russian Federation (Russia),Pulau Pinang,80,34,46
1/06/2024,Russian Federation (Russia),Sabah,62,30,32
1/06/2024,Russian Federation (Russia),Sarawak,42,19,23
1/06/2024,Russian Federation (Russia),Selangor,7576,3710,3866
1/06/2024,Russian Federation (Russia),W.P. Labuan,9,4,5
1/06/2024,Rwanda,Johor,1,1,0
1/06/2024,Rwanda,Selangor,6,4,2
1/06/2024,Saudi Arabia,Johor,394,209,185
1/06/2024,Saudi Arabia,Kedah,158,82,76
1/06/2024,Saudi Arabia,Kelantan,4,3,1
1/06/2024,Saudi Arabia,Perak,4,1,3
1/06/2024,Saudi Arabia,Perlis,2,1,1
1/06/2024,Saudi Arabia,Pulau Pinang,135,58,77
1/06/2024,Saudi Arabia,Sabah,3,2,1
1/06/2024,Saudi Arabia,Sarawak,4,3,1
1/06/2024,Saudi Arabia,Selangor,10757,5812,4945
1/06/2024,Sudan,Johor,15,13,2
1/06/2024,Sudan,Kedah,4,3,1
1/06/2024,Sudan,Perlis,1,1,0
1/06/2024,Sudan,Pulau Pinang,3,1,2
1/06/2024,Sudan,Sarawak,2,0,2
1/06/2024,Sudan,Selangor,1506,838,668
1/06/2024,Sudan,W.P. Labuan,2,2,0
1/06/2024,Senegal,Johor,6,5,1
1/06/2024,Senegal,Kedah,1,1,0
1/06/2024,Senegal,Pulau Pinang,1,0,1
1/06/2024,Senegal,Selangor,54,39,15
1/06/2024,Singapore,Johor,1684536,931196,753340
1/06/2024,Singapore,Kedah,8231,4175,4056
1/06/2024,Singapore,Kelantan,212,124,88
1/06/2024,Singapore,Melaka,49,35,14
1/06/2024,Singapore,Negeri Sembilan,3,0,3
1/06/2024,Singapore,Pahang,882,439,443
1/06/2024,Singapore,Perak,8977,4127,4850
1/06/2024,Singapore,Perlis,522,286,236
1/06/2024,Singapore,Pulau Pinang,28598,13835,14763
1/06/2024,Singapore,Sabah,4053,2008,2045
1/06/2024,Singapore,Sarawak,5684,3078,2606
1/06/2024,Singapore,Selangor,63733,32034,31699
1/06/2024,Singapore,W.P. Labuan,12,11,1
1/06/2024,Solomon Islands,Johor,8,2,6
1/06/2024,Solomon Islands,Pulau Pinang,1,1,0
1/06/2024,Solomon Islands,Sarawak,4,1,3
1/06/2024,Solomon Islands,Selangor,13,5,8
1/06/2024,Sierra Leone,Johor,3,1,2
1/06/2024,Sierra Leone,Kedah,1,1,0
1/06/2024,Sierra Leone,Kelantan,1,1,0
1/06/2024,Sierra Leone,Selangor,34,18,16
1/06/2024,El Salvador,Johor,1,1,0
1/06/2024,El Salvador,Pulau Pinang,2,2,0
1/06/2024,El Salvador,Sabah,1,0,1
1/06/2024,El Salvador,Selangor,13,4,9
1/06/2024,San Marino,Selangor,1,1,0
1/06/2024,Somalia,Selangor,232,144,88
1/06/2024,Serbia,Johor,5,4,1
1/06/2024,Serbia,Perlis,1,1,0
1/06/2024,Serbia,Selangor,101,50,51
1/06/2024,South Sudan,Kedah,1,1,0
1/06/2024,South Sudan,Pulau Pinang,2,0,2
1/06/2024,South Sudan,Sarawak,2,2,0
1/06/2024,South Sudan,Selangor,33,16,17
1/06/2024,Sao Tome and Principe,Selangor,1,1,0
1/06/2024,Suriname,Johor,5,3,2
1/06/2024,Suriname,Sabah,2,2,0
1/06/2024,Suriname,Selangor,14,11,3
1/06/2024,Slovakia,Johor,56,34,22
1/06/2024,Slovakia,Kedah,29,13,16
1/06/2024,Slovakia,Perlis,1,0,1
1/06/2024,Slovakia,Pulau Pinang,10,5,5
1/06/2024,Slovakia,Sabah,2,1,1
1/06/2024,Slovakia,Sarawak,5,3,2
1/06/2024,Slovakia,Selangor,285,156,129
1/06/2024,Slovenia,Johor,10,6,4
1/06/2024,Slovenia,Kedah,4,1,3
1/06/2024,Slovenia,Pulau Pinang,7,3,4
1/06/2024,Slovenia,Sarawak,2,1,1
1/06/2024,Slovenia,Selangor,194,97,97
1/06/2024,Sweden,Johor,313,195,118
1/06/2024,Sweden,Kedah,33,12,21
1/06/2024,Sweden,Kelantan,17,8,9
1/06/2024,Sweden,Pahang,2,2,0
1/06/2024,Sweden,Perak,5,1,4
1/06/2024,Sweden,Perlis,7,6,1
1/06/2024,Sweden,Pulau Pinang,133,87,46
1/06/2024,Sweden,Sabah,16,8,8
1/06/2024,Sweden,Sarawak,28,17,11
1/06/2024,Sweden,Selangor,1018,593,425
1/06/2024,Sweden,W.P. Labuan,5,2,3
1/06/2024,Eswatini,Johor,3,2,1
1/06/2024,Eswatini,Selangor,53,28,25
1/06/2024,Seychelles,Johor,3,2,1
1/06/2024,Seychelles,Pulau Pinang,1,1,0
1/06/2024,Seychelles,Selangor,92,33,59
1/06/2024,Syrian Arab Republic,Johor,23,16,7
1/06/2024,Syrian Arab Republic,Kedah,32,17,15
1/06/2024,Syrian Arab Republic,Pulau Pinang,4,3,1
1/06/2024,Syrian Arab Republic,Sabah,4,1,3
1/06/2024,Syrian Arab Republic,Sarawak,8,6,2
1/06/2024,Syrian Arab Republic,Selangor,912,514,398
1/06/2024,TCD,Johor,9,7,2
1/06/2024,TCD,Pulau Pinang,1,1,0
1/06/2024,TCD,Selangor,31,26,5
1/06/2024,Togo,Johor,2,2,0
1/06/2024,Togo,Sabah,1,1,0
1/06/2024,Togo,Selangor,5,4,1
1/06/2024,Thailand,Johor,7062,1622,5440
1/06/2024,Thailand,Kedah,47857,26418,21439
1/06/2024,Thailand,Kelantan,50235,25102,25133
1/06/2024,Thailand,Melaka,6,4,2
1/06/2024,Thailand,Pahang,29,23,6
1/06/2024,Thailand,Perak,9023,4335,4688
1/06/2024,Thailand,Perlis,47503,26921,20582
1/06/2024,Thailand,Pulau Pinang,3132,1231,1901
1/06/2024,Thailand,Sabah,25,6,19
1/06/2024,Thailand,Sarawak,418,128,290
1/06/2024,Thailand,Selangor,13695,5023,8672
1/06/2024,Thailand,W.P. Labuan,11,4,7
1/06/2024,Tajikistan,Selangor,201,139,62
1/06/2024,Turkmenistan,Johor,1,0,1
1/06/2024,Turkmenistan,Pulau Pinang,2,2,0
1/06/2024,Turkmenistan,Sarawak,1,1,0
1/06/2024,Turkmenistan,Selangor,580,318,262
1/06/2024,Timor-Leste,Johor,12,6,6
1/06/2024,Timor-Leste,Perak,6,2,4
1/06/2024,Timor-Leste,Pulau Pinang,12,2,10
1/06/2024,Timor-Leste,Selangor,296,171,125
1/06/2024,Tonga,Johor,1,1,0
1/06/2024,Tonga,Pulau Pinang,1,0,1
1/06/2024,Tonga,Selangor,15,8,7
1/06/2024,Trinidad and Tobago,Johor,6,5,1
1/06/2024,Trinidad and Tobago,Kedah,1,1,0
1/06/2024,Trinidad and Tobago,Pulau Pinang,1,1,0
1/06/2024,Trinidad and Tobago,Sabah,1,1,0
1/06/2024,Trinidad and Tobago,Sarawak,1,0,1
1/06/2024,Trinidad and Tobago,Selangor,29,13,16
1/06/2024,Tunisia,Johor,20,12,8
1/06/2024,Tunisia,Kedah,6,3,3
1/06/2024,Tunisia,Kelantan,1,1,0
1/06/2024,Tunisia,Pulau Pinang,5,1,4
1/06/2024,Tunisia,Sarawak,1,1,0
1/06/2024,Tunisia,Selangor,476,244,232
1/06/2024,Türkiye,Johor,357,243,114
1/06/2024,Türkiye,Kedah,51,34,17
1/06/2024,Türkiye,Kelantan,6,5,1
1/06/2024,Türkiye,Melaka,1,1,0
1/06/2024,Türkiye,Perak,3,2,1
1/06/2024,Türkiye,Perlis,7,6,1
1/06/2024,Türkiye,Pulau Pinang,35,25,10
1/06/2024,Türkiye,Sabah,2,2,0
1/06/2024,Türkiye,Sarawak,26,19,7
1/06/2024,Türkiye,Selangor,2549,1509,1040
1/06/2024,Tuvalu,Selangor,1,0,1
1/06/2024,"Taiwan, Province of China",Johor,9187,3913,5274
1/06/2024,"Taiwan, Province of China",Kedah,224,112,112
1/06/2024,"Taiwan, Province of China",Kelantan,3,3,0
1/06/2024,"Taiwan, Province of China",Melaka,3,1,2
1/06/2024,"Taiwan, Province of China",Pahang,6,5,1
1/06/2024,"Taiwan, Province of China",Perak,77,38,39
1/06/2024,"Taiwan, Province of China",Perlis,45,22,23
1/06/2024,"Taiwan, Province of China",Pulau Pinang,5005,2385,2620
1/06/2024,"Taiwan, Province of China",Sabah,3056,1431,1625
1/06/2024,"Taiwan, Province of China",Sarawak,307,125,182
1/06/2024,"Taiwan, Province of China",Selangor,22555,10704,11851
1/06/2024,"Taiwan, Province of China",W.P. Labuan,1,1,0
1/06/2024,"Tanzania, United Republic of",Johor,36,17,19
1/06/2024,"Tanzania, United Republic of",Pulau Pinang,1,0,1
1/06/2024,"Tanzania, United Republic of",Sarawak,4,4,0
1/06/2024,"Tanzania, United Republic of",Selangor,225,112,113
1/06/2024,Uganda,Johor,16,6,10
1/06/2024,Uganda,Kedah,1,0,1
1/06/2024,Uganda,Pahang,1,1,0
1/06/2024,Uganda,Pulau Pinang,1,0,1
1/06/2024,Uganda,Sabah,1,0,1
1/06/2024,Uganda,Selangor,154,62,92
1/06/2024,Ukraine,Johor,106,50,56
1/06/2024,Ukraine,Kedah,8,4,4
1/06/2024,Ukraine,Kelantan,18,7,11
1/06/2024,Ukraine,Perak,1,0,1
1/06/2024,Ukraine,Perlis,1,0,1
1/06/2024,Ukraine,Pulau Pinang,38,18,20
1/06/2024,Ukraine,Sabah,9,3,6
1/06/2024,Ukraine,Sarawak,2,1,1
1/06/2024,Ukraine,Selangor,921,460,461
1/06/2024,Uruguay,Johor,7,1,6
1/06/2024,Uruguay,Kedah,2,0,2
1/06/2024,Uruguay,Pulau Pinang,1,1,0
1/06/2024,Uruguay,Selangor,61,30,31
1/06/2024,United States of America,Johor,5886,3360,2526
1/06/2024,United States of America,Kedah,431,212,219
1/06/2024,United States of America,Kelantan,20,15,5
1/06/2024,United States of America,Pahang,13,10,3
1/06/2024,United States of America,Perak,180,105,75
1/06/2024,United States of America,Perlis,148,103,45
1/06/2024,United States of America,Pulau Pinang,2644,1547,1097
1/06/2024,United States of America,Sabah,787,502,285
1/06/2024,United States of America,Sarawak,402,198,204
1/06/2024,United States of America,Selangor,18228,10175,8053
1/06/2024,United States of America,Terengganu,2,2,0
1/06/2024,United States of America,W.P. Labuan,5,5,0
1/06/2024,Uzbekistan,Johor,83,62,21
1/06/2024,Uzbekistan,Kedah,3,2,1
1/06/2024,Uzbekistan,Kelantan,2,2,0
1/06/2024,Uzbekistan,Pulau Pinang,1,1,0
1/06/2024,Uzbekistan,Sabah,5,2,3
1/06/2024,Uzbekistan,Selangor,1225,673,552
1/06/2024,Holy See,Selangor,1,0,1
1/06/2024,Saint Vincent and the Grenadines,Selangor,1,1,0
1/06/2024,"Venezuela, Bolivarian Republic of",Johor,11,9,2
1/06/2024,"Venezuela, Bolivarian Republic of",Kedah,2,2,0
1/06/2024,"Venezuela, Bolivarian Republic of",Perlis,1,0,1
1/06/2024,"Venezuela, Bolivarian Republic of",Pulau Pinang,4,3,1
1/06/2024,"Venezuela, Bolivarian Republic of",Sabah,1,1,0
1/06/2024,"Venezuela, Bolivarian Republic of",Sarawak,4,3,1
1/06/2024,"Venezuela, Bolivarian Republic of",Selangor,76,40,36
1/06/2024,Viet Nam,Johor,22007,7263,14744
1/06/2024,Viet Nam,Kedah,421,51,370
1/06/2024,Viet Nam,Kelantan,15,7,8
1/06/2024,Viet Nam,Melaka,1,1,0
1/06/2024,Viet Nam,Pahang,1,0,1
1/06/2024,Viet Nam,Perak,83,7,76
1/06/2024,Viet Nam,Perlis,301,23,278
1/06/2024,Viet Nam,Pulau Pinang,1886,573,1313
1/06/2024,Viet Nam,Sabah,24,4,20
1/06/2024,Viet Nam,Sarawak,296,44,252
1/06/2024,Viet Nam,Selangor,18665,6462,12203
1/06/2024,Viet Nam,W.P. Labuan,3,0,3
1/06/2024,Vanuatu,Johor,40,32,8
1/06/2024,Vanuatu,Pulau Pinang,10,7,3
1/06/2024,Vanuatu,Sabah,2,1,1
1/06/2024,Vanuatu,Selangor,118,103,15
1/06/2024, Samoa,Selangor,2,2,0
1/06/2024,Yemen,Johor,57,36,21
1/06/2024,Yemen,Kedah,7,5,2
1/06/2024,Yemen,Melaka,1,1,0
1/06/2024,Yemen,Perlis,5,5,0
1/06/2024,Yemen,Pulau Pinang,10,6,4
1/06/2024,Yemen,Sabah,1,1,0
1/06/2024,Yemen,Sarawak,3,2,1
1/06/2024,Yemen,Selangor,1731,1065,666
1/06/2024,South Africa,Johor,404,230,174
1/06/2024,South Africa,Kedah,61,30,31
1/06/2024,South Africa,Pahang,9,5,4
1/06/2024,South Africa,Perak,2,1,1
1/06/2024,South Africa,Perlis,25,15,10
1/06/2024,South Africa,Pulau Pinang,84,43,41
1/06/2024,South Africa,Sabah,27,16,11
1/06/2024,South Africa,Sarawak,88,39,49
1/06/2024,South Africa,Selangor,1178,637,541
1/06/2024,South Africa,W.P. Labuan,3,1,2
1/06/2024,ZAR,Selangor,5,3,2
1/06/2024,Zambia,Johor,6,5,1
1/06/2024,Zambia,Pulau Pinang,1,1,0
1/06/2024,Zambia,Selangor,70,33,37
1/06/2024,Zimbabwe,Johor,14,8,6
1/06/2024,Zimbabwe,Pulau Pinang,3,1,2
1/06/2024,Zimbabwe,Selangor,164,82,82
